,car.id,car.type,startDatetime,startTimestamp,gate.name,duration,endTimestamp,endDatetime
5427,20153203033246-681,1,5/6/2015 6:12,1430917945,C0,75193,1430993138,5/7/2015 3:05
6384,20155101065139-549,1,5/9/2015 0:18,1431155939,C0,83455,1431239394,5/9/2015 23:29
4921,20153003023054-91,3,5/11/2015 8:11,1431357102,C0,83556,1431440658,5/12/2015 7:24
6124,20150104050128-43,2,5/11/2015 16:13,1431385984,C0,601896,1431987880,5/18/2015 15:24
122,20154911084948-971,3,5/15/2015 7:47,1431701241,C0,113951,1431815192,5/16/2015 15:26
6144,20152602012639-340,3,5/15/2015 11:47,1431715677,C0,372426,1432088103,5/19/2015 19:15
1630,20152209012245-920,2,5/15/2015 22:48,1431755307,C0,276171,1432031478,5/19/2015 3:31
6002,20155809125852-460,2,5/17/2015 20:17,1431919026,C0,358747,1432277773,5/21/2015 23:56
763,20154001044056-714,3,5/21/2015 21:23,1432268637,C0,249283,1432517920,5/24/2015 18:38
1143,20151319101335-59,2,5/22/2015 10:11,1432314701,C0,86362,1432401063,5/23/2015 10:11
6037,20152503032527-873,1,5/23/2015 3:09,1432375784,C0,240551,1432616335,5/25/2015 21:58
2956,20154913014902-715,2,5/25/2015 6:54,1432562098,C0,505978,1433068076,5/31/2015 3:27
4726,20155020055005-112,1,5/25/2015 17:19,1432599557,C0,53769,1432653326,5/26/2015 8:15
3844,20154410124411-337,1,5/26/2015 11:19,1432664355,C0,172163,1432836518,5/28/2015 11:08
6426,20153426063448-128,3,5/27/2015 11:37,1432751857,C0,104569,1432856426,5/28/2015 16:40
4783,20154823064844-637,2,5/27/2015 12:16,1432754192,C0,182634,1432936826,5/29/2015 15:00
5873,20153622123619-566,2,5/28/2015 3:10,1432807856,C0,69211,1432877067,5/28/2015 22:24
5980,20152625012610-60,1,6/1/2015 9:19,1433175599,C0,590029,1433765628,6/8/2015 5:13
2154,20151431111405-813,1,6/2/2015 1:49,1433234943,C0,69449,1433304392,6/2/2015 21:06
3725,20150617090658-734,1,6/2/2015 8:15,1433258133,C0,197045,1433455178,6/4/2015 14:59
2707,20155102045121-443,1,6/3/2015 15:32,1433370758,C0,81677,1433452435,6/4/2015 14:13
3586,20155102095112-902,3,6/5/2015 3:50,1433501403,C0,79177,1433580580,6/6/2015 1:49
3301,20152703012746-542,1,6/5/2015 16:39,1433547598,C0,92166,1433639764,6/6/2015 18:16
1530,20154129084107-872,1,6/6/2015 5:10,1433592611,C0,84818,1433677429,6/7/2015 4:43
1155,20153704013734-599,1,6/6/2015 8:53,1433606002,C0,77874,1433683876,6/7/2015 6:31
5636,20151505041552-201,1,6/6/2015 16:35,1433633748,C0,87596,1433721344,6/7/2015 16:55
5292,20152203012222-575,1,6/6/2015 20:55,1433649322,C0,95460,1433744782,6/7/2015 23:26
6193,20151329121310-651,2,6/6/2015 21:37,1433651871,C0,103583,1433755454,6/8/2015 2:24
4296,20152704012752-116,3,6/7/2015 3:50,1433674220,C0,112274,1433786494,6/8/2015 11:01
5178,20155803095829-960,3,6/7/2015 12:29,1433705355,C0,177323,1433882678,6/9/2015 13:44
2236,20152202102255-946,1,6/7/2015 21:58,1433739508,C0,473733,1434213241,6/13/2015 9:34
2599,20154005074031-234,1,6/8/2015 1:50,1433753449,C0,79406,1433832855,6/8/2015 23:54
3178,20152005082009-82,2,6/8/2015 10:30,1433784618,C0,89003,1433873621,6/9/2015 11:13
473,20150404040434-742,3,6/8/2015 18:35,1433813732,C0,354658,1434168390,6/12/2015 21:06
5456,20150002070024-376,2,6/9/2015 6:49,1433857764,C0,302070,1434159834,6/12/2015 18:43
2920,20150805010805-339,1,6/9/2015 17:05,1433894751,C0,179933,1434074684,6/11/2015 19:04
4017,20152707062703-3,2,6/9/2015 18:56,1433901369,C0,108873,1434010242,6/11/2015 1:10
5070,20151708021738-621,1,6/10/2015 23:24,1434003888,C0,102815,1434106703,6/12/2015 3:58
1367,20151009061043-83,1,6/12/2015 4:03,1434107017,C0,125787,1434232804,6/13/2015 15:00
5471,20155306125304-711,2,6/12/2015 9:53,1434128035,C0,169217,1434297252,6/14/2015 8:54
406,20155517035538-277,1,6/12/2015 22:18,1434172710,C0,324196,1434496906,6/16/2015 16:21
3972,20152603062609-710,2,6/13/2015 7:40,1434206413,C0,434222,1434640635,6/18/2015 8:17
5115,20154003064021-184,2,6/13/2015 16:48,1434239285,C0,112558,1434351843,6/15/2015 0:04
6558,20154005024018-445,1,6/15/2015 11:58,1434394737,C0,284773,1434679510,6/18/2015 19:05
3858,20154407024412-194,1,6/15/2015 22:51,1434433890,C0,240146,1434674036,6/18/2015 17:33
4145,20153909123913-261,2,6/16/2015 11:44,1434480298,C0,85935,1434566233,6/17/2015 11:37
5342,20152315122321-162,3,6/16/2015 11:49,1434480596,C0,84395,1434564991,6/17/2015 11:16
3765,20153708073703-436,2,6/16/2015 13:16,1434485761,C0,355769,1434841530,6/20/2015 16:05
2440,20155813115831-288,1,6/17/2015 5:33,1434544435,C0,161262,1434705697,6/19/2015 2:21
3312,20152313102357-845,2,6/17/2015 10:11,1434561118,C0,344881,1434905999,6/21/2015 9:59
6461,20150409100452-47,1,6/18/2015 6:40,1434634837,C0,255115,1434889952,6/21/2015 5:32
3853,20154211054209-984,2,6/18/2015 9:17,1434644225,C0,406612,1435050837,6/23/2015 2:13
5674,20155004085057-252,3,6/18/2015 19:48,1434682109,C0,178436,1434860545,6/20/2015 21:22
2900,20153007083052-124,1,6/18/2015 23:03,1434693811,C0,334253,1435028064,6/22/2015 19:54
1277,20152311102347-770,1,6/19/2015 4:55,1434714909,C0,95926,1434810835,6/20/2015 7:33
3641,20154916014913-150,3,6/19/2015 6:19,1434719983,C0,116115,1434836098,6/20/2015 14:34
540,20154914054916-877,2,6/19/2015 17:47,1434761221,C0,61695,1434822916,6/20/2015 10:55
5748,20153417073443-887,3,6/20/2015 2:58,1434794281,C0,80866,1434875147,6/21/2015 1:25
3144,20155418045458-340,1,6/20/2015 12:47,1434829636,C0,157938,1434987574,6/22/2015 8:39
3847,20155514115559-607,1,6/20/2015 14:04,1434834276,C0,526117,1435360393,6/26/2015 16:13
1806,20153202123219-728,3,6/21/2015 13:32,1434918779,C0,205655,1435124434,6/23/2015 22:40
2579,20155228125229-86,3,6/21/2015 17:09,1434931765,C0,261127,1435192892,6/24/2015 17:41
3983,20151619061642-149,2,6/21/2015 22:39,1434951586,C0,115892,1435067478,6/23/2015 6:51
278,20151712051721-6,1,6/22/2015 5:26,1434975960,C0,273773,1435249733,6/25/2015 9:28
2787,20154119094154-19,2,6/22/2015 6:35,1434980121,C0,82669,1435062790,6/23/2015 5:33
4196,20155720025749-383,1,6/22/2015 10:54,1434995665,C0,52732,1435048397,6/23/2015 1:33
2763,20152519052551-298,1,6/22/2015 18:21,1435022496,C0,262545,1435285041,6/25/2015 19:17
2856,20151711011732-63,3,6/22/2015 19:40,1435027225,C0,973373,1436000598,7/4/2015 2:03
6078,20154019104036-155,2,6/22/2015 21:44,1435034690,C0,299054,1435333744,6/26/2015 8:49
6279,20152912072922-999,1,6/23/2015 10:52,1435081936,C0,481287,1435563223,6/29/2015 0:33
3226,20155515095508-771,2,6/24/2015 17:07,1435190846,C0,803538,1435994384,7/4/2015 0:19
2457,20151816031811-238,1,6/25/2015 0:26,1435217217,C0,362063,1435579280,6/29/2015 5:01
1704,20154118104113-978,3,6/25/2015 1:39,1435221579,C0,81758,1435303337,6/26/2015 0:22
1889,20153123053127-918,1,6/25/2015 4:58,1435233517,C0,63815,1435297332,6/25/2015 22:42
3237,20153721043746-702,3,6/25/2015 15:53,1435272804,C0,171469,1435444273,6/27/2015 15:31
3484,20150723090724-2,1,6/25/2015 19:07,1435284430,C0,208786,1435493216,6/28/2015 5:06
2863,20154420054455-558,2,6/25/2015 22:43,1435297396,C0,149967,1435447363,6/27/2015 16:22
5095,20150422080420-314,3,6/26/2015 7:08,1435327715,C0,114085,1435441800,6/27/2015 14:50
1498,20151924051901-835,2,6/26/2015 16:45,1435362345,C0,170804,1435533149,6/28/2015 16:12
2166,20151805061831-133,1,6/26/2015 19:21,1435371695,C0,567473,1435939168,7/3/2015 8:59
3115,20154126064136-539,3,6/27/2015 7:15,1435414537,C0,88441,1435502978,6/28/2015 7:49
516,20152120062126-798,2,6/27/2015 9:20,1435422038,C0,87936,1435509974,6/28/2015 9:46
5541,20154522074550-726,3,6/28/2015 9:29,1435508942,C0,262296,1435771238,7/1/2015 10:20
5540,20151919051903-993,3,6/28/2015 16:40,1435534815,C0,96909,1435631724,6/29/2015 19:35
179,20154824124835-785,1,6/28/2015 17:26,1435537565,C0,181125,1435718690,6/30/2015 19:44
2285,20155228125210-442,3,6/29/2015 17:54,1435625660,C0,104530,1435730190,6/30/2015 22:56
1230,20153529083516-535,1,6/30/2015 8:14,1435677256,C0,85140,1435762396,7/1/2015 7:53
4388,20151127061106-88,3,6/30/2015 12:57,1435694220,C0,94518,1435788738,7/1/2015 15:12
5552,20155626105649-404,1,6/30/2015 15:17,1435702633,C0,120408,1435823041,7/2/2015 0:44
5154,20152729032750-703,2,7/1/2015 1:37,1435739854,C0,61492,1435801346,7/1/2015 18:42
5488,20151726071747-488,1,7/1/2015 9:45,1435769133,C0,440866,1436209999,7/6/2015 12:13
5352,20151614091646-956,1,7/1/2015 17:05,1435795542,C0,213848,1436009390,7/4/2015 4:29
4757,20155026035048-916,1,7/1/2015 18:23,1435800237,C0,63027,1435863264,7/2/2015 11:54
1153,20151823081833-359,1,7/1/2015 18:27,1435800475,C0,103966,1435904441,7/2/2015 23:20
1327,20153626023632-111,1,7/2/2015 0:32,1435822320,C0,233864,1436056184,7/4/2015 17:29
41,20153419063412-632,1,7/2/2015 6:44,1435844676,C0,140478,1435985154,7/3/2015 21:45
339,20150129090159-131,2,7/2/2015 8:34,1435851266,C0,85849,1435937115,7/3/2015 8:25
2450,20150820070819-746,2,7/2/2015 16:08,1435878491,C0,133649,1436012140,7/4/2015 5:15
3929,20151020081012-980,1,7/2/2015 18:45,1435887916,C0,537452,1436425368,7/9/2015 0:02
4164,20153101083156-266,2,7/2/2015 20:56,1435895797,C0,131081,1436026878,7/4/2015 9:21
5478,20152730062723-66,2,7/3/2015 6:30,1435930256,C0,86471,1436016727,7/4/2015 6:32
2609,20151802061810-813,1,7/3/2015 9:21,1435940480,C0,97390,1436037870,7/4/2015 12:24
4095,20152730062720-372,1,7/3/2015 15:57,1435964225,C0,97795,1436062020,7/4/2015 19:07
5578,20151330051300-634,1,7/3/2015 16:21,1435965695,C0,256115,1436221810,7/6/2015 15:30
1067,20153620053622-72,1,7/3/2015 19:24,1435976677,C0,161385,1436138062,7/5/2015 16:14
5076,20155412025439-711,2,7/4/2015 1:16,1435997783,C0,231463,1436229246,7/6/2015 17:34
3361,20154730124723-254,3,7/4/2015 8:28,1436023687,C0,330044,1436353731,7/8/2015 4:08
2239,20154830104827-205,1,7/4/2015 13:02,1436040169,C0,176831,1436217000,7/6/2015 14:10
2337,20150614120640-492,1,7/4/2015 19:02,1436061754,C0,250422,1436312176,7/7/2015 16:36
5368,20151927041904-297,3,7/4/2015 20:14,1436066084,C0,309470,1436375554,7/8/2015 10:12
1553,20152529092504-987,2,7/5/2015 2:04,1436087074,C0,245985,1436333059,7/7/2015 22:24
6440,20153730013733-766,3,7/5/2015 20:04,1436151842,C0,65027,1436216869,7/6/2015 14:07
3645,20151927101928-443,1,7/5/2015 23:52,1436165527,C0,246653,1436412180,7/8/2015 20:23
6544,20151028011029-820,3,7/6/2015 4:49,1436183349,C0,82640,1436265989,7/7/2015 3:46
4475,20154426024411-840,2,7/6/2015 6:13,1436188418,C0,277789,1436466207,7/9/2015 11:23
177,20150926110958-805,2,7/6/2015 8:42,1436197372,C0,285058,1436482430,7/9/2015 15:53
1376,20155418045455-317,2,7/6/2015 14:02,1436216571,C0,772438,1436989009,7/15/2015 12:36
6270,20153505093535-456,2,7/6/2015 20:05,1436238356,C0,124221,1436362577,7/8/2015 6:36
3578,20153125023115-598,1,7/7/2015 0:40,1436254854,C0,328993,1436583847,7/10/2015 20:04
1348,20155030015058-336,1,7/7/2015 5:14,1436271294,C0,286918,1436558212,7/10/2015 12:56
4228,20151404021437-954,3,7/7/2015 7:44,1436280264,C0,235787,1436516051,7/10/2015 1:14
525,20155525015513-235,2,7/7/2015 14:01,1436302897,C0,345728,1436648625,7/11/2015 14:03
5384,20153205083252-86,1,7/7/2015 16:52,1436313145,C0,202773,1436515918,7/10/2015 1:11
3330,20155003045027-887,1,7/8/2015 7:43,1436366617,C0,399190,1436765807,7/12/2015 22:36
326,20155805025842-634,1,7/8/2015 13:24,1436387071,C0,406507,1436793578,7/13/2015 6:19
704,20150025040004-379,2,7/8/2015 14:16,1436390180,C0,159568,1436549748,7/10/2015 10:35
1278,20151106041146-807,1,7/8/2015 14:55,1436392508,C0,84101,1436476609,7/9/2015 14:16
6399,20150929060957-709,1,7/8/2015 15:09,1436393341,C0,101243,1436494584,7/9/2015 19:16
5890,20154520014506-55,1,7/8/2015 15:43,1436395390,C0,781142,1437176532,7/17/2015 16:42
733,20152116022122-905,1,7/8/2015 15:58,1436396286,C0,272372,1436668658,7/11/2015 19:37
3365,20155603015621-472,2,7/8/2015 16:24,1436397855,C0,62982,1436460837,7/9/2015 9:53
4260,20151002101014-792,3,7/9/2015 0:35,1436427332,C0,190106,1436617438,7/11/2015 5:23
1857,20153130083112-439,2,7/9/2015 2:38,1436434696,C0,378212,1436812908,7/13/2015 11:41
6063,20155021125027-18,1,7/9/2015 3:46,1436438787,C0,507520,1436946307,7/15/2015 0:45
312,20154821034852-404,1,7/9/2015 22:12,1436505148,C0,789108,1437294256,7/19/2015 1:24
987,20150603090639-155,3,7/10/2015 4:45,1436528705,C0,294553,1436823258,7/13/2015 14:34
6472,20151315031359-879,2,7/10/2015 6:05,1436533511,C0,265884,1436799395,7/13/2015 7:56
3532,20154926014915-775,2,7/10/2015 7:12,1436537539,C0,592892,1437130431,7/17/2015 3:53
2490,20152608112631-387,3,7/10/2015 17:41,1436575297,C0,195306,1436770603,7/12/2015 23:56
995,20153406083403-509,2,7/11/2015 2:39,1436607553,C0,205355,1436812908,7/13/2015 11:41
5957,20153204053251-894,2,7/11/2015 7:09,1436623788,C0,189139,1436812927,7/13/2015 11:42
5759,20153830123835-677,1,7/11/2015 10:22,1436635347,C0,117779,1436753126,7/12/2015 19:05
1991,20151004061009-733,2,7/11/2015 11:01,1436637711,C0,622302,1437260013,7/18/2015 15:53
4546,20155901015947-373,2,7/11/2015 11:53,1436640803,C0,285472,1436926275,7/14/2015 19:11
2583,20152902012912-255,3,7/11/2015 17:13,1436660001,C0,263683,1436923684,7/14/2015 18:28
3571,20155309115300-960,1,7/12/2015 0:50,1436687415,C0,73145,1436760560,7/12/2015 21:09
3771,20152206032259-605,2,7/12/2015 10:12,1436721137,C0,249879,1436971016,7/15/2015 7:36
672,20151111041119-158,1,7/12/2015 16:09,1436742549,C0,86270,1436828819,7/13/2015 16:06
3825,20155304095308-767,1,7/12/2015 23:46,1436769974,C0,370593,1437140567,7/17/2015 6:42
542,20153313043332-986,1,7/12/2015 23:49,1436770154,C0,843914,1437614068,7/22/2015 18:14
5543,20150405100402-510,1,7/13/2015 22:06,1436850416,C0,734574,1437584990,7/22/2015 10:09
4147,20155812125816-703,3,7/13/2015 22:36,1436852203,C0,121107,1436973310,7/15/2015 8:15
3587,20153013053056-41,1,7/14/2015 7:18,1436883510,C0,49654,1436933164,7/14/2015 21:06
4568,20153619073613-656,2,7/14/2015 8:07,1436886427,C0,1080927,1437967354,7/26/2015 20:22
2792,20150503040507-176,1,7/14/2015 8:58,1436889490,C0,308261,1437197751,7/17/2015 22:35
865,20150110090142-745,2,7/14/2015 9:51,1436892694,C0,174296,1437066990,7/16/2015 10:16
374,20155713105709-55,2,7/14/2015 10:45,1436895951,C0,85722,1436981673,7/15/2015 10:34
499,20153508083547-956,1,7/14/2015 11:39,1436899189,C0,264721,1437163910,7/17/2015 13:11
3940,20153410103418-726,2,7/14/2015 13:35,1436906130,C0,178236,1437084366,7/16/2015 15:06
3994,20152729042736-714,2,7/14/2015 19:52,1436928768,C0,436104,1437364872,7/19/2015 21:01
3790,20152104072145-815,1,7/14/2015 23:48,1436942893,C0,131884,1437074777,7/16/2015 12:26
4769,20152929022956-198,1,7/15/2015 6:33,1436967217,C0,193403,1437160620,7/17/2015 12:17
3291,20153514073546-814,3,7/15/2015 7:04,1436969063,C0,84517,1437053580,7/16/2015 6:33
610,20152411082436-105,3,7/15/2015 7:06,1436969166,C0,340890,1437310056,7/19/2015 5:47
4942,20155307085318-512,3,7/15/2015 13:14,1436991246,C0,88356,1437079602,7/16/2015 13:46
836,20152613022643-189,1,7/15/2015 13:28,1436992125,C0,84661,1437076786,7/16/2015 12:59
6187,20155002125000-291,1,7/15/2015 23:58,1437029896,C0,145412,1437175308,7/17/2015 16:21
772,20151106061100-410,1,7/16/2015 5:21,1437049284,C0,431628,1437480912,7/21/2015 5:15
84,20152312122312-603,1,7/16/2015 5:22,1437049329,C0,970779,1438020108,7/27/2015 11:01
801,20152408032428-524,1,7/16/2015 6:31,1437053507,C0,94177,1437147684,7/17/2015 8:41
866,20155822125820-486,1,7/16/2015 8:44,1437061472,C0,686124,1437747596,7/24/2015 7:19
1946,20153914023918-636,1,7/17/2015 13:46,1437165991,C0,256033,1437422024,7/20/2015 12:53
863,20153415093431-204,2,7/17/2015 22:07,1437196053,C0,108991,1437305044,7/19/2015 4:24
2927,20152907052915-532,2,7/18/2015 3:13,1437214435,C0,128440,1437342875,7/19/2015 14:54
332,20151504021557-531,2,7/18/2015 7:12,1437228754,C0,169171,1437397925,7/20/2015 6:12
4847,20154711064739-979,1,7/18/2015 13:40,1437252015,C0,209852,1437461867,7/20/2015 23:57
2020,20155112105111-296,3,7/18/2015 14:16,1437254165,C0,176898,1437431063,7/20/2015 15:24
2029,20150827020823-652,2,7/18/2015 17:03,1437264231,C0,228116,1437492347,7/21/2015 8:25
926,20154003074050-280,1,7/18/2015 20:36,1437277006,C0,944708,1438221714,7/29/2015 19:01
3240,20152018102004-940,1,7/19/2015 6:35,1437312932,C0,72928,1437385860,7/20/2015 2:51
411,20155303055334-250,2,7/19/2015 7:19,1437315582,C0,168046,1437483628,7/21/2015 6:00
2600,20155524065529-638,3,7/19/2015 11:51,1437331892,C0,725921,1438057813,7/27/2015 21:30
446,20152414072405-565,2,7/19/2015 12:01,1437332463,C0,434374,1437766837,7/24/2015 12:40
1650,20150903090936-932,1,7/19/2015 14:50,1437342656,C0,175360,1437518016,7/21/2015 15:33
1926,20155517085542-741,3,7/19/2015 18:50,1437357034,C0,208492,1437565526,7/22/2015 4:45
2671,20150115050115-511,2,7/20/2015 10:24,1437413090,C0,408215,1437821305,7/25/2015 3:48
6184,20155715045720-815,2,7/20/2015 18:25,1437441913,C0,437273,1437879186,7/25/2015 19:53
664,20155915055956-404,3,7/20/2015 19:17,1437445040,C0,145548,1437590588,7/22/2015 11:43
2844,20150517010500-796,2,7/21/2015 0:56,1437465378,C0,150939,1437616317,7/22/2015 18:51
3289,20152518042537-745,2,7/21/2015 1:33,1437467629,C0,102846,1437570475,7/22/2015 6:07
2535,20151717121704-659,3,7/21/2015 17:17,1437524246,C0,181811,1437706057,7/23/2015 19:47
2369,20150820090811-228,2,7/21/2015 22:11,1437541896,C0,133405,1437675301,7/23/2015 11:15
418,20155809075828-607,1,7/21/2015 22:35,1437543342,C0,544717,1438088059,7/28/2015 5:54
4797,20151413081417-823,1,7/21/2015 23:56,1437548209,C0,93469,1437641678,7/23/2015 1:54
4217,20152319052357-61,3,7/22/2015 1:10,1437552645,C0,349101,1437901746,7/26/2015 2:09
4117,20150319020304-688,1,7/22/2015 4:27,1437564458,C0,112337,1437676795,7/23/2015 11:39
5208,20153519103528-888,2,7/22/2015 7:55,1437576928,C0,124800,1437701728,7/23/2015 18:35
3378,20150011070002-311,3,7/22/2015 12:45,1437594330,C0,485564,1438079894,7/28/2015 3:38
2880,20153719053715-589,3,7/22/2015 15:01,1437602463,C0,83276,1437685739,7/23/2015 14:08
2077,20153722113733-394,1,7/23/2015 11:23,1437675801,C0,85548,1437761349,7/24/2015 11:09
243,20151921051948-603,3,7/23/2015 14:35,1437687306,C0,81459,1437768765,7/24/2015 13:12
2974,20152221102210-862,1,7/24/2015 8:17,1437751042,C0,125856,1437876898,7/25/2015 19:14
6243,20152118082127-664,2,7/24/2015 16:23,1437780205,C0,273659,1438053864,7/27/2015 20:24
6284,20152819062830-519,2,7/24/2015 17:36,1437784575,C0,472065,1438256640,7/30/2015 4:44
897,20152515112517-831,1,7/24/2015 20:20,1437794450,C0,269911,1438064361,7/27/2015 23:19
140,20154116034139-452,1,7/25/2015 1:56,1437814619,C0,91015,1437905634,7/26/2015 3:13
796,20151722091759-375,2,7/25/2015 2:48,1437817685,C0,78602,1437896287,7/26/2015 0:38
2460,20152517072551-546,1,7/25/2015 2:56,1437818210,C0,96437,1437914647,7/26/2015 5:44
6254,20152817062846-890,2,7/25/2015 3:02,1437818545,C0,226273,1438044818,7/27/2015 17:53
2419,20155522055527-809,1,7/25/2015 15:58,1437865134,C0,84069,1437949203,7/26/2015 15:20
5658,20154922084949-200,3,7/26/2015 1:52,1437900763,C0,106858,1438007621,7/27/2015 7:33
2391,20154323064305-880,1,7/26/2015 12:26,1437938769,C0,139892,1438078661,7/28/2015 3:17
5045,20153317083347-992,1,7/26/2015 14:53,1437947597,C0,800370,1438747967,8/4/2015 21:12
705,20150111030116-821,1,7/27/2015 2:48,1437990497,C0,191203,1438181700,7/29/2015 7:55
5477,20151522091559-339,1,7/27/2015 4:32,1437996739,C0,207490,1438204229,7/29/2015 14:10
2126,20153017103047-976,1,7/27/2015 8:10,1438009853,C0,427803,1438437656,8/1/2015 7:00
4435,20151921021945-394,3,7/27/2015 11:39,1438022376,C0,169597,1438191973,7/29/2015 10:46
971,20154914104905-829,3,7/27/2015 17:13,1438042409,C0,382088,1438424497,8/1/2015 3:21
5392,20152513092550-113,1,7/27/2015 22:45,1438062300,C0,179650,1438241950,7/30/2015 0:39
3124,20154321124336-179,1,7/28/2015 3:09,1438078196,C0,1581190,1439659386,8/15/2015 10:23
2397,20155722085740-393,1,7/28/2015 8:13,1438096436,C0,257888,1438354324,7/31/2015 7:52
3447,20150923050915-668,1,7/28/2015 22:13,1438146802,C0,64321,1438211123,7/29/2015 16:05
4114,20155008095000-690,2,7/29/2015 5:16,1438172213,C0,256859,1438429072,8/1/2015 4:37
226,20152322092332-533,3,7/29/2015 8:00,1438182012,C0,74975,1438256987,7/30/2015 4:49
2296,20155206025224-627,2,7/29/2015 8:41,1438184480,C0,245617,1438430097,8/1/2015 4:54
5944,20154121094145-294,1,7/29/2015 9:51,1438188674,C0,691769,1438880443,8/6/2015 10:00
2189,20155325045321-836,1,7/29/2015 11:45,1438195513,C0,327112,1438522625,8/2/2015 6:37
2420,20153611043604-222,2,7/29/2015 12:02,1438196553,C0,219827,1438416380,8/1/2015 1:06
6206,20152205022233-507,2,7/30/2015 2:52,1438249945,C0,264824,1438514769,8/2/2015 4:26
32,20152902022959-436,1,7/30/2015 6:40,1438263625,C0,1195513,1439459138,8/13/2015 2:45
3830,20155929045944-214,1,7/30/2015 7:59,1438268392,C0,330751,1438599143,8/3/2015 3:52
2356,20150923010916-544,3,7/30/2015 17:41,1438303301,C0,88735,1438392036,7/31/2015 18:20
6028,20150223090243-726,3,7/30/2015 17:52,1438303971,C0,90944,1438394915,7/31/2015 19:08
504,20153404123427-942,1,7/31/2015 2:48,1438336122,C0,765885,1439102007,8/8/2015 23:33
1892,20152208032247-227,1,7/31/2015 3:20,1438338023,C0,242982,1438581005,8/2/2015 22:50
4729,20153123063158-685,1,7/31/2015 12:39,1438371597,C0,101897,1438473494,8/1/2015 16:58
6038,20151824041829-872,1,7/31/2015 18:11,1438391484,C0,611575,1439003059,8/7/2015 20:04
3927,20150526060526-540,2,7/31/2015 19:32,1438396329,C0,480403,1438876732,8/6/2015 8:58
910,20155427065441-961,1,7/31/2015 22:59,1438408741,C0,201730,1438610471,8/3/2015 7:01
1029,20154905084932-890,3,8/1/2015 3:54,1438426478,C0,771702,1439198180,8/10/2015 2:16
1518,20151623071615-935,2,8/1/2015 16:23,1438471395,C0,270140,1438741535,8/4/2015 19:25
1792,20153722023710-935,2,8/1/2015 19:21,1438482098,C0,440534,1438922632,8/6/2015 21:43
293,20155628055649-858,1,8/1/2015 22:57,1438495038,C0,51947,1438546985,8/2/2015 13:23
1588,20152227032235-207,1,8/1/2015 23:50,1438498217,C0,66066,1438564283,8/2/2015 18:11
3774,20150224010207-397,2,8/2/2015 1:02,1438502527,C0,415800,1438918327,8/6/2015 20:32
5916,20154530104517-465,1,8/2/2015 4:43,1438515782,C0,79155,1438594937,8/3/2015 2:42
204,20155417065414-463,1,8/2/2015 8:24,1438529086,C0,173479,1438702565,8/4/2015 8:36
4686,20153928053942-429,3,8/2/2015 11:12,1438539148,C0,408766,1438947914,8/7/2015 4:45
233,20151731021708-898,2,8/2/2015 12:52,1438545167,C0,167739,1438712906,8/4/2015 11:28
5972,20154111034148-335,1,8/2/2015 12:56,1438545404,C0,270128,1438815532,8/5/2015 15:58
6358,20151227041255-244,3,8/2/2015 12:58,1438545519,C0,506744,1439052263,8/8/2015 9:44
5157,20152027062003-395,2,8/2/2015 15:35,1438554939,C0,275868,1438830807,8/5/2015 20:13
4753,20155430115403-341,1,8/2/2015 17:30,1438561830,C0,93129,1438654959,8/3/2015 19:22
3592,20155201035213-815,2,8/2/2015 20:30,1438572635,C0,103102,1438675737,8/4/2015 1:08
1915,20151503041535-262,3,8/2/2015 21:12,1438575175,C0,326230,1438901405,8/6/2015 15:50
6030,20155323075349-302,2,8/3/2015 3:57,1438599479,C0,133750,1438733229,8/4/2015 17:07
5909,20153007073050-177,1,8/3/2015 10:13,1438622034,C0,616823,1439238857,8/10/2015 13:34
5,20154502084548-823,3,8/3/2015 13:32,1438633927,C0,103579,1438737506,8/4/2015 18:18
4903,20154326034342-937,2,8/3/2015 18:03,1438650202,C0,99940,1438750142,8/4/2015 21:49
3372,20154214064232-812,2,8/4/2015 8:30,1438702248,C0,260128,1438962376,8/7/2015 8:46
4472,20155825075830-372,3,8/4/2015 9:03,1438704186,C0,289292,1438993478,8/7/2015 17:24
1119,20155525115532-571,1,8/4/2015 11:39,1438713576,C0,431522,1439145098,8/9/2015 11:31
4113,20154903084903-690,2,8/4/2015 13:07,1438718852,C0,101909,1438820761,8/5/2015 17:26
1248,20152431022403-301,2,8/4/2015 20:13,1438744419,C0,52368,1438796787,8/5/2015 10:46
5176,20151029031046-528,2,8/4/2015 20:38,1438745923,C0,179359,1438925282,8/6/2015 22:28
1833,20151902061935-596,3,8/4/2015 23:49,1438757385,C0,117905,1438875290,8/6/2015 8:34
2842,20155431125443-408,1,8/5/2015 3:35,1438770919,C0,199218,1438970137,8/7/2015 10:55
1922,20152423072412-875,1,8/5/2015 6:18,1438780710,C0,373086,1439153796,8/9/2015 13:56
3510,20153827043838-171,1,8/6/2015 1:54,1438851298,C0,405490,1439256788,8/10/2015 18:33
4579,20150702020750-193,2,8/6/2015 14:56,1438898207,C0,116179,1439014386,8/7/2015 23:13
4655,20155708025703-505,3,8/6/2015 16:07,1438902471,C0,313731,1439216202,8/10/2015 7:16
3091,20155625015640-270,2,8/6/2015 23:52,1438930340,C0,153220,1439083560,8/8/2015 18:26
2893,20154325114323-182,1,8/7/2015 3:57,1438945072,C0,156467,1439101539,8/8/2015 23:25
5315,20150621090620-651,2,8/7/2015 6:07,1438952852,C0,506259,1439459111,8/13/2015 2:45
2112,20150904060946-997,1,8/7/2015 6:33,1438954410,C0,130312,1439084722,8/8/2015 18:45
2284,20150329030344-472,2,8/7/2015 8:12,1438960325,C0,250967,1439211292,8/10/2015 5:54
4156,20150104050127-736,1,8/7/2015 14:44,1438983843,C0,83652,1439067495,8/8/2015 13:58
6275,20151601101604-955,2,8/7/2015 22:11,1439010694,C0,80190,1439090884,8/8/2015 20:28
1528,20154429124439-546,3,8/8/2015 1:55,1439024106,C0,117861,1439141967,8/9/2015 10:39
4766,20152922072959-445,3,8/8/2015 11:55,1439060134,C0,212105,1439272239,8/10/2015 22:50
2108,20155330095316-775,3,8/8/2015 14:21,1439068915,C0,264573,1439333488,8/11/2015 15:51
4496,20150607040626-348,2,8/8/2015 22:05,1439096708,C0,53961,1439150669,8/9/2015 13:04
3103,20151202101257-746,1,8/9/2015 2:47,1439113637,C0,82580,1439196217,8/10/2015 1:43
1084,20152028062056-368,3,8/9/2015 6:39,1439127590,C0,345978,1439473568,8/13/2015 6:46
5014,20151907021947-595,2,8/9/2015 10:39,1439141971,C0,159584,1439301555,8/11/2015 6:59
373,20155807125802-565,1,8/9/2015 16:13,1439162014,C0,92266,1439254280,8/10/2015 17:51
2247,20154931014916-410,2,8/9/2015 22:19,1439183976,C0,115460,1439299436,8/11/2015 6:23
5343,20150218120246-220,1,8/10/2015 2:43,1439199789,C0,279089,1439478878,8/13/2015 8:14
1338,20151518061551-586,2,8/10/2015 6:01,1439211717,C0,993183,1440204900,8/21/2015 17:55
4855,20150629090627-62,2,8/10/2015 8:25,1439220331,C0,129293,1439349624,8/11/2015 20:20
232,20153609033627-164,2,8/10/2015 9:56,1439225817,C0,66030,1439291847,8/11/2015 4:17
1078,20154605024652-886,1,8/10/2015 13:35,1439238958,C0,142582,1439381540,8/12/2015 5:12
589,20152517012540-586,2,8/10/2015 14:26,1439241980,C0,583655,1439825635,8/17/2015 8:33
1306,20153108053138-793,1,8/10/2015 15:31,1439245918,C0,82810,1439328728,8/11/2015 14:32
2309,20150507060531-534,1,8/10/2015 19:30,1439260204,C0,1859291,1441119495,9/1/2015 7:58
5333,20155508035530-98,1,8/10/2015 21:19,1439266774,C0,96122,1439362896,8/12/2015 0:01
3207,20153604053608-723,2,8/10/2015 21:27,1439267224,C0,401332,1439668556,8/15/2015 12:55
906,20152209112223-837,2,8/11/2015 0:24,1439277857,C0,66657,1439344514,8/11/2015 18:55
819,20154328084349-846,1,8/11/2015 4:47,1439293669,C0,473430,1439767099,8/16/2015 16:18
3968,20150925070901-487,2,8/11/2015 9:50,1439311846,C0,211215,1439523061,8/13/2015 20:31
5106,20152307042315-347,2,8/11/2015 10:17,1439313425,C0,323630,1439637055,8/15/2015 4:10
2664,20153706063755-802,1,8/11/2015 17:50,1439340606,C0,472331,1439812937,8/17/2015 5:02
2914,20153604073634-474,1,8/11/2015 18:56,1439344564,C0,215190,1439559754,8/14/2015 6:42
6439,20155925035953-311,2,8/12/2015 1:04,1439366696,C0,500501,1439867197,8/17/2015 20:06
1957,20155519095518-431,3,8/12/2015 7:05,1439388357,C0,294777,1439683134,8/15/2015 16:58
4106,20153208123237-878,1,8/12/2015 12:27,1439407662,C0,345305,1439752967,8/16/2015 12:22
6218,20153303113325-724,1,8/13/2015 13:08,1439496533,C0,434864,1439931397,8/18/2015 13:56
1584,20150304070342-20,2,8/14/2015 11:56,1439578598,C0,444997,1440023595,8/19/2015 15:33
5404,20150003080058-668,3,8/14/2015 12:03,1439579039,C0,520483,1440099522,8/20/2015 12:38
5071,20151114071121-782,2,8/15/2015 18:46,1439689592,C0,128111,1439817703,8/17/2015 6:21
4524,20150108050153-619,3,8/16/2015 4:17,1439723829,C0,92188,1439816017,8/17/2015 5:53
4165,20153401073445-361,2,8/16/2015 11:29,1439749784,C0,187157,1439936941,8/18/2015 15:29
4760,20151315011308-405,1,8/16/2015 13:53,1439758429,C0,88841,1439847270,8/17/2015 14:34
3483,20155201035224-590,1,8/16/2015 16:54,1439769280,C0,497267,1440266547,8/22/2015 11:02
1075,20155829125801-230,2,8/16/2015 17:55,1439772903,C0,786511,1440559414,8/25/2015 20:23
5118,20155117065115-489,3,8/17/2015 9:15,1439828115,C0,179136,1440007251,8/19/2015 11:00
6073,20154927084959-505,2,8/17/2015 11:50,1439837449,C0,912625,1440750074,8/28/2015 1:21
3887,20153402013445-750,1,8/17/2015 15:35,1439850917,C0,186176,1440037093,8/19/2015 19:18
5326,20151823021857-278,3,8/17/2015 16:39,1439854785,C0,271056,1440125841,8/20/2015 19:57
2334,20154011014002-294,1,8/17/2015 23:00,1439877635,C0,184011,1440061646,8/20/2015 2:07
5796,20151514111535-583,1,8/18/2015 0:38,1439883505,C0,153685,1440037190,8/19/2015 19:19
4868,20155529075511-496,1,8/18/2015 9:53,1439916831,C0,216890,1440133721,8/20/2015 22:08
3137,20154215114244-418,2,8/18/2015 13:27,1439929628,C0,88488,1440018116,8/19/2015 14:01
3038,20153316013306-455,1,8/18/2015 16:56,1439942179,C0,184993,1440127172,8/20/2015 20:19
3905,20152816122841-313,1,8/18/2015 17:46,1439945161,C0,95920,1440041081,8/19/2015 20:24
4997,20151813031829-984,2,8/19/2015 12:23,1440012237,C0,63491,1440075728,8/20/2015 6:02
2726,20154229104255-661,3,8/19/2015 17:23,1440030192,C0,262631,1440292823,8/22/2015 18:20
2294,20151318061334-243,2,8/19/2015 18:46,1440035162,C0,131548,1440166710,8/21/2015 7:18
3837,20150525050525-344,3,8/19/2015 20:53,1440042828,C0,310529,1440353357,8/23/2015 11:09
3566,20150606090640-663,1,8/19/2015 21:16,1440044170,C0,166710,1440210880,8/21/2015 19:34
3989,20150214110230-668,1,8/20/2015 3:17,1440065850,C0,245250,1440311100,8/22/2015 23:25
1320,20151403101408-211,1,8/20/2015 3:52,1440067950,C0,589186,1440657136,8/26/2015 23:32
6199,20155206035248-482,3,8/20/2015 7:40,1440081608,C0,147505,1440229113,8/22/2015 0:38
4292,20152818012813-881,1,8/20/2015 17:59,1440118759,C0,409638,1440528397,8/25/2015 11:46
6148,20154708104711-651,2,8/21/2015 7:24,1440167054,C0,370341,1440537395,8/25/2015 14:16
1707,20154114104153-864,1,8/21/2015 8:23,1440170630,C0,198839,1440369469,8/23/2015 15:37
3490,20151115041109-804,1,8/21/2015 20:23,1440213837,C0,76224,1440290061,8/22/2015 17:34
430,20153815113857-329,3,8/22/2015 3:42,1440240163,C0,288113,1440528276,8/25/2015 11:44
6306,20154214044236-934,2,8/22/2015 11:47,1440269268,C0,224504,1440493772,8/25/2015 2:09
169,20155810125837-406,1,8/22/2015 17:34,1440290080,C0,351121,1440641201,8/26/2015 19:06
981,20153219093204-479,1,8/22/2015 20:06,1440299173,C0,297249,1440596422,8/26/2015 6:40
3522,20151315121331-773,1,8/23/2015 6:28,1440336503,C0,670492,1441006995,8/31/2015 0:43
1671,20153320073331-255,1,8/23/2015 6:40,1440337227,C0,366802,1440704029,8/27/2015 12:33
2207,20153217083226-786,2,8/23/2015 12:41,1440358883,C0,76191,1440435074,8/24/2015 9:51
5959,20152130072111-229,2,8/23/2015 17:12,1440375171,C0,301300,1440676471,8/27/2015 4:54
3540,20152719032729-250,1,8/23/2015 18:29,1440379776,C0,356527,1440736303,8/27/2015 21:31
2034,20150328070321-554,1,8/24/2015 0:10,1440400241,C0,288505,1440688746,8/27/2015 8:19
4359,20150105090139-623,1,8/24/2015 3:08,1440410890,C0,614113,1441025003,8/31/2015 5:43
690,20153118123109-283,1,8/24/2015 13:12,1440447146,C0,74411,1440521557,8/25/2015 9:52
658,20152207072213-862,3,8/24/2015 19:39,1440470362,C0,216147,1440686509,8/27/2015 7:41
4294,20151913121932-661,3,8/24/2015 20:02,1440471734,C0,978162,1441449896,9/5/2015 3:44
1807,20152009032045-131,3,8/25/2015 2:34,1440495257,C0,668206,1441163463,9/1/2015 20:11
3685,20151721041729-734,1,8/25/2015 2:56,1440496613,C0,99188,1440595801,8/26/2015 6:30
788,20153022043047-509,2,8/25/2015 3:03,1440496991,C0,70248,1440567239,8/25/2015 22:33
119,20153723103750-402,3,8/25/2015 9:49,1440521349,C0,169879,1440691228,8/27/2015 9:00
2928,20153123053121-598,2,8/25/2015 14:10,1440537015,C0,80367,1440617382,8/26/2015 12:29
618,20152202022209-169,1,8/26/2015 6:50,1440597045,C0,674988,1441272033,9/3/2015 2:20
421,20154421024437-278,2,8/26/2015 19:45,1440643527,C0,450050,1441093577,9/1/2015 0:46
3228,20155624045618-21,1,8/26/2015 20:20,1440645658,C0,681935,1441327593,9/3/2015 17:46
5433,20153130073133-253,3,8/26/2015 20:31,1440646277,C0,621448,1441267725,9/3/2015 1:08
2224,20152814122805-968,2,8/26/2015 20:58,1440647935,C0,533725,1441181660,9/2/2015 1:14
3748,20155825095843-923,2,8/27/2015 6:22,1440681739,C0,79908,1440761647,8/28/2015 4:34
5340,20151625021614-449,1,8/27/2015 7:50,1440687054,C0,677510,1441364564,9/4/2015 4:02
2127,20155919125917-79,2,8/27/2015 9:10,1440691859,C0,96786,1440788645,8/28/2015 12:04
5623,20152813042852-20,2,8/27/2015 11:22,1440699763,C0,397077,1441096840,9/1/2015 1:40
4533,20154423044431-936,2,8/27/2015 13:50,1440708614,C0,335143,1441043757,8/31/2015 10:55
489,20152325032338-563,2,8/27/2015 17:18,1440721118,C0,179700,1440900818,8/29/2015 19:13
6191,20154422124407-513,1,8/28/2015 3:29,1440757789,C0,242571,1441000360,8/30/2015 22:52
3159,20151122021140-914,1,8/28/2015 11:41,1440787308,C0,63676,1440850984,8/29/2015 5:23
3261,20150907070922-234,1,8/28/2015 12:14,1440789258,C0,563887,1441353145,9/4/2015 0:52
2418,20153430083434-174,1,8/28/2015 13:29,1440793799,C0,360475,1441154274,9/1/2015 17:37
4860,20154120094138-417,2,8/28/2015 13:54,1440795280,C0,353191,1441148471,9/1/2015 16:01
5029,20152017102041-706,3,8/28/2015 15:10,1440799825,C0,120973,1440920798,8/30/2015 0:46
3626,20152012032040-682,2,8/29/2015 0:15,1440832505,C0,584695,1441417200,9/4/2015 18:40
1092,20154627014626-335,2,8/29/2015 6:57,1440856621,C0,403805,1441260426,9/2/2015 23:07
5767,20151412091419-116,1,8/29/2015 8:51,1440863507,C0,518231,1441381738,9/4/2015 8:48
1206,20151728041704-292,1,8/29/2015 22:07,1440911260,C0,107436,1441018696,8/31/2015 3:58
5754,20151712081746-902,3,8/30/2015 5:45,1440938731,C0,515355,1441454086,9/5/2015 4:54
1081,20153122043149-695,2,8/30/2015 17:31,1440981103,C0,231598,1441212701,9/2/2015 9:51
6483,20155707085753-292,2,8/31/2015 3:34,1441017263,C0,684730,1441701993,9/8/2015 1:46
563,20150728080743-392,1,8/31/2015 6:54,1441029247,C0,84928,1441114175,9/1/2015 6:29
718,20153003103059-290,3,8/31/2015 14:18,1441055930,C0,347553,1441403483,9/4/2015 14:51
6441,20154305094304-138,1,8/31/2015 14:39,1441057172,C0,706084,1441763256,9/8/2015 18:47
1932,20150530010559-140,2,8/31/2015 19:39,1441075188,C0,110029,1441185217,9/2/2015 2:13
4887,20151102061116-400,1,9/1/2015 0:51,1441093905,C0,367547,1441461452,9/5/2015 6:57
5926,20154923124957-839,2,9/1/2015 6:27,1441114077,C0,251560,1441365637,9/4/2015 4:20
5065,20151428061408-195,2,9/1/2015 6:59,1441115963,C0,348315,1441464278,9/5/2015 7:44
3742,20150028060003-741,1,9/1/2015 7:18,1441117090,C0,350287,1441467377,9/5/2015 8:36
1958,20152030102012-63,1,9/1/2015 16:40,1441150808,C0,195596,1441346404,9/3/2015 23:00
171,20154930084931-614,1,9/1/2015 22:19,1441171192,C0,73807,1441244999,9/2/2015 18:49
141,20155331025312-334,1,9/2/2015 14:48,1441230483,C0,57497,1441287980,9/3/2015 6:46
497,20151217121251-526,1,9/2/2015 15:01,1441231295,C0,198932,1441430227,9/4/2015 22:17
1025,20150022040009-518,1,9/2/2015 23:31,1441261864,C0,522265,1441784129,9/9/2015 0:35
4454,20150501030502-599,3,9/3/2015 3:58,1441277888,C0,66393,1441344281,9/3/2015 22:24
5621,20152124062158-615,1,9/3/2015 12:15,1441307740,C0,295074,1441602814,9/6/2015 22:13
3677,20155102055140-273,3,9/3/2015 16:13,1441322005,C0,80505,1441402510,9/4/2015 14:35
4166,20152620032609-833,1,9/4/2015 7:32,1441377136,C0,181081,1441558217,9/6/2015 9:50
493,20155024045011-587,3,9/4/2015 18:15,1441415744,C0,1211311,1442627055,9/18/2015 18:44
614,20150401110417-611,1,9/5/2015 8:55,1441468517,C0,168930,1441637447,9/7/2015 7:50
2675,20155504115554-356,1,9/5/2015 14:28,1441488490,C0,95536,1441584026,9/6/2015 17:00
6228,20152924112938-506,3,9/5/2015 15:09,1441490946,C0,466046,1441956992,9/11/2015 0:36
701,20151001081041-702,1,9/5/2015 20:10,1441509043,C0,194401,1441703444,9/8/2015 2:10
1832,20150403120405-547,3,9/5/2015 21:06,1441512395,C0,68450,1441580845,9/6/2015 16:07
2056,20150226090228-180,3,9/6/2015 5:39,1441543170,C0,469111,1442012281,9/11/2015 15:58
4030,20152527102521-92,2,9/6/2015 6:45,1441547158,C0,850837,1442397995,9/16/2015 3:06
4490,20151128091137-757,1,9/6/2015 8:09,1441552177,C0,386940,1441939117,9/10/2015 19:38
1273,20152431122444-914,2,9/6/2015 14:25,1441574729,C0,175215,1441749944,9/8/2015 15:05
2246,20154612024622-150,1,9/6/2015 18:54,1441590899,C0,693331,1442284230,9/14/2015 19:30
1017,20150301050357-768,1,9/6/2015 21:36,1441600615,C0,64054,1441664669,9/7/2015 15:24
1592,20154504064547-329,1,9/6/2015 22:30,1441603819,C0,114736,1441718555,9/8/2015 6:22
1091,20152812122818-384,3,9/7/2015 0:39,1441611554,C0,610282,1442221836,9/14/2015 2:10
73,20151026041051-922,1,9/7/2015 0:45,1441611929,C0,490639,1442102568,9/12/2015 17:02
4732,20150720100717-213,1,9/7/2015 14:49,1441662542,C0,607215,1442269757,9/14/2015 15:29
3069,20152422012450-156,1,9/7/2015 19:02,1441677770,C0,175335,1441853105,9/9/2015 19:45
3385,20153406023410-438,1,9/8/2015 1:45,1441701944,C0,63347,1441765291,9/8/2015 19:21
3444,20155628075607-90,1,9/9/2015 11:09,1441822141,C0,349458,1442171599,9/13/2015 12:13
5545,20151307011356-805,2,9/9/2015 22:31,1441863112,C0,103138,1441966250,9/11/2015 3:10
5080,20155107095150-103,2,9/9/2015 23:59,1441868366,C0,74552,1441942918,9/10/2015 20:41
2365,20153103053109-344,3,9/11/2015 15:08,1442009307,C0,682638,1442691945,9/19/2015 12:45
1137,20151101081129-848,1,9/11/2015 22:02,1442034161,C0,783834,1442817995,9/20/2015 23:46
6022,20155107025120-910,2,9/12/2015 7:00,1442066440,C0,403760,1442470200,9/16/2015 23:10
6450,20153011043031-930,1,9/12/2015 8:23,1442071403,C0,57172,1442128575,9/13/2015 0:16
5498,20154311024355-911,1,9/12/2015 9:02,1442073756,C0,65921,1442139677,9/13/2015 3:21
4364,20150821110852-676,1,9/12/2015 12:25,1442085946,C0,272202,1442358148,9/15/2015 16:02
5218,20155206105202-711,1,9/12/2015 20:48,1442116082,C0,184720,1442300802,9/15/2015 0:06
4026,20153124123117-215,2,9/12/2015 23:36,1442126196,C0,240217,1442366413,9/15/2015 18:20
2826,20155211075227-27,1,9/13/2015 23:35,1442212557,C0,114705,1442327262,9/15/2015 7:27
6033,20151106071138-520,2,9/14/2015 5:47,1442234850,C0,343076,1442577926,9/18/2015 5:05
2288,20152914112948-207,1,9/14/2015 15:09,1442268540,C0,671244,1442939784,9/22/2015 9:36
3506,20155609015650-953,2,9/14/2015 19:01,1442282477,C0,150089,1442432566,9/16/2015 12:42
6460,20152405092403-279,1,9/15/2015 4:45,1442317530,C0,282429,1442599959,9/18/2015 11:12
3581,20155712125720-473,1,9/15/2015 7:24,1442327080,C0,699505,1443026585,9/23/2015 9:43
4819,20150612040643-903,1,9/15/2015 11:51,1442343089,C0,243886,1442586975,9/18/2015 7:36
4424,20151324041323-86,1,9/15/2015 16:52,1442361128,C0,271875,1442633003,9/18/2015 20:23
6293,20152505102537-378,3,9/15/2015 19:34,1442370885,C0,448474,1442819359,9/21/2015 0:09
907,20153931113929-38,1,9/15/2015 22:52,1442382749,C0,445460,1442828209,9/21/2015 2:36
4762,20153804013829-884,2,9/16/2015 18:38,1442453911,C0,150686,1442604597,9/18/2015 12:29
3910,20151913061938-878,1,9/16/2015 19:27,1442456837,C0,102153,1442558990,9/17/2015 23:49
5885,20155823085830-345,1,9/16/2015 23:20,1442470829,C0,303617,1442774446,9/20/2015 11:40
3356,20154509104501-59,2,9/16/2015 23:55,1442472901,C0,416325,1442889226,9/21/2015 19:33
5518,20153425093430-367,2,9/17/2015 6:06,1442495219,C0,282107,1442777326,9/20/2015 12:28
5624,20154811054808-989,1,9/17/2015 21:26,1442550416,C0,66441,1442616857,9/18/2015 15:54
34,20151211081210-391,2,9/18/2015 3:20,1442571636,C0,293653,1442865289,9/21/2015 12:54
2529,20150630110633-414,1,9/18/2015 3:29,1442572143,C0,538050,1443110193,9/24/2015 8:56
787,20155815115806-862,3,9/18/2015 5:54,1442580878,C0,364474,1442945352,9/22/2015 11:09
2631,20152724112733-858,1,9/18/2015 6:30,1442583021,C0,602571,1443185592,9/25/2015 5:53
3611,20151228021221-216,1,9/18/2015 13:25,1442607917,C0,226447,1442834364,9/21/2015 4:19
4274,20152917082955-286,3,9/19/2015 8:12,1442675561,C0,171766,1442847327,9/21/2015 7:55
6437,20153612033615-297,1,9/19/2015 18:09,1442711383,C0,76751,1442788134,9/20/2015 15:28
1531,20153106033136-478,1,9/20/2015 3:52,1442746328,C0,145954,1442892282,9/21/2015 20:24
2282,20151713071733-979,1,9/20/2015 7:19,1442758795,C0,302471,1443061266,9/23/2015 19:21
808,20151013101006-462,1,9/20/2015 8:09,1442761758,C0,74694,1442836452,9/21/2015 4:54
2404,20155417095454-820,3,9/20/2015 11:08,1442772492,C0,263598,1443036090,9/23/2015 12:21
6453,20153925033936-464,2,9/20/2015 12:53,1442778792,C0,279552,1443058344,9/23/2015 18:32
3097,20155810015814-86,3,9/20/2015 22:56,1442814994,C0,448150,1443263144,9/26/2015 3:25
3420,20152518072549-657,3,9/21/2015 19:58,1442890733,C0,372848,1443263581,9/26/2015 3:33
3266,20153903123925-684,1,9/22/2015 1:58,1442912309,C0,535193,1443447502,9/28/2015 6:38
536,20153723093753-818,3,9/23/2015 12:52,1443037961,C0,336261,1443374222,9/27/2015 10:17
5597,20152615012610-377,2,9/23/2015 14:36,1443044182,C0,347706,1443391888,9/27/2015 15:11
607,20152225082250-866,2,9/23/2015 18:02,1443056538,C0,652346,1443708884,10/1/2015 7:14
6369,20154703104737-748,3,9/23/2015 21:14,1443068053,C0,882798,1443950851,10/4/2015 2:27
5210,20155301055312-754,2,9/23/2015 21:54,1443070493,C0,656243,1443726736,10/1/2015 12:12
4207,20153218053206-183,1,9/24/2015 13:06,1443125178,C0,251226,1443376404,9/27/2015 10:53
4203,20150322090352-662,1,9/25/2015 3:10,1443175843,C0,79337,1443255180,9/26/2015 1:13
2069,20151219101232-863,3,9/25/2015 22:13,1443244433,C0,187227,1443431660,9/28/2015 2:14
3358,20151426091431-80,2,9/26/2015 6:03,1443272592,C0,1133903,1444406495,10/9/2015 9:01
1316,20154610014621-394,2,9/26/2015 16:37,1443310666,C0,198955,1443509621,9/28/2015 23:53
6245,20154922094908-595,1,9/28/2015 5:58,1443445112,C0,1060988,1444506100,10/10/2015 12:41
2790,20154019064052-72,2,9/28/2015 6:38,1443447507,C0,111065,1443558572,9/29/2015 13:29
2759,20150926060947-3,1,9/28/2015 11:29,1443464988,C0,192001,1443656989,9/30/2015 16:49
4246,20150307010338-210,2,9/28/2015 19:08,1443492521,C0,262329,1443754850,10/1/2015 20:00
1534,20150908120959-737,2,9/28/2015 20:41,1443498062,C0,586221,1444084283,10/5/2015 15:31
481,20155115045123-3,1,9/29/2015 1:22,1443514927,C0,576922,1444091849,10/5/2015 17:37
5537,20153828093806-862,2,9/29/2015 17:23,1443572614,C0,114328,1443686942,10/1/2015 1:09
1118,20152224022226-330,1,9/29/2015 18:10,1443575453,C0,445707,1444021160,10/4/2015 21:59
6237,20150925030923-872,2,9/29/2015 18:50,1443577847,C0,179442,1443757289,10/1/2015 20:41
5085,20155711025756-499,3,9/30/2015 7:55,1443624948,C0,230896,1443855844,10/3/2015 0:04
2667,20150729110716-839,1,9/30/2015 15:15,1443651307,C0,101271,1443752578,10/1/2015 19:22
1951,20153624113634-748,2,9/30/2015 16:38,1443656299,C0,178835,1443835134,10/2/2015 18:18
5123,20150930110949-443,1,10/1/2015 22:23,1443763389,C0,350650,1444114039,10/5/2015 23:47
1969,20155923115946-322,2,10/2/2015 6:21,1443792116,C0,378665,1444170781,10/6/2015 15:33
5151,20155925115933-802,2,10/2/2015 10:48,1443808131,C0,200186,1444008317,10/4/2015 18:25
1594,20150722010749-2,1,10/2/2015 17:24,1443831891,C0,439711,1444271602,10/7/2015 19:33
5138,20155611055631-743,2,10/3/2015 4:21,1443871262,C0,264553,1444135815,10/6/2015 5:50
820,20152826012855-73,3,10/3/2015 9:43,1443890623,C0,197096,1444087719,10/5/2015 16:28
953,20155431125412-835,3,10/3/2015 11:58,1443898700,C0,789464,1444688164,10/12/2015 15:16
3092,20154524034503-939,3,10/3/2015 21:00,1443931239,C0,99567,1444030806,10/5/2015 0:40
5858,20150026120010-942,2,10/4/2015 14:43,1443995004,C0,350497,1444345501,10/8/2015 16:05
3340,20155229035205-191,2,10/4/2015 19:59,1444013971,C0,223423,1444237394,10/7/2015 10:03
3129,20153613033606-451,2,10/4/2015 21:17,1444018653,C0,611629,1444630282,10/11/2015 23:11
3976,20150824070825-886,3,10/4/2015 23:43,1444027438,C0,307911,1444335349,10/8/2015 13:15
5699,20151821011808-722,1,10/5/2015 15:07,1444082822,C0,608067,1444690889,10/12/2015 16:01
3303,20152215092206-481,1,10/6/2015 3:56,1444128966,C0,893955,1445022921,10/16/2015 12:15
4002,20154725064714-647,2,10/7/2015 0:04,1444201490,C0,461382,1444662872,10/12/2015 8:14
2492,20150825120831-381,1,10/7/2015 22:04,1444280686,C0,357525,1444638211,10/12/2015 1:23
1567,20150228100235-385,2,10/8/2015 11:17,1444328227,C0,434236,1444762463,10/13/2015 11:54
4205,20150628060613-79,1,10/9/2015 0:59,1444377549,C0,515768,1444893317,10/15/2015 0:15
3511,20153723123726-448,2,10/9/2015 17:32,1444437178,C0,700066,1445137244,10/17/2015 20:00
3334,20150025100041-260,3,10/10/2015 5:32,1444480352,C0,426637,1444906989,10/15/2015 4:03
4939,20151522061542-891,2,10/10/2015 14:39,1444513146,C0,528468,1445041614,10/16/2015 17:26
59,20154314084327-265,2,10/11/2015 23:16,1444630567,C0,298145,1444928712,10/15/2015 10:05
4843,20153029123049-92,2,10/12/2015 4:04,1444647854,C0,156115,1444803969,10/13/2015 23:26
4465,20152803072816-844,2,10/13/2015 17:40,1444783256,C0,436595,1445219851,10/18/2015 18:57
5043,20152909092941-524,1,10/13/2015 22:21,1444800061,C0,195940,1444996001,10/16/2015 4:46
444,20151119091154-119,3,10/13/2015 23:38,1444804719,C0,1068915,1445873634,10/26/2015 8:33
1663,20151526061504-680,3,10/14/2015 18:57,1444874238,C0,800467,1445674705,10/24/2015 1:18
854,20154023044028-20,1,10/15/2015 20:05,1444964717,C0,655927,1445620644,10/23/2015 10:17
3633,20151707111715-550,2,10/17/2015 2:13,1445073211,C0,118768,1445191979,10/18/2015 11:12
3229,20155415055448-117,1,10/18/2015 4:09,1445166543,C0,69885,1445236428,10/18/2015 23:33
5256,20153329083354-580,1,10/18/2015 23:50,1445237410,C0,212072,1445449482,10/21/2015 10:44
6107,20152512052534-249,2,10/19/2015 15:09,1445292566,C0,398579,1445691145,10/24/2015 5:52
114,20155723035703-81,1,10/19/2015 17:45,1445301935,C0,951214,1446253149,10/30/2015 17:59
3293,20155411025401-133,3,10/20/2015 20:00,1445396417,C0,758297,1446154714,10/29/2015 14:38
6248,20150419080453-269,2,10/22/2015 1:40,1445503214,C0,78707,1445581921,10/22/2015 23:32
5220,20155706065753-746,1,10/22/2015 20:51,1445572260,C0,957541,1446529801,11/2/2015 21:50
6557,20152823032832-378,2,10/28/2015 17:26,1446078360,C0,54881,1446133241,10/29/2015 8:40
2719,20153720123722-777,2,10/29/2015 0:22,1446103354,C0,750489,1446853843,11/6/2015 15:50
6519,20151308101333-914,2,10/30/2015 17:39,1446251980,C0,1028281,1447280261,11/11/2015 14:17
1793,20154518094547-315,1,10/31/2015 8:12,1446304339,C0,463699,1446768038,11/5/2015 16:00
4134,20152130102130-760,2,10/31/2015 12:59,1446321585,C0,383985,1446705570,11/4/2015 22:39
928,20155913015944-240,1,11/1/2015 15:06,1446419165,C0,605883,1447025048,11/8/2015 15:24
5795,20151823041807-23,3,11/2/2015 0:49,1446454175,C0,101486,1446555661,11/3/2015 5:01
1873,20154623114627-225,1,11/2/2015 9:15,1446484521,C0,286178,1446770699,11/5/2015 16:44
4012,20155817085826-736,1,11/5/2015 23:01,1446793274,C0,535971,1447329245,11/12/2015 3:54
6183,20151518011531-224,1,11/8/2015 12:28,1447014515,C0,1220498,1448235013,11/22/2015 15:30
1529,20150606090649-896,1,11/9/2015 10:50,1447095033,C0,692428,1447787461,11/17/2015 11:11
2756,20155114055130-358,1,11/10/2015 16:10,1447200605,C0,1468445,1448669050,11/27/2015 16:04
3996,20153730083758-789,2,11/12/2015 0:36,1447317416,C0,527134,1447844550,11/18/2015 3:02
3396,20150930030938-661,3,12/1/2015 1:50,1448963439,C0,758923,1449722362,12/9/2015 20:39
708,20154326044353-158,3,12/12/2015 15:29,1449962993,C0,950280,1450913273,12/23/2015 15:27
6347,20160506090520-274,2,1/8/2016 18:00,1452304806,C0,102443,1452407249,1/9/2016 22:27
47,20162904122951-717,1,3/9/2016 5:37,1457530653,C0,203631,1457734284,3/11/2016 14:11
6489,20161412121444-732,1,3/13/2016 9:13,1457885589,C0,71905,1457957494,3/14/2016 5:11
48,20162904122951-717,FALSE,3/16/2016 6:10,1458133839,C0,202965,1458336804,3/18/2016 14:33
49,20162904122951-717,FALSE,3/23/2016 6:01,1458738089,C0,204763,1458942852,3/25/2016 14:54
50,20162904122951-717,FALSE,3/30/2016 5:12,1459339972,C0,202951,1459542923,4/1/2016 13:35
51,20162904122951-717,FALSE,4/6/2016 5:18,1459945130,C0,202754,1460147884,4/8/2016 13:38
52,20162904122951-717,FALSE,4/13/2016 5:49,1460551783,C0,203710,1460755493,4/15/2016 14:24
2315,20162403012456-660,1,5/8/2016 5:13,1462709628,C0,201266,1462910894,5/10/2016 13:08
397,20163806093805-983,1,5/9/2016 20:51,1462852279,C0,299594,1463151873,5/13/2016 8:04
5379,20163108043103-996,3,5/12/2016 9:56,1463072177,C0,160957,1463233134,5/14/2016 6:38
5002,20163607053650-333,1,5/12/2016 16:18,1463095139,C0,61047,1463156186,5/13/2016 9:16
5985,20163207073234-8,2,5/14/2016 19:16,1463278591,C0,215679,1463494270,5/17/2016 7:11
4650,20161412101451-978,1,5/15/2016 13:32,1463344378,C0,271087,1463615465,5/18/2016 16:51
3594,20162101102134-434,3,5/16/2016 10:40,1463420408,C0,185302,1463605710,5/18/2016 14:08
4807,20163909093927-432,1,5/17/2016 7:40,1463496033,C0,342033,1463838066,5/21/2016 6:41
3876,20163707033759-413,1,5/19/2016 0:57,1463644669,C0,140570,1463785239,5/20/2016 16:00
1140,20161214011208-135,1,5/19/2016 4:47,1463658465,C0,57391,1463715856,5/19/2016 20:44
5356,20160412100403-624,1,5/19/2016 17:28,1463704138,C0,631495,1464335633,5/27/2016 0:53
3768,20163922113927-867,3,5/20/2016 18:37,1463794634,C0,349181,1464143815,5/24/2016 19:36
696,20161618071617-763,2,5/21/2016 2:17,1463822247,C0,120635,1463942882,5/22/2016 11:48
5509,20165305015329-885,1,5/21/2016 20:25,1463887537,C0,175741,1464063278,5/23/2016 21:14
455,20160109120154-984,3,5/22/2016 1:24,1463905464,C0,542475,1464447939,5/28/2016 8:05
1346,20161112031156-198,2,5/22/2016 8:46,1463932004,C0,280296,1464212300,5/25/2016 14:38
1100,20165814095833-724,2,5/23/2016 5:00,1464004854,C0,253247,1464258101,5/26/2016 3:21
5480,20160711110708-553,2,5/23/2016 5:34,1464006888,C0,508430,1464515318,5/29/2016 2:48
3648,20165920055941-216,1,5/23/2016 22:15,1464066902,C0,274521,1464341423,5/27/2016 2:30
2465,20161414041441-290,3,5/24/2016 1:22,1464078127,C0,405223,1464483350,5/28/2016 17:55
4477,20162323112359-854,1,5/24/2016 10:17,1464110230,C0,82391,1464192621,5/25/2016 9:10
5182,20163217053256-155,1,5/25/2016 2:13,1464167614,C0,318019,1464485633,5/28/2016 18:33
6115,20162621032632-655,1,5/25/2016 7:17,1464185876,C0,105428,1464291304,5/26/2016 12:35
1023,20165116035154-472,1,5/25/2016 12:52,1464205954,C0,95855,1464301809,5/26/2016 15:30
4857,20160521040514-90,1,5/28/2016 4:03,1464433400,C0,187162,1464620562,5/30/2016 8:02
4153,20165529085512-11,1,5/31/2016 14:56,1464731790,C0,194478,1464926268,6/2/2016 20:57
6082,20162828032836-807,2,6/5/2016 23:35,1465194945,C0,240143,1465435088,6/8/2016 18:18
5903,20164923044905-91,3,6/15/2016 6:09,1465996145,C0,243600,1466239745,6/18/2016 1:49
6528,20164622054644-414,2,6/27/2016 15:55,1467068120,C0,443388,1467511508,7/2/2016 19:05
5736,20155705025759-63,1,10/14/2018 16:31,1539559883,C0,2789958,1542349841,11/15/2018 22:30
5741,20155705025759-63,1,6/26/2020 10:28,1593192533,C0,2575017,1595767550,7/26/2020 5:45
