"","car.id","car.type","startDatetime","startTimestamp","gate.name","duration","endTimestamp","endDatetime"
"4698","20152002042015-193",3,"2015-05-04 12:06:00",1430766360,"C8",78780,1430845140,"2015-05-05 09:59:00"
"6090","20153002013028-298",3,"2015-05-05 04:30:00",1430825400,"C4",75600,1430901000,"2015-05-06 01:30:00"
"5307","20153601093644-33",1,"2015-05-05 09:42:00",1430844120,"C3",115320,1430959440,"2015-05-06 17:44:00"
"5427","20153203033246-681",1,"2015-05-06 06:14:00",1430918040,"C0",75240,1430993280,"2015-05-07 03:08:00"
"2724","20155003035017-260",1,"2015-05-06 20:26:00",1430969160,"C5",91920,1431061080,"2015-05-07 21:58:00"
"3426","20155401045441-227",2,"2015-05-07 13:26:00",1431030360,"C3",63240,1431093600,"2015-05-08 07:00:00"
"1987","20154401104416-538",3,"2015-05-07 17:08:00",1431043680,"C2",67680,1431111360,"2015-05-08 11:56:00"
"6332","20153203033255-977",1,"2015-05-08 01:28:00",1431073680,"C4",190680,1431264360,"2015-05-10 06:26:00"
"2357","20155201095259-137",1,"2015-05-08 10:06:00",1431104760,"C8",302820,1431407580,"2015-05-11 22:13:00"
"161","20154807104818-336",1,"2015-05-08 13:06:00",1431115560,"C2",94680,1431210240,"2015-05-09 15:24:00"
"6384","20155101065139-549",1,"2015-05-09 00:19:00",1431155940,"C0",83460,1431239400,"2015-05-09 23:30:00"
"5242","20153603073614-148",1,"2015-05-09 06:50:00",1431179400,"C5",257820,1431437220,"2015-05-12 06:27:00"
"1990","20155701105733-580",1,"2015-05-09 11:27:00",1431196020,"C5",346500,1431542520,"2015-05-13 11:42:00"
"107","20155403055431-257",3,"2015-05-09 18:34:00",1431221640,"C7",74400,1431296040,"2015-05-10 15:14:00"
"4401","20154008114008-610",1,"2015-05-09 20:27:00",1431228420,"C3",118020,1431346440,"2015-05-11 05:14:00"
"947","20152907112958-34",2,"2015-05-10 01:23:00",1431246180,"C2",74280,1431320460,"2015-05-10 22:01:00"
"1494","20152705082700-328",1,"2015-05-10 07:27:00",1431268020,"C8",214200,1431482220,"2015-05-12 18:57:00"
"3135","20155803105858-900",2,"2015-05-10 10:55:00",1431280500,"C2",201540,1431482040,"2015-05-12 18:54:00"
"3651","20152807082801-714",1,"2015-05-11 03:37:00",1431340620,"C2",109380,1431450000,"2015-05-12 10:00:00"
"4921","20153003023054-91",3,"2015-05-11 08:14:00",1431357240,"C0",83580,1431440820,"2015-05-12 07:27:00"
"6124","20150104050128-43",2,"2015-05-11 16:13:00",1431385980,"C0",601920,1431987900,"2015-05-18 15:25:00"
"1161","20150703110736-237",1,"2015-05-11 20:43:00",1431402180,"C5",241920,1431644100,"2015-05-14 15:55:00"
"1801","20153507023544-222",1,"2015-05-11 22:23:00",1431408180,"C7",186840,1431595020,"2015-05-14 02:17:00"
"3401","20152908012941-964",2,"2015-05-12 00:15:00",1431414900,"C5",148980,1431563880,"2015-05-13 17:38:00"
"1438","20151903071934-939",1,"2015-05-12 08:35:00",1431444900,"C3",782160,1432227060,"2015-05-21 09:51:00"
"2868","20155910065938-444",1,"2015-05-12 15:29:00",1431469740,"C8",101700,1431571440,"2015-05-13 19:44:00"
"5615","20150410110411-548",1,"2015-05-12 17:24:00",1431476640,"C6",195600,1431672240,"2015-05-14 23:44:00"
"6512","20154506074517-446",1,"2015-05-12 18:23:00",1431480180,"C5",278340,1431758520,"2015-05-15 23:42:00"
"5777","20150207050247-410",3,"2015-05-12 18:34:00",1431480840,"C6",437520,1431918360,"2015-05-17 20:06:00"
"2991","20153109123109-53",1,"2015-05-13 09:25:00",1431534300,"C2",111480,1431645780,"2015-05-14 16:23:00"
"5526","20154702084758-168",1,"2015-05-13 10:33:00",1431538380,"C5",478380,1432016760,"2015-05-18 23:26:00"
"941","20150309100312-290",1,"2015-05-13 12:57:00",1431547020,"C4",178020,1431725040,"2015-05-15 14:24:00"
"5251","20152606062618-786",1,"2015-05-13 13:22:00",1431548520,"C5",314880,1431863400,"2015-05-17 04:50:00"
"2732","20155801105820-248",2,"2015-05-13 17:33:00",1431563580,"C5",151500,1431715080,"2015-05-15 11:38:00"
"1139","20155009055024-626",2,"2015-05-13 20:06:00",1431572760,"C6",353760,1431926520,"2015-05-17 22:22:00"
"4673","20153010103013-306",2,"2015-05-14 06:51:00",1431611460,"C2",110820,1431722280,"2015-05-15 13:38:00"
"3948","20151312051315-26",2,"2015-05-14 18:59:00",1431655140,"C8",89580,1431744720,"2015-05-15 19:52:00"
"3460","20154713054724-651",1,"2015-05-14 21:13:00",1431663180,"C2",49380,1431712560,"2015-05-15 10:56:00"
"2168","20150910080953-624",2,"2015-05-14 22:29:00",1431667740,"C5",198600,1431866340,"2015-05-17 05:39:00"
"1940","20153314113313-788",3,"2015-05-15 07:09:00",1431698940,"C2",70560,1431769500,"2015-05-16 02:45:00"
"122","20154911084948-971",3,"2015-05-15 07:46:00",1431701160,"C0",113940,1431815100,"2015-05-16 15:25:00"
"3342","20155705125721-407",3,"2015-05-15 08:05:00",1431702300,"C5",423240,1432125540,"2015-05-20 05:39:00"
"931","20153912113932-996",2,"2015-05-15 08:21:00",1431703260,"C7",123660,1431826920,"2015-05-16 18:42:00"
"6144","20152602012639-340",3,"2015-05-15 11:47:00",1431715620,"C0",372420,1432088040,"2015-05-19 19:14:00"
"2040","20153311093300-612",1,"2015-05-15 13:43:00",1431722580,"C4",360600,1432083180,"2015-05-19 17:53:00"
"1630","20152209012245-920",2,"2015-05-15 22:48:00",1431755280,"C0",276180,1432031460,"2015-05-19 03:31:00"
"6448","20153014023000-132",2,"2015-05-15 22:50:00",1431755400,"C5",58200,1431813600,"2015-05-16 15:00:00"
"4700","20154510064550-279",2,"2015-05-16 08:45:00",1431791100,"C3",175200,1431966300,"2015-05-18 09:25:00"
"2292","20153602023647-120",2,"2015-05-16 17:24:00",1431822240,"C3",174240,1431996480,"2015-05-18 17:48:00"
"5035","20154407084406-55",3,"2015-05-17 06:38:00",1431869880,"C8",428220,1432298100,"2015-05-22 05:35:00"
"201","20153108053146-433",1,"2015-05-17 08:11:00",1431875460,"C3",93000,1431968460,"2015-05-18 10:01:00"
"4376","20152608082640-6",1,"2015-05-17 18:18:00",1431911880,"C5",101640,1432013520,"2015-05-18 22:32:00"
"6002","20155809125852-460",2,"2015-05-17 20:16:00",1431918960,"C0",358740,1432277700,"2015-05-21 23:55:00"
"2714","20154707104714-7",1,"2015-05-17 22:35:00",1431927300,"C5",453240,1432380540,"2015-05-23 04:29:00"
"2743","20152309042350-396",2,"2015-05-18 00:07:00",1431932820,"C7",102720,1432035540,"2015-05-19 04:39:00"
"3964","20151202021230-956",2,"2015-05-18 01:09:00",1431936540,"C4",445140,1432381680,"2015-05-23 04:48:00"
"6388","20151312041350-13",2,"2015-05-18 05:49:00",1431953340,"C5",240480,1432193820,"2015-05-21 00:37:00"
"4508","20150412120454-71",1,"2015-05-18 07:58:00",1431961080,"C6",83940,1432045020,"2015-05-19 07:17:00"
"6065","20155516015501-914",2,"2015-05-18 12:56:00",1431978960,"C2",169260,1432148220,"2015-05-20 11:57:00"
"1172","20153114093106-881",1,"2015-05-18 13:55:00",1431982500,"C5",180720,1432163220,"2015-05-20 16:07:00"
"1687","20155604035654-479",2,"2015-05-18 19:56:00",1432004160,"C2",153000,1432157160,"2015-05-20 14:26:00"
"5634","20152712012750-549",1,"2015-05-18 20:19:00",1432005540,"C6",543120,1432548660,"2015-05-25 03:11:00"
"6039","20151017091042-992",1,"2015-05-18 22:16:00",1432012560,"C6",133560,1432146120,"2015-05-20 11:22:00"
"4522","20155414015450-986",1,"2015-05-19 00:11:00",1432019460,"C3",54660,1432074120,"2015-05-19 15:22:00"
"3411","20152813082845-836",1,"2015-05-19 02:22:00",1432027320,"C2",165480,1432192800,"2015-05-21 00:20:00"
"1431","20151503091545-22",1,"2015-05-19 02:57:00",1432029420,"C8",679860,1432709280,"2015-05-26 23:48:00"
"1769","20153817023856-742",2,"2015-05-19 08:16:00",1432048560,"C8",74940,1432123500,"2015-05-20 05:05:00"
"2094","20150416040445-103",1,"2015-05-19 11:33:00",1432060380,"C3",242940,1432303320,"2015-05-22 07:02:00"
"2619","20155016105014-878",2,"2015-05-19 12:54:00",1432065240,"C6",266640,1432331880,"2015-05-22 14:58:00"
"3747","20152708012754-464",2,"2015-05-19 21:36:00",1432096560,"C2",326580,1432423140,"2015-05-23 16:19:00"
"1558","20151810071802-340",2,"2015-05-19 22:09:00",1432098540,"C4",277020,1432375560,"2015-05-23 03:06:00"
"1482","20152816052835-878",1,"2015-05-19 23:06:00",1432101960,"C5",139740,1432241700,"2015-05-21 13:55:00"
"3359","20151807111855-648",3,"2015-05-20 01:57:00",1432112220,"C5",363180,1432475400,"2015-05-24 06:50:00"
"5382","20151112051139-269",3,"2015-05-20 04:37:00",1432121820,"C4",92280,1432214100,"2015-05-21 06:15:00"
"2545","20155519055512-566",1,"2015-05-20 10:30:00",1432143000,"C6",59700,1432202700,"2015-05-21 03:05:00"
"1964","20155608095633-284",1,"2015-05-20 18:04:00",1432170240,"C5",533040,1432703280,"2015-05-26 22:08:00"
"4270","20154002074031-133",1,"2015-05-20 18:20:00",1432171200,"C6",199200,1432370400,"2015-05-23 01:40:00"
"1371","20155411105423-23",2,"2015-05-20 19:59:00",1432177140,"C8",162060,1432339200,"2015-05-22 17:00:00"
"2327","20152018052046-592",1,"2015-05-21 02:02:00",1432198920,"C4",102060,1432300980,"2015-05-22 06:23:00"
"6091","20152114052147-25",2,"2015-05-21 02:48:00",1432201680,"C3",184140,1432385820,"2015-05-23 05:57:00"
"6554","20153215073237-222",3,"2015-05-21 04:36:00",1432208160,"C5",253920,1432462080,"2015-05-24 03:08:00"
"5822","20150409050412-493",2,"2015-05-21 06:23:00",1432214580,"C2",142620,1432357200,"2015-05-22 22:00:00"
"1497","20150818010852-458",1,"2015-05-21 07:08:00",1432217280,"C3",118800,1432336080,"2015-05-22 16:08:00"
"4799","20155509125554-329",2,"2015-05-21 08:04:00",1432220640,"C8",145620,1432366260,"2015-05-23 00:31:00"
"3674","20150020030052-644",2,"2015-05-21 09:34:00",1432226040,"C4",66840,1432292880,"2015-05-22 04:08:00"
"924","20155517095500-40",1,"2015-05-21 12:13:00",1432235580,"C8",176940,1432412520,"2015-05-23 13:22:00"
"2386","20150115010107-702",2,"2015-05-21 14:37:00",1432244220,"C2",74880,1432319100,"2015-05-22 11:25:00"
"2117","20155313065344-641",1,"2015-05-21 17:18:00",1432253880,"C5",104100,1432357980,"2015-05-22 22:13:00"
"763","20154001044056-714",3,"2015-05-21 21:25:00",1432268700,"C0",249300,1432518000,"2015-05-24 18:40:00"
"1251","20154215074223-266",1,"2015-05-21 23:02:00",1432274520,"C8",114720,1432389240,"2015-05-23 06:54:00"
"6253","20154908114938-83",1,"2015-05-22 01:13:00",1432282380,"C6",195240,1432477620,"2015-05-24 07:27:00"
"2482","20152011032039-149",1,"2015-05-22 04:35:00",1432294500,"C8",182340,1432476840,"2015-05-24 07:14:00"
"1143","20151319101335-59",2,"2015-05-22 10:10:00",1432314600,"C0",86340,1432400940,"2015-05-23 10:09:00"
"5383","20151006031050-832",1,"2015-05-22 10:58:00",1432317480,"C7",683640,1433001120,"2015-05-30 08:52:00"
"3727","20155719035725-878",1,"2015-05-22 13:33:00",1432326780,"C4",250560,1432577340,"2015-05-25 11:09:00"
"5141","20153618073639-900",1,"2015-05-22 21:10:00",1432354200,"C4",197220,1432551420,"2015-05-25 03:57:00"
"6119","20152016092004-862",2,"2015-05-22 22:24:00",1432358640,"C5",282720,1432641360,"2015-05-26 04:56:00"
"5455","20150317010343-76",2,"2015-05-22 23:39:00",1432363140,"C4",156720,1432519860,"2015-05-24 19:11:00"
"6037","20152503032527-873",1,"2015-05-23 03:08:00",1432375680,"C0",240540,1432616220,"2015-05-25 21:57:00"
"4580","20151717101752-508",1,"2015-05-23 06:17:00",1432387020,"C5",252000,1432639020,"2015-05-26 04:17:00"
"6025","20154820084851-636",3,"2015-05-23 07:06:00",1432389960,"C5",126540,1432516500,"2015-05-24 18:15:00"
"3074","20151617071647-820",3,"2015-05-23 16:22:00",1432423320,"C2",275580,1432698900,"2015-05-26 20:55:00"
"524","20152022032029-340",1,"2015-05-23 19:59:00",1432436340,"C6",103140,1432539480,"2015-05-25 00:38:00"
"6382","20153417063456-447",3,"2015-05-23 22:17:00",1432444620,"C5",82140,1432526760,"2015-05-24 21:06:00"
"5474","20153410023431-149",3,"2015-05-24 04:42:00",1432467720,"C6",146760,1432614480,"2015-05-25 21:28:00"
"2721","20155422015444-143",2,"2015-05-24 11:58:00",1432493880,"C8",82920,1432576800,"2015-05-25 11:00:00"
"1026","20155717055748-249",1,"2015-05-24 12:29:00",1432495740,"C4",73140,1432568880,"2015-05-25 08:48:00"
"2698","20155221085210-381",2,"2015-05-24 13:11:00",1432498260,"C4",274740,1432773000,"2015-05-27 17:30:00"
"4944","20150413050443-129",2,"2015-05-24 15:28:00",1432506480,"C5",314880,1432821360,"2015-05-28 06:56:00"
"2015","20151521011559-569",2,"2015-05-24 16:27:00",1432510020,"C3",270720,1432780740,"2015-05-27 19:39:00"
"2512","20155812035804-861",1,"2015-05-24 19:14:00",1432520040,"C7",524280,1433044320,"2015-05-30 20:52:00"
"3179","20150817100809-138",2,"2015-05-24 22:16:00",1432530960,"C3",81060,1432612020,"2015-05-25 20:47:00"
"521","20153622093615-832",1,"2015-05-25 03:15:00",1432548900,"C2",78780,1432627680,"2015-05-26 01:08:00"
"423","20153514093535-484",1,"2015-05-25 04:49:00",1432554540,"C8",466620,1433021160,"2015-05-30 14:26:00"
"2956","20154913014902-715",2,"2015-05-25 06:55:00",1432562100,"C0",505980,1433068080,"2015-05-31 03:28:00"
"1204","20150115090150-109",2,"2015-05-25 09:49:00",1432572540,"C8",123840,1432696380,"2015-05-26 20:13:00"
"4726","20155020055005-112",1,"2015-05-25 17:26:00",1432599960,"C0",53820,1432653780,"2015-05-26 08:23:00"
"3039","20153615103638-158",3,"2015-05-25 19:24:00",1432607040,"C2",298560,1432905600,"2015-05-29 06:20:00"
"3404","20155103035116-592",1,"2015-05-26 02:51:00",1432633860,"C4",970200,1433604060,"2015-06-06 08:21:00"
"2290","20150516120527-450",2,"2015-05-26 05:53:00",1432644780,"C4",120240,1432765020,"2015-05-27 15:17:00"
"1440","20152025052053-433",2,"2015-05-26 07:37:00",1432651020,"C6",51420,1432702440,"2015-05-26 21:54:00"
"4703","20152009082046-820",1,"2015-05-26 07:56:00",1432652160,"C5",183420,1432835580,"2015-05-28 10:53:00"
"1767","20152615072606-62",2,"2015-05-26 08:23:00",1432653780,"C5",136260,1432790040,"2015-05-27 22:14:00"
"1573","20150621060618-266",3,"2015-05-26 09:14:00",1432656840,"C8",221640,1432878480,"2015-05-28 22:48:00"
"3844","20154410124411-337",1,"2015-05-26 11:16:00",1432664160,"C0",172140,1432836300,"2015-05-28 11:05:00"
"1844","20150419110442-824",3,"2015-05-26 13:45:00",1432673100,"C3",87780,1432760880,"2015-05-27 14:08:00"
"4369","20150309080352-837",2,"2015-05-26 17:18:00",1432685880,"C8",300420,1432986300,"2015-05-30 04:45:00"
"1201","20150324080316-784",1,"2015-05-26 17:44:00",1432687440,"C4",207660,1432895100,"2015-05-29 03:25:00"
"5899","20151324031316-217",1,"2015-05-26 23:01:00",1432706460,"C8",100440,1432806900,"2015-05-28 02:55:00"
"1652","20155911075946-694",2,"2015-05-27 01:10:00",1432714200,"C7",193980,1432908180,"2015-05-29 07:03:00"
"795","20150911060947-468",3,"2015-05-27 01:24:00",1432715040,"C8",273060,1432988100,"2015-05-30 05:15:00"
"2874","20154023084059-267",2,"2015-05-27 06:04:00",1432731840,"C5",168120,1432899960,"2015-05-29 04:46:00"
"340","20153316033329-899",2,"2015-05-27 06:13:00",1432732380,"C8",183360,1432915740,"2015-05-29 09:09:00"
"3061","20155417065446-3",3,"2015-05-27 06:25:00",1432733100,"C8",123180,1432856280,"2015-05-28 16:38:00"
"6426","20153426063448-128",3,"2015-05-27 11:37:00",1432751820,"C0",104580,1432856400,"2015-05-28 16:40:00"
"4783","20154823064844-637",2,"2015-05-27 12:16:00",1432754160,"C0",182640,1432936800,"2015-05-29 15:00:00"
"4704","20151121091142-55",2,"2015-05-27 14:29:00",1432762140,"C8",268740,1433030880,"2015-05-30 17:08:00"
"234","20150821090834-726",2,"2015-05-27 17:06:00",1432771560,"C8",273540,1433045100,"2015-05-30 21:05:00"
"2181","20155020035009-541",3,"2015-05-27 18:36:00",1432776960,"C2",614760,1433391720,"2015-06-03 21:22:00"
"5560","20151822101852-375",3,"2015-05-27 21:36:00",1432787760,"C4",472680,1433260440,"2015-06-02 08:54:00"
"5179","20155522035520-589",2,"2015-05-27 22:58:00",1432792680,"C5",65340,1432858020,"2015-05-28 17:07:00"
"5873","20153622123619-566",2,"2015-05-28 03:14:00",1432808040,"C0",69240,1432877280,"2015-05-28 22:28:00"
"260","20153719023744-10",1,"2015-05-28 04:21:00",1432812060,"C5",370320,1433182380,"2015-06-01 11:13:00"
"2446","20151415091432-219",2,"2015-05-28 17:11:00",1432858260,"C7",127980,1432986240,"2015-05-30 04:44:00"
"6506","20152421032440-973",1,"2015-05-29 00:37:00",1432885020,"C5",91140,1432976160,"2015-05-30 01:56:00"
"5337","20154105104122-644",2,"2015-05-29 03:05:00",1432893900,"C5",292320,1433186220,"2015-06-01 12:17:00"
"2976","20153024043032-864",1,"2015-05-29 07:58:00",1432911480,"C3",50160,1432961640,"2015-05-29 21:54:00"
"3979","20151924061922-35",1,"2015-05-29 11:19:00",1432923540,"C7",225000,1433148540,"2015-06-01 01:49:00"
"3156","20152423082429-73",3,"2015-05-29 13:21:00",1432930860,"C4",178740,1433109600,"2015-05-31 15:00:00"
"5749","20153927083939-140",1,"2015-05-29 16:31:00",1432942260,"C8",100560,1433042820,"2015-05-30 20:27:00"
"213","20155724025730-431",1,"2015-05-29 17:41:00",1432946460,"C6",441840,1433388300,"2015-06-03 20:25:00"
"3350","20155322125316-320",2,"2015-05-29 18:29:00",1432949340,"C2",78120,1433027460,"2015-05-30 16:11:00"
"4594","20154612054651-827",2,"2015-05-30 02:30:00",1432978200,"C5",750120,1433728320,"2015-06-07 18:52:00"
"2849","20151521111559-556",2,"2015-05-30 04:51:00",1432986660,"C4",251520,1433238180,"2015-06-02 02:43:00"
"4751","20153601073650-751",3,"2015-05-30 06:35:00",1432992900,"C2",357420,1433350320,"2015-06-03 09:52:00"
"82","20150526090547-123",3,"2015-05-30 08:57:00",1433001420,"C3",345120,1433346540,"2015-06-03 08:49:00"
"4406","20154222064254-555",1,"2015-05-30 11:40:00",1433011200,"C3",354540,1433365740,"2015-06-03 14:09:00"
"5274","20152919092946-526",1,"2015-05-30 12:50:00",1433015400,"C4",962460,1433977860,"2015-06-10 16:11:00"
"5728","20152523042522-538",3,"2015-05-30 17:14:00",1433031240,"C4",86820,1433118060,"2015-05-31 17:21:00"
"3740","20155329045346-171",1,"2015-05-30 20:11:00",1433041860,"C5",49140,1433091000,"2015-05-31 09:50:00"
"1822","20152823042801-343",1,"2015-05-30 22:45:00",1433051100,"C2",627420,1433678520,"2015-06-07 05:02:00"
"4193","20155926065906-435",1,"2015-05-31 07:29:00",1433082540,"C5",216900,1433299440,"2015-06-02 19:44:00"
"2500","20153023033057-365",1,"2015-05-31 18:34:00",1433122440,"C2",87780,1433210220,"2015-06-01 18:57:00"
"4121","20153725123729-641",1,"2015-05-31 22:59:00",1433138340,"C2",277860,1433416200,"2015-06-04 04:10:00"
"5022","20154820094833-789",1,"2015-06-01 01:24:00",1433147040,"C5",125820,1433272860,"2015-06-02 12:21:00"
"5301","20152323032339-44",2,"2015-06-01 02:32:00",1433151120,"C2",243780,1433394900,"2015-06-03 22:15:00"
"4935","20150028040010-50",3,"2015-06-01 02:54:00",1433152440,"C4",149220,1433301660,"2015-06-02 20:21:00"
"6517","20155930075904-615",2,"2015-06-01 06:49:00",1433166540,"C7",84300,1433250840,"2015-06-02 06:14:00"
"172","20154026084019-504",1,"2015-06-01 07:04:00",1433167440,"C8",256320,1433423760,"2015-06-04 06:16:00"
"5980","20152625012610-60",1,"2015-06-01 09:20:00",1433175600,"C0",590040,1433765640,"2015-06-08 05:14:00"
"4024","20150929070904-711",2,"2015-06-01 11:09:00",1433182140,"C3",273600,1433455740,"2015-06-04 15:09:00"
"3362","20154321084329-326",3,"2015-06-01 12:58:00",1433188680,"C8",193140,1433381820,"2015-06-03 18:37:00"
"1131","20152231072249-788",2,"2015-06-01 14:44:00",1433195040,"C6",112920,1433307960,"2015-06-02 22:06:00"
"710","20153029093029-8",2,"2015-06-01 17:07:00",1433203620,"C2",286620,1433490240,"2015-06-05 00:44:00"
"2192","20151029071053-279",1,"2015-06-01 23:37:00",1433227020,"C5",106140,1433333160,"2015-06-03 05:06:00"
"2154","20151431111405-813",1,"2015-06-02 01:50:00",1433235000,"C0",69480,1433304480,"2015-06-02 21:08:00"
"5359","20154230064213-204",3,"2015-06-02 03:30:00",1433241000,"C4",82560,1433323560,"2015-06-03 02:26:00"
"3725","20150617090658-734",1,"2015-06-02 08:14:00",1433258040,"C0",197040,1433455080,"2015-06-04 14:58:00"
"1787","20151812011836-943",1,"2015-06-02 09:06:00",1433261160,"C7",257040,1433518200,"2015-06-05 08:30:00"
"334","20152227022219-923",1,"2015-06-02 09:22:00",1433262120,"C5",250200,1433512320,"2015-06-05 06:52:00"
"4889","20150722110719-792",1,"2015-06-02 10:59:00",1433267940,"C2",118740,1433386680,"2015-06-03 19:58:00"
"5847","20154011114039-253",1,"2015-06-02 11:06:00",1433268360,"C5",949380,1434217740,"2015-06-13 10:49:00"
"1710","20152815032843-542",3,"2015-06-02 20:44:00",1433303040,"C5",787080,1434090120,"2015-06-11 23:22:00"
"2106","20150905090932-101",2,"2015-06-02 21:03:00",1433304180,"C7",351720,1433655900,"2015-06-06 22:45:00"
"1169","20151422031406-22",1,"2015-06-02 22:38:00",1433309880,"C5",488520,1433798400,"2015-06-08 14:20:00"
"742","20150204020258-450",2,"2015-06-03 01:16:00",1433319360,"C8",363720,1433683080,"2015-06-07 06:18:00"
"5401","20155227105245-707",2,"2015-06-03 01:37:00",1433320620,"C8",114300,1433434920,"2015-06-04 09:22:00"
"2153","20150117010157-104",2,"2015-06-03 05:01:00",1433332860,"C4",180000,1433512860,"2015-06-05 07:01:00"
"2779","20151201031215-712",1,"2015-06-03 08:16:00",1433344560,"C7",73920,1433418480,"2015-06-04 04:48:00"
"4782","20151025101044-367",1,"2015-06-03 09:46:00",1433349960,"C5",110880,1433460840,"2015-06-04 16:34:00"
"97","20154130084155-739",2,"2015-06-03 11:47:00",1433357220,"C4",118920,1433476140,"2015-06-04 20:49:00"
"3399","20155130115135-673",1,"2015-06-03 13:15:00",1433362500,"C2",116880,1433479380,"2015-06-04 21:43:00"
"2685","20152802112850-57",1,"2015-06-03 13:49:00",1433364540,"C4",94860,1433459400,"2015-06-04 16:10:00"
"1037","20151601031653-102",1,"2015-06-03 14:50:00",1433368200,"C7",85620,1433453820,"2015-06-04 14:37:00"
"2707","20155102045121-443",1,"2015-06-03 15:33:00",1433370780,"C0",81720,1433452500,"2015-06-04 14:15:00"
"5559","20154302064319-564",2,"2015-06-03 16:23:00",1433373780,"C3",121200,1433494980,"2015-06-05 02:03:00"
"4062","20154502014508-491",1,"2015-06-03 18:30:00",1433381400,"C6",103500,1433484900,"2015-06-04 23:15:00"
"2006","20151202051249-156",3,"2015-06-03 19:32:00",1433385120,"C4",47400,1433432520,"2015-06-04 08:42:00"
"2727","20155801025816-705",2,"2015-06-03 22:44:00",1433396640,"C5",100380,1433497020,"2015-06-05 02:37:00"
"535","20155023065015-612",3,"2015-06-04 00:18:00",1433402280,"C2",126660,1433528940,"2015-06-05 11:29:00"
"2824","20151026031053-559",1,"2015-06-04 01:00:00",1433404800,"C7",103800,1433508600,"2015-06-05 05:50:00"
"5225","20151328121327-774",1,"2015-06-04 04:53:00",1433418780,"C8",115680,1433534460,"2015-06-05 13:01:00"
"1688","20150102120151-257",1,"2015-06-04 08:57:00",1433433420,"C2",161760,1433595180,"2015-06-06 05:53:00"
"4651","20151928041922-215",3,"2015-06-04 09:52:00",1433436720,"C4",193860,1433630580,"2015-06-06 15:43:00"
"1715","20152120032144-608",2,"2015-06-04 10:45:00",1433439900,"C5",426480,1433866380,"2015-06-09 09:13:00"
"5357","20151412071422-498",1,"2015-06-04 11:16:00",1433441760,"C2",285960,1433727720,"2015-06-07 18:42:00"
"25","20152917072906-13",2,"2015-06-04 14:29:00",1433453340,"C3",526800,1433980140,"2015-06-10 16:49:00"
"1581","20150820080854-186",1,"2015-06-04 15:38:00",1433457480,"C5",441000,1433898480,"2015-06-09 18:08:00"
"3016","20150123020103-717",2,"2015-06-04 18:25:00",1433467500,"C8",526320,1433993820,"2015-06-10 20:37:00"
"1880","20152901032906-564",1,"2015-06-04 18:44:00",1433468640,"C8",54180,1433522820,"2015-06-05 09:47:00"
"933","20155302045335-245",1,"2015-06-04 22:11:00",1433481060,"C5",63960,1433545020,"2015-06-05 15:57:00"
"1895","20151126011144-948",2,"2015-06-04 23:03:00",1433484180,"C5",116160,1433600340,"2015-06-06 07:19:00"
"4585","20153002113049-336",2,"2015-06-04 23:10:00",1433484600,"C8",107400,1433592000,"2015-06-06 05:00:00"
"5330","20153008103024-792",1,"2015-06-04 23:10:00",1433484600,"C4",297300,1433781900,"2015-06-08 09:45:00"
"2931","20155630025632-929",2,"2015-06-05 00:47:00",1433490420,"C2",155820,1433646240,"2015-06-06 20:04:00"
"3586","20155102095112-902",3,"2015-06-05 03:48:00",1433501280,"C0",79140,1433580420,"2015-06-06 01:47:00"
"3145","20155622035604-568",2,"2015-06-05 07:32:00",1433514720,"C3",168480,1433683200,"2015-06-07 06:20:00"
"196","20151627121622-355",1,"2015-06-05 10:21:00",1433524860,"C8",110100,1433634960,"2015-06-06 16:56:00"
"6425","20151507051530-305",1,"2015-06-05 10:35:00",1433525700,"C8",496320,1434022020,"2015-06-11 04:27:00"
"6331","20153903083921-101",1,"2015-06-05 11:27:00",1433528820,"C4",91440,1433620260,"2015-06-06 12:51:00"
"5430","20150605040618-478",1,"2015-06-05 12:06:00",1433531160,"C4",333000,1433864160,"2015-06-09 08:36:00"
"3567","20151807041812-701",1,"2015-06-05 14:28:00",1433539680,"C3",357000,1433896680,"2015-06-09 17:38:00"
"496","20153620073655-119",1,"2015-06-05 15:36:00",1433543760,"C8",282240,1433826000,"2015-06-08 22:00:00"
"3301","20152703012746-542",1,"2015-06-05 16:39:00",1433547540,"C0",92160,1433639700,"2015-06-06 18:15:00"
"2766","20151029121011-173",1,"2015-06-05 17:53:00",1433551980,"C2",89340,1433641320,"2015-06-06 18:42:00"
"205","20155927065901-324",1,"2015-06-05 17:59:00",1433552340,"C4",272400,1433824740,"2015-06-08 21:39:00"
"982","20153502063548-280",1,"2015-06-05 18:29:00",1433554140,"C4",100680,1433654820,"2015-06-06 22:27:00"
"2783","20151104091103-487",2,"2015-06-05 19:25:00",1433557500,"C2",123240,1433680740,"2015-06-07 05:39:00"
"1675","20153024043021-679",1,"2015-06-05 22:18:00",1433567880,"C6",176280,1433744160,"2015-06-07 23:16:00"
"5967","20153622113653-407",1,"2015-06-05 22:26:00",1433568360,"C8",249720,1433818080,"2015-06-08 19:48:00"
"4264","20155815125820-398",1,"2015-06-05 23:25:00",1433571900,"C4",617340,1434189240,"2015-06-13 02:54:00"
"1702","20155501085548-717",2,"2015-06-05 23:39:00",1433572740,"C2",199320,1433772060,"2015-06-08 07:01:00"
"1411","20155203095227-377",2,"2015-06-06 00:20:00",1433575200,"C5",112440,1433687640,"2015-06-07 07:34:00"
"2456","20152404022405-329",3,"2015-06-06 01:20:00",1433578800,"C3",62880,1433641680,"2015-06-06 18:48:00"
"4884","20152602112608-911",2,"2015-06-06 04:04:00",1433588640,"C3",159540,1433748180,"2015-06-08 00:23:00"
"1530","20154129084107-872",1,"2015-06-06 05:05:00",1433592300,"C0",84780,1433677080,"2015-06-07 04:38:00"
"5538","20153829013822-10",1,"2015-06-06 05:54:00",1433595240,"C2",331680,1433926920,"2015-06-10 02:02:00"
"841","20151102091154-662",2,"2015-06-06 07:23:00",1433600580,"C2",339120,1433939700,"2015-06-10 05:35:00"
"3036","20154102114109-572",2,"2015-06-06 07:37:00",1433601420,"C8",165480,1433766900,"2015-06-08 05:35:00"
"4157","20151902111913-640",3,"2015-06-06 07:59:00",1433602740,"C8",602400,1434205140,"2015-06-13 07:19:00"
"1155","20153704013734-599",1,"2015-06-06 08:53:00",1433605980,"C0",77880,1433683860,"2015-06-07 06:31:00"
"1414","20150030060046-176",3,"2015-06-06 08:58:00",1433606280,"C5",307740,1433914020,"2015-06-09 22:27:00"
"1586","20153804023854-460",2,"2015-06-06 10:17:00",1433611020,"C4",157140,1433768160,"2015-06-08 05:56:00"
"2205","20151022041004-148",1,"2015-06-06 11:04:00",1433613840,"C5",182520,1433796360,"2015-06-08 13:46:00"
"4904","20150719050740-812",1,"2015-06-06 15:23:00",1433629380,"C2",774480,1434403860,"2015-06-15 14:31:00"
"1275","20150027100037-189",2,"2015-06-06 15:49:00",1433630940,"C5",126420,1433757360,"2015-06-08 02:56:00"
"5636","20151505041552-201",1,"2015-06-06 16:34:00",1433633640,"C0",87540,1433721180,"2015-06-07 16:53:00"
"1223","20153002103029-92",2,"2015-06-06 16:57:00",1433635020,"C4",122940,1433757960,"2015-06-08 03:06:00"
"2370","20153402063455-599",1,"2015-06-06 20:14:00",1433646840,"C2",197400,1433844240,"2015-06-09 03:04:00"
"5292","20152203012222-575",1,"2015-06-06 20:55:00",1433649300,"C0",95460,1433744760,"2015-06-07 23:26:00"
"6193","20151329121310-651",2,"2015-06-06 21:35:00",1433651700,"C0",103560,1433755260,"2015-06-08 02:21:00"
"960","20151604011635-266",2,"2015-06-07 01:56:00",1433667360,"C3",362100,1434029460,"2015-06-11 06:31:00"
"2981","20151304041354-441",1,"2015-06-07 03:43:00",1433673780,"C4",71400,1433745180,"2015-06-07 23:33:00"
"4296","20152704012752-116",3,"2015-06-07 03:51:00",1433674260,"C0",112320,1433786580,"2015-06-08 11:03:00"
"2669","20154102064127-486",2,"2015-06-07 04:50:00",1433677800,"C3",141780,1433819580,"2015-06-08 20:13:00"
"3684","20155504125520-496",2,"2015-06-07 05:37:00",1433680620,"C4",77640,1433758260,"2015-06-08 03:11:00"
"1526","20155305035315-90",3,"2015-06-07 06:25:00",1433683500,"C3",138720,1433822220,"2015-06-08 20:57:00"
"3344","20152801112857-221",3,"2015-06-07 06:58:00",1433685480,"C3",167400,1433852880,"2015-06-09 05:28:00"
"2959","20153831123814-376",2,"2015-06-07 08:11:00",1433689860,"C2",196260,1433886120,"2015-06-09 14:42:00"
"247","20152703062723-570",1,"2015-06-07 08:12:00",1433689920,"C2",117300,1433807220,"2015-06-08 16:47:00"
"21","20152923082949-398",1,"2015-06-07 11:05:00",1433700300,"C5",186480,1433886780,"2015-06-09 14:53:00"
"5611","20151602021614-218",1,"2015-06-07 11:18:00",1433701080,"C6",421320,1434122400,"2015-06-12 08:20:00"
"1314","20155304065335-775",1,"2015-06-07 11:21:00",1433701260,"C2",137640,1433838900,"2015-06-09 01:35:00"
"5178","20155803095829-960",3,"2015-06-07 12:30:00",1433705400,"C0",177360,1433882760,"2015-06-09 13:46:00"
"3796","20152204012203-647",2,"2015-06-07 13:10:00",1433707800,"C3",258480,1433966280,"2015-06-10 12:58:00"
"6289","20151401011424-950",1,"2015-06-07 13:20:00",1433708400,"C8",259380,1433967780,"2015-06-10 13:23:00"
"2511","20153226123245-963",1,"2015-06-07 13:42:00",1433709720,"C7",520500,1434230220,"2015-06-13 14:17:00"
"1046","20150608040651-249",2,"2015-06-07 14:12:00",1433711520,"C5",861720,1434573240,"2015-06-17 13:34:00"
"654","20154705124714-48",2,"2015-06-07 14:55:00",1433714100,"C3",90240,1433804340,"2015-06-08 15:59:00"
"4383","20152805102823-890",1,"2015-06-07 15:34:00",1433716440,"C8",95580,1433812020,"2015-06-08 18:07:00"
"5283","20152501032517-581",2,"2015-06-07 16:53:00",1433721180,"C5",261840,1433983020,"2015-06-10 17:37:00"
"463","20150205070257-697",2,"2015-06-07 17:36:00",1433723760,"C8",105420,1433829180,"2015-06-08 22:53:00"
"6429","20150006010020-419",1,"2015-06-07 18:23:00",1433726580,"C4",105780,1433832360,"2015-06-08 23:46:00"
"851","20154906014956-369",1,"2015-06-07 18:28:00",1433726880,"C2",103140,1433830020,"2015-06-08 23:07:00"
"4941","20152304102334-555",1,"2015-06-07 19:04:00",1433729040,"C4",290460,1434019500,"2015-06-11 03:45:00"
"5701","20153031113006-452",1,"2015-06-07 19:40:00",1433731200,"C8",90600,1433821800,"2015-06-08 20:50:00"
"2236","20152202102255-946",1,"2015-06-07 21:57:00",1433739420,"C0",473700,1434213120,"2015-06-13 09:32:00"
"3477","20153504043512-341",3,"2015-06-07 23:57:00",1433746620,"C7",142860,1433889480,"2015-06-09 15:38:00"
"1071","20150823070821-824",2,"2015-06-08 00:59:00",1433750340,"C3",453420,1434203760,"2015-06-13 06:56:00"
"2599","20154005074031-234",1,"2015-06-08 01:49:00",1433753340,"C0",79380,1433832720,"2015-06-08 23:52:00"
"4539","20154506114531-504",3,"2015-06-08 02:57:00",1433757420,"C7",70560,1433827980,"2015-06-08 22:33:00"
"2225","20154102124124-992",2,"2015-06-08 02:58:00",1433757480,"C5",69060,1433826540,"2015-06-08 22:09:00"
"4446","20154126024152-89",1,"2015-06-08 04:14:00",1433762040,"C4",361860,1434123900,"2015-06-12 08:45:00"
"5793","20150706080728-516",3,"2015-06-08 05:45:00",1433767500,"C2",82140,1433849640,"2015-06-09 04:34:00"
"5863","20155902105925-30",3,"2015-06-08 06:11:00",1433769060,"C5",167040,1433936100,"2015-06-10 04:35:00"
"1917","20154106094112-225",1,"2015-06-08 06:14:00",1433769240,"C3",160380,1433929620,"2015-06-10 02:47:00"
"2341","20151404031404-378",2,"2015-06-08 06:22:00",1433769720,"C4",313680,1434083400,"2015-06-11 21:30:00"
"2105","20152106092143-261",1,"2015-06-08 07:24:00",1433773440,"C2",165780,1433939220,"2015-06-10 05:27:00"
"4300","20153227063240-542",1,"2015-06-08 09:04:00",1433779440,"C7",522960,1434302400,"2015-06-14 10:20:00"
"3178","20152005082009-82",2,"2015-06-08 10:29:00",1433784540,"C0",88980,1433873520,"2015-06-09 11:12:00"
"1708","20154606094659-402",1,"2015-06-08 10:44:00",1433785440,"C7",88140,1433873580,"2015-06-09 11:13:00"
"3150","20151202071233-557",1,"2015-06-08 12:38:00",1433792280,"C4",268980,1434061260,"2015-06-11 15:21:00"
"1916","20152731112735-564",1,"2015-06-08 14:19:00",1433798340,"C7",350760,1434149100,"2015-06-12 15:45:00"
"1291","20151302111323-649",2,"2015-06-08 15:23:00",1433802180,"C8",106680,1433908860,"2015-06-09 21:01:00"
"473","20150404040434-742",3,"2015-06-08 18:35:00",1433813700,"C0",354660,1434168360,"2015-06-12 21:06:00"
"174","20153206033243-388",2,"2015-06-08 19:05:00",1433815500,"C4",185580,1434001080,"2015-06-10 22:38:00"
"1602","20153730113759-10",3,"2015-06-08 21:45:00",1433825100,"C5",101760,1433926860,"2015-06-10 02:01:00"
"5542","20153504033505-27",3,"2015-06-08 22:35:00",1433828100,"C2",185400,1434013500,"2015-06-11 02:05:00"
"4034","20150707040715-238",1,"2015-06-09 03:51:00",1433847060,"C5",64320,1433911380,"2015-06-09 21:43:00"
"4943","20154505074523-130",1,"2015-06-09 04:12:00",1433848320,"C5",110940,1433959260,"2015-06-10 11:01:00"
"5785","20152102062100-389",2,"2015-06-09 05:36:00",1433853360,"C7",364500,1434217860,"2015-06-13 10:51:00"
"5456","20150002070024-376",2,"2015-06-09 06:50:00",1433857800,"C0",302100,1434159900,"2015-06-12 18:45:00"
"2109","20152207122235-665",2,"2015-06-09 07:40:00",1433860800,"C5",77940,1433938740,"2015-06-10 05:19:00"
"5855","20153906013936-263",3,"2015-06-09 08:05:00",1433862300,"C6",239160,1434101460,"2015-06-12 02:31:00"
"5371","20155004125004-492",1,"2015-06-09 08:10:00",1433862600,"C8",83040,1433945640,"2015-06-10 07:14:00"
"4191","20153907063953-451",2,"2015-06-09 10:01:00",1433869260,"C5",92460,1433961720,"2015-06-10 11:42:00"
"2227","20155301085312-76",1,"2015-06-09 11:05:00",1433873100,"C4",349560,1434222660,"2015-06-13 12:11:00"
"4786","20150104060101-478",2,"2015-06-09 11:25:00",1433874300,"C8",225720,1434100020,"2015-06-12 02:07:00"
"2988","20150606010609-786",1,"2015-06-09 16:29:00",1433892540,"C2",271380,1434163920,"2015-06-12 19:52:00"
"5137","20154607064650-344",3,"2015-06-09 16:30:00",1433892600,"C5",103920,1433996520,"2015-06-10 21:22:00"
"2920","20150805010805-339",1,"2015-06-09 17:06:00",1433894760,"C0",179940,1434074700,"2015-06-11 19:05:00"
"3856","20155907055958-889",2,"2015-06-09 17:17:00",1433895420,"C4",170280,1434065700,"2015-06-11 16:35:00"
"2022","20153107033139-406",3,"2015-06-09 18:15:00",1433898900,"C4",91320,1433990220,"2015-06-10 19:37:00"
"5449","20152305052333-803",2,"2015-06-09 18:51:00",1433901060,"C3",350880,1434251940,"2015-06-13 20:19:00"
"4017","20152707062703-3",2,"2015-06-09 18:55:00",1433901300,"C0",108840,1434010140,"2015-06-11 01:09:00"
"783","20153203053218-362",3,"2015-06-09 19:02:00",1433901720,"C6",87300,1433989020,"2015-06-10 19:17:00"
"4787","20151105121120-955",3,"2015-06-09 19:05:00",1433901900,"C5",185220,1434087120,"2015-06-11 22:32:00"
"5422","20150308110346-628",1,"2015-06-09 20:11:00",1433905860,"C2",119280,1434025140,"2015-06-11 05:19:00"
"2018","20151905081937-688",1,"2015-06-09 21:31:00",1433910660,"C4",196560,1434107220,"2015-06-12 04:07:00"
"4551","20153104043113-656",2,"2015-06-09 23:52:00",1433919120,"C7",50940,1433970060,"2015-06-10 14:01:00"
"165","20151503071547-841",1,"2015-06-10 03:45:00",1433933100,"C8",84600,1434017700,"2015-06-11 03:15:00"
"506","20152923012904-916",3,"2015-06-10 04:19:00",1433935140,"C5",761100,1434696240,"2015-06-18 23:44:00"
"5424","20152603072628-94",1,"2015-06-10 04:38:00",1433936280,"C4",84960,1434021240,"2015-06-11 04:14:00"
"5755","20152607112632-973",2,"2015-06-10 08:01:00",1433948460,"C2",246900,1434195360,"2015-06-13 04:36:00"
"4353","20152004012053-387",2,"2015-06-10 08:14:00",1433949240,"C7",250020,1434199260,"2015-06-13 05:41:00"
"2854","20152031112006-199",3,"2015-06-10 08:42:00",1433950920,"C5",427260,1434378180,"2015-06-15 07:23:00"
"2765","20154204024204-803",1,"2015-06-10 13:54:00",1433969640,"C2",515520,1434485160,"2015-06-16 13:06:00"
"2277","20152709072702-390",2,"2015-06-10 14:13:00",1433970780,"C3",110760,1434081540,"2015-06-11 20:59:00"
"565","20155801095814-110",2,"2015-06-10 16:34:00",1433979240,"C4",114480,1434093720,"2015-06-12 00:22:00"
"6088","20154314114311-549",2,"2015-06-10 18:06:00",1433984760,"C2",336540,1434321300,"2015-06-14 15:35:00"
"1908","20152504072503-198",2,"2015-06-10 19:19:00",1433989140,"C7",280620,1434269760,"2015-06-14 01:16:00"
"1377","20155606015608-991",3,"2015-06-10 19:53:00",1433991180,"C3",367020,1434358200,"2015-06-15 01:50:00"
"381","20153801053802-368",2,"2015-06-10 20:23:00",1433992980,"C4",262500,1434255480,"2015-06-13 21:18:00"
"3272","20155501015552-358",1,"2015-06-10 21:53:00",1433998380,"C4",403140,1434401520,"2015-06-15 13:52:00"
"173","20153008023037-716",1,"2015-06-10 22:14:00",1433999640,"C5",100320,1434099960,"2015-06-12 02:06:00"
"5070","20151708021738-621",1,"2015-06-10 23:23:00",1434003780,"C0",102780,1434106560,"2015-06-12 03:56:00"
"3219","20152907062931-133",2,"2015-06-11 01:08:00",1434010080,"C5",108780,1434118860,"2015-06-12 07:21:00"
"2658","20152026112029-817",1,"2015-06-11 01:12:00",1434010320,"C2",168240,1434178560,"2015-06-12 23:56:00"
"3363","20151802021836-315",2,"2015-06-11 02:18:00",1434014280,"C2",91800,1434106080,"2015-06-12 03:48:00"
"1725","20150806040856-166",2,"2015-06-11 03:42:00",1434019320,"C5",55320,1434074640,"2015-06-11 19:04:00"
"4596","20153504033551-486",1,"2015-06-11 03:47:00",1434019620,"C5",187440,1434207060,"2015-06-13 07:51:00"
"1183","20150304080318-31",1,"2015-06-11 04:55:00",1434023700,"C2",296760,1434320460,"2015-06-14 15:21:00"
"1422","20150708030724-124",2,"2015-06-11 06:42:00",1434030120,"C6",228900,1434259020,"2015-06-13 22:17:00"
"3643","20154307024334-228",1,"2015-06-11 06:47:00",1434030420,"C3",317040,1434347460,"2015-06-14 22:51:00"
"3583","20151309071349-323",1,"2015-06-11 07:43:00",1434033780,"C8",87300,1434121080,"2015-06-12 07:58:00"
"211","20153403093425-594",1,"2015-06-11 07:58:00",1434034680,"C7",97920,1434132600,"2015-06-12 11:10:00"
"770","20155610035651-241",2,"2015-06-11 08:12:00",1434035520,"C6",58560,1434094080,"2015-06-12 00:28:00"
"1667","20154910014900-520",1,"2015-06-11 09:27:00",1434040020,"C4",70680,1434110700,"2015-06-12 05:05:00"
"3495","20150808100805-344",1,"2015-06-11 11:16:00",1434046560,"C8",131640,1434178200,"2015-06-12 23:50:00"
"6444","20152705112755-32",2,"2015-06-11 12:27:00",1434050820,"C2",174000,1434224820,"2015-06-13 12:47:00"
"255","20152509092558-706",1,"2015-06-11 12:57:00",1434052620,"C5",92760,1434145380,"2015-06-12 14:43:00"
"1062","20151602031658-446",3,"2015-06-11 13:21:00",1434054060,"C8",154140,1434208200,"2015-06-13 08:10:00"
"5267","20155707045718-181",2,"2015-06-11 14:27:00",1434058020,"C5",168300,1434226320,"2015-06-13 13:12:00"
"1633","20155824115842-88",2,"2015-06-11 15:46:00",1434062760,"C6",261480,1434324240,"2015-06-14 16:24:00"
"3841","20151808071834-232",1,"2015-06-11 16:38:00",1434065880,"C3",292800,1434358680,"2015-06-15 01:58:00"
"2078","20150802030830-611",1,"2015-06-11 18:50:00",1434073800,"C5",263640,1434337440,"2015-06-14 20:04:00"
"3952","20153509123549-969",1,"2015-06-11 20:59:00",1434081540,"C5",101520,1434183060,"2015-06-13 01:11:00"
"4268","20155203125254-748",3,"2015-06-12 00:37:00",1434094620,"C8",146700,1434241320,"2015-06-13 17:22:00"
"1031","20153831033841-860",1,"2015-06-12 02:54:00",1434102840,"C5",495480,1434598320,"2015-06-17 20:32:00"
"1367","20151009061043-83",1,"2015-06-12 04:04:00",1434107040,"C0",125820,1434232860,"2015-06-13 15:01:00"
"310","20152302082313-686",1,"2015-06-12 04:55:00",1434110100,"C2",106440,1434216540,"2015-06-13 10:29:00"
"958","20152623092639-730",1,"2015-06-12 06:57:00",1434117420,"C2",245580,1434363000,"2015-06-15 03:10:00"
"3503","20151431071428-170",1,"2015-06-12 06:59:00",1434117540,"C2",345300,1434462840,"2015-06-16 06:54:00"
"1765","20154806044809-982",3,"2015-06-12 08:15:00",1434122100,"C4",69660,1434191760,"2015-06-13 03:36:00"
"6179","20155301085317-34",1,"2015-06-12 08:23:00",1434122580,"C8",189720,1434312300,"2015-06-14 13:05:00"
"5410","20151002121039-700",1,"2015-06-12 08:54:00",1434124440,"C5",426120,1434550560,"2015-06-17 07:16:00"
"2772","20152507042553-806",1,"2015-06-12 09:45:00",1434127500,"C4",51000,1434178500,"2015-06-12 23:55:00"
"5471","20155306125304-711",2,"2015-06-12 09:53:00",1434127980,"C0",169200,1434297180,"2015-06-14 08:53:00"
"3380","20154310024344-489",3,"2015-06-12 10:22:00",1434129720,"C2",157140,1434286860,"2015-06-14 06:01:00"
"6398","20154405034405-591",1,"2015-06-12 15:04:00",1434146640,"C3",75300,1434221940,"2015-06-13 11:59:00"
"769","20154405064401-508",2,"2015-06-12 15:14:00",1434147240,"C8",127080,1434274320,"2015-06-14 02:32:00"
"4683","20152910022924-572",2,"2015-06-12 15:37:00",1434148620,"C3",176880,1434325500,"2015-06-14 16:45:00"
"2999","20150003040042-47",1,"2015-06-12 17:28:00",1434155280,"C3",97860,1434253140,"2015-06-13 20:39:00"
"4644","20150509040535-12",2,"2015-06-12 18:14:00",1434158040,"C2",88980,1434247020,"2015-06-13 18:57:00"
"4481","20150102100120-757",2,"2015-06-12 18:24:00",1434158640,"C5",127740,1434286380,"2015-06-14 05:53:00"
"4116","20153208033241-763",1,"2015-06-12 18:39:00",1434159540,"C2",356820,1434516360,"2015-06-16 21:46:00"
"990","20150508110558-558",1,"2015-06-12 20:05:00",1434164700,"C3",126000,1434290700,"2015-06-14 07:05:00"
"406","20155517035538-277",1,"2015-06-12 22:16:00",1434172560,"C0",324180,1434496740,"2015-06-16 16:19:00"
"4516","20151807101827-295",2,"2015-06-12 22:18:00",1434172680,"C4",158400,1434331080,"2015-06-14 18:18:00"
"632","20151910041931-214",3,"2015-06-12 22:43:00",1434174180,"C7",97920,1434272100,"2015-06-14 01:55:00"
"2657","20152504102542-990",3,"2015-06-12 23:17:00",1434176220,"C5",105360,1434281580,"2015-06-14 04:33:00"
"1151","20150108040141-642",1,"2015-06-12 23:21:00",1434176460,"C7",186000,1434362460,"2015-06-15 03:01:00"
"1790","20155804095839-242",3,"2015-06-13 00:21:00",1434180060,"C7",106140,1434286200,"2015-06-14 05:50:00"
"5364","20151905031957-601",1,"2015-06-13 01:37:00",1434184620,"C7",320940,1434505560,"2015-06-16 18:46:00"
"3403","20154310114354-581",1,"2015-06-13 03:13:00",1434190380,"C8",114300,1434304680,"2015-06-14 10:58:00"
"2175","20151808121849-986",2,"2015-06-13 03:54:00",1434192840,"C6",66960,1434259800,"2015-06-13 22:30:00"
"3652","20152029102006-584",3,"2015-06-13 05:38:00",1434199080,"C6",213180,1434412260,"2015-06-15 16:51:00"
"5628","20150808020840-877",1,"2015-06-13 05:56:00",1434200160,"C8",201240,1434401400,"2015-06-15 13:50:00"
"6482","20152924032915-517",1,"2015-06-13 06:47:00",1434203220,"C6",282780,1434486000,"2015-06-16 13:20:00"
"1548","20150124080152-145",1,"2015-06-13 07:25:00",1434205500,"C6",287640,1434493140,"2015-06-16 15:19:00"
"3972","20152603062609-710",2,"2015-06-13 07:40:00",1434206400,"C0",434220,1434640620,"2015-06-18 08:17:00"
"616","20155007045010-724",2,"2015-06-13 08:14:00",1434208440,"C5",243720,1434452160,"2015-06-16 03:56:00"
"2184","20150624080656-470",1,"2015-06-13 08:20:00",1434208800,"C8",864420,1435073220,"2015-06-23 08:27:00"
"4597","20152112122156-641",2,"2015-06-13 10:22:00",1434216120,"C4",79260,1434295380,"2015-06-14 08:23:00"
"4027","20151403121420-600",2,"2015-06-13 10:53:00",1434217980,"C4",286380,1434504360,"2015-06-16 18:26:00"
"2632","20152209122210-562",1,"2015-06-13 10:58:00",1434218280,"C7",170280,1434388560,"2015-06-15 10:16:00"
"1978","20150307120319-340",2,"2015-06-13 12:35:00",1434224100,"C3",65040,1434289140,"2015-06-14 06:39:00"
"2744","20154711044729-817",2,"2015-06-13 12:35:00",1434224100,"C4",52560,1434276660,"2015-06-14 03:11:00"
"2430","20151004021051-72",1,"2015-06-13 12:42:00",1434224520,"C4",96540,1434321060,"2015-06-14 15:31:00"
"4681","20151711021720-756",2,"2015-06-13 14:35:00",1434231300,"C2",173880,1434405180,"2015-06-15 14:53:00"
"1412","20155311065304-252",1,"2015-06-13 14:39:00",1434231540,"C2",100380,1434331920,"2015-06-14 18:32:00"
"5115","20154003064021-184",2,"2015-06-13 16:48:00",1434239280,"C0",112560,1434351840,"2015-06-15 00:04:00"
"1","20152930032938-338",1,"2015-06-13 17:54:00",1434243240,"C8",243660,1434486900,"2015-06-16 13:35:00"
"5556","20150007110022-413",2,"2015-06-13 18:00:00",1434243600,"C2",543600,1434787200,"2015-06-20 01:00:00"
"1619","20155417065430-542",1,"2015-06-13 18:59:00",1434247140,"C8",475260,1434722400,"2015-06-19 07:00:00"
"6020","20153603023614-793",1,"2015-06-13 19:40:00",1434249600,"C5",441120,1434690720,"2015-06-18 22:12:00"
"4428","20154212054245-458",1,"2015-06-13 20:41:00",1434253260,"C3",97140,1434350400,"2015-06-14 23:40:00"
"3197","20155802065857-168",2,"2015-06-13 23:18:00",1434262680,"C8",201840,1434464520,"2015-06-16 07:22:00"
"1262","20155205045211-58",1,"2015-06-14 00:36:00",1434267360,"C7",102720,1434370080,"2015-06-15 05:08:00"
"4696","20154509014559-37",1,"2015-06-14 07:09:00",1434290940,"C7",204120,1434495060,"2015-06-16 15:51:00"
"5365","20152729102731-508",1,"2015-06-14 07:32:00",1434292320,"C8",274380,1434566700,"2015-06-17 11:45:00"
"2575","20154312124334-595",1,"2015-06-14 08:05:00",1434294300,"C5",78060,1434372360,"2015-06-15 05:46:00"
"2448","20151511061503-898",1,"2015-06-14 08:19:00",1434295140,"C2",133320,1434428460,"2015-06-15 21:21:00"
"6133","20150710010709-698",1,"2015-06-14 10:12:00",1434301920,"C8",67020,1434368940,"2015-06-15 04:49:00"
"663","20155922025905-519",2,"2015-06-14 10:26:00",1434302760,"C4",656940,1434959700,"2015-06-22 00:55:00"
"5604","20152305092355-533",2,"2015-06-14 11:29:00",1434306540,"C7",392580,1434699120,"2015-06-19 00:32:00"
"955","20154706084700-54",2,"2015-06-14 11:35:00",1434306900,"C2",87660,1434394560,"2015-06-15 11:56:00"
"1174","20152311062324-562",1,"2015-06-14 12:05:00",1434308700,"C5",139860,1434448560,"2015-06-16 02:56:00"
"5204","20155706075734-63",2,"2015-06-14 12:53:00",1434311580,"C5",354480,1434666060,"2015-06-18 15:21:00"
"2642","20155202065231-630",1,"2015-06-14 13:20:00",1434313200,"C7",530040,1434843240,"2015-06-20 16:34:00"
"4252","20155208125234-73",2,"2015-06-14 16:20:00",1434324000,"C8",265440,1434589440,"2015-06-17 18:04:00"
"472","20155412025458-760",1,"2015-06-14 16:44:00",1434325440,"C5",89700,1434415140,"2015-06-15 17:39:00"
"2573","20152707102734-863",3,"2015-06-14 19:33:00",1434335580,"C4",91080,1434426660,"2015-06-15 20:51:00"
"3707","20150106120154-473",2,"2015-06-14 19:37:00",1434335820,"C5",89820,1434425640,"2015-06-15 20:34:00"
"3078","20153606123604-841",1,"2015-06-14 20:52:00",1434340320,"C4",90120,1434430440,"2015-06-15 21:54:00"
"1134","20151212031240-621",1,"2015-06-14 21:42:00",1434343320,"C5",98100,1434441420,"2015-06-16 00:57:00"
"3132","20151811051833-890",2,"2015-06-14 21:43:00",1434343380,"C8",55020,1434398400,"2015-06-15 13:00:00"
"1427","20150413110402-150",1,"2015-06-14 22:05:00",1434344700,"C4",126060,1434470760,"2015-06-16 09:06:00"
"4314","20150606030611-107",2,"2015-06-14 22:08:00",1434344880,"C5",102360,1434447240,"2015-06-16 02:34:00"
"19","20151106121113-182",2,"2015-06-14 22:55:00",1434347700,"C8",364920,1434712620,"2015-06-19 04:17:00"
"5502","20151113011134-396",1,"2015-06-15 02:49:00",1434361740,"C4",67740,1434429480,"2015-06-15 21:38:00"
"4329","20152509072533-673",2,"2015-06-15 03:10:00",1434363000,"C5",167700,1434530700,"2015-06-17 01:45:00"
"5941","20155913025927-438",3,"2015-06-15 05:21:00",1434370860,"C7",69060,1434439920,"2015-06-16 00:32:00"
"5465","20151813101843-73",1,"2015-06-15 06:04:00",1434373440,"C8",78780,1434452220,"2015-06-16 03:57:00"
"6086","20153213033256-646",1,"2015-06-15 06:34:00",1434375240,"C5",70260,1434445500,"2015-06-16 02:05:00"
"6169","20152107072157-137",1,"2015-06-15 06:39:00",1434375540,"C8",344340,1434719880,"2015-06-19 06:18:00"
"4348","20150808020805-83",2,"2015-06-15 06:46:00",1434375960,"C5",289140,1434665100,"2015-06-18 15:05:00"
"384","20151613031640-694",1,"2015-06-15 09:48:00",1434386880,"C5",353940,1434740820,"2015-06-19 12:07:00"
"646","20153512093552-508",1,"2015-06-15 09:57:00",1434387420,"C4",260520,1434647940,"2015-06-18 10:19:00"
"5668","20151813091850-644",1,"2015-06-15 10:11:00",1434388260,"C6",175980,1434564240,"2015-06-17 11:04:00"
"3084","20154913094911-76",1,"2015-06-15 11:23:00",1434392580,"C2",89220,1434481800,"2015-06-16 12:10:00"
"1593","20155407025401-645",1,"2015-06-15 11:26:00",1434392760,"C4",84840,1434477600,"2015-06-16 11:00:00"
"2777","20154620024622-348",2,"2015-06-15 11:41:00",1434393660,"C8",447060,1434840720,"2015-06-20 15:52:00"
"6558","20154005024018-445",1,"2015-06-15 11:58:00",1434394680,"C0",284760,1434679440,"2015-06-18 19:04:00"
"5630","20150513030530-407",2,"2015-06-15 12:43:00",1434397380,"C8",82140,1434479520,"2015-06-16 11:32:00"
"4077","20152008082056-988",1,"2015-06-15 12:50:00",1434397800,"C7",310500,1434708300,"2015-06-19 03:05:00"
"1295","20151406101448-508",2,"2015-06-15 14:30:00",1434403800,"C5",113280,1434517080,"2015-06-16 21:58:00"
"4278","20155409065419-204",3,"2015-06-15 14:56:00",1434405360,"C7",273660,1434679020,"2015-06-18 18:57:00"
"6376","20152813042842-830",3,"2015-06-15 15:10:00",1434406200,"C2",84060,1434490260,"2015-06-16 14:31:00"
"188","20151007061036-970",2,"2015-06-15 15:12:00",1434406320,"C5",361860,1434768180,"2015-06-19 19:43:00"
"2801","20155413045417-828",2,"2015-06-15 16:22:00",1434410520,"C7",85440,1434495960,"2015-06-16 16:06:00"
"4362","20154512124548-471",1,"2015-06-15 16:39:00",1434411540,"C4",91080,1434502620,"2015-06-16 17:57:00"
"1973","20151414041459-646",1,"2015-06-15 17:29:00",1434414540,"C6",90900,1434505440,"2015-06-16 18:44:00"
"1101","20150309010348-628",1,"2015-06-15 18:09:00",1434416940,"C5",268380,1434685320,"2015-06-18 20:42:00"
"4080","20152913122916-642",2,"2015-06-15 18:17:00",1434417420,"C7",96840,1434514260,"2015-06-16 21:11:00"
"6495","20152607102647-573",1,"2015-06-15 18:59:00",1434419940,"C4",103140,1434523080,"2015-06-16 23:38:00"
"1571","20153213063205-982",1,"2015-06-15 20:02:00",1434423720,"C8",110700,1434534420,"2015-06-17 02:47:00"
"2479","20153005093039-50",1,"2015-06-15 20:50:00",1434426600,"C8",180960,1434607560,"2015-06-17 23:06:00"
"3991","20152114012137-37",1,"2015-06-15 20:59:00",1434427140,"C4",113880,1434541020,"2015-06-17 04:37:00"
"1369","20154009054046-633",3,"2015-06-15 21:10:00",1434427800,"C5",265500,1434693300,"2015-06-18 22:55:00"
"4389","20150113030159-936",1,"2015-06-15 21:28:00",1434428880,"C4",196020,1434624900,"2015-06-18 03:55:00"
"6060","20150013110026-797",1,"2015-06-15 22:12:00",1434431520,"C5",106560,1434538080,"2015-06-17 03:48:00"
"712","20153203093248-618",1,"2015-06-15 22:46:00",1434433560,"C5",542220,1434975780,"2015-06-22 05:23:00"
"3858","20154407024412-194",1,"2015-06-15 22:53:00",1434433980,"C0",240180,1434674160,"2015-06-18 17:36:00"
"1890","20151707051709-188",2,"2015-06-15 23:56:00",1434437760,"C4",238380,1434676140,"2015-06-18 18:09:00"
"1205","20155214125258-653",1,"2015-06-16 01:34:00",1434443640,"C7",66060,1434509700,"2015-06-16 19:55:00"
"850","20153710103717-23",1,"2015-06-16 01:58:00",1434445080,"C4",162420,1434607500,"2015-06-17 23:05:00"
"4761","20155222025248-836",1,"2015-06-16 03:07:00",1434449220,"C8",423540,1434872760,"2015-06-21 00:46:00"
"2820","20151403111404-688",2,"2015-06-16 03:08:00",1434449280,"C6",182340,1434631620,"2015-06-18 05:47:00"
"1219","20150114030106-231",1,"2015-06-16 03:57:00",1434452220,"C2",66480,1434518700,"2015-06-16 22:25:00"
"2489","20151413031402-190",3,"2015-06-16 04:10:00",1434453000,"C2",109680,1434562680,"2015-06-17 10:38:00"
"1321","20151514091533-555",2,"2015-06-16 05:13:00",1434456780,"C4",79140,1434535920,"2015-06-17 03:12:00"
"4498","20155107105141-423",2,"2015-06-16 05:23:00",1434457380,"C2",378960,1434836340,"2015-06-20 14:39:00"
"6094","20151012111048-832",1,"2015-06-16 07:15:00",1434464100,"C4",331500,1434795600,"2015-06-20 03:20:00"
"4901","20151813021824-408",2,"2015-06-16 08:22:00",1434468120,"C3",237840,1434705960,"2015-06-19 02:26:00"
"868","20155408015402-944",2,"2015-06-16 11:43:00",1434480180,"C4",97620,1434577800,"2015-06-17 14:50:00"
"4145","20153909123913-261",2,"2015-06-16 11:43:00",1434480180,"C0",85920,1434566100,"2015-06-17 11:35:00"
"3010","20152315102354-941",1,"2015-06-16 11:48:00",1434480480,"C4",91500,1434571980,"2015-06-17 13:13:00"
"5342","20152315122321-162",3,"2015-06-16 11:50:00",1434480600,"C0",84420,1434565020,"2015-06-17 11:17:00"
"270","20153407123403-76",2,"2015-06-16 11:52:00",1434480720,"C2",258360,1434739080,"2015-06-19 11:38:00"
"3765","20153708073703-436",2,"2015-06-16 13:17:00",1434485820,"C0",355800,1434841620,"2015-06-20 16:07:00"
"5815","20153801063806-347",1,"2015-06-16 14:04:00",1434488640,"C2",1322760,1435811400,"2015-07-01 21:30:00"
"2123","20150011020058-334",2,"2015-06-16 14:10:00",1434489000,"C2",61800,1434550800,"2015-06-17 07:20:00"
"1488","20155712125721-681",1,"2015-06-16 14:57:00",1434491820,"C2",117600,1434609420,"2015-06-17 23:37:00"
"948","20152807062821-864",1,"2015-06-16 14:58:00",1434491880,"C5",269400,1434761280,"2015-06-19 17:48:00"
"2627","20152012032058-971",1,"2015-06-16 15:22:00",1434493320,"C5",172860,1434666180,"2015-06-18 15:23:00"
"3313","20152308052334-841",3,"2015-06-16 16:29:00",1434497340,"C3",98280,1434595620,"2015-06-17 19:47:00"
"6089","20153508053537-848",3,"2015-06-16 16:50:00",1434498600,"C2",229500,1434728100,"2015-06-19 08:35:00"
"700","20154207084222-772",1,"2015-06-16 16:56:00",1434498960,"C5",115320,1434614280,"2015-06-18 00:58:00"
"4845","20151615011608-528",2,"2015-06-16 22:48:00",1434520080,"C6",120720,1434640800,"2015-06-18 08:20:00"
"1903","20150010050052-231",1,"2015-06-17 01:24:00",1434529440,"C2",68580,1434598020,"2015-06-17 20:27:00"
"404","20154810034812-304",3,"2015-06-17 01:28:00",1434529680,"C4",276600,1434806280,"2015-06-20 06:18:00"
"3299","20152310032340-322",1,"2015-06-17 01:30:00",1434529800,"C4",79260,1434609060,"2015-06-17 23:31:00"
"2902","20155314075350-327",1,"2015-06-17 02:03:00",1434531780,"C7",119100,1434650880,"2015-06-18 11:08:00"
"1486","20153509013553-476",3,"2015-06-17 04:10:00",1434539400,"C7",93900,1434633300,"2015-06-18 06:15:00"
"3434","20155409125422-39",2,"2015-06-17 04:14:00",1434539640,"C5",82500,1434622140,"2015-06-18 03:09:00"
"5716","20152004042018-896",3,"2015-06-17 04:20:00",1434540000,"C6",180000,1434720000,"2015-06-19 06:20:00"
"5979","20151011011032-480",2,"2015-06-17 04:36:00",1434540960,"C8",243780,1434784740,"2015-06-20 00:19:00"
"2440","20155813115831-288",1,"2015-06-17 05:32:00",1434544320,"C0",161220,1434705540,"2015-06-19 02:19:00"
"5345","20150907060938-780",2,"2015-06-17 06:51:00",1434549060,"C6",144420,1434693480,"2015-06-18 22:58:00"
"1181","20155909075931-597",3,"2015-06-17 07:09:00",1434550140,"C2",344100,1434894240,"2015-06-21 06:44:00"
"1869","20153815083827-733",2,"2015-06-17 07:14:00",1434550440,"C2",83880,1434634320,"2015-06-18 06:32:00"
"3698","20150514090542-943",3,"2015-06-17 08:26:00",1434554760,"C5",85620,1434640380,"2015-06-18 08:13:00"
"3312","20152313102357-845",2,"2015-06-17 10:11:00",1434561060,"C0",344880,1434905940,"2015-06-21 09:59:00"
"156","20150305060300-527",1,"2015-06-17 10:17:00",1434561420,"C5",526020,1435087440,"2015-06-23 12:24:00"
"1569","20151307091345-782",1,"2015-06-17 11:26:00",1434565560,"C3",871980,1435437540,"2015-06-27 13:39:00"
"1720","20153906013912-384",2,"2015-06-17 12:05:00",1434567900,"C8",1811580,1436379480,"2015-07-08 11:18:00"
"3686","20155014015019-965",1,"2015-06-17 12:08:00",1434568080,"C3",84360,1434652440,"2015-06-18 11:34:00"
"4144","20153015023037-512",1,"2015-06-17 13:40:00",1434573600,"C8",84900,1434658500,"2015-06-18 13:15:00"
"2554","20155106065150-500",1,"2015-06-17 13:52:00",1434574320,"C5",139380,1434713700,"2015-06-19 04:35:00"
"3678","20151807121828-117",2,"2015-06-17 14:42:00",1434577320,"C2",436320,1435013640,"2015-06-22 15:54:00"
"3975","20152913022938-375",3,"2015-06-17 15:55:00",1434581700,"C8",175380,1434757080,"2015-06-19 16:38:00"
"2300","20151616021636-386",1,"2015-06-17 18:52:00",1434592320,"C6",102960,1434695280,"2015-06-18 23:28:00"
"3697","20152614032608-515",3,"2015-06-17 21:12:00",1434600720,"C8",139980,1434740700,"2015-06-19 12:05:00"
"3192","20155311045315-402",1,"2015-06-17 21:19:00",1434601140,"C4",267180,1434868320,"2015-06-20 23:32:00"
"5142","20153013013015-228",1,"2015-06-17 21:19:00",1434601140,"C2",373740,1434974880,"2015-06-22 05:08:00"
"2641","20153716033726-119",2,"2015-06-17 22:08:00",1434604080,"C2",109860,1434713940,"2015-06-19 04:39:00"
"6041","20150210020219-563",1,"2015-06-17 23:54:00",1434610440,"C4",80040,1434690480,"2015-06-18 22:08:00"
"5694","20150715100705-414",1,"2015-06-17 23:59:00",1434610740,"C5",111360,1434722100,"2015-06-19 06:55:00"
"460","20152307102329-186",1,"2015-06-18 00:11:00",1434611460,"C5",456840,1435068300,"2015-06-23 07:05:00"
"129","20152603032638-774",1,"2015-06-18 01:21:00",1434615660,"C5",177900,1434793560,"2015-06-20 02:46:00"
"554","20154810074844-679",2,"2015-06-18 05:43:00",1434631380,"C8",136740,1434768120,"2015-06-19 19:42:00"
"3497","20154309114329-296",2,"2015-06-18 05:53:00",1434631980,"C5",378300,1435010280,"2015-06-22 14:58:00"
"6461","20150409100452-47",1,"2015-06-18 06:40:00",1434634800,"C0",255120,1434889920,"2015-06-21 05:32:00"
"5250","20155809125823-570",1,"2015-06-18 07:06:00",1434636360,"C3",94560,1434730920,"2015-06-19 09:22:00"
"894","20153217103251-836",1,"2015-06-18 08:34:00",1434641640,"C2",79320,1434720960,"2015-06-19 06:36:00"
"2270","20154416074444-263",1,"2015-06-18 08:47:00",1434642420,"C4",176580,1434819000,"2015-06-20 09:50:00"
"3853","20154211054209-984",2,"2015-06-18 09:18:00",1434644280,"C0",406620,1435050900,"2015-06-23 02:15:00"
"3647","20155511075557-246",2,"2015-06-18 09:29:00",1434644940,"C3",305220,1434950160,"2015-06-21 22:16:00"
"3961","20155612075623-190",1,"2015-06-18 09:31:00",1434645060,"C8",104820,1434749880,"2015-06-19 14:38:00"
"2193","20154308034359-236",1,"2015-06-18 10:00:00",1434646800,"C4",843420,1435490220,"2015-06-28 04:17:00"
"6353","20154913024913-440",2,"2015-06-18 10:54:00",1434650040,"C7",59700,1434709740,"2015-06-19 03:29:00"
"2451","20152206102254-44",2,"2015-06-18 11:24:00",1434651840,"C7",520260,1435172100,"2015-06-24 11:55:00"
"4780","20155308075334-739",1,"2015-06-18 11:52:00",1434653520,"C4",209220,1434862740,"2015-06-20 21:59:00"
"5034","20153915063929-257",1,"2015-06-18 12:19:00",1434655140,"C7",139800,1434794940,"2015-06-20 03:09:00"
"702","20155904055905-326",2,"2015-06-18 12:37:00",1434656220,"C7",170040,1434826260,"2015-06-20 11:51:00"
"4971","20153709073753-995",3,"2015-06-18 13:05:00",1434657900,"C6",797280,1435455180,"2015-06-27 18:33:00"
"4821","20151515041526-196",1,"2015-06-18 13:09:00",1434658140,"C4",82680,1434740820,"2015-06-19 12:07:00"
"344","20151316021336-107",3,"2015-06-18 13:35:00",1434659700,"C2",85260,1434744960,"2015-06-19 13:16:00"
"2647","20154210124201-733",1,"2015-06-18 13:56:00",1434660960,"C4",347820,1435008780,"2015-06-22 14:33:00"
"6305","20153704083744-741",3,"2015-06-18 14:41:00",1434663660,"C5",175920,1434839580,"2015-06-20 15:33:00"
"4336","20153912053941-227",1,"2015-06-18 15:29:00",1434666540,"C4",255300,1434921840,"2015-06-21 14:24:00"
"4373","20153513013506-980",3,"2015-06-18 15:40:00",1434667200,"C3",439500,1435106700,"2015-06-23 17:45:00"
"4718","20153510023528-508",2,"2015-06-18 19:39:00",1434681540,"C4",88680,1434770220,"2015-06-19 20:17:00"
"5674","20155004085057-252",3,"2015-06-18 19:48:00",1434682080,"C0",178440,1434860520,"2015-06-20 21:22:00"
"3288","20152104052130-587",2,"2015-06-18 19:55:00",1434682500,"C2",174120,1434856620,"2015-06-20 20:17:00"
"2953","20152116052127-688",1,"2015-06-18 19:57:00",1434682620,"C2",91080,1434773700,"2015-06-19 21:15:00"
"1849","20152415102404-680",2,"2015-06-18 20:49:00",1434685740,"C4",296700,1434982440,"2015-06-22 07:14:00"
"5026","20150816050850-701",1,"2015-06-18 21:58:00",1434689880,"C8",95100,1434784980,"2015-06-20 00:23:00"
"6212","20155412045446-0",1,"2015-06-18 22:36:00",1434692160,"C8",269460,1434961620,"2015-06-22 01:27:00"
"2900","20153007083052-124",1,"2015-06-18 23:03:00",1434693780,"C0",334260,1435028040,"2015-06-22 19:54:00"
"440","20153704113707-880",1,"2015-06-18 23:51:00",1434696660,"C4",626820,1435323480,"2015-06-26 05:58:00"
"2262","20152614112619-98",2,"2015-06-19 00:26:00",1434698760,"C3",196200,1434894960,"2015-06-21 06:56:00"
"4137","20151816121814-878",1,"2015-06-19 02:08:00",1434704880,"C8",111300,1434816180,"2015-06-20 09:03:00"
"966","20155613125611-113",1,"2015-06-19 02:56:00",1434707760,"C5",60300,1434768060,"2015-06-19 19:41:00"
"4273","20154213044221-384",1,"2015-06-19 03:01:00",1434708060,"C8",67020,1434775080,"2015-06-19 21:38:00"
"1871","20155711035748-460",3,"2015-06-19 03:58:00",1434711480,"C4",92580,1434804060,"2015-06-20 05:41:00"
"22","20155817095851-242",3,"2015-06-19 04:40:00",1434714000,"C4",76860,1434790860,"2015-06-20 02:01:00"
"1277","20152311102347-770",1,"2015-06-19 04:56:00",1434714960,"C0",95940,1434810900,"2015-06-20 07:35:00"
"6515","20151506031529-885",3,"2015-06-19 05:04:00",1434715440,"C7",155220,1434870660,"2015-06-21 00:11:00"
"2304","20151201071206-107",3,"2015-06-19 05:14:00",1434716040,"C8",221160,1434937200,"2015-06-21 18:40:00"
"4648","20154404074423-76",1,"2015-06-19 05:39:00",1434717540,"C8",257700,1434975240,"2015-06-22 05:14:00"
"4451","20154317014329-54",1,"2015-06-19 05:57:00",1434718620,"C5",72420,1434791040,"2015-06-20 02:04:00"
"3521","20152711112749-922",3,"2015-06-19 06:00:00",1434718800,"C2",95940,1434814740,"2015-06-20 08:39:00"
"4802","20150613070629-561",2,"2015-06-19 06:04:00",1434719040,"C8",257340,1434976380,"2015-06-22 05:33:00"
"6042","20155712085725-362",1,"2015-06-19 06:05:00",1434719100,"C4",297240,1435016340,"2015-06-22 16:39:00"
"3641","20154916014913-150",3,"2015-06-19 06:19:00",1434719940,"C0",116100,1434836040,"2015-06-20 14:34:00"
"4864","20150918040902-934",1,"2015-06-19 06:21:00",1434720060,"C2",51120,1434771180,"2015-06-19 20:33:00"
"2104","20153618123612-480",2,"2015-06-19 06:31:00",1434720660,"C6",64500,1434785160,"2015-06-20 00:26:00"
"5671","20150603100608-37",3,"2015-06-19 06:58:00",1434722280,"C5",685560,1435407840,"2015-06-27 05:24:00"
"2561","20154318074327-65",2,"2015-06-19 07:02:00",1434722520,"C3",83940,1434806460,"2015-06-20 06:21:00"
"5640","20152215122235-485",1,"2015-06-19 07:15:00",1434723300,"C6",327180,1435050480,"2015-06-23 02:08:00"
"395","20155106085152-545",1,"2015-06-19 07:18:00",1434723480,"C2",159660,1434883140,"2015-06-21 03:39:00"
"4871","20153407083404-897",1,"2015-06-19 08:37:00",1434728220,"C2",1036980,1435765200,"2015-07-01 08:40:00"
"400","20150017100000-961",2,"2015-06-19 08:41:00",1434728460,"C4",168060,1434896520,"2015-06-21 07:22:00"
"5572","20150218080215-880",3,"2015-06-19 09:12:00",1434730320,"C4",90600,1434820920,"2015-06-20 10:22:00"
"2486","20151815041843-802",1,"2015-06-19 11:18:00",1434737880,"C4",327600,1435065480,"2015-06-23 06:18:00"
"839","20152507042512-111",1,"2015-06-19 13:19:00",1434745140,"C3",146520,1434891660,"2015-06-21 06:01:00"
"5263","20153606073656-187",1,"2015-06-19 14:48:00",1434750480,"C3",383040,1435133520,"2015-06-24 01:12:00"
"1058","20153213083242-735",1,"2015-06-19 17:04:00",1434758640,"C2",274560,1435033200,"2015-06-22 21:20:00"
"3204","20152517042527-36",1,"2015-06-19 17:15:00",1434759300,"C2",87900,1434847200,"2015-06-20 17:40:00"
"4308","20154507074526-430",1,"2015-06-19 17:21:00",1434759660,"C2",133920,1434893580,"2015-06-21 06:33:00"
"4833","20152004092005-697",2,"2015-06-19 17:32:00",1434760320,"C8",189360,1434949680,"2015-06-21 22:08:00"
"1318","20154213024216-561",1,"2015-06-19 17:33:00",1434760380,"C4",176220,1434936600,"2015-06-21 18:30:00"
"4399","20154412114408-299",2,"2015-06-19 17:38:00",1434760680,"C2",626040,1435386720,"2015-06-26 23:32:00"
"540","20154914054916-877",2,"2015-06-19 17:45:00",1434761100,"C0",61680,1434822780,"2015-06-20 10:53:00"
"3194","20155813105800-351",3,"2015-06-19 18:42:00",1434764520,"C5",68280,1434832800,"2015-06-20 13:40:00"
"4710","20153217103218-546",1,"2015-06-19 19:19:00",1434766740,"C4",204420,1434971160,"2015-06-22 04:06:00"
"1478","20152005072047-527",2,"2015-06-19 20:22:00",1434770520,"C8",628260,1435398780,"2015-06-27 02:53:00"
"6513","20155911095900-214",2,"2015-06-19 20:35:00",1434771300,"C5",364680,1435135980,"2015-06-24 01:53:00"
"561","20150116050129-415",2,"2015-06-19 20:45:00",1434771900,"C6",272640,1435044540,"2015-06-23 00:29:00"
"5724","20153411023411-472",1,"2015-06-19 20:47:00",1434772020,"C4",101940,1434873960,"2015-06-21 01:06:00"
"2676","20152917022939-684",2,"2015-06-19 21:16:00",1434773760,"C4",197220,1434970980,"2015-06-22 04:03:00"
"2443","20151215021211-822",1,"2015-06-19 22:02:00",1434776520,"C7",186900,1434963420,"2015-06-22 01:57:00"
"1930","20155417075442-571",1,"2015-06-20 01:28:00",1434788880,"C3",118020,1434906900,"2015-06-21 10:15:00"
"4708","20155312015304-1",1,"2015-06-20 02:17:00",1434791820,"C2",81180,1434873000,"2015-06-21 00:50:00"
"5748","20153417073443-887",3,"2015-06-20 02:58:00",1434794280,"C0",80880,1434875160,"2015-06-21 01:26:00"
"4142","20153514023510-367",1,"2015-06-20 02:59:00",1434794340,"C5",59580,1434853920,"2015-06-20 19:32:00"
"4515","20150803060828-975",3,"2015-06-20 03:05:00",1434794700,"C5",208260,1435002960,"2015-06-22 12:56:00"
"1184","20151809111800-66",1,"2015-06-20 03:08:00",1434794880,"C5",460500,1435255380,"2015-06-25 11:03:00"
"5898","20152917022938-308",2,"2015-06-20 03:53:00",1434797580,"C2",110520,1434908100,"2015-06-21 10:35:00"
"5086","20155516055530-619",3,"2015-06-20 04:29:00",1434799740,"C5",148620,1434948360,"2015-06-21 21:46:00"
"6533","20151014091022-504",1,"2015-06-20 05:52:00",1434804720,"C6",84420,1434889140,"2015-06-21 05:19:00"
"5241","20151017081005-686",1,"2015-06-20 06:52:00",1434808320,"C8",127260,1434935580,"2015-06-21 18:13:00"
"2128","20150201080212-913",2,"2015-06-20 06:58:00",1434808680,"C5",204720,1435013400,"2015-06-22 15:50:00"
"3414","20150616120616-647",1,"2015-06-20 07:20:00",1434810000,"C4",164220,1434974220,"2015-06-22 04:57:00"
"4067","20154729084718-7",2,"2015-06-20 08:11:00",1434813060,"C7",210960,1435024020,"2015-06-22 18:47:00"
"4075","20154508054512-557",1,"2015-06-20 08:41:00",1434814860,"C7",502080,1435316940,"2015-06-26 04:09:00"
"1993","20153307123351-488",1,"2015-06-20 08:47:00",1434815220,"C8",158520,1434973740,"2015-06-22 04:49:00"
"6433","20153619103622-151",1,"2015-06-20 09:05:00",1434816300,"C4",80940,1434897240,"2015-06-21 07:34:00"
"1213","20155613065614-139",1,"2015-06-20 09:26:00",1434817560,"C2",204600,1435022160,"2015-06-22 18:16:00"
"136","20151308081312-606",1,"2015-06-20 10:43:00",1434822180,"C2",248280,1435070460,"2015-06-23 07:41:00"
"3422","20152010012044-386",1,"2015-06-20 10:56:00",1434822960,"C4",106920,1434929880,"2015-06-21 16:38:00"
"3144","20155418045458-340",1,"2015-06-20 12:46:00",1434829560,"C0",157920,1434987480,"2015-06-22 08:38:00"
"1456","20151218051211-725",3,"2015-06-20 12:49:00",1434829740,"C6",157020,1434986760,"2015-06-22 08:26:00"
"3847","20155514115559-607",1,"2015-06-20 14:03:00",1434834180,"C0",526080,1435360260,"2015-06-26 16:11:00"
"502","20155605125623-741",3,"2015-06-20 14:15:00",1434834900,"C5",185820,1435020720,"2015-06-22 17:52:00"
"2806","20150018050050-556",2,"2015-06-20 14:40:00",1434836400,"C4",164400,1435000800,"2015-06-22 12:20:00"
"10","20152119012112-241",1,"2015-06-20 14:45:00",1434836700,"C4",91440,1434928140,"2015-06-21 16:09:00"
"2374","20150329010340-772",2,"2015-06-20 15:18:00",1434838680,"C3",272700,1435111380,"2015-06-23 19:03:00"
"2904","20155213115254-355",1,"2015-06-20 16:32:00",1434843120,"C2",88800,1434931920,"2015-06-21 17:12:00"
"3020","20153919063918-509",1,"2015-06-20 17:12:00",1434845520,"C3",124380,1434969900,"2015-06-22 03:45:00"
"3015","20152908102913-779",1,"2015-06-20 17:54:00",1434848040,"C8",212700,1435060740,"2015-06-23 04:59:00"
"2613","20155307025311-47",1,"2015-06-20 18:28:00",1434850080,"C2",162300,1435012380,"2015-06-22 15:33:00"
"5922","20155417055404-842",2,"2015-06-20 19:03:00",1434852180,"C5",87780,1434939960,"2015-06-21 19:26:00"
"111","20155212055238-204",1,"2015-06-20 20:57:00",1434859020,"C8",140460,1434999480,"2015-06-22 11:58:00"
"5516","20155517025520-359",1,"2015-06-20 21:35:00",1434861300,"C2",141600,1435002900,"2015-06-22 12:55:00"
"3515","20155616035629-355",1,"2015-06-20 22:34:00",1434864840,"C8",184740,1435049580,"2015-06-23 01:53:00"
"2480","20152119122102-412",1,"2015-06-21 00:47:00",1434872820,"C5",65580,1434938400,"2015-06-21 19:00:00"
"1018","20153416013418-86",2,"2015-06-21 01:32:00",1434875520,"C8",194340,1435069860,"2015-06-23 07:31:00"
"6096","20150914090940-696",1,"2015-06-21 01:54:00",1434876840,"C8",115740,1434992580,"2015-06-22 10:03:00"
"1396","20151210121248-239",1,"2015-06-21 03:00:00",1434880800,"C1",114660,1434995460,"2015-06-22 10:51:00"
"294","20152215082242-794",1,"2015-06-21 03:07:00",1434881220,"C3",166500,1435047720,"2015-06-23 01:22:00"
"5245","20153919023921-5",2,"2015-06-21 03:29:00",1434882540,"C5",66300,1434948840,"2015-06-21 21:54:00"
"1388","20152312032319-646",2,"2015-06-21 04:41:00",1434886860,"C4",246360,1435133220,"2015-06-24 01:07:00"
"3469","20153604113610-711",3,"2015-06-21 05:09:00",1434888540,"C8",589140,1435477680,"2015-06-28 00:48:00"
"1737","20150612090614-805",1,"2015-06-21 05:40:00",1434890400,"C2",109320,1434999720,"2015-06-22 12:02:00"
"2176","20153601093619-939",1,"2015-06-21 06:32:00",1434893520,"C8",245280,1435138800,"2015-06-24 02:40:00"
"5381","20153514073524-157",3,"2015-06-21 07:50:00",1434898200,"C5",201900,1435100100,"2015-06-23 15:55:00"
"77","20153619123625-792",3,"2015-06-21 08:00:00",1434898800,"C3",156240,1435055040,"2015-06-23 03:24:00"
"5585","20151201081219-907",2,"2015-06-21 08:52:00",1434901920,"C6",216300,1435118220,"2015-06-23 20:57:00"
"2742","20153118023112-598",3,"2015-06-21 09:25:00",1434903900,"C2",80280,1434984180,"2015-06-22 07:43:00"
"2881","20152919012937-798",1,"2015-06-21 10:41:00",1434908460,"C6",162720,1435071180,"2015-06-23 07:53:00"
"697","20154111084119-363",1,"2015-06-21 12:03:00",1434913380,"C2",125160,1435038540,"2015-06-22 22:49:00"
"3112","20153317123351-161",1,"2015-06-21 12:13:00",1434913980,"C8",68880,1434982860,"2015-06-22 07:21:00"
"1806","20153202123219-728",3,"2015-06-21 13:28:00",1434918480,"C0",205620,1435124100,"2015-06-23 22:35:00"
"2579","20155228125229-86",3,"2015-06-21 17:08:00",1434931680,"C0",261120,1435192800,"2015-06-24 17:40:00"
"4104","20152513092510-818",2,"2015-06-21 18:25:00",1434936300,"C6",120600,1435056900,"2015-06-23 03:55:00"
"6397","20152314062321-228",2,"2015-06-21 19:10:00",1434939000,"C6",650820,1435589820,"2015-06-29 07:57:00"
"880","20155519105547-921",1,"2015-06-21 19:19:00",1434939540,"C5",101520,1435041060,"2015-06-22 23:31:00"
"6095","20154824104802-646",3,"2015-06-21 20:08:00",1434942480,"C7",350400,1435292880,"2015-06-25 21:28:00"
"2679","20154907054902-752",2,"2015-06-21 20:37:00",1434944220,"C5",152460,1435096680,"2015-06-23 14:58:00"
"1076","20153419053450-999",1,"2015-06-21 21:37:00",1434947820,"C4",62460,1435010280,"2015-06-22 14:58:00"
"5450","20153719113733-632",1,"2015-06-21 21:52:00",1434948720,"C4",69900,1435018620,"2015-06-22 17:17:00"
"2164","20153315043301-166",3,"2015-06-21 22:18:00",1434950280,"C2",179700,1435129980,"2015-06-24 00:13:00"
"3983","20151619061642-149",2,"2015-06-21 22:38:00",1434951480,"C0",115860,1435067340,"2015-06-23 06:49:00"
"4602","20154519024544-322",2,"2015-06-21 23:37:00",1434955020,"C4",204720,1435159740,"2015-06-24 08:29:00"
"5827","20151411091404-225",1,"2015-06-22 00:26:00",1434957960,"C8",459360,1435417320,"2015-06-27 08:02:00"
"4346","20150517050533-767",3,"2015-06-22 00:49:00",1434959340,"C5",186720,1435146060,"2015-06-24 04:41:00"
"2057","20153020053014-949",1,"2015-06-22 00:50:00",1434959400,"C7",56400,1435015800,"2015-06-22 16:30:00"
"890","20155711125712-255",1,"2015-06-22 01:09:00",1434960540,"C5",453960,1435414500,"2015-06-27 07:15:00"
"1609","20151416011455-25",2,"2015-06-22 02:20:00",1434964800,"C4",239580,1435204380,"2015-06-24 20:53:00"
"4297","20152012032058-382",2,"2015-06-22 02:56:00",1434966960,"C4",102420,1435069380,"2015-06-23 07:23:00"
"3400","20154914124917-488",1,"2015-06-22 03:03:00",1434967380,"C8",93720,1435061100,"2015-06-23 05:05:00"
"65","20154918074910-267",1,"2015-06-22 03:25:00",1434968700,"C8",164880,1435133580,"2015-06-24 01:13:00"
"5475","20152905032910-293",1,"2015-06-22 04:57:00",1434974220,"C7",715440,1435689660,"2015-06-30 11:41:00"
"278","20151712051721-6",1,"2015-06-22 05:26:00",1434975960,"C0",273780,1435249740,"2015-06-25 09:29:00"
"5486","20151115031100-780",1,"2015-06-22 05:26:00",1434975960,"C4",189900,1435165860,"2015-06-24 10:11:00"
"2787","20154119094154-19",2,"2015-06-22 06:35:00",1434980100,"C0",82680,1435062780,"2015-06-23 05:33:00"
"1358","20153520033505-60",1,"2015-06-22 07:23:00",1434982980,"C4",143280,1435126260,"2015-06-23 23:11:00"
"2870","20151118091136-43",3,"2015-06-22 07:31:00",1434983460,"C8",169800,1435153260,"2015-06-24 06:41:00"
"608","20154810044808-531",1,"2015-06-22 08:45:00",1434987900,"C2",335940,1435323840,"2015-06-26 06:04:00"
"5209","20154926084915-416",2,"2015-06-22 10:04:00",1434992640,"C8",467460,1435460100,"2015-06-27 19:55:00"
"4196","20155720025749-383",1,"2015-06-22 10:54:00",1434995640,"C0",52740,1435048380,"2015-06-23 01:33:00"
"1337","20155520125548-491",1,"2015-06-22 11:49:00",1434998940,"C8",84420,1435083360,"2015-06-23 11:16:00"
"3781","20151717071728-569",1,"2015-06-22 12:09:00",1435000140,"C4",224760,1435224900,"2015-06-25 02:35:00"
"2322","20153414023451-770",3,"2015-06-22 13:14:00",1435004040,"C3",85800,1435089840,"2015-06-23 13:04:00"
"539","20152417062433-543",1,"2015-06-22 14:12:00",1435007520,"C8",230040,1435237560,"2015-06-25 06:06:00"
"2633","20153813093827-417",1,"2015-06-22 14:15:00",1435007700,"C3",113460,1435121160,"2015-06-23 21:46:00"
"4880","20155507095534-53",3,"2015-06-22 14:16:00",1435007760,"C7",187380,1435195140,"2015-06-24 18:19:00"
"4414","20152420022419-264",2,"2015-06-22 14:48:00",1435009680,"C3",58080,1435067760,"2015-06-23 06:56:00"
"5783","20153002123026-8",3,"2015-06-22 15:30:00",1435012200,"C7",248400,1435260600,"2015-06-25 12:30:00"
"2763","20152519052551-298",1,"2015-06-22 18:21:00",1435022460,"C0",262560,1435285020,"2015-06-25 19:17:00"
"4689","20152213052248-272",2,"2015-06-22 18:24:00",1435022640,"C3",781320,1435803960,"2015-07-01 19:26:00"
"2882","20152319092320-59",1,"2015-06-22 18:40:00",1435023600,"C4",292620,1435316220,"2015-06-26 03:57:00"
"2856","20151711011732-63",3,"2015-06-22 19:40:00",1435027200,"C0",973380,1436000580,"2015-07-04 02:03:00"
"5857","20153818043830-284",2,"2015-06-22 20:05:00",1435028700,"C2",358020,1435386720,"2015-06-26 23:32:00"
"1088","20151414071412-997",1,"2015-06-22 21:36:00",1435034160,"C8",371460,1435405620,"2015-06-27 04:47:00"
"5576","20151219081235-39",1,"2015-06-22 21:44:00",1435034640,"C4",307920,1435342560,"2015-06-26 11:16:00"
"6078","20154019104036-155",2,"2015-06-22 21:44:00",1435034640,"C0",299040,1435333680,"2015-06-26 08:48:00"
"198","20153717123759-246",1,"2015-06-22 22:57:00",1435039020,"C7",234600,1435273620,"2015-06-25 16:07:00"
"3691","20152507042535-456",1,"2015-06-22 23:07:00",1435039620,"C5",660060,1435699680,"2015-06-30 14:28:00"
"4068","20151515051521-888",1,"2015-06-23 00:13:00",1435043580,"C8",314940,1435358520,"2015-06-26 15:42:00"
"3370","20154512054518-584",2,"2015-06-23 01:01:00",1435046460,"C8",445080,1435491540,"2015-06-28 04:39:00"
"671","20151006101058-57",1,"2015-06-23 01:14:00",1435047240,"C4",179580,1435226820,"2015-06-25 03:07:00"
"6031","20152914062905-376",1,"2015-06-23 01:17:00",1435047420,"C5",94860,1435142280,"2015-06-24 03:38:00"
"4660","20154920094954-832",3,"2015-06-23 01:21:00",1435047660,"C5",114360,1435162020,"2015-06-24 09:07:00"
"3655","20155620025615-452",1,"2015-06-23 01:40:00",1435048800,"C5",105720,1435154520,"2015-06-24 07:02:00"
"6414","20155721095721-40",1,"2015-06-23 01:43:00",1435048980,"C5",71580,1435120560,"2015-06-23 21:36:00"
"3718","20154017114049-331",1,"2015-06-23 03:14:00",1435054440,"C4",69720,1435124160,"2015-06-23 22:36:00"
"2924","20151009091020-539",2,"2015-06-23 03:44:00",1435056240,"C4",595020,1435651260,"2015-06-30 01:01:00"
"5096","20151522051555-293",3,"2015-06-23 06:43:00",1435066980,"C2",48480,1435115460,"2015-06-23 20:11:00"
"3580","20150910020919-2",3,"2015-06-23 06:51:00",1435067460,"C5",365640,1435433100,"2015-06-27 12:25:00"
"1390","20154502084556-629",2,"2015-06-23 07:21:00",1435069260,"C4",258480,1435327740,"2015-06-26 07:09:00"
"6291","20153016033036-967",1,"2015-06-23 07:42:00",1435070520,"C6",96120,1435166640,"2015-06-24 10:24:00"
"1788","20151320091309-87",1,"2015-06-23 08:19:00",1435072740,"C4",85320,1435158060,"2015-06-24 08:01:00"
"5534","20154914084953-37",3,"2015-06-23 09:16:00",1435076160,"C4",259740,1435335900,"2015-06-26 09:25:00"
"3787","20150420100412-238",2,"2015-06-23 09:20:00",1435076400,"C2",128280,1435204680,"2015-06-24 20:58:00"
"268","20153320113340-933",1,"2015-06-23 09:33:00",1435077180,"C8",126000,1435203180,"2015-06-24 20:33:00"
"4848","20152915032948-543",1,"2015-06-23 09:39:00",1435077540,"C3",335100,1435412640,"2015-06-27 06:44:00"
"828","20154713014720-385",1,"2015-06-23 10:02:00",1435078920,"C8",170100,1435249020,"2015-06-25 09:17:00"
"6279","20152912072922-999",1,"2015-06-23 10:51:00",1435081860,"C0",481260,1435563120,"2015-06-29 00:32:00"
"6296","20153121123116-781",3,"2015-06-23 12:05:00",1435086300,"C4",85620,1435171920,"2015-06-24 11:52:00"
"5824","20155919085948-945",3,"2015-06-23 14:05:00",1435093500,"C3",181980,1435275480,"2015-06-25 16:38:00"
"560","20152108052101-440",1,"2015-06-23 14:21:00",1435094460,"C5",428400,1435522860,"2015-06-28 13:21:00"
"4846","20153114083105-937",1,"2015-06-23 15:10:00",1435097400,"C2",267180,1435364580,"2015-06-26 17:23:00"
"5226","20155021055038-706",3,"2015-06-23 16:14:00",1435101240,"C7",83520,1435184760,"2015-06-24 15:26:00"
"4128","20150312050331-531",3,"2015-06-23 16:43:00",1435102980,"C3",949200,1436052180,"2015-07-04 16:23:00"
"5507","20150312020332-263",1,"2015-06-23 16:53:00",1435103580,"C8",192120,1435295700,"2015-06-25 22:15:00"
"786","20150019050058-11",2,"2015-06-23 18:36:00",1435109760,"C5",175680,1435285440,"2015-06-25 19:24:00"
"4014","20155815085831-779",1,"2015-06-23 18:46:00",1435110360,"C6",121080,1435231440,"2015-06-25 04:24:00"
"2177","20151520041535-563",2,"2015-06-23 19:25:00",1435112700,"C4",135300,1435248000,"2015-06-25 09:00:00"
"5121","20154625034642-17",3,"2015-06-23 19:32:00",1435113120,"C2",359880,1435473000,"2015-06-27 23:30:00"
"1628","20154821044849-587",3,"2015-06-23 19:58:00",1435114680,"C6",184200,1435298880,"2015-06-25 23:08:00"
"4948","20151121111157-61",3,"2015-06-23 22:03:00",1435122180,"C8",105960,1435228140,"2015-06-25 03:29:00"
"5013","20152909122903-721",3,"2015-06-23 22:38:00",1435124280,"C4",178020,1435302300,"2015-06-26 00:05:00"
"4996","20152422092440-277",1,"2015-06-24 02:06:00",1435136760,"C8",73260,1435210020,"2015-06-24 22:27:00"
"2072","20155618085648-561",1,"2015-06-24 02:24:00",1435137840,"C8",247440,1435385280,"2015-06-26 23:08:00"
"6157","20151515081555-958",3,"2015-06-24 02:55:00",1435139700,"C4",94800,1435234500,"2015-06-25 05:15:00"
"2522","20150108040111-888",1,"2015-06-24 03:08:00",1435140480,"C4",190860,1435331340,"2015-06-26 08:09:00"
"2434","20154514124545-947",1,"2015-06-24 04:05:00",1435143900,"C5",501600,1435645500,"2015-06-29 23:25:00"
"5931","20151604031616-721",3,"2015-06-24 04:06:00",1435143960,"C8",337560,1435481520,"2015-06-28 01:52:00"
"6432","20151820051846-474",2,"2015-06-24 04:33:00",1435145580,"C8",59940,1435205520,"2015-06-24 21:12:00"
"4647","20151317101348-437",1,"2015-06-24 07:04:00",1435154640,"C8",84780,1435239420,"2015-06-25 06:37:00"
"5375","20151921121956-754",3,"2015-06-24 07:27:00",1435156020,"C6",241680,1435397700,"2015-06-27 02:35:00"
"1402","20152815102844-133",2,"2015-06-24 08:28:00",1435159680,"C4",385200,1435544880,"2015-06-28 19:28:00"
"6359","20154021124002-193",3,"2015-06-24 08:44:00",1435160640,"C2",245040,1435405680,"2015-06-27 04:48:00"
"5918","20154213024208-839",2,"2015-06-24 09:15:00",1435162500,"C2",930780,1436093280,"2015-07-05 03:48:00"
"3126","20150518020503-955",1,"2015-06-24 09:17:00",1435162620,"C6",83520,1435246140,"2015-06-25 08:29:00"
"36","20152115032120-829",1,"2015-06-24 09:51:00",1435164660,"C2",252600,1435417260,"2015-06-27 08:01:00"
"3734","20150804030847-490",1,"2015-06-24 11:36:00",1435170960,"C7",245040,1435416000,"2015-06-27 07:40:00"
"2995","20151914081957-769",1,"2015-06-24 11:55:00",1435172100,"C4",438480,1435610580,"2015-06-29 13:43:00"
"26","20153622043643-625",1,"2015-06-24 12:14:00",1435173240,"C5",78540,1435251780,"2015-06-25 10:03:00"
"2328","20150221080255-974",3,"2015-06-24 14:11:00",1435180260,"C5",93780,1435274040,"2015-06-25 16:14:00"
"949","20155011095054-239",1,"2015-06-24 14:23:00",1435180980,"C2",379860,1435560840,"2015-06-28 23:54:00"
"2375","20152920042942-140",1,"2015-06-24 14:27:00",1435181220,"C4",169140,1435350360,"2015-06-26 13:26:00"
"4402","20152721012702-519",2,"2015-06-24 14:42:00",1435182120,"C2",87900,1435270020,"2015-06-25 15:07:00"
"3212","20152113072113-341",2,"2015-06-24 14:46:00",1435182360,"C8",195420,1435377780,"2015-06-26 21:03:00"
"5314","20154612114650-326",1,"2015-06-24 14:52:00",1435182720,"C7",523980,1435706700,"2015-06-30 16:25:00"
"3617","20155816045813-135",3,"2015-06-24 16:36:00",1435188960,"C2",689880,1435878840,"2015-07-02 16:14:00"
"1258","20150420120432-763",3,"2015-06-24 16:59:00",1435190340,"C8",72660,1435263000,"2015-06-25 13:10:00"
"3226","20155515095508-771",2,"2015-06-24 17:07:00",1435190820,"C0",803520,1435994340,"2015-07-04 00:19:00"
"5563","20152218012209-123",1,"2015-06-24 17:12:00",1435191120,"C8",106440,1435297560,"2015-06-25 22:46:00"
"408","20155923075941-191",3,"2015-06-24 17:16:00",1435191360,"C2",119820,1435311180,"2015-06-26 02:33:00"
"2281","20155121065100-589",1,"2015-06-24 17:57:00",1435193820,"C4",99720,1435293540,"2015-06-25 21:39:00"
"999","20150722100759-856",3,"2015-06-24 18:11:00",1435194660,"C5",100920,1435295580,"2015-06-25 22:13:00"
"6104","20152414012455-891",1,"2015-06-24 18:26:00",1435195560,"C7",441060,1435636620,"2015-06-29 20:57:00"
"6175","20152823032800-166",3,"2015-06-24 19:11:00",1435198260,"C6",99780,1435298040,"2015-06-25 22:54:00"
"1190","20152218122205-541",1,"2015-06-24 19:34:00",1435199640,"C5",272160,1435471800,"2015-06-27 23:10:00"
"2179","20155118105146-971",1,"2015-06-24 21:07:00",1435205220,"C4",277680,1435482900,"2015-06-28 02:15:00"
"6516","20155319035359-974",1,"2015-06-24 21:35:00",1435206900,"C8",226260,1435433160,"2015-06-27 12:26:00"
"5973","20150806110818-449",1,"2015-06-24 21:40:00",1435207200,"C2",796560,1436003760,"2015-07-04 02:56:00"
"6362","20153621033624-514",3,"2015-06-24 21:41:00",1435207260,"C3",281100,1435488360,"2015-06-28 03:46:00"
"4047","20155122015113-891",1,"2015-06-24 22:17:00",1435209420,"C5",101580,1435311000,"2015-06-26 02:30:00"
"154","20155417085454-80",3,"2015-06-24 22:44:00",1435211040,"C8",130920,1435341960,"2015-06-26 11:06:00"
"4967","20151222031241-371",1,"2015-06-24 23:18:00",1435213080,"C2",100980,1435314060,"2015-06-26 03:21:00"
"1981","20151818071851-924",2,"2015-06-24 23:28:00",1435213680,"C5",288300,1435501980,"2015-06-28 07:33:00"
"2174","20151310041329-620",1,"2015-06-25 00:07:00",1435216020,"C5",619020,1435835040,"2015-07-02 04:04:00"
"2457","20151816031811-238",1,"2015-06-25 00:26:00",1435217160,"C0",362040,1435579200,"2015-06-29 05:00:00"
"3218","20153719123745-647",3,"2015-06-25 00:57:00",1435219020,"C5",238200,1435457220,"2015-06-27 19:07:00"
"298","20151710121709-837",1,"2015-06-25 01:33:00",1435221180,"C5",628680,1435849860,"2015-07-02 08:11:00"
"1704","20154118104113-978",3,"2015-06-25 01:42:00",1435221720,"C0",81780,1435303500,"2015-06-26 00:25:00"
"5902","20153319103352-70",2,"2015-06-25 02:56:00",1435226160,"C5",70140,1435296300,"2015-06-25 22:25:00"
"5257","20153309043302-556",2,"2015-06-25 03:12:00",1435227120,"C4",444780,1435671900,"2015-06-30 06:45:00"
"3693","20151821051837-55",1,"2015-06-25 03:36:00",1435228560,"C3",148140,1435376700,"2015-06-26 20:45:00"
"1889","20153123053127-918",1,"2015-06-25 04:57:00",1435233420,"C0",63780,1435297200,"2015-06-25 22:40:00"
"6264","20154414124412-684",1,"2015-06-25 06:12:00",1435237920,"C6",450660,1435688580,"2015-06-30 11:23:00"
"272","20152509072520-737",1,"2015-06-25 06:54:00",1435240440,"C3",197220,1435437660,"2015-06-27 13:41:00"
"6383","20150717030756-157",1,"2015-06-25 07:17:00",1435241820,"C8",331500,1435573320,"2015-06-29 03:22:00"
"3709","20152012102044-576",3,"2015-06-25 07:29:00",1435242540,"C5",370980,1435613520,"2015-06-29 14:32:00"
"4867","20154115024109-180",2,"2015-06-25 07:59:00",1435244340,"C5",419940,1435664280,"2015-06-30 04:38:00"
"1597","20154117024144-496",3,"2015-06-25 08:57:00",1435247820,"C5",335280,1435583100,"2015-06-29 06:05:00"
"1112","20152515012542-655",1,"2015-06-25 09:40:00",1435250400,"C8",170100,1435420500,"2015-06-27 08:55:00"
"5939","20152113112111-474",1,"2015-06-25 10:05:00",1435251900,"C5",516120,1435768020,"2015-07-01 09:27:00"
"2165","20155720095752-177",1,"2015-06-25 10:41:00",1435254060,"C2",217320,1435471380,"2015-06-27 23:03:00"
"1656","20155023115047-443",1,"2015-06-25 12:06:00",1435259160,"C5",86880,1435346040,"2015-06-26 12:14:00"
"1476","20154618094619-43",2,"2015-06-25 12:20:00",1435260000,"C2",614040,1435874040,"2015-07-02 14:54:00"
"5059","20153624063634-720",2,"2015-06-25 13:15:00",1435263300,"C4",110340,1435373640,"2015-06-26 19:54:00"
"2580","20154802114807-830",1,"2015-06-25 13:23:00",1435263780,"C4",284700,1435548480,"2015-06-28 20:28:00"
"1931","20155823075842-421",2,"2015-06-25 14:03:00",1435266180,"C6",194700,1435460880,"2015-06-27 20:08:00"
"5690","20151109091155-536",3,"2015-06-25 14:26:00",1435267560,"C2",467100,1435734660,"2015-07-01 00:11:00"
"2865","20154623064643-371",1,"2015-06-25 15:04:00",1435269840,"C2",101340,1435371180,"2015-06-26 19:13:00"
"3859","20152311102311-455",2,"2015-06-25 15:29:00",1435271340,"C6",204660,1435476000,"2015-06-28 00:20:00"
"3237","20153721043746-702",3,"2015-06-25 15:53:00",1435272780,"C0",171480,1435444260,"2015-06-27 15:31:00"
"873","20150623020640-155",1,"2015-06-25 18:14:00",1435281240,"C5",93840,1435375080,"2015-06-26 20:18:00"
"6423","20153723043748-531",2,"2015-06-25 18:17:00",1435281420,"C3",89400,1435370820,"2015-06-26 19:07:00"
"3484","20150723090724-2",1,"2015-06-25 19:06:00",1435284360,"C0",208740,1435493100,"2015-06-28 05:05:00"
"2688","20153216013237-980",2,"2015-06-25 19:23:00",1435285380,"C6",798660,1436084040,"2015-07-05 01:14:00"
"1301","20151619071622-794",1,"2015-06-25 20:54:00",1435290840,"C5",283740,1435574580,"2015-06-29 03:43:00"
"5338","20153419023448-961",1,"2015-06-25 21:14:00",1435292040,"C8",108480,1435400520,"2015-06-27 03:22:00"
"2863","20154420054455-558",2,"2015-06-25 22:41:00",1435297260,"C0",149940,1435447200,"2015-06-27 16:20:00"
"4663","20152124122113-381",3,"2015-06-25 22:59:00",1435298340,"C5",62340,1435360680,"2015-06-26 16:18:00"
"2340","20151113071127-855",3,"2015-06-26 00:11:00",1435302660,"C3",366000,1435668660,"2015-06-30 05:51:00"
"157","20153906123947-442",1,"2015-06-26 01:11:00",1435306260,"C7",240960,1435547220,"2015-06-28 20:07:00"
"2468","20154713064720-448",3,"2015-06-26 01:47:00",1435308420,"C8",221040,1435529460,"2015-06-28 15:11:00"
"3253","20154521074546-272",2,"2015-06-26 02:27:00",1435310820,"C5",137640,1435448460,"2015-06-27 16:41:00"
"5820","20155908075949-522",2,"2015-06-26 02:56:00",1435312560,"C3",512340,1435824900,"2015-07-02 01:15:00"
"1455","20150510020551-789",3,"2015-06-26 03:04:00",1435313040,"C8",191820,1435504860,"2015-06-28 08:21:00"
"2194","20152619062611-689",3,"2015-06-26 03:14:00",1435313640,"C4",296640,1435610280,"2015-06-29 13:38:00"
"4858","20155720065732-452",1,"2015-06-26 03:30:00",1435314600,"C3",168660,1435483260,"2015-06-28 02:21:00"
"5171","20152016062004-516",2,"2015-06-26 04:13:00",1435317180,"C8",122340,1435439520,"2015-06-27 14:12:00"
"749","20155216125240-140",1,"2015-06-26 05:37:00",1435322220,"C8",167580,1435489800,"2015-06-28 04:10:00"
"5444","20153514073548-195",2,"2015-06-26 06:56:00",1435326960,"C5",344820,1435671780,"2015-06-30 06:43:00"
"5095","20150422080420-314",3,"2015-06-26 07:10:00",1435327800,"C0",114120,1435441920,"2015-06-27 14:52:00"
"1816","20150408060458-999",1,"2015-06-26 08:10:00",1435331400,"C6",260460,1435591860,"2015-06-29 08:31:00"
"2760","20152224092219-261",1,"2015-06-26 09:02:00",1435334520,"C5",85800,1435420320,"2015-06-27 08:52:00"
"4244","20151012091054-963",2,"2015-06-26 09:16:00",1435335360,"C7",604980,1435940340,"2015-07-03 09:19:00"
"917","20151813031843-852",1,"2015-06-26 09:26:00",1435335960,"C3",137760,1435473720,"2015-06-27 23:42:00"
"4094","20154210104209-855",1,"2015-06-26 10:46:00",1435340760,"C7",197520,1435538280,"2015-06-28 17:38:00"
"3270","20152424062413-508",1,"2015-06-26 12:32:00",1435347120,"C5",97440,1435444560,"2015-06-27 15:36:00"
"4430","20152319082350-281",1,"2015-06-26 12:58:00",1435348680,"C8",124260,1435472940,"2015-06-27 23:29:00"
"1515","20151720081740-125",3,"2015-06-26 13:07:00",1435349220,"C8",107160,1435456380,"2015-06-27 18:53:00"
"2202","20155022075038-528",1,"2015-06-26 14:08:00",1435352880,"C2",184140,1435537020,"2015-06-28 17:17:00"
"1746","20154112014114-381",1,"2015-06-26 15:05:00",1435356300,"C6",202440,1435558740,"2015-06-28 23:19:00"
"5958","20151303111300-96",1,"2015-06-26 15:22:00",1435357320,"C7",286020,1435643340,"2015-06-29 22:49:00"
"3492","20155612055615-47",3,"2015-06-26 15:40:00",1435358400,"C5",484980,1435843380,"2015-07-02 06:23:00"
"380","20155725075744-903",1,"2015-06-26 16:22:00",1435360920,"C6",116700,1435477620,"2015-06-28 00:47:00"
"1498","20151924051901-835",2,"2015-06-26 16:45:00",1435362300,"C0",170760,1435533060,"2015-06-28 16:11:00"
"5854","20152517072506-105",3,"2015-06-26 17:25:00",1435364700,"C3",271200,1435635900,"2015-06-29 20:45:00"
"2166","20151805061831-133",1,"2015-06-26 19:22:00",1435371720,"C0",567480,1435939200,"2015-07-03 09:00:00"
"5991","20150522030548-312",1,"2015-06-26 19:31:00",1435372260,"C7",180780,1435553040,"2015-06-28 21:44:00"
"5451","20150907070951-183",1,"2015-06-26 21:17:00",1435378620,"C6",211560,1435590180,"2015-06-29 08:03:00"
"4658","20152220112252-143",1,"2015-06-26 23:04:00",1435385040,"C2",280260,1435665300,"2015-06-30 04:55:00"
"2626","20154825054846-818",1,"2015-06-26 23:30:00",1435386600,"C8",53460,1435440060,"2015-06-27 14:21:00"
"4898","20151224041202-651",2,"2015-06-26 23:30:00",1435386600,"C4",99540,1435486140,"2015-06-28 03:09:00"
"1087","20154909034948-631",1,"2015-06-27 00:07:00",1435388820,"C4",499560,1435888380,"2015-07-02 18:53:00"
"422","20153422113416-107",1,"2015-06-27 00:17:00",1435389420,"C3",438540,1435827960,"2015-07-02 02:06:00"
"4838","20150425010456-10",1,"2015-06-27 01:26:00",1435393560,"C7",65460,1435459020,"2015-06-27 19:37:00"
"4983","20150422040421-938",1,"2015-06-27 02:09:00",1435396140,"C8",76380,1435472520,"2015-06-27 23:22:00"
"3529","20153322053325-204",3,"2015-06-27 02:59:00",1435399140,"C5",189780,1435588920,"2015-06-29 07:42:00"
"238","20154623084625-271",2,"2015-06-27 03:10:00",1435399800,"C4",108480,1435508280,"2015-06-28 09:18:00"
"6161","20153924103929-927",3,"2015-06-27 04:19:00",1435403940,"C7",118200,1435522140,"2015-06-28 13:09:00"
"918","20155324085325-903",3,"2015-06-27 04:33:00",1435404780,"C3",121800,1435526580,"2015-06-28 14:23:00"
"1048","20151116081119-191",1,"2015-06-27 06:05:00",1435410300,"C7",104760,1435515060,"2015-06-28 11:11:00"
"3115","20154126064136-539",3,"2015-06-27 07:15:00",1435414500,"C0",88440,1435502940,"2015-06-28 07:49:00"
"516","20152120062126-798",2,"2015-06-27 09:16:00",1435421760,"C0",87900,1435509660,"2015-06-28 09:41:00"
"180","20152725032725-88",1,"2015-06-27 10:26:00",1435425960,"C2",154740,1435580700,"2015-06-29 05:25:00"
"3035","20153524063556-760",1,"2015-06-27 11:07:00",1435428420,"C5",137760,1435566180,"2015-06-29 01:23:00"
"4844","20150503080543-310",1,"2015-06-27 11:49:00",1435430940,"C2",260880,1435691820,"2015-06-30 12:17:00"
"5089","20151015061023-821",1,"2015-06-27 12:26:00",1435433160,"C4",467220,1435900380,"2015-07-02 22:13:00"
"1898","20155122015143-390",2,"2015-06-27 12:37:00",1435433820,"C6",427560,1435861380,"2015-07-02 11:23:00"
"2896","20151801061858-931",1,"2015-06-27 12:42:00",1435434120,"C3",283680,1435717800,"2015-06-30 19:30:00"
"5612","20155926125931-19",1,"2015-06-27 16:59:00",1435449540,"C2",100800,1435550340,"2015-06-28 20:59:00"
"3538","20153723103701-496",3,"2015-06-27 18:17:00",1435454220,"C5",186600,1435640820,"2015-06-29 22:07:00"
"6377","20154005024056-186",3,"2015-06-27 18:18:00",1435454280,"C3",956940,1436411220,"2015-07-08 20:07:00"
"997","20154701124730-552",1,"2015-06-27 19:50:00",1435459800,"C4",324540,1435784340,"2015-07-01 13:59:00"
"5961","20155006035017-391",3,"2015-06-27 20:17:00",1435461420,"C5",610140,1436071560,"2015-07-04 21:46:00"
"3394","20150112050156-642",1,"2015-06-27 20:26:00",1435461960,"C8",186900,1435648860,"2015-06-30 00:21:00"
"3044","20150104040106-481",1,"2015-06-27 21:31:00",1435465860,"C4",669000,1436134860,"2015-07-05 15:21:00"
"2255","20155721075705-83",1,"2015-06-27 22:29:00",1435469340,"C8",285360,1435754700,"2015-07-01 05:45:00"
"5999","20155417035454-444",3,"2015-06-27 22:30:00",1435469400,"C6",147960,1435617360,"2015-06-29 15:36:00"
"1692","20153814023849-856",1,"2015-06-27 23:00:00",1435471200,"C8",164760,1435635960,"2015-06-29 20:46:00"
"116","20152620042635-437",3,"2015-06-27 23:16:00",1435472160,"C5",314700,1435786860,"2015-07-01 14:41:00"
"4422","20155919085937-643",3,"2015-06-27 23:39:00",1435473540,"C5",372000,1435845540,"2015-07-02 06:59:00"
"5426","20151417011439-309",2,"2015-06-28 01:02:00",1435478520,"C5",453240,1435931760,"2015-07-03 06:56:00"
"1419","20155523085557-121",2,"2015-06-28 01:31:00",1435480260,"C5",202680,1435682940,"2015-06-30 09:49:00"
"3873","20151924051922-114",2,"2015-06-28 01:51:00",1435481460,"C8",144960,1435626420,"2015-06-29 18:07:00"
"4222","20150416030444-791",3,"2015-06-28 02:32:00",1435483920,"C8",495840,1435979760,"2015-07-03 20:16:00"
"3767","20154919094921-666",2,"2015-06-28 02:39:00",1435484340,"C8",375900,1435860240,"2015-07-02 11:04:00"
"3527","20150120020159-683",1,"2015-06-28 02:41:00",1435484460,"C4",81300,1435565760,"2015-06-29 01:16:00"
"379","20150822090837-736",2,"2015-06-28 02:53:00",1435485180,"C8",99180,1435584360,"2015-06-29 06:26:00"
"3315","20151823061853-546",1,"2015-06-28 03:33:00",1435487580,"C3",140700,1435628280,"2015-06-29 18:38:00"
"4262","20152124032130-189",1,"2015-06-28 04:51:00",1435492260,"C3",102600,1435594860,"2015-06-29 09:21:00"
"2250","20155020095009-169",3,"2015-06-28 05:08:00",1435493280,"C7",337140,1435830420,"2015-07-02 02:47:00"
"2485","20154024034035-259",2,"2015-06-28 05:50:00",1435495800,"C8",62040,1435557840,"2015-06-28 23:04:00"
"5697","20152521082543-773",2,"2015-06-28 06:41:00",1435498860,"C2",74820,1435573680,"2015-06-29 03:28:00"
"5168","20150224040251-670",1,"2015-06-28 07:20:00",1435501200,"C2",157140,1435658340,"2015-06-30 02:59:00"
"4727","20153021073045-85",1,"2015-06-28 07:54:00",1435503240,"C8",303120,1435806360,"2015-07-01 20:06:00"
"5752","20154617044627-301",1,"2015-06-28 08:30:00",1435505400,"C3",131520,1435636920,"2015-06-29 21:02:00"
"1175","20150417100406-907",3,"2015-06-28 08:34:00",1435505640,"C7",472500,1435978140,"2015-07-03 19:49:00"
"5541","20154522074550-726",3,"2015-06-28 09:27:00",1435508820,"C0",262260,1435771080,"2015-07-01 10:18:00"
"5515","20155811055815-517",1,"2015-06-28 09:28:00",1435508880,"C5",479400,1435988280,"2015-07-03 22:38:00"
"898","20152515082556-333",2,"2015-06-28 09:40:00",1435509600,"C7",161100,1435670700,"2015-06-30 06:25:00"
"3101","20155318075334-519",2,"2015-06-28 09:41:00",1435509660,"C3",290160,1435799820,"2015-07-01 18:17:00"
"1632","20150907080945-381",1,"2015-06-28 09:54:00",1435510440,"C8",364140,1435874580,"2015-07-02 15:03:00"
"67","20152523032526-775",1,"2015-06-28 10:13:00",1435511580,"C3",137760,1435649340,"2015-06-30 00:29:00"
"626","20153516053542-376",2,"2015-06-28 10:45:00",1435513500,"C2",144600,1435658100,"2015-06-30 02:55:00"
"6074","20153721073751-968",1,"2015-06-28 12:22:00",1435519320,"C6",621900,1436141220,"2015-07-05 17:07:00"
"507","20155522115544-987",2,"2015-06-28 12:28:00",1435519680,"C4",74340,1435594020,"2015-06-29 09:07:00"
"5779","20153121113129-538",2,"2015-06-28 12:46:00",1435520760,"C2",203100,1435723860,"2015-06-30 21:11:00"
"1868","20154023044047-684",1,"2015-06-28 14:40:00",1435527600,"C5",141600,1435669200,"2015-06-30 06:00:00"
"4303","20155327055311-62",3,"2015-06-28 14:50:00",1435528200,"C6",75420,1435603620,"2015-06-29 11:47:00"
"2718","20150415110415-762",2,"2015-06-28 15:21:00",1435530060,"C2",1138620,1436668680,"2015-07-11 19:38:00"
"5144","20155620035613-395",1,"2015-06-28 16:04:00",1435532640,"C2",86460,1435619100,"2015-06-29 16:05:00"
"4019","20152421022448-172",1,"2015-06-28 16:08:00",1435532880,"C3",76380,1435609260,"2015-06-29 13:21:00"
"2444","20150203060210-288",1,"2015-06-28 16:12:00",1435533120,"C8",439320,1435972440,"2015-07-03 18:14:00"
"5540","20151919051903-993",3,"2015-06-28 16:39:00",1435534740,"C0",96900,1435631640,"2015-06-29 19:34:00"
"2053","20153821073821-483",1,"2015-06-28 17:13:00",1435536780,"C8",127860,1435664640,"2015-06-30 04:44:00"
"179","20154824124835-785",1,"2015-06-28 17:26:00",1435537560,"C0",181140,1435718700,"2015-06-30 19:45:00"
"3408","20153808123846-946",2,"2015-06-28 19:36:00",1435545360,"C7",250440,1435795800,"2015-07-01 17:10:00"
"4557","20151025051035-258",1,"2015-06-28 19:40:00",1435545600,"C4",89400,1435635000,"2015-06-29 20:30:00"
"5197","20155021095034-253",3,"2015-06-28 20:48:00",1435549680,"C7",92040,1435641720,"2015-06-29 22:22:00"
"2555","20154527104510-24",1,"2015-06-28 20:50:00",1435549800,"C4",122700,1435672500,"2015-06-30 06:55:00"
"651","20153927033926-724",3,"2015-06-28 21:39:00",1435552740,"C5",54000,1435606740,"2015-06-29 12:39:00"
"6165","20151927081907-93",1,"2015-06-28 21:42:00",1435552920,"C6",134580,1435687500,"2015-06-30 11:05:00"
"3142","20150318040329-875",1,"2015-06-29 00:00:00",1435561200,"C7",99180,1435660380,"2015-06-30 03:33:00"
"2233","20154026034051-679",2,"2015-06-29 00:22:00",1435562520,"C8",102060,1435664580,"2015-06-30 04:43:00"
"6412","20154920054923-830",2,"2015-06-29 01:49:00",1435567740,"C8",144000,1435711740,"2015-06-30 17:49:00"
"3003","20152127122100-117",1,"2015-06-29 03:13:00",1435572780,"C5",69960,1435642740,"2015-06-29 22:39:00"
"5066","20150607010649-553",2,"2015-06-29 03:46:00",1435574760,"C2",233400,1435808160,"2015-07-01 20:36:00"
"199","20152118072137-646",2,"2015-06-29 04:25:00",1435577100,"C3",117480,1435694580,"2015-06-30 13:03:00"
"6438","20155324075339-328",1,"2015-06-29 04:27:00",1435577220,"C8",209820,1435787040,"2015-07-01 14:44:00"
"1795","20155909085910-596",1,"2015-06-29 04:37:00",1435577820,"C4",2195340,1437773160,"2015-07-24 14:26:00"
"458","20150426010442-203",1,"2015-06-29 05:04:00",1435579440,"C5",115200,1435694640,"2015-06-30 13:04:00"
"3048","20154212104244-750",1,"2015-06-29 05:57:00",1435582620,"C8",290340,1435872960,"2015-07-02 14:36:00"
"5731","20155826045853-500",1,"2015-06-29 06:46:00",1435585560,"C4",74160,1435659720,"2015-06-30 03:22:00"
"4146","20150016010039-314",3,"2015-06-29 07:01:00",1435586460,"C2",157380,1435743840,"2015-07-01 02:44:00"
"6449","20151120071106-120",1,"2015-06-29 07:22:00",1435587720,"C5",111180,1435698900,"2015-06-30 14:15:00"
"963","20153128113151-636",1,"2015-06-29 08:31:00",1435591860,"C2",75600,1435667460,"2015-06-30 05:31:00"
"968","20151211051259-166",1,"2015-06-29 08:48:00",1435592880,"C4",508320,1436101200,"2015-07-05 06:00:00"
"5269","20155115055136-775",1,"2015-06-29 08:55:00",1435593300,"C6",481980,1436075280,"2015-07-04 22:48:00"
"1217","20154928064939-570",2,"2015-06-29 10:01:00",1435597260,"C3",97920,1435695180,"2015-06-30 13:13:00"
"4937","20151623051636-911",2,"2015-06-29 10:21:00",1435598460,"C2",70500,1435668960,"2015-06-30 05:56:00"
"5227","20155725095739-361",2,"2015-06-29 11:49:00",1435603740,"C4",176160,1435779900,"2015-07-01 12:45:00"
"2621","20150827070822-694",3,"2015-06-29 13:04:00",1435608240,"C5",97080,1435705320,"2015-06-30 16:02:00"
"5618","20153521043509-287",2,"2015-06-29 14:11:00",1435612260,"C5",341280,1435953540,"2015-07-03 12:59:00"
"3056","20152126092144-384",2,"2015-06-29 14:18:00",1435612680,"C5",92340,1435705020,"2015-06-30 15:57:00"
"4333","20155425085422-138",1,"2015-06-29 15:20:00",1435616400,"C2",368760,1435985160,"2015-07-03 21:46:00"
"5453","20154612074618-947",3,"2015-06-29 15:22:00",1435616520,"C5",187020,1435803540,"2015-07-01 19:19:00"
"5067","20150227070202-589",2,"2015-06-29 15:28:00",1435616880,"C5",101580,1435718460,"2015-06-30 19:41:00"
"6375","20150231050204-372",2,"2015-06-29 16:15:00",1435619700,"C8",357540,1435977240,"2015-07-03 19:34:00"
"4798","20154227114255-944",1,"2015-06-29 17:34:00",1435624440,"C2",96960,1435721400,"2015-06-30 20:30:00"
"1758","20155402085412-825",1,"2015-06-29 17:42:00",1435624920,"C6",295560,1435920480,"2015-07-03 03:48:00"
"2285","20155228125210-442",3,"2015-06-29 17:54:00",1435625640,"C0",104520,1435730160,"2015-06-30 22:56:00"
"4046","20154121124110-292",1,"2015-06-29 18:44:00",1435628640,"C4",712980,1436341620,"2015-07-08 00:47:00"
"425","20153826053837-25",2,"2015-06-29 18:48:00",1435628880,"C4",263400,1435892280,"2015-07-02 19:58:00"
"1948","20153627113639-711",1,"2015-06-29 19:08:00",1435630080,"C3",99960,1435730040,"2015-06-30 22:54:00"
"2687","20151826091818-219",1,"2015-06-29 19:27:00",1435631220,"C5",98580,1435729800,"2015-06-30 22:50:00"
"3245","20151305081322-814",1,"2015-06-29 19:33:00",1435631580,"C4",264300,1435895880,"2015-07-02 20:58:00"
"5943","20152925072930-684",3,"2015-06-29 20:02:00",1435633320,"C5",130260,1435763580,"2015-07-01 08:13:00"
"5282","20155528055512-788",2,"2015-06-29 20:37:00",1435635420,"C8",48060,1435683480,"2015-06-30 09:58:00"
"2080","20154227054240-936",1,"2015-06-29 20:42:00",1435635720,"C5",61200,1435696920,"2015-06-30 13:42:00"
"2156","20151021041005-169",1,"2015-06-29 21:41:00",1435639260,"C8",101580,1435740840,"2015-07-01 01:54:00"
"4795","20150815040821-280",1,"2015-06-29 21:58:00",1435640280,"C4",175800,1435816080,"2015-07-01 22:48:00"
"195","20150123040140-843",3,"2015-06-29 23:28:00",1435645680,"C4",181740,1435827420,"2015-07-02 01:57:00"
"4089","20153120113117-670",2,"2015-06-29 23:42:00",1435646520,"C4",499980,1436146500,"2015-07-05 18:35:00"
"1798","20151314081340-101",1,"2015-06-29 23:53:00",1435647180,"C5",193200,1435840380,"2015-07-02 05:33:00"
"3309","20150720110747-627",1,"2015-06-30 00:01:00",1435647660,"C3",117720,1435765380,"2015-07-01 08:43:00"
"4158","20152328112340-523",1,"2015-06-30 00:47:00",1435650420,"C8",67320,1435717740,"2015-06-30 19:29:00"
"2140","20152706102715-95",2,"2015-06-30 01:33:00",1435653180,"C5",1020780,1436673960,"2015-07-11 21:06:00"
"3154","20154928124919-762",2,"2015-06-30 01:59:00",1435654740,"C4",66900,1435721640,"2015-06-30 20:34:00"
"2833","20153921093922-779",2,"2015-06-30 02:17:00",1435655820,"C5",375540,1436031360,"2015-07-04 10:36:00"
"209","20152528092511-140",3,"2015-06-30 02:25:00",1435656300,"C8",73800,1435730100,"2015-06-30 22:55:00"
"3963","20153428023417-311",3,"2015-06-30 02:26:00",1435656360,"C8",64560,1435720920,"2015-06-30 20:22:00"
"6276","20155827045831-194",1,"2015-06-30 03:04:00",1435658640,"C4",104580,1435763220,"2015-07-01 08:07:00"
"3173","20155124095131-809",1,"2015-06-30 03:15:00",1435659300,"C2",164880,1435824180,"2015-07-02 01:03:00"
"3658","20155009035012-229",2,"2015-06-30 03:42:00",1435660920,"C3",252960,1435913880,"2015-07-03 01:58:00"
"2110","20153525043522-499",1,"2015-06-30 04:44:00",1435664640,"C3",55620,1435720260,"2015-06-30 20:11:00"
"1199","20154627094625-389",2,"2015-06-30 05:12:00",1435666320,"C4",121380,1435787700,"2015-07-01 14:55:00"
"4466","20154127084141-786",3,"2015-06-30 06:57:00",1435672620,"C5",126480,1435799100,"2015-07-01 18:05:00"
"1537","20153624093618-492",1,"2015-06-30 07:56:00",1435676160,"C7",73200,1435749360,"2015-07-01 04:16:00"
"4255","20155023065026-661",1,"2015-06-30 08:07:00",1435676820,"C5",87060,1435763880,"2015-07-01 08:18:00"
"1230","20153529083516-535",1,"2015-06-30 08:14:00",1435677240,"C0",85140,1435762380,"2015-07-01 07:53:00"
"3666","20154627094652-597",1,"2015-06-30 08:22:00",1435677720,"C2",84720,1435762440,"2015-07-01 07:54:00"
"3627","20154220084208-864",2,"2015-06-30 08:47:00",1435679220,"C8",172860,1435852080,"2015-07-02 08:48:00"
"2387","20155914095952-732",2,"2015-06-30 11:14:00",1435688040,"C8",277380,1435965420,"2015-07-03 16:17:00"
"5349","20155324075301-513",3,"2015-06-30 12:32:00",1435692720,"C4",178380,1435871100,"2015-07-02 14:05:00"
"4388","20151127061106-88",3,"2015-06-30 12:56:00",1435694160,"C0",94500,1435788660,"2015-07-01 15:11:00"
"1186","20155826045826-106",2,"2015-06-30 13:38:00",1435696680,"C6",333600,1436030280,"2015-07-04 10:18:00"
"2148","20151613111653-93",1,"2015-06-30 13:58:00",1435697880,"C7",461880,1436159760,"2015-07-05 22:16:00"
"5552","20155626105649-404",1,"2015-06-30 15:17:00",1435702620,"C0",120420,1435823040,"2015-07-02 00:44:00"
"1108","20151026081006-92",2,"2015-06-30 15:40:00",1435704000,"C5",186300,1435890300,"2015-07-02 19:25:00"
"1697","20152712102715-951",2,"2015-06-30 16:11:00",1435705860,"C5",196980,1435902840,"2015-07-02 22:54:00"
"5150","20150616060652-850",3,"2015-06-30 17:04:00",1435709040,"C5",178440,1435887480,"2015-07-02 18:38:00"
"4768","20150222020245-78",1,"2015-06-30 17:18:00",1435709880,"C8",351480,1436061360,"2015-07-04 18:56:00"
"4725","20153727053754-806",1,"2015-06-30 19:37:00",1435718220,"C4",88800,1435807020,"2015-07-01 20:17:00"
"2524","20155229035239-568",3,"2015-06-30 19:42:00",1435718520,"C7",50100,1435768620,"2015-07-01 09:37:00"
"464","20151823051805-597",1,"2015-06-30 19:55:00",1435719300,"C2",614220,1436333520,"2015-07-07 22:32:00"
"6468","20151325051319-382",3,"2015-06-30 20:21:00",1435720860,"C5",221640,1435942500,"2015-07-03 09:55:00"
"2389","20150521090524-397",1,"2015-06-30 21:39:00",1435725540,"C6",822840,1436548380,"2015-07-10 10:13:00"
"5661","20152729032736-810",2,"2015-06-30 21:43:00",1435725780,"C2",108960,1435834740,"2015-07-02 03:59:00"
"3739","20153914093936-718",1,"2015-06-30 23:27:00",1435732020,"C3",477360,1436209380,"2015-07-06 12:03:00"
"2673","20153507013548-133",3,"2015-06-30 23:53:00",1435733580,"C4",674760,1436408340,"2015-07-08 19:19:00"
"4125","20155129025110-549",2,"2015-07-01 00:25:00",1435735500,"C2",60420,1435795920,"2015-07-01 17:12:00"
"4879","20152317012346-970",1,"2015-07-01 00:33:00",1435735980,"C7",166200,1435902180,"2015-07-02 22:43:00"
"5154","20152729032750-703",2,"2015-07-01 01:37:00",1435739820,"C0",61500,1435801320,"2015-07-01 18:42:00"
"3998","20154019124057-626",1,"2015-07-01 01:49:00",1435740540,"C5",332580,1436073120,"2015-07-04 22:12:00"
"2537","20153626023634-935",1,"2015-07-01 02:03:00",1435741380,"C2",55260,1435796640,"2015-07-01 17:24:00"
"3542","20153221093222-957",2,"2015-07-01 02:03:00",1435741380,"C8",119580,1435860960,"2015-07-02 11:16:00"
"18","20155529015507-923",1,"2015-07-01 02:07:00",1435741620,"C5",65160,1435806780,"2015-07-01 20:13:00"
"6079","20154620114644-698",2,"2015-07-01 02:22:00",1435742520,"C5",458280,1436200800,"2015-07-06 09:40:00"
"5105","20153026023048-941",1,"2015-07-01 02:48:00",1435744080,"C5",194940,1435939020,"2015-07-03 08:57:00"
"5160","20151913091934-158",1,"2015-07-01 03:35:00",1435746900,"C8",383640,1436130540,"2015-07-05 14:09:00"
"5023","20153808083849-175",1,"2015-07-01 04:08:00",1435748880,"C8",394200,1436143080,"2015-07-05 17:38:00"
"492","20153729063729-602",1,"2015-07-01 04:35:00",1435750500,"C5",82740,1435833240,"2015-07-02 03:34:00"
"573","20150627070602-460",2,"2015-07-01 05:21:00",1435753260,"C5",113100,1435866360,"2015-07-02 12:46:00"
"1045","20155124045148-189",1,"2015-07-01 07:19:00",1435760340,"C2",570480,1436330820,"2015-07-07 21:47:00"
"3981","20152128062123-84",3,"2015-07-01 08:48:00",1435765680,"C4",89340,1435855020,"2015-07-02 09:37:00"
"5488","20151726071747-488",1,"2015-07-01 09:45:00",1435769100,"C0",440880,1436209980,"2015-07-06 12:13:00"
"3221","20153307023326-161",2,"2015-07-01 09:57:00",1435769820,"C8",1028520,1436798340,"2015-07-13 07:39:00"
"713","20154317064310-833",1,"2015-07-01 10:55:00",1435773300,"C8",174960,1435948260,"2015-07-03 11:31:00"
"2305","20153722033750-276",1,"2015-07-01 11:34:00",1435775640,"C5",254340,1436029980,"2015-07-04 10:13:00"
"6226","20151212011241-763",3,"2015-07-01 12:47:00",1435780020,"C8",328020,1436108040,"2015-07-05 07:54:00"
"1434","20151223091254-664",1,"2015-07-01 14:00:00",1435784400,"C3",88560,1435872960,"2015-07-02 14:36:00"
"1373","20154729104715-725",1,"2015-07-01 14:37:00",1435786620,"C4",186600,1435973220,"2015-07-03 18:27:00"
"4737","20153126063149-265",1,"2015-07-01 15:02:00",1435788120,"C6",462660,1436250780,"2015-07-06 23:33:00"
"396","20151128091155-501",1,"2015-07-01 15:11:00",1435788660,"C5",93600,1435882260,"2015-07-02 17:11:00"
"4739","20151701121746-803",1,"2015-07-01 16:09:00",1435792140,"C6",325740,1436117880,"2015-07-05 10:38:00"
"2745","20150225120206-4",1,"2015-07-01 16:35:00",1435793700,"C2",534780,1436328480,"2015-07-07 21:08:00"
"2525","20151323091336-516",1,"2015-07-01 16:55:00",1435794900,"C5",359460,1436154360,"2015-07-05 20:46:00"
"5352","20151614091646-956",1,"2015-07-01 17:04:00",1435795440,"C0",213840,1436009280,"2015-07-04 04:28:00"
"3155","20152325012334-763",1,"2015-07-01 17:51:00",1435798260,"C5",267240,1436065500,"2015-07-04 20:05:00"
"4757","20155026035048-916",1,"2015-07-01 18:27:00",1435800420,"C0",63060,1435863480,"2015-07-02 11:58:00"
"1153","20151823081833-359",1,"2015-07-01 18:29:00",1435800540,"C0",103980,1435904520,"2015-07-02 23:22:00"
"1086","20151221041237-821",1,"2015-07-01 18:40:00",1435801200,"C5",436440,1436237640,"2015-07-06 19:54:00"
"2469","20152830022847-358",3,"2015-07-01 19:14:00",1435803240,"C3",103560,1435906800,"2015-07-03 00:00:00"
"2326","20150527020511-685",1,"2015-07-01 19:29:00",1435804140,"C8",182520,1435986660,"2015-07-03 22:11:00"
"1866","20151122031145-815",2,"2015-07-01 20:15:00",1435806900,"C6",99480,1435906380,"2015-07-02 23:53:00"
"1257","20152426012444-553",1,"2015-07-01 20:48:00",1435808880,"C5",65520,1435874400,"2015-07-02 15:00:00"
"109","20153026033020-755",3,"2015-07-01 21:02:00",1435809720,"C6",451920,1436261640,"2015-07-07 02:34:00"
"627","20154923074927-301",2,"2015-07-01 21:55:00",1435812900,"C6",123660,1435936560,"2015-07-03 08:16:00"
"5833","20153808013814-745",1,"2015-07-01 22:05:00",1435813500,"C3",672540,1436486040,"2015-07-09 16:54:00"
"867","20152828012807-551",2,"2015-07-01 22:31:00",1435815060,"C6",291780,1436106840,"2015-07-05 07:34:00"
"2968","20154726114701-192",1,"2015-07-01 23:33:00",1435818780,"C5",237180,1436055960,"2015-07-04 17:26:00"
"3368","20150008060003-21",1,"2015-07-02 00:02:00",1435820520,"C7",293160,1436113680,"2015-07-05 09:28:00"
"4441","20154430014454-721",1,"2015-07-02 00:16:00",1435821360,"C7",62160,1435883520,"2015-07-02 17:32:00"
"1327","20153626023632-111",1,"2015-07-02 00:32:00",1435822320,"C0",233880,1436056200,"2015-07-04 17:30:00"
"1511","20151121121107-368",1,"2015-07-02 02:43:00",1435830180,"C2",114540,1435944720,"2015-07-03 10:32:00"
"4931","20154228054230-169",1,"2015-07-02 03:03:00",1435831380,"C5",97620,1435929000,"2015-07-03 06:10:00"
"1082","20151728101733-413",3,"2015-07-02 04:51:00",1435837860,"C5",163020,1436000880,"2015-07-04 02:08:00"
"6372","20153028123046-38",3,"2015-07-02 05:14:00",1435839240,"C8",159720,1435998960,"2015-07-04 01:36:00"
"776","20155217105219-132",2,"2015-07-02 05:40:00",1435840800,"C2",425760,1436266560,"2015-07-07 03:56:00"
"6330","20154422114404-501",1,"2015-07-02 06:26:00",1435843560,"C5",422460,1436266020,"2015-07-07 03:47:00"
"517","20155430055405-608",3,"2015-07-02 06:32:00",1435843920,"C5",65940,1435909860,"2015-07-03 00:51:00"
"41","20153419063412-632",1,"2015-07-02 06:42:00",1435844520,"C0",140460,1435984980,"2015-07-03 21:43:00"
"3870","20154629044625-977",2,"2015-07-02 08:01:00",1435849260,"C3",75900,1435925160,"2015-07-03 05:06:00"
"3065","20155024045031-794",3,"2015-07-02 08:28:00",1435850880,"C5",330540,1436181420,"2015-07-06 04:17:00"
"4899","20151101051151-134",1,"2015-07-02 08:28:00",1435850880,"C4",55020,1435905900,"2015-07-02 23:45:00"
"339","20150129090159-131",2,"2015-07-02 08:31:00",1435851060,"C0",85800,1435936860,"2015-07-03 08:21:00"
"3355","20155814045802-471",2,"2015-07-02 08:43:00",1435851780,"C2",508500,1436360280,"2015-07-08 05:58:00"
"3724","20150529110523-979",2,"2015-07-02 08:51:00",1435852260,"C4",125580,1435977840,"2015-07-03 19:44:00"
"5657","20150621010643-875",2,"2015-07-02 09:12:00",1435853520,"C7",104040,1435957560,"2015-07-03 14:06:00"
"6478","20153813043802-884",2,"2015-07-02 09:20:00",1435854000,"C8",230760,1436084760,"2015-07-05 01:26:00"
"634","20154412124411-6",1,"2015-07-02 10:00:00",1435856400,"C5",859080,1436715480,"2015-07-12 08:38:00"
"5801","20152219012207-18",3,"2015-07-02 11:19:00",1435861140,"C5",371940,1436233080,"2015-07-06 18:38:00"
"1657","20154530034515-528",1,"2015-07-02 12:25:00",1435865100,"C3",80400,1435945500,"2015-07-03 10:45:00"
"4654","20152727032726-130",1,"2015-07-02 12:39:00",1435865940,"C4",140640,1436006580,"2015-07-04 03:43:00"
"3894","20152726042728-687",2,"2015-07-02 13:09:00",1435867740,"C5",253260,1436121000,"2015-07-05 11:30:00"
"3714","20152918052938-439",2,"2015-07-02 14:05:00",1435871100,"C8",598680,1436469780,"2015-07-09 12:23:00"
"759","20152522072551-380",2,"2015-07-02 14:17:00",1435871820,"C4",126960,1435998780,"2015-07-04 01:33:00"
"283","20154316104341-889",3,"2015-07-02 15:47:00",1435877220,"C4",175080,1436052300,"2015-07-04 16:25:00"
"2450","20150820070819-746",2,"2015-07-02 16:04:00",1435878240,"C0",133620,1436011860,"2015-07-04 05:11:00"
"2725","20153326103309-465",2,"2015-07-02 16:39:00",1435880340,"C7",270180,1436150520,"2015-07-05 19:42:00"
"568","20155328035326-113",2,"2015-07-02 17:09:00",1435882140,"C6",350160,1436232300,"2015-07-06 18:25:00"
"5688","20155608015646-673",1,"2015-07-02 17:14:00",1435882440,"C7",231720,1436114160,"2015-07-05 09:36:00"
"1237","20152827042814-470",2,"2015-07-02 17:46:00",1435884360,"C4",145560,1436029920,"2015-07-04 10:12:00"
"4747","20154513064520-256",2,"2015-07-02 17:57:00",1435885020,"C5",210240,1436095260,"2015-07-05 04:21:00"
"4839","20150430120449-822",2,"2015-07-02 17:58:00",1435885080,"C6",194040,1436079120,"2015-07-04 23:52:00"
"3929","20151020081012-980",1,"2015-07-02 18:44:00",1435887840,"C0",537420,1436425260,"2015-07-09 00:01:00"
"4317","20153601083632-281",3,"2015-07-02 19:52:00",1435891920,"C2",126960,1436018880,"2015-07-04 07:08:00"
"4164","20153101083156-266",2,"2015-07-02 20:55:00",1435895700,"C0",131040,1436026740,"2015-07-04 09:19:00"
"5300","20151701071741-626",3,"2015-07-02 21:19:00",1435897140,"C2",136920,1436034060,"2015-07-04 11:21:00"
"1170","20152619052643-277",3,"2015-07-03 02:14:00",1435914840,"C3",144360,1436059200,"2015-07-04 18:20:00"
"628","20154606074613-942",2,"2015-07-03 02:26:00",1435915560,"C5",289200,1436204760,"2015-07-06 10:46:00"
"879","20151929101959-58",3,"2015-07-03 02:41:00",1435916460,"C8",159060,1436075520,"2015-07-04 22:52:00"
"3634","20155829095814-906",3,"2015-07-03 05:10:00",1435925400,"C7",164160,1436089560,"2015-07-05 02:46:00"
"2908","20155826125821-822",3,"2015-07-03 05:14:00",1435925640,"C3",72120,1435997760,"2015-07-04 01:16:00"
"5568","20154623074640-436",3,"2015-07-03 05:46:00",1435927560,"C5",285600,1436213160,"2015-07-06 13:06:00"
"5478","20152730062723-66",2,"2015-07-03 06:33:00",1435930380,"C0",86520,1436016900,"2015-07-04 06:35:00"
"3353","20152017012017-5",1,"2015-07-03 06:52:00",1435931520,"C8",194160,1436125680,"2015-07-05 12:48:00"
"1923","20152201042213-827",1,"2015-07-03 07:58:00",1435935480,"C5",341820,1436277300,"2015-07-07 06:55:00"
"1728","20154725104717-951",2,"2015-07-03 08:17:00",1435936620,"C7",341100,1436277720,"2015-07-07 07:02:00"
"4984","20153521043512-619",2,"2015-07-03 08:32:00",1435937520,"C4",335940,1436273460,"2015-07-07 05:51:00"
"3914","20154325044303-21",2,"2015-07-03 08:53:00",1435938780,"C5",331500,1436270280,"2015-07-07 04:58:00"
"2609","20151802061810-813",1,"2015-07-03 09:21:00",1435940460,"C0",97380,1436037840,"2015-07-04 12:24:00"
"3326","20154820114822-453",2,"2015-07-03 10:15:00",1435943700,"C4",159660,1436103360,"2015-07-05 06:36:00"
"5866","20150517080508-420",2,"2015-07-03 10:15:00",1435943700,"C2",198600,1436142300,"2015-07-05 17:25:00"
"5880","20153029033048-921",2,"2015-07-03 10:40:00",1435945200,"C8",65640,1436010840,"2015-07-04 04:54:00"
"5761","20150924070945-953",1,"2015-07-03 11:09:00",1435946940,"C7",396000,1436342940,"2015-07-08 01:09:00"
"170","20150801120859-136",2,"2015-07-03 11:23:00",1435947780,"C6",170100,1436117880,"2015-07-05 10:38:00"
"287","20154428064410-192",3,"2015-07-03 11:34:00",1435948440,"C8",89880,1436038320,"2015-07-04 12:32:00"
"5956","20152404052454-43",1,"2015-07-03 11:42:00",1435948920,"C6",414180,1436363100,"2015-07-08 06:45:00"
"2507","20151429091426-986",2,"2015-07-03 12:08:00",1435950480,"C5",178020,1436128500,"2015-07-05 13:35:00"
"6040","20153123023120-949",2,"2015-07-03 12:55:00",1435953300,"C4",286080,1436239380,"2015-07-06 20:23:00"
"750","20150206110209-450",2,"2015-07-03 13:27:00",1435955220,"C3",334500,1436289720,"2015-07-07 10:22:00"
"2293","20155919015912-624",1,"2015-07-03 14:13:00",1435957980,"C8",172920,1436130900,"2015-07-05 14:15:00"
"3917","20155601025658-508",1,"2015-07-03 15:06:00",1435961160,"C6",173400,1436134560,"2015-07-05 15:16:00"
"3738","20153126113104-616",1,"2015-07-03 15:13:00",1435961580,"C5",206040,1436167620,"2015-07-06 00:27:00"
"2084","20150229050210-638",1,"2015-07-03 15:38:00",1435963080,"C5",170280,1436133360,"2015-07-05 14:56:00"
"4095","20152730062720-372",1,"2015-07-03 15:57:00",1435964220,"C0",97800,1436062020,"2015-07-04 19:07:00"
"5650","20152524082502-366",1,"2015-07-03 15:58:00",1435964280,"C5",268260,1436232540,"2015-07-06 18:29:00"
"1747","20154112014114-381",1,"2015-07-03 16:00:00",1435964400,"C6",202980,1436167380,"2015-07-06 00:23:00"
"5578","20151330051300-634",1,"2015-07-03 16:22:00",1435965720,"C0",256140,1436221860,"2015-07-06 15:31:00"
"530","20150030050049-156",2,"2015-07-03 16:52:00",1435967520,"C3",258720,1436226240,"2015-07-06 16:44:00"
"5199","20151521121533-656",1,"2015-07-03 17:07:00",1435968420,"C3",527160,1436495580,"2015-07-09 19:33:00"
"1385","20150930010911-718",1,"2015-07-03 17:20:00",1435969200,"C4",274260,1436243460,"2015-07-06 21:31:00"
"1287","20152702082701-295",1,"2015-07-03 17:38:00",1435970280,"C6",119460,1436089740,"2015-07-05 02:49:00"
"4456","20152904032905-433",1,"2015-07-03 18:29:00",1435973340,"C8",503280,1436476620,"2015-07-09 14:17:00"
"2624","20151322121351-809",1,"2015-07-03 18:43:00",1435974180,"C8",194760,1436168940,"2015-07-06 00:49:00"
"4495","20153416023407-833",1,"2015-07-03 19:01:00",1435975260,"C2",494940,1436470200,"2015-07-09 12:30:00"
"1067","20153620053622-72",1,"2015-07-03 19:26:00",1435976760,"C0",161400,1436138160,"2015-07-05 16:16:00"
"2291","20151801111852-365",1,"2015-07-03 20:52:00",1435981920,"C6",207240,1436189160,"2015-07-06 06:26:00"
"5593","20150501060550-176",3,"2015-07-03 23:17:00",1435990620,"C6",353340,1436343960,"2015-07-08 01:26:00"
"2623","20152329052335-690",1,"2015-07-04 00:53:00",1435996380,"C5",186300,1436182680,"2015-07-06 04:38:00"
"5076","20155412025439-711",2,"2015-07-04 01:18:00",1435997880,"C0",231480,1436229360,"2015-07-06 17:36:00"
"1583","20153526093522-53",1,"2015-07-04 03:13:00",1436004780,"C5",334140,1436338920,"2015-07-08 00:02:00"
"3382","20150118110157-82",1,"2015-07-04 03:13:00",1436004780,"C8",677160,1436681940,"2015-07-11 23:19:00"
"1566","20154217034220-309",2,"2015-07-04 04:44:00",1436010240,"C5",714660,1436724900,"2015-07-12 11:15:00"
"3146","20153330113330-512",2,"2015-07-04 04:45:00",1436010300,"C5",160560,1436170860,"2015-07-06 01:21:00"
"3667","20153907123907-228",1,"2015-07-04 05:27:00",1436012820,"C3",288360,1436301180,"2015-07-07 13:33:00"
"5003","20154406044427-579",1,"2015-07-04 06:00:00",1436014800,"C3",340080,1436354880,"2015-07-08 04:28:00"
"1551","20151403101418-295",2,"2015-07-04 06:22:00",1436016120,"C8",380640,1436396760,"2015-07-08 16:06:00"
"2344","20155230035222-748",2,"2015-07-04 07:06:00",1436018760,"C8",157020,1436175780,"2015-07-06 02:43:00"
"1335","20150313080324-835",1,"2015-07-04 07:47:00",1436021220,"C8",906720,1436927940,"2015-07-14 19:39:00"
"3361","20154730124723-254",3,"2015-07-04 08:28:00",1436023680,"C0",330060,1436353740,"2015-07-08 04:09:00"
"295","20152923072910-395",2,"2015-07-04 09:39:00",1436027940,"C8",479100,1436507040,"2015-07-09 22:44:00"
"1466","20150419060418-689",1,"2015-07-04 09:48:00",1436028480,"C5",654720,1436683200,"2015-07-11 23:40:00"
"4488","20150404050454-793",1,"2015-07-04 11:04:00",1436033040,"C6",321300,1436354340,"2015-07-08 04:19:00"
"4513","20155501035544-811",3,"2015-07-04 11:31:00",1436034660,"C6",243360,1436278020,"2015-07-07 07:07:00"
"2239","20154830104827-205",1,"2015-07-04 13:02:00",1436040120,"C0",176820,1436216940,"2015-07-06 14:09:00"
"4544","20151924061911-225",2,"2015-07-04 14:43:00",1436046180,"C2",447120,1436493300,"2015-07-09 18:55:00"
"3897","20152003112040-99",1,"2015-07-04 15:01:00",1436047260,"C2",99660,1436146920,"2015-07-05 18:42:00"
"4453","20153003023020-726",1,"2015-07-04 15:01:00",1436047260,"C3",88260,1436135520,"2015-07-05 15:32:00"
"3644","20152514072525-135",1,"2015-07-04 15:45:00",1436049900,"C8",879000,1436928900,"2015-07-14 19:55:00"
"4956","20154630044606-595",3,"2015-07-04 16:34:00",1436052840,"C8",172440,1436225280,"2015-07-06 16:28:00"
"5331","20153312103323-598",3,"2015-07-04 18:12:00",1436058720,"C5",642780,1436701500,"2015-07-12 04:45:00"
"2337","20150614120640-492",1,"2015-07-04 19:04:00",1436061840,"C0",250440,1436312280,"2015-07-07 16:38:00"
"3562","20150628010613-142",1,"2015-07-04 20:02:00",1436065320,"C2",67920,1436133240,"2015-07-05 14:54:00"
"5368","20151927041904-297",3,"2015-07-04 20:15:00",1436066100,"C0",309480,1436375580,"2015-07-08 10:13:00"
"2377","20154525084548-607",2,"2015-07-04 20:24:00",1436066640,"C2",273180,1436339820,"2015-07-08 00:17:00"
"4210","20150029030057-969",2,"2015-07-04 20:34:00",1436067240,"C4",452040,1436519280,"2015-07-10 02:08:00"
"467","20153902073935-578",2,"2015-07-04 20:35:00",1436067300,"C8",109680,1436176980,"2015-07-06 03:03:00"
"6098","20152103042134-429",2,"2015-07-04 20:37:00",1436067420,"C7",50880,1436118300,"2015-07-05 10:45:00"
"3687","20152513102549-213",3,"2015-07-04 20:55:00",1436068500,"C5",264600,1436333100,"2015-07-07 22:25:00"
"3878","20153224063221-780",1,"2015-07-04 22:11:00",1436073060,"C4",306780,1436379840,"2015-07-08 11:24:00"
"2129","20153324033312-407",3,"2015-07-04 22:19:00",1436073540,"C7",444180,1436517720,"2015-07-10 01:42:00"
"2518","20152302052353-71",1,"2015-07-05 01:47:00",1436086020,"C5",67680,1436153700,"2015-07-05 20:35:00"
"1553","20152529092504-987",2,"2015-07-05 02:05:00",1436087100,"C0",246000,1436333100,"2015-07-07 22:25:00"
"893","20154702124720-238",3,"2015-07-05 03:35:00",1436092500,"C5",75360,1436167860,"2015-07-06 00:31:00"
"3590","20152326082325-308",1,"2015-07-05 04:43:00",1436096580,"C7",109200,1436205780,"2015-07-06 11:03:00"
"5651","20152226032253-445",1,"2015-07-05 05:13:00",1436098380,"C4",247020,1436345400,"2015-07-08 01:50:00"
"6502","20155828095857-94",2,"2015-07-05 06:00:00",1436101200,"C2",84360,1436185560,"2015-07-06 05:26:00"
"3049","20150801020830-440",1,"2015-07-05 06:02:00",1436101320,"C4",158220,1436259540,"2015-07-07 01:59:00"
"5839","20153706113731-583",3,"2015-07-05 06:22:00",1436102520,"C8",497340,1436599860,"2015-07-11 00:31:00"
"131","20155801085847-425",1,"2015-07-05 06:28:00",1436102880,"C4",336600,1436439480,"2015-07-09 03:58:00"
"3706","20155501035526-887",1,"2015-07-05 07:05:00",1436105100,"C2",313800,1436418900,"2015-07-08 22:15:00"
"4184","20151020091049-173",1,"2015-07-05 08:34:00",1436110440,"C2",431280,1436541720,"2015-07-10 08:22:00"
"5437","20155830085850-481",1,"2015-07-05 09:38:00",1436114280,"C6",434400,1436548680,"2015-07-10 10:18:00"
"3953","20155019075059-941",3,"2015-07-05 12:08:00",1436123280,"C5",465960,1436589240,"2015-07-10 21:34:00"
"3721","20154627024615-98",2,"2015-07-05 13:43:00",1436128980,"C6",687420,1436816400,"2015-07-13 12:40:00"
"3920","20154527024553-723",1,"2015-07-05 14:05:00",1436130300,"C5",344400,1436474700,"2015-07-09 13:45:00"
"1463","20154303024324-525",2,"2015-07-05 14:07:00",1436130420,"C5",85320,1436215740,"2015-07-06 13:49:00"
"3164","20154128104144-208",2,"2015-07-05 14:09:00",1436130540,"C6",77160,1436207700,"2015-07-06 11:35:00"
"4154","20151701091730-48",3,"2015-07-05 14:13:00",1436130780,"C5",181680,1436312460,"2015-07-07 16:41:00"
"5230","20155404065421-768",1,"2015-07-05 14:31:00",1436131860,"C4",113820,1436245680,"2015-07-06 22:08:00"
"449","20153028103038-731",3,"2015-07-05 14:42:00",1436132520,"C6",619920,1436752440,"2015-07-12 18:54:00"
"1246","20153917033947-416",3,"2015-07-05 15:26:00",1436135160,"C8",222060,1436357220,"2015-07-08 05:07:00"
"725","20150103100100-923",2,"2015-07-05 15:57:00",1436137020,"C5",97080,1436234100,"2015-07-06 18:55:00"
"4818","20150701040708-313",3,"2015-07-05 15:57:00",1436137020,"C5",172500,1436309520,"2015-07-07 15:52:00"
"2082","20154703044705-734",1,"2015-07-05 16:18:00",1436138280,"C3",171060,1436309340,"2015-07-07 15:49:00"
"5212","20150127030110-863",1,"2015-07-05 16:22:00",1436138520,"C7",77340,1436215860,"2015-07-06 13:51:00"
"1016","20155315115319-974",3,"2015-07-05 16:45:00",1436139900,"C8",872760,1437012660,"2015-07-15 19:11:00"
"6424","20155328035310-746",2,"2015-07-05 17:19:00",1436141940,"C6",609960,1436751900,"2015-07-12 18:45:00"
"3210","20152301032339-982",2,"2015-07-05 17:35:00",1436142900,"C7",176760,1436319660,"2015-07-07 18:41:00"
"1443","20154001124007-163",1,"2015-07-05 17:37:00",1436143020,"C2",121140,1436264160,"2015-07-07 03:16:00"
"3973","20155826105805-860",1,"2015-07-05 18:01:00",1436144460,"C4",267660,1436412120,"2015-07-08 20:22:00"
"4355","20153730123713-648",1,"2015-07-05 18:27:00",1436146020,"C8",90600,1436236620,"2015-07-06 19:37:00"
"4949","20154603024647-48",2,"2015-07-05 19:12:00",1436148720,"C8",94380,1436243100,"2015-07-06 21:25:00"
"6440","20153730013733-766",3,"2015-07-05 19:58:00",1436151480,"C0",64980,1436216460,"2015-07-06 14:01:00"
"58","20151422021453-376",2,"2015-07-05 20:16:00",1436152560,"C7",163560,1436316120,"2015-07-07 17:42:00"
"790","20154201104250-936",2,"2015-07-05 20:24:00",1436153040,"C2",126840,1436279880,"2015-07-07 07:38:00"
"5350","20151722101732-165",2,"2015-07-05 20:29:00",1436153340,"C6",193320,1436346660,"2015-07-08 02:11:00"
"548","20153617093653-526",2,"2015-07-05 21:09:00",1436155740,"C7",177420,1436333160,"2015-07-07 22:26:00"
"6310","20153629073622-752",2,"2015-07-05 21:30:00",1436157000,"C8",284220,1436441220,"2015-07-09 04:27:00"
"1242","20152201102241-597",3,"2015-07-05 22:26:00",1436160360,"C7",194520,1436354880,"2015-07-08 04:28:00"
"2047","20152019082054-582",2,"2015-07-05 22:44:00",1436161440,"C4",514080,1436675520,"2015-07-11 21:32:00"
"2918","20152305022313-514",1,"2015-07-05 23:33:00",1436164380,"C8",525000,1436689380,"2015-07-12 01:23:00"
"3645","20151927101928-443",1,"2015-07-05 23:52:00",1436165520,"C0",246660,1436412180,"2015-07-08 20:23:00"
"1469","20152917082934-698",1,"2015-07-05 23:57:00",1436165820,"C5",805440,1436971260,"2015-07-15 07:41:00"
"6221","20150420110457-500",2,"2015-07-06 00:56:00",1436169360,"C4",168240,1436337600,"2015-07-07 23:40:00"
"6540","20150806040859-207",1,"2015-07-06 00:56:00",1436169360,"C2",317160,1436486520,"2015-07-09 17:02:00"
"4039","20154129084132-74",1,"2015-07-06 01:13:00",1436170380,"C3",82560,1436252940,"2015-07-07 00:09:00"
"2197","20152530052504-640",3,"2015-07-06 01:47:00",1436172420,"C8",231060,1436403480,"2015-07-08 17:58:00"
"1372","20151205011253-317",2,"2015-07-06 03:23:00",1436178180,"C4",377580,1436555760,"2015-07-10 12:16:00"
"6435","20150013020033-816",1,"2015-07-06 03:55:00",1436180100,"C8",278700,1436458800,"2015-07-09 09:20:00"
"668","20154801084800-755",1,"2015-07-06 04:13:00",1436181180,"C8",83100,1436264280,"2015-07-07 03:18:00"
"4038","20151302081321-676",3,"2015-07-06 04:19:00",1436181540,"C4",110520,1436292060,"2015-07-07 11:01:00"
"779","20153902093914-109",1,"2015-07-06 04:27:00",1436182020,"C4",108960,1436290980,"2015-07-07 10:43:00"
"6188","20153120103108-805",2,"2015-07-06 04:47:00",1436183220,"C2",170220,1436353440,"2015-07-08 04:04:00"
"6544","20151028011029-820",3,"2015-07-06 04:54:00",1436183640,"C0",82680,1436266320,"2015-07-07 03:52:00"
"2060","20150325020345-881",3,"2015-07-06 05:03:00",1436184180,"C8",183600,1436367780,"2015-07-08 08:03:00"
"4475","20154426024411-840",2,"2015-07-06 06:14:00",1436188440,"C0",277800,1436466240,"2015-07-09 11:24:00"
"1774","20152601122623-54",1,"2015-07-06 06:18:00",1436188680,"C3",204960,1436393640,"2015-07-08 15:14:00"
"3454","20154121084107-952",3,"2015-07-06 06:55:00",1436190900,"C5",644820,1436835720,"2015-07-13 18:02:00"
"6505","20151304011310-154",1,"2015-07-06 06:57:00",1436191020,"C3",150240,1436341260,"2015-07-08 00:41:00"
"959","20154003114038-680",2,"2015-07-06 07:13:00",1436191980,"C3",81060,1436273040,"2015-07-07 05:44:00"
"6103","20150605070642-510",1,"2015-07-06 07:58:00",1436194680,"C3",89520,1436284200,"2015-07-07 08:50:00"
"4036","20153524123538-428",1,"2015-07-06 08:09:00",1436195340,"C4",510420,1436705760,"2015-07-12 05:56:00"
"3926","20151430011409-669",1,"2015-07-06 08:40:00",1436197200,"C4",250980,1436448180,"2015-07-09 06:23:00"
"177","20150926110958-805",2,"2015-07-06 08:42:00",1436197320,"C0",285060,1436482380,"2015-07-09 15:53:00"
"3417","20155524085551-928",1,"2015-07-06 09:58:00",1436201880,"C4",346860,1436548740,"2015-07-10 10:19:00"
"3978","20154904104947-550",2,"2015-07-06 10:13:00",1436202780,"C3",85320,1436288100,"2015-07-07 09:55:00"
"259","20151001031016-663",1,"2015-07-06 10:58:00",1436205480,"C2",138960,1436344440,"2015-07-08 01:34:00"
"456","20151609011626-759",2,"2015-07-06 11:16:00",1436206560,"C5",290700,1436497260,"2015-07-09 20:01:00"
"62","20150610040636-776",2,"2015-07-06 13:42:00",1436215320,"C7",248640,1436463960,"2015-07-09 10:46:00"
"1376","20155418045455-317",2,"2015-07-06 14:02:00",1436216520,"C0",772440,1436988960,"2015-07-15 12:36:00"
"112","20150105040107-528",2,"2015-07-06 14:29:00",1436218140,"C3",80880,1436299020,"2015-07-07 12:57:00"
"3563","20153029063054-508",1,"2015-07-06 14:32:00",1436218320,"C7",316860,1436535180,"2015-07-10 06:33:00"
"3341","20151603051629-978",1,"2015-07-06 14:49:00",1436219340,"C5",83460,1436302800,"2015-07-07 14:00:00"
"1768","20155420105422-518",3,"2015-07-06 15:02:00",1436220120,"C4",174660,1436394780,"2015-07-08 15:33:00"
"426","20150723050745-341",1,"2015-07-06 15:55:00",1436223300,"C8",159840,1436383140,"2015-07-08 12:19:00"
"4646","20155503085502-843",1,"2015-07-06 16:13:00",1436224380,"C3",95160,1436319540,"2015-07-07 18:39:00"
"5093","20152709052754-9",3,"2015-07-06 16:22:00",1436224920,"C4",332700,1436557620,"2015-07-10 12:47:00"
"1713","20153904043911-814",3,"2015-07-06 16:57:00",1436227020,"C3",86940,1436313960,"2015-07-07 17:06:00"
"5262","20150128070124-874",1,"2015-07-06 18:16:00",1436231760,"C4",731700,1436963460,"2015-07-15 05:31:00"
"5415","20151004041028-27",1,"2015-07-06 18:25:00",1436232300,"C2",180900,1436413200,"2015-07-08 20:40:00"
"3308","20152230122233-577",1,"2015-07-06 18:26:00",1436232360,"C4",270120,1436502480,"2015-07-09 21:28:00"
"5655","20155805015836-890",1,"2015-07-06 18:51:00",1436233860,"C3",103980,1436337840,"2015-07-07 23:44:00"
"679","20154304044323-645",1,"2015-07-06 19:09:00",1436234940,"C3",90780,1436325720,"2015-07-07 20:22:00"
"5308","20152730102714-620",1,"2015-07-06 19:43:00",1436236980,"C2",551760,1436788740,"2015-07-13 04:59:00"
"1451","20154421014437-375",1,"2015-07-06 20:00:00",1436238000,"C4",164820,1436402820,"2015-07-08 17:47:00"
"5565","20151423051449-551",1,"2015-07-06 20:02:00",1436238120,"C3",141660,1436379780,"2015-07-08 11:23:00"
"6270","20153505093535-456",2,"2015-07-06 20:05:00",1436238300,"C0",124200,1436362500,"2015-07-08 06:35:00"
"3489","20154804044802-635",2,"2015-07-06 20:24:00",1436239440,"C5",92880,1436332320,"2015-07-07 22:12:00"
"3601","20151304121328-420",1,"2015-07-06 20:35:00",1436240100,"C3",202920,1436443020,"2015-07-09 04:57:00"
"4048","20150801050802-446",2,"2015-07-06 20:44:00",1436240640,"C4",222480,1436463120,"2015-07-09 10:32:00"
"3295","20151805071821-119",3,"2015-07-06 21:39:00",1436243940,"C6",138060,1436382000,"2015-07-08 12:00:00"
"261","20150702040704-305",1,"2015-07-06 21:47:00",1436244420,"C8",73200,1436317620,"2015-07-07 18:07:00"
"27","20154602084650-633",1,"2015-07-06 21:56:00",1436244960,"C8",597000,1436841960,"2015-07-13 19:46:00"
"1097","20155416025450-542",3,"2015-07-06 21:59:00",1436245140,"C4",250500,1436495640,"2015-07-09 19:34:00"
"6194","20151202021203-963",1,"2015-07-06 22:01:00",1436245260,"C4",373740,1436619000,"2015-07-11 05:50:00"
"2649","20154112084109-806",1,"2015-07-06 22:54:00",1436248440,"C8",303540,1436551980,"2015-07-10 11:13:00"
"1635","20151710081754-167",2,"2015-07-06 23:37:00",1436251020,"C5",287700,1436538720,"2015-07-10 07:32:00"
"1899","20155304025306-399",1,"2015-07-07 00:03:00",1436252580,"C2",102900,1436355480,"2015-07-08 04:38:00"
"1074","20152302012357-409",1,"2015-07-07 00:11:00",1436253060,"C7",192240,1436445300,"2015-07-09 05:35:00"
"3578","20153125023115-598",1,"2015-07-07 00:43:00",1436254980,"C0",329040,1436584020,"2015-07-10 20:07:00"
"3585","20150201040231-215",1,"2015-07-07 00:58:00",1436255880,"C2",232080,1436487960,"2015-07-09 17:26:00"
"944","20151203041231-943",1,"2015-07-07 01:48:00",1436258880,"C2",97920,1436356800,"2015-07-08 05:00:00"
"1176","20151403031412-911",1,"2015-07-07 02:23:00",1436260980,"C3",99780,1436360760,"2015-07-08 06:06:00"
"4325","20154009094029-596",2,"2015-07-07 02:40:00",1436262000,"C8",342000,1436604000,"2015-07-11 01:40:00"
"699","20154501044554-839",2,"2015-07-07 02:57:00",1436263020,"C8",66960,1436329980,"2015-07-07 21:33:00"
"1996","20151626061648-946",3,"2015-07-07 03:16:00",1436264160,"C5",313200,1436577360,"2015-07-10 18:16:00"
"2710","20153504013504-269",1,"2015-07-07 03:35:00",1436265300,"C5",74400,1436339700,"2015-07-08 00:15:00"
"1348","20155030015058-336",1,"2015-07-07 05:14:00",1436271240,"C0",286920,1436558160,"2015-07-10 12:56:00"
"4702","20151506031509-899",2,"2015-07-07 05:50:00",1436273400,"C3",52500,1436325900,"2015-07-07 20:25:00"
"1043","20155501105513-756",2,"2015-07-07 05:59:00",1436273940,"C4",71520,1436345460,"2015-07-08 01:51:00"
"459","20155630015659-740",1,"2015-07-07 06:01:00",1436274060,"C8",115260,1436389320,"2015-07-08 14:02:00"
"1004","20153903103958-735",3,"2015-07-07 06:30:00",1436275800,"C6",330660,1436606460,"2015-07-11 02:21:00"
"1831","20150729120752-754",2,"2015-07-07 06:35:00",1436276100,"C2",335640,1436611740,"2015-07-11 03:49:00"
"2578","20155904065927-209",1,"2015-07-07 06:35:00",1436276100,"C2",128880,1436404980,"2015-07-08 18:23:00"
"3621","20151103101135-993",1,"2015-07-07 07:11:00",1436278260,"C5",111600,1436389860,"2015-07-08 14:11:00"
"3607","20152222012249-468",3,"2015-07-07 07:14:00",1436278440,"C5",159240,1436437680,"2015-07-09 03:28:00"
"4982","20153505123531-2",1,"2015-07-07 07:15:00",1436278500,"C3",343200,1436621700,"2015-07-11 06:35:00"
"1691","20154501084530-202",2,"2015-07-07 07:40:00",1436280000,"C8",73500,1436353500,"2015-07-08 04:05:00"
"4228","20151404021437-954",3,"2015-07-07 07:44:00",1436280240,"C0",235800,1436516040,"2015-07-10 01:14:00"
"89","20151303071356-254",3,"2015-07-07 07:59:00",1436281140,"C5",174180,1436455320,"2015-07-09 08:22:00"
"323","20152703112735-711",1,"2015-07-07 07:59:00",1436281140,"C5",166560,1436447700,"2015-07-09 06:15:00"
"4041","20154821104859-297",2,"2015-07-07 08:24:00",1436282640,"C5",171720,1436454360,"2015-07-09 08:06:00"
"3189","20153830123858-160",1,"2015-07-07 08:54:00",1436284440,"C4",84480,1436368920,"2015-07-08 08:22:00"
"2681","20155104055125-368",2,"2015-07-07 09:52:00",1436287920,"C6",230460,1436518380,"2015-07-10 01:53:00"
"6016","20150203060259-209",2,"2015-07-07 10:26:00",1436289960,"C5",120480,1436410440,"2015-07-08 19:54:00"
"2190","20154201114254-498",2,"2015-07-07 10:57:00",1436291820,"C8",103140,1436394960,"2015-07-08 15:36:00"
"2442","20155501115549-423",2,"2015-07-07 11:04:00",1436292240,"C4",73620,1436365860,"2015-07-08 07:31:00"
"1784","20152005092056-151",2,"2015-07-07 11:05:00",1436292300,"C8",554220,1436846520,"2015-07-13 21:02:00"
"4175","20154714024730-244",1,"2015-07-07 11:56:00",1436295360,"C7",282420,1436577780,"2015-07-10 18:23:00"
"4139","20150903090957-551",1,"2015-07-07 13:17:00",1436300220,"C5",180240,1436480460,"2015-07-09 15:21:00"
"5394","20155313105324-362",1,"2015-07-07 13:38:00",1436301480,"C4",694500,1436995980,"2015-07-15 14:33:00"
"6190","20154303124314-941",1,"2015-07-07 13:55:00",1436302500,"C5",174960,1436477460,"2015-07-09 14:31:00"
"525","20155525015513-235",2,"2015-07-07 14:01:00",1436302860,"C0",345720,1436648580,"2015-07-11 14:03:00"
"1631","20153906073935-24",2,"2015-07-07 15:44:00",1436309040,"C4",115500,1436424540,"2015-07-08 23:49:00"
"5008","20155418035415-502",1,"2015-07-07 16:00:00",1436310000,"C6",273660,1436583660,"2015-07-10 20:01:00"
"571","20152123012131-392",2,"2015-07-07 16:33:00",1436311980,"C6",152640,1436464620,"2015-07-09 10:57:00"
"4548","20155428065442-400",3,"2015-07-07 16:33:00",1436311980,"C4",812340,1437124320,"2015-07-17 02:12:00"
"5384","20153205083252-86",1,"2015-07-07 16:51:00",1436313060,"C0",202740,1436515800,"2015-07-10 01:10:00"
"2210","20155502125507-435",1,"2015-07-07 16:56:00",1436313360,"C2",63780,1436377140,"2015-07-08 10:39:00"
"611","20153301123341-61",2,"2015-07-07 17:11:00",1436314260,"C5",76440,1436390700,"2015-07-08 14:25:00"
"2847","20155803045848-101",3,"2015-07-07 17:38:00",1436315880,"C2",174000,1436489880,"2015-07-09 17:58:00"
"5017","20153605033636-902",1,"2015-07-07 17:56:00",1436316960,"C8",90600,1436407560,"2015-07-08 19:06:00"
"2823","20150921010943-734",2,"2015-07-07 18:19:00",1436318340,"C8",280200,1436598540,"2015-07-11 00:09:00"
"1665","20154204124245-802",3,"2015-07-07 18:27:00",1436318820,"C2",93300,1436412120,"2015-07-08 20:22:00"
"5139","20153530093500-378",1,"2015-07-07 18:47:00",1436320020,"C2",79740,1436399760,"2015-07-08 16:56:00"
"1014","20151602121624-797",1,"2015-07-07 18:53:00",1436320380,"C3",455820,1436776200,"2015-07-13 01:30:00"
"6329","20151928081935-515",2,"2015-07-07 19:49:00",1436323740,"C5",273000,1436596740,"2015-07-10 23:39:00"
"241","20152303052305-443",1,"2015-07-07 22:04:00",1436331840,"C5",51780,1436383620,"2015-07-08 12:27:00"
"5302","20154127114129-6",1,"2015-07-07 22:06:00",1436331960,"C8",180300,1436512260,"2015-07-10 00:11:00"
"1352","20151223091224-134",2,"2015-07-07 23:03:00",1436335380,"C2",419820,1436755200,"2015-07-12 19:40:00"
"3002","20150122060128-25",2,"2015-07-07 23:26:00",1436336760,"C7",194100,1436530860,"2015-07-10 05:21:00"
"2336","20150323040301-184",1,"2015-07-07 23:31:00",1436337060,"C7",176640,1436513700,"2015-07-10 00:35:00"
"118","20154701074721-510",2,"2015-07-08 00:44:00",1436341440,"C4",193140,1436534580,"2015-07-10 06:23:00"
"1133","20153204013239-640",1,"2015-07-08 01:08:00",1436342880,"C2",100320,1436443200,"2015-07-09 05:00:00"
"3854","20154203064217-174",1,"2015-07-08 01:36:00",1436344560,"C5",137880,1436482440,"2015-07-09 15:54:00"
"4343","20152025032033-74",1,"2015-07-08 02:11:00",1436346660,"C2",358620,1436705280,"2015-07-12 05:48:00"
"1690","20152215022221-833",1,"2015-07-08 03:18:00",1436350680,"C7",973680,1437324360,"2015-07-19 09:46:00"
"964","20153104023109-416",3,"2015-07-08 03:46:00",1436352360,"C8",61380,1436413740,"2015-07-08 20:49:00"
"1532","20150405010405-973",1,"2015-07-08 03:56:00",1436352960,"C5",113160,1436466120,"2015-07-09 11:22:00"
"125","20152109062104-583",2,"2015-07-08 04:13:00",1436353980,"C2",312240,1436666220,"2015-07-11 18:57:00"
"4174","20153003083030-321",3,"2015-07-08 07:34:00",1436366040,"C8",214320,1436580360,"2015-07-10 19:06:00"
"3330","20155003045027-887",1,"2015-07-08 07:44:00",1436366640,"C0",399240,1436765880,"2015-07-12 22:38:00"
"220","20155603015631-143",2,"2015-07-08 07:54:00",1436367240,"C4",410280,1436777520,"2015-07-13 01:52:00"
"1332","20153926013940-342",1,"2015-07-08 07:55:00",1436367300,"C5",508080,1436875380,"2015-07-14 05:03:00"
"3694","20155506035548-222",1,"2015-07-08 07:57:00",1436367420,"C3",72060,1436439480,"2015-07-09 03:58:00"
"2160","20153907063955-529",2,"2015-07-08 08:00:00",1436367600,"C2",91260,1436458860,"2015-07-09 09:21:00"
"192","20154904034903-354",1,"2015-07-08 10:35:00",1436376900,"C4",163380,1436540280,"2015-07-10 07:58:00"
"985","20152704012705-41",1,"2015-07-08 11:07:00",1436378820,"C5",168600,1436547420,"2015-07-10 09:57:00"
"1135","20153224073256-73",1,"2015-07-08 11:10:00",1436379000,"C5",611340,1436990340,"2015-07-15 12:59:00"
"6250","20154011124049-78",1,"2015-07-08 11:25:00",1436379900,"C2",776100,1437156000,"2015-07-17 11:00:00"
"4578","20155902015910-865",1,"2015-07-08 11:30:00",1436380200,"C4",509460,1436889660,"2015-07-14 09:01:00"
"326","20155805025842-634",1,"2015-07-08 13:23:00",1436386980,"C0",406500,1436793480,"2015-07-13 06:18:00"
"4427","20153222013237-308",1,"2015-07-08 13:26:00",1436387160,"C4",460680,1436847840,"2015-07-13 21:24:00"
"3321","20150326090329-717",2,"2015-07-08 14:03:00",1436389380,"C8",210960,1436600340,"2015-07-11 00:39:00"
"704","20150025040004-379",2,"2015-07-08 14:13:00",1436389980,"C0",159540,1436549520,"2015-07-10 10:32:00"
"3005","20152323072348-119",2,"2015-07-08 14:19:00",1436390340,"C2",165120,1436555460,"2015-07-10 12:11:00"
"5416","20150903040923-931",3,"2015-07-08 14:20:00",1436390400,"C5",60780,1436451180,"2015-07-09 07:13:00"
"1278","20151106041146-807",1,"2015-07-08 14:55:00",1436392500,"C0",84120,1436476620,"2015-07-09 14:17:00"
"6399","20150929060957-709",1,"2015-07-08 15:05:00",1436393100,"C0",101220,1436494320,"2015-07-09 19:12:00"
"1413","20152828112812-119",1,"2015-07-08 15:08:00",1436393280,"C3",87720,1436481000,"2015-07-09 15:30:00"
"1409","20151503011524-795",2,"2015-07-08 15:24:00",1436394240,"C5",146580,1436540820,"2015-07-10 08:07:00"
"5890","20154520014506-55",1,"2015-07-08 15:43:00",1436395380,"C0",781140,1437176520,"2015-07-17 16:42:00"
"2607","20153320043334-346",1,"2015-07-08 15:45:00",1436395500,"C8",776160,1437171660,"2015-07-17 15:21:00"
"5236","20150027100030-310",1,"2015-07-08 15:45:00",1436395500,"C8",194220,1436589720,"2015-07-10 21:42:00"
"733","20152116022122-905",1,"2015-07-08 15:54:00",1436396040,"C0",272340,1436668380,"2015-07-11 19:33:00"
"5788","20151821121849-891",3,"2015-07-08 16:10:00",1436397000,"C4",185340,1436582340,"2015-07-10 19:39:00"
"3365","20155603015621-472",2,"2015-07-08 16:19:00",1436397540,"C0",62940,1436460480,"2015-07-09 09:48:00"
"113","20150620070638-960",1,"2015-07-08 17:18:00",1436401080,"C3",795960,1437197040,"2015-07-17 22:24:00"
"5693","20150523030511-17",2,"2015-07-08 17:27:00",1436401620,"C3",186360,1436587980,"2015-07-10 21:13:00"
"5032","20153307063313-327",1,"2015-07-08 19:01:00",1436407260,"C5",389040,1436796300,"2015-07-13 07:05:00"
"219","20155204105251-380",3,"2015-07-08 20:47:00",1436413620,"C4",381300,1436794920,"2015-07-13 06:42:00"
"1937","20152728082727-282",1,"2015-07-08 20:47:00",1436413620,"C4",454200,1436867820,"2015-07-14 02:57:00"
"3857","20151727091758-4",3,"2015-07-08 21:02:00",1436414520,"C8",198540,1436613060,"2015-07-11 04:11:00"
"3202","20152004072035-991",2,"2015-07-08 21:28:00",1436416080,"C8",198240,1436614320,"2015-07-11 04:32:00"
"2569","20151104091151-104",3,"2015-07-08 21:47:00",1436417220,"C8",195480,1436612700,"2015-07-11 04:05:00"
"5992","20155802055814-251",2,"2015-07-08 21:47:00",1436417220,"C7",76020,1436493240,"2015-07-09 18:54:00"
"5309","20154404094430-924",3,"2015-07-08 21:56:00",1436417760,"C5",129840,1436547600,"2015-07-10 10:00:00"
"2611","20150001010009-284",3,"2015-07-08 22:42:00",1436420520,"C6",106620,1436527140,"2015-07-10 04:19:00"
"1285","20151924091906-140",3,"2015-07-08 22:58:00",1436421480,"C7",179820,1436601300,"2015-07-11 00:55:00"
"3236","20153305123353-662",1,"2015-07-08 23:57:00",1436425020,"C5",100080,1436525100,"2015-07-10 03:45:00"
"6135","20150503020544-302",1,"2015-07-09 00:13:00",1436425980,"C5",234240,1436660220,"2015-07-11 17:17:00"
"4260","20151002101014-792",3,"2015-07-09 00:34:00",1436427240,"C0",190080,1436617320,"2015-07-11 05:22:00"
"755","20153805023838-887",1,"2015-07-09 01:11:00",1436429460,"C5",99060,1436528520,"2015-07-10 04:42:00"
"1343","20152504112551-431",2,"2015-07-09 01:31:00",1436430660,"C2",198180,1436628840,"2015-07-11 08:34:00"
"1857","20153130083112-439",2,"2015-07-09 02:37:00",1436434620,"C0",378180,1436812800,"2015-07-13 11:40:00"
"1341","20153004023033-371",2,"2015-07-09 02:54:00",1436435640,"C7",195120,1436630760,"2015-07-11 09:06:00"
"3588","20151619091658-670",1,"2015-07-09 03:00:00",1436436000,"C2",213180,1436649180,"2015-07-11 14:13:00"
"2012","20154602034646-21",1,"2015-07-09 03:37:00",1436438220,"C2",187020,1436625240,"2015-07-11 07:34:00"
"6063","20155021125027-18",1,"2015-07-09 03:44:00",1436438640,"C0",507480,1436946120,"2015-07-15 00:42:00"
"6200","20150320020348-641",2,"2015-07-09 03:53:00",1436439180,"C5",802500,1437241680,"2015-07-18 10:48:00"
"1572","20150730070718-674",2,"2015-07-09 04:27:00",1436441220,"C3",96000,1436537220,"2015-07-10 07:07:00"
"510","20151604081612-669",1,"2015-07-09 05:48:00",1436446080,"C2",211560,1436657640,"2015-07-11 16:34:00"
"3168","20151419121435-102",3,"2015-07-09 06:08:00",1436447280,"C8",243720,1436691000,"2015-07-12 01:50:00"
"4429","20155307045325-414",2,"2015-07-09 06:48:00",1436449680,"C4",136500,1436586180,"2015-07-10 20:43:00"
"1163","20152027112040-21",2,"2015-07-09 06:50:00",1436449800,"C8",204120,1436653920,"2015-07-11 15:32:00"
"288","20150028030041-325",1,"2015-07-09 06:52:00",1436449920,"C6",449940,1436899860,"2015-07-14 11:51:00"
"2003","20150330060312-987",1,"2015-07-09 07:17:00",1436451420,"C4",111720,1436563140,"2015-07-10 14:19:00"
"4350","20150826020807-226",1,"2015-07-09 07:27:00",1436452020,"C8",157020,1436609040,"2015-07-11 03:04:00"
"3491","20150205010257-226",1,"2015-07-09 08:00:00",1436454000,"C5",163740,1436617740,"2015-07-11 05:29:00"
"5173","20150205080250-857",2,"2015-07-09 08:02:00",1436454120,"C8",172800,1436626920,"2015-07-11 08:02:00"
"4375","20154801124855-611",3,"2015-07-09 08:08:00",1436454480,"C5",337200,1436791680,"2015-07-13 05:48:00"
"2017","20153505073536-429",1,"2015-07-09 09:04:00",1436457840,"C6",350940,1436808780,"2015-07-13 10:33:00"
"3726","20152403102434-408",3,"2015-07-09 09:04:00",1436457840,"C8",102720,1436560560,"2015-07-10 13:36:00"
"90","20153705093703-55",2,"2015-07-09 09:05:00",1436457900,"C2",366960,1436824860,"2015-07-13 15:01:00"
"5335","20153122113135-902",1,"2015-07-09 09:07:00",1436458020,"C7",162240,1436620260,"2015-07-11 06:11:00"
"3028","20152707122720-612",3,"2015-07-09 09:59:00",1436461140,"C8",81960,1436543100,"2015-07-10 08:45:00"
"2730","20150705050702-651",1,"2015-07-09 10:05:00",1436461500,"C4",160140,1436621640,"2015-07-11 06:34:00"
"4998","20150408040443-205",2,"2015-07-09 10:13:00",1436461980,"C2",65340,1436527320,"2015-07-10 04:22:00"
"3777","20152707102716-827",3,"2015-07-09 10:33:00",1436463180,"C5",86580,1436549760,"2015-07-10 10:36:00"
"6258","20151929051927-102",1,"2015-07-09 11:31:00",1436466660,"C8",421560,1436888220,"2015-07-14 08:37:00"
"3169","20150404120407-76",3,"2015-07-09 12:21:00",1436469660,"C4",61860,1436531520,"2015-07-10 05:32:00"
"5963","20154507074558-617",1,"2015-07-09 12:51:00",1436471460,"C5",95580,1436567040,"2015-07-10 15:24:00"
"1608","20155204015210-595",2,"2015-07-09 13:19:00",1436473140,"C5",143340,1436616480,"2015-07-11 05:08:00"
"891","20151705081717-385",1,"2015-07-09 13:47:00",1436474820,"C2",182700,1436657520,"2015-07-11 16:32:00"
"83","20151207091211-916",2,"2015-07-09 14:02:00",1436475720,"C5",95100,1436570820,"2015-07-10 16:27:00"
"3277","20153513123506-982",1,"2015-07-09 14:35:00",1436477700,"C4",281700,1436759400,"2015-07-12 20:50:00"
"1196","20152403092454-380",2,"2015-07-09 14:56:00",1436478960,"C5",269160,1436748120,"2015-07-12 17:42:00"
"5004","20154520034536-573",2,"2015-07-09 15:34:00",1436481240,"C5",234420,1436715660,"2015-07-12 08:41:00"
"1421","20153204073231-660",3,"2015-07-09 15:52:00",1436482320,"C8",92400,1436574720,"2015-07-10 17:32:00"
"602","20154905014906-97",1,"2015-07-09 16:17:00",1436483820,"C5",177240,1436661060,"2015-07-11 17:31:00"
"5600","20150828120844-852",1,"2015-07-09 16:56:00",1436486160,"C4",120960,1436607120,"2015-07-11 02:32:00"
"2232","20153601123633-561",1,"2015-07-09 17:03:00",1436486580,"C2",235740,1436722320,"2015-07-12 10:32:00"
"5683","20150307100357-262",2,"2015-07-09 17:41:00",1436488860,"C5",100140,1436589000,"2015-07-10 21:30:00"
"601","20151103051148-977",3,"2015-07-09 18:23:00",1436491380,"C5",261360,1436752740,"2015-07-12 18:59:00"
"470","20155808075842-527",3,"2015-07-09 18:31:00",1436491860,"C2",124380,1436616240,"2015-07-11 05:04:00"
"5463","20152518112549-926",2,"2015-07-09 18:43:00",1436492580,"C2",613560,1437106140,"2015-07-16 21:09:00"
"5706","20153906043929-561",1,"2015-07-09 19:44:00",1436496240,"C8",408900,1436905140,"2015-07-14 13:19:00"
"4886","20151704041709-562",1,"2015-07-09 20:25:00",1436498700,"C5",55860,1436554560,"2015-07-10 11:56:00"
"2640","20153905073902-613",3,"2015-07-09 21:01:00",1436500860,"C8",196860,1436697720,"2015-07-12 03:42:00"
"1525","20152303032328-493",1,"2015-07-09 21:08:00",1436501280,"C2",179700,1436680980,"2015-07-11 23:03:00"
"312","20154821034852-404",1,"2015-07-09 22:12:00",1436505120,"C0",789120,1437294240,"2015-07-19 01:24:00"
"4595","20153903043925-167",2,"2015-07-09 22:21:00",1436505660,"C2",269460,1436775120,"2015-07-13 01:12:00"
"1983","20153707073745-657",1,"2015-07-09 22:49:00",1436507340,"C2",227520,1436734860,"2015-07-12 14:01:00"
"1858","20155930095901-918",1,"2015-07-09 22:55:00",1436507700,"C2",437820,1436945520,"2015-07-15 00:32:00"
"1942","20154805014852-697",2,"2015-07-09 23:43:00",1436510580,"C8",76260,1436586840,"2015-07-10 20:54:00"
"6203","20155405045446-551",1,"2015-07-09 23:54:00",1436511240,"C6",61800,1436573040,"2015-07-10 17:04:00"
"1920","20153101023158-837",1,"2015-07-10 00:21:00",1436512860,"C3",103800,1436616660,"2015-07-11 05:11:00"
"2788","20155503095520-726",3,"2015-07-10 00:25:00",1436513100,"C8",285300,1436798400,"2015-07-13 07:40:00"
"5778","20155721085718-188",2,"2015-07-10 00:41:00",1436514060,"C8",805920,1437319980,"2015-07-19 08:33:00"
"732","20151804041847-14",2,"2015-07-10 01:20:00",1436516400,"C8",232260,1436748660,"2015-07-12 17:51:00"
"6317","20154501124525-792",2,"2015-07-10 01:37:00",1436517420,"C3",105360,1436622780,"2015-07-11 06:53:00"
"4831","20153115103103-717",1,"2015-07-10 02:16:00",1436519760,"C8",426060,1436945820,"2015-07-15 00:37:00"
"2560","20151208091253-564",3,"2015-07-10 02:56:00",1436522160,"C2",75120,1436597280,"2015-07-10 23:48:00"
"6265","20153019073056-11",1,"2015-07-10 02:58:00",1436522280,"C5",224760,1436747040,"2015-07-12 17:24:00"
"4372","20151920091934-950",1,"2015-07-10 02:59:00",1436522340,"C2",243600,1436765940,"2015-07-12 22:39:00"
"1095","20154324084313-457",2,"2015-07-10 03:25:00",1436523900,"C5",194760,1436718660,"2015-07-12 09:31:00"
"4743","20153226093201-782",3,"2015-07-10 03:28:00",1436524080,"C5",169680,1436693760,"2015-07-12 02:36:00"
"5369","20154704074710-516",2,"2015-07-10 03:42:00",1436524920,"C8",619140,1437144060,"2015-07-17 07:41:00"
"3381","20152105062125-369",2,"2015-07-10 03:45:00",1436525100,"C5",211320,1436736420,"2015-07-12 14:27:00"
"5897","20154806014828-598",1,"2015-07-10 04:34:00",1436528040,"C3",156180,1436684220,"2015-07-11 23:57:00"
"987","20150603090639-155",3,"2015-07-10 04:44:00",1436528640,"C0",294540,1436823180,"2015-07-13 14:33:00"
"6472","20151315031359-879",2,"2015-07-10 06:09:00",1436533740,"C0",265920,1436799660,"2015-07-13 08:01:00"
"1935","20155915035951-998",2,"2015-07-10 06:20:00",1436534400,"C5",708420,1437242820,"2015-07-18 11:07:00"
"3962","20154402124413-668",3,"2015-07-10 06:21:00",1436534460,"C8",95460,1436629920,"2015-07-11 08:52:00"
"6537","20151001011026-433",1,"2015-07-10 06:49:00",1436536140,"C5",107820,1436643960,"2015-07-11 12:46:00"
"2363","20154521024518-105",2,"2015-07-10 06:57:00",1436536620,"C4",537840,1437074460,"2015-07-16 12:21:00"
"3532","20154926014915-775",2,"2015-07-10 07:13:00",1436537580,"C0",592920,1437130500,"2015-07-17 03:55:00"
"5757","20153505113500-23",2,"2015-07-10 08:23:00",1436541780,"C5",210240,1436752020,"2015-07-12 18:47:00"
"6055","20150505110546-631",1,"2015-07-10 08:45:00",1436543100,"C2",430800,1436973900,"2015-07-15 08:25:00"
"5438","20155402055423-909",1,"2015-07-10 08:57:00",1436543820,"C8",94140,1436637960,"2015-07-11 11:06:00"
"69","20151405011458-832",2,"2015-07-10 10:08:00",1436548080,"C5",60120,1436608200,"2015-07-11 02:50:00"
"5500","20155019065024-371",2,"2015-07-10 11:10:00",1436551800,"C8",366000,1436917800,"2015-07-14 16:50:00"
"3945","20155809095821-297",1,"2015-07-10 11:41:00",1436553660,"C3",92580,1436646240,"2015-07-11 13:24:00"
"1103","20155820025849-226",2,"2015-07-10 11:49:00",1436554140,"C4",572220,1437126360,"2015-07-17 02:46:00"
"445","20154825064848-825",2,"2015-07-10 12:05:00",1436555100,"C7",187860,1436742960,"2015-07-12 16:16:00"
"1717","20155318095346-528",1,"2015-07-10 12:27:00",1436556420,"C4",955020,1437511440,"2015-07-21 13:44:00"
"4570","20153104043140-683",2,"2015-07-10 12:45:00",1436557500,"C5",252420,1436809920,"2015-07-13 10:52:00"
"104","20154708074757-401",1,"2015-07-10 13:02:00",1436558520,"C4",191700,1436750220,"2015-07-12 18:17:00"
"5177","20152605042639-261",2,"2015-07-10 13:55:00",1436561700,"C8",60420,1436622120,"2015-07-11 06:42:00"
"3736","20153008033000-100",1,"2015-07-10 13:56:00",1436561760,"C5",1379580,1437941340,"2015-07-26 13:09:00"
"2491","20150402120425-392",3,"2015-07-10 14:12:00",1436562720,"C2",99840,1436662560,"2015-07-11 17:56:00"
"61","20154404114459-43",1,"2015-07-10 14:26:00",1436563560,"C8",264060,1436827620,"2015-07-13 15:47:00"
"771","20151515021534-406",1,"2015-07-10 14:31:00",1436563860,"C2",270120,1436833980,"2015-07-13 17:33:00"
"3255","20152424062452-330",2,"2015-07-10 15:57:00",1436569020,"C5",472260,1437041280,"2015-07-16 03:08:00"
"4190","20154520074540-882",3,"2015-07-10 16:51:00",1436572260,"C8",880380,1437452640,"2015-07-20 21:24:00"
"1836","20151306101326-304",3,"2015-07-10 17:03:00",1436572980,"C5",185100,1436758080,"2015-07-12 20:28:00"
"3098","20155001105054-534",1,"2015-07-10 17:30:00",1436574600,"C4",100200,1436674800,"2015-07-11 21:20:00"
"2490","20152608112631-387",3,"2015-07-10 17:41:00",1436575260,"C0",195300,1436770560,"2015-07-12 23:56:00"
"4914","20154521094550-685",1,"2015-07-10 18:15:00",1436577300,"C4",557400,1437134700,"2015-07-17 05:05:00"
"1748","20154112014114-381",1,"2015-07-10 18:18:00",1436577480,"C6",204480,1436781960,"2015-07-13 03:06:00"
"3347","20153025083001-968",3,"2015-07-10 18:18:00",1436577480,"C6",221880,1436799360,"2015-07-13 07:56:00"
"6076","20150801100813-808",1,"2015-07-10 18:29:00",1436578140,"C5",115380,1436693520,"2015-07-12 02:32:00"
"6536","20155614105606-280",2,"2015-07-10 19:37:00",1436582220,"C5",325380,1436907600,"2015-07-14 14:00:00"
"4649","20155405015448-33",2,"2015-07-10 19:45:00",1436582700,"C4",453060,1437035760,"2015-07-16 01:36:00"
"1394","20155503025536-107",3,"2015-07-10 19:49:00",1436582940,"C4",622440,1437205380,"2015-07-18 00:43:00"
"2266","20154404064457-308",1,"2015-07-10 20:46:00",1436586360,"C2",284460,1436870820,"2015-07-14 03:47:00"
"6257","20153104103154-685",1,"2015-07-10 21:41:00",1436589660,"C2",79800,1436669460,"2015-07-11 19:51:00"
"461","20154405034454-883",3,"2015-07-10 22:05:00",1436591100,"C2",151620,1436742720,"2015-07-12 16:12:00"
"1168","20153225063205-641",3,"2015-07-10 22:08:00",1436591280,"C5",169020,1436760300,"2015-07-12 21:05:00"
"2310","20155604055630-978",1,"2015-07-10 22:41:00",1436593260,"C5",178500,1436771760,"2015-07-13 00:16:00"
"3702","20154804094840-923",1,"2015-07-10 22:44:00",1436593440,"C2",282480,1436875920,"2015-07-14 05:12:00"
"2238","20153316123340-662",1,"2015-07-11 00:41:00",1436600460,"C5",264660,1436865120,"2015-07-14 02:12:00"
"1125","20150509110512-403",2,"2015-07-11 01:05:00",1436601900,"C6",454800,1437056700,"2015-07-16 07:25:00"
"4078","20154107044154-514",1,"2015-07-11 01:31:00",1436603460,"C4",145500,1436748960,"2015-07-12 17:56:00"
"644","20150202120211-959",3,"2015-07-11 02:20:00",1436606400,"C7",371340,1436977740,"2015-07-15 09:29:00"
"995","20153406083403-509",2,"2015-07-11 02:38:00",1436607480,"C0",205320,1436812800,"2015-07-13 11:40:00"
"2395","20150108080154-471",1,"2015-07-11 02:51:00",1436608260,"C7",120300,1436728560,"2015-07-12 12:16:00"
"5078","20151309041310-608",1,"2015-07-11 03:01:00",1436608860,"C5",62640,1436671500,"2015-07-11 20:25:00"
"4754","20154605084600-982",3,"2015-07-11 03:02:00",1436608920,"C5",248880,1436857800,"2015-07-14 00:10:00"
"31","20152005102037-864",2,"2015-07-11 03:10:00",1436609400,"C5",246300,1436855700,"2015-07-13 23:35:00"
"5467","20152603072604-152",1,"2015-07-11 03:14:00",1436609640,"C6",112680,1436722320,"2015-07-12 10:32:00"
"4378","20154304044326-805",2,"2015-07-11 04:13:00",1436613180,"C2",186600,1436799780,"2015-07-13 08:03:00"
"2950","20153604113656-45",1,"2015-07-11 04:34:00",1436614440,"C5",289740,1436904180,"2015-07-14 13:03:00"
"5639","20153908113930-121",1,"2015-07-11 04:53:00",1436615580,"C5",117420,1436733000,"2015-07-12 13:30:00"
"5418","20150523060517-30",1,"2015-07-11 05:20:00",1436617200,"C5",103500,1436720700,"2015-07-12 10:05:00"
"4976","20154803104834-431",2,"2015-07-11 06:00:00",1436619600,"C7",74880,1436694480,"2015-07-12 02:48:00"
"901","20151808051847-914",1,"2015-07-11 06:40:00",1436622000,"C2",220920,1436842920,"2015-07-13 20:02:00"
"5957","20153204053251-894",2,"2015-07-11 07:11:00",1436623860,"C0",189180,1436813040,"2015-07-13 11:44:00"
"4878","20154408064412-833",3,"2015-07-11 07:44:00",1436625840,"C3",87600,1436713440,"2015-07-12 08:04:00"
"2274","20152826092848-943",1,"2015-07-11 07:46:00",1436625960,"C6",214980,1436840940,"2015-07-13 19:29:00"
"1480","20155702065700-462",1,"2015-07-11 08:00:00",1436626800,"C7",86820,1436713620,"2015-07-12 08:07:00"
"1307","20153705123714-935",3,"2015-07-11 09:22:00",1436631720,"C4",506700,1437138420,"2015-07-17 06:07:00"
"6407","20155605055620-608",3,"2015-07-11 09:50:00",1436633400,"C7",244620,1436878020,"2015-07-14 05:47:00"
"143","20155817085846-463",1,"2015-07-11 10:22:00",1436635320,"C5",692880,1437328200,"2015-07-19 10:50:00"
"5759","20153830123835-677",1,"2015-07-11 10:22:00",1436635320,"C0",117780,1436753100,"2015-07-12 19:05:00"
"1991","20151004061009-733",2,"2015-07-11 11:02:00",1436637720,"C0",622320,1437260040,"2015-07-18 15:54:00"
"11","20153705023701-460",1,"2015-07-11 11:33:00",1436639580,"C4",72480,1436712060,"2015-07-12 07:41:00"
"4546","20155901015947-373",2,"2015-07-11 11:53:00",1436640780,"C0",285480,1436926260,"2015-07-14 19:11:00"
"2280","20154306044342-841",2,"2015-07-11 12:27:00",1436642820,"C5",52080,1436694900,"2015-07-12 02:55:00"
"3872","20151807041826-31",1,"2015-07-11 13:34:00",1436646840,"C4",167880,1436814720,"2015-07-13 12:12:00"
"4129","20154510104522-927",1,"2015-07-11 13:48:00",1436647680,"C2",97380,1436745060,"2015-07-12 16:51:00"
"5323","20150905040910-240",3,"2015-07-11 14:11:00",1436649060,"C5",255660,1436904720,"2015-07-14 13:12:00"
"724","20154922024915-450",3,"2015-07-11 14:17:00",1436649420,"C4",234240,1436883660,"2015-07-14 07:21:00"
"5264","20155509105541-792",1,"2015-07-11 14:31:00",1436650260,"C7",92880,1436743140,"2015-07-12 16:19:00"
"4701","20151008091003-541",1,"2015-07-11 15:00:00",1436652000,"C2",280200,1436932200,"2015-07-14 20:50:00"
"5448","20154801044816-267",2,"2015-07-11 16:08:00",1436656080,"C5",430800,1437086880,"2015-07-16 15:48:00"
"3203","20150707090744-193",2,"2015-07-11 16:52:00",1436658720,"C4",124500,1436783220,"2015-07-13 03:27:00"
"3220","20150307030320-55",3,"2015-07-11 17:11:00",1436659860,"C8",176640,1436836500,"2015-07-13 18:15:00"
"2583","20152902012912-255",3,"2015-07-11 17:14:00",1436660040,"C0",263700,1436923740,"2015-07-14 18:29:00"
"5814","20153606063624-577",3,"2015-07-11 17:41:00",1436661660,"C8",94380,1436756040,"2015-07-12 19:54:00"
"3415","20151905041959-420",2,"2015-07-11 17:55:00",1436662500,"C5",65520,1436728020,"2015-07-12 12:07:00"
"729","20151203121253-478",3,"2015-07-11 18:04:00",1436663040,"C2",89040,1436752080,"2015-07-12 18:48:00"
"5048","20151319101312-156",3,"2015-07-11 19:14:00",1436667240,"C8",276180,1436943420,"2015-07-14 23:57:00"
"3520","20152509112544-291",1,"2015-07-11 20:07:00",1436670420,"C7",102060,1436772480,"2015-07-13 00:28:00"
"1034","20155905045912-583",1,"2015-07-11 20:53:00",1436673180,"C6",88740,1436761920,"2015-07-12 21:32:00"
"5717","20150823040809-813",2,"2015-07-11 21:50:00",1436676600,"C8",787860,1437464460,"2015-07-21 00:41:00"
"6241","20150201020251-919",2,"2015-07-11 22:32:00",1436679120,"C2",447300,1437126420,"2015-07-17 02:47:00"
"6163","20150209060238-306",3,"2015-07-11 22:52:00",1436680320,"C2",116700,1436797020,"2015-07-13 07:17:00"
"1354","20154201074239-779",2,"2015-07-11 23:26:00",1436682360,"C5",115080,1436797440,"2015-07-13 07:24:00"
"2919","20151827081812-463",1,"2015-07-11 23:42:00",1436683320,"C4",180720,1436864040,"2015-07-14 01:54:00"
"2860","20155103015112-816",2,"2015-07-12 00:16:00",1436685360,"C8",145740,1436831100,"2015-07-13 16:45:00"
"5627","20150003090030-424",3,"2015-07-12 00:18:00",1436685480,"C4",373140,1437058620,"2015-07-16 07:57:00"
"3571","20155309115300-960",1,"2015-07-12 00:50:00",1436687400,"C0",73140,1436760540,"2015-07-12 21:09:00"
"6395","20154002074029-503",1,"2015-07-12 01:08:00",1436688480,"C5",105060,1436793540,"2015-07-13 06:19:00"
"1648","20150305030327-986",1,"2015-07-12 01:18:00",1436689080,"C3",1049100,1437738180,"2015-07-24 04:43:00"
"5849","20152308062330-627",3,"2015-07-12 01:20:00",1436689200,"C3",109140,1436798340,"2015-07-13 07:39:00"
"6345","20152420122429-39",2,"2015-07-12 01:52:00",1436691120,"C6",232860,1436923980,"2015-07-14 18:33:00"
"3333","20153029033050-443",3,"2015-07-12 01:56:00",1436691360,"C3",153480,1436844840,"2015-07-13 20:34:00"
"4310","20151008051030-28",1,"2015-07-12 02:24:00",1436693040,"C7",146220,1436839260,"2015-07-13 19:01:00"
"3713","20155409015439-148",1,"2015-07-12 02:26:00",1436693160,"C3",108960,1436802120,"2015-07-13 08:42:00"
"108","20151104121158-643",2,"2015-07-12 02:51:00",1436694660,"C2",406200,1437100860,"2015-07-16 19:41:00"
"6546","20154829104840-718",1,"2015-07-12 03:20:00",1436696400,"C8",548160,1437244560,"2015-07-18 11:36:00"
"512","20150103040138-632",1,"2015-07-12 04:06:00",1436699160,"C8",146940,1436846100,"2015-07-13 20:55:00"
"3504","20150606110611-539",1,"2015-07-12 04:58:00",1436702280,"C7",248160,1436950440,"2015-07-15 01:54:00"
"3785","20153605113620-487",1,"2015-07-12 06:15:00",1436706900,"C2",195180,1436902080,"2015-07-14 12:28:00"
"5321","20150405040445-909",2,"2015-07-12 06:28:00",1436707680,"C5",71280,1436778960,"2015-07-13 02:16:00"
"2694","20150730080701-11",2,"2015-07-12 06:37:00",1436708220,"C5",515700,1437223920,"2015-07-18 05:52:00"
"3773","20152004062054-876",1,"2015-07-12 07:39:00",1436711940,"C4",695940,1437407880,"2015-07-20 08:58:00"
"4672","20152009082025-752",1,"2015-07-12 09:46:00",1436719560,"C8",132180,1436851740,"2015-07-13 22:29:00"
"166","20151329011319-87",1,"2015-07-12 09:48:00",1436719680,"C5",158700,1436878380,"2015-07-14 05:53:00"
"547","20153708023749-220",1,"2015-07-12 09:53:00",1436719980,"C7",164280,1436884260,"2015-07-14 07:31:00"
"3386","20155407095445-308",1,"2015-07-12 09:54:00",1436720040,"C7",216000,1436936040,"2015-07-14 21:54:00"
"3771","20152206032259-605",2,"2015-07-12 10:10:00",1436721000,"C0",249840,1436970840,"2015-07-15 07:34:00"
"1430","20152804012816-125",2,"2015-07-12 10:14:00",1436721240,"C8",339780,1437061020,"2015-07-16 08:37:00"
"3200","20151511071529-602",2,"2015-07-12 10:27:00",1436722020,"C6",97920,1436819940,"2015-07-13 13:39:00"
"5297","20155517095518-749",1,"2015-07-12 12:27:00",1436729220,"C3",271140,1437000360,"2015-07-15 15:46:00"
"4069","20155803085804-911",3,"2015-07-12 12:32:00",1436729520,"C3",112920,1436842440,"2015-07-13 19:54:00"
"4150","20154530114544-776",1,"2015-07-12 14:22:00",1436736120,"C4",149460,1436885580,"2015-07-14 07:53:00"
"5296","20154827114820-401",1,"2015-07-12 14:45:00",1436737500,"C8",186660,1436924160,"2015-07-14 18:36:00"
"1079","20152030062014-252",2,"2015-07-12 14:58:00",1436738280,"C4",533940,1437272220,"2015-07-18 19:17:00"
"2273","20155205015233-851",3,"2015-07-12 15:07:00",1436738820,"C2",609300,1437348120,"2015-07-19 16:22:00"
"2339","20151808021841-200",2,"2015-07-12 15:12:00",1436739120,"C8",174420,1436913540,"2015-07-14 15:39:00"
"4924","20153403063427-228",3,"2015-07-12 15:31:00",1436740260,"C4",269940,1437010200,"2015-07-15 18:30:00"
"2813","20153707023747-858",1,"2015-07-12 15:52:00",1436741520,"C4",145500,1436887020,"2015-07-14 08:17:00"
"4777","20150515020535-533",1,"2015-07-12 16:02:00",1436742120,"C2",334260,1437076380,"2015-07-16 12:53:00"
"672","20151111041119-158",1,"2015-07-12 16:09:00",1436742540,"C0",86280,1436828820,"2015-07-13 16:07:00"
"558","20150911050916-197",1,"2015-07-12 16:25:00",1436743500,"C2",83760,1436827260,"2015-07-13 15:41:00"
"5989","20153504013535-186",1,"2015-07-12 17:11:00",1436746260,"C6",88020,1436834280,"2015-07-13 17:38:00"
"4206","20153208083240-926",3,"2015-07-12 17:56:00",1436748960,"C7",1485720,1438234680,"2015-07-29 22:38:00"
"3064","20153206103213-613",1,"2015-07-12 18:48:00",1436752080,"C4",68520,1436820600,"2015-07-13 13:50:00"
"3573","20153910063929-445",1,"2015-07-12 19:28:00",1436754480,"C6",218940,1436973420,"2015-07-15 08:17:00"
"1623","20151410081443-694",3,"2015-07-12 19:42:00",1436755320,"C5",107040,1436862360,"2015-07-14 01:26:00"
"5924","20155904075953-519",2,"2015-07-12 19:47:00",1436755620,"C8",366840,1437122460,"2015-07-17 01:41:00"
"3657","20151326111319-353",1,"2015-07-12 21:12:00",1436760720,"C8",202620,1436963340,"2015-07-15 05:29:00"
"1150","20154030104055-168",3,"2015-07-12 21:34:00",1436762040,"C2",538020,1437300060,"2015-07-19 03:01:00"
"6531","20150010040037-125",1,"2015-07-12 21:38:00",1436762280,"C5",96540,1436858820,"2015-07-14 00:27:00"
"1282","20153005113023-61",2,"2015-07-12 22:26:00",1436765160,"C4",80520,1436845680,"2015-07-13 20:48:00"
"4185","20153110063138-887",2,"2015-07-12 22:55:00",1436766900,"C4",115920,1436882820,"2015-07-14 07:07:00"
"2778","20155502115525-896",3,"2015-07-12 23:07:00",1436767620,"C3",113040,1436880660,"2015-07-14 06:31:00"
"3825","20155304095308-767",1,"2015-07-12 23:45:00",1436769900,"C0",370560,1437140460,"2015-07-17 06:41:00"
"542","20153313043332-986",1,"2015-07-12 23:48:00",1436770080,"C0",843900,1437613980,"2015-07-22 18:13:00"
"4989","20155708025745-242",1,"2015-07-12 23:50:00",1436770200,"C5",53940,1436824140,"2015-07-13 14:49:00"
"2159","20154504014517-802",2,"2015-07-13 00:25:00",1436772300,"C6",91200,1436863500,"2015-07-14 01:45:00"
"4841","20154423124442-224",2,"2015-07-13 00:33:00",1436772780,"C7",623220,1437396000,"2015-07-20 05:40:00"
"1771","20155511045543-118",2,"2015-07-13 00:53:00",1436773980,"C7",57540,1436831520,"2015-07-13 16:52:00"
"5143","20153805053836-382",1,"2015-07-13 00:56:00",1436774160,"C4",315540,1437089700,"2015-07-16 16:35:00"
"4411","20151525101516-848",2,"2015-07-13 01:43:00",1436776980,"C4",190560,1436967540,"2015-07-15 06:39:00"
"3799","20155602045653-926",1,"2015-07-13 02:00:00",1436778000,"C5",436080,1437214080,"2015-07-18 03:08:00"
"4592","20154608064621-71",1,"2015-07-13 02:10:00",1436778600,"C5",207720,1436986320,"2015-07-15 11:52:00"
"5562","20150418070414-573",2,"2015-07-13 02:11:00",1436778660,"C7",306060,1437084720,"2015-07-16 15:12:00"
"5664","20152711112746-346",2,"2015-07-13 02:11:00",1436778660,"C7",69720,1436848380,"2015-07-13 21:33:00"
"4572","20152927032921-834",1,"2015-07-13 02:15:00",1436778900,"C2",190680,1436969580,"2015-07-15 07:13:00"
"3755","20154925044945-414",1,"2015-07-13 02:25:00",1436779500,"C7",167040,1436946540,"2015-07-15 00:49:00"
"5813","20155918055936-835",1,"2015-07-13 02:50:00",1436781000,"C5",300780,1437081780,"2015-07-16 14:23:00"
"286","20153504103503-465",1,"2015-07-13 02:53:00",1436781180,"C5",374940,1437156120,"2015-07-17 11:02:00"
"6043","20152711092730-427",3,"2015-07-13 03:03:00",1436781780,"C8",74880,1436856660,"2015-07-13 23:51:00"
"4796","20150502120548-840",2,"2015-07-13 04:31:00",1436787060,"C4",461580,1437248640,"2015-07-18 12:44:00"
"4257","20152004102015-754",1,"2015-07-13 05:00:00",1436788800,"C5",379200,1437168000,"2015-07-17 14:20:00"
"3834","20151308011359-158",2,"2015-07-13 05:09:00",1436789340,"C8",201480,1436990820,"2015-07-15 13:07:00"
"4352","20152404042428-569",1,"2015-07-13 05:14:00",1436789640,"C8",147480,1436937120,"2015-07-14 22:12:00"
"1629","20152712122737-855",1,"2015-07-13 06:21:00",1436793660,"C6",442740,1437236400,"2015-07-18 09:20:00"
"360","20155811045827-264",3,"2015-07-13 06:24:00",1436793840,"C3",134760,1436928600,"2015-07-14 19:50:00"
"2200","20154603024631-872",3,"2015-07-13 06:46:00",1436795160,"C4",278400,1437073560,"2015-07-16 12:06:00"
"2888","20152827092833-950",2,"2015-07-13 06:58:00",1436795880,"C4",196200,1436992080,"2015-07-15 13:28:00"
"2118","20150611020620-822",3,"2015-07-13 07:08:00",1436796480,"C8",73860,1436870340,"2015-07-14 03:39:00"
"1778","20150209010259-697",1,"2015-07-13 07:17:00",1436797020,"C8",64980,1436862000,"2015-07-14 01:20:00"
"4674","20151306121351-539",1,"2015-07-13 07:41:00",1436798460,"C4",588480,1437386940,"2015-07-20 03:09:00"
"2170","20152703112748-47",2,"2015-07-13 07:57:00",1436799420,"C5",283800,1437083220,"2015-07-16 14:47:00"
"3884","20151504091530-898",2,"2015-07-13 08:11:00",1436800260,"C4",96720,1436896980,"2015-07-14 11:03:00"
"2551","20152805062805-519",1,"2015-07-13 09:02:00",1436803320,"C2",350220,1437153540,"2015-07-17 10:19:00"
"3548","20151527081514-392",1,"2015-07-13 09:22:00",1436804520,"C7",198060,1437002580,"2015-07-15 16:23:00"
"5533","20154904124934-601",1,"2015-07-13 09:29:00",1436804940,"C4",95700,1436900640,"2015-07-14 12:04:00"
"4338","20150311090356-344",3,"2015-07-13 10:25:00",1436808300,"C8",88860,1436897160,"2015-07-14 11:06:00"
"4915","20154430064432-451",2,"2015-07-13 10:54:00",1436810040,"C8",227640,1437037680,"2015-07-16 02:08:00"
"4345","20152506042511-712",2,"2015-07-13 11:37:00",1436812620,"C2",397440,1437210060,"2015-07-18 02:01:00"
"683","20150211080249-753",2,"2015-07-13 12:06:00",1436814360,"C6",187440,1437001800,"2015-07-15 16:10:00"
"2746","20155510025531-344",2,"2015-07-13 12:24:00",1436815440,"C2",250140,1437065580,"2015-07-16 09:53:00"
"1724","20153811083856-28",1,"2015-07-13 13:12:00",1436818320,"C5",94620,1436912940,"2015-07-14 15:29:00"
"5917","20152405052406-500",3,"2015-07-13 13:12:00",1436818320,"C5",338040,1437156360,"2015-07-17 11:06:00"
"2768","20154311084343-102",3,"2015-07-13 13:29:00",1436819340,"C5",94980,1436914320,"2015-07-14 15:52:00"
"979","20155309065327-597",1,"2015-07-13 13:40:00",1436820000,"C4",370020,1437190020,"2015-07-17 20:27:00"
"1243","20153304063341-413",3,"2015-07-13 14:17:00",1436822220,"C4",100680,1436922900,"2015-07-14 18:15:00"
"2738","20150211030246-951",3,"2015-07-13 14:58:00",1436824680,"C8",86280,1436910960,"2015-07-14 14:56:00"
"2260","20150427020450-544",2,"2015-07-13 15:46:00",1436827560,"C2",694260,1437521820,"2015-07-21 16:37:00"
"309","20154911124924-532",1,"2015-07-13 16:13:00",1436829180,"C3",61680,1436890860,"2015-07-14 09:21:00"
"2428","20150911080900-458",3,"2015-07-13 16:33:00",1436830380,"C3",203040,1437033420,"2015-07-16 00:57:00"
"5993","20153001073008-682",3,"2015-07-13 16:54:00",1436831640,"C7",535320,1437366960,"2015-07-19 21:36:00"
"546","20155504075511-773",1,"2015-07-13 17:33:00",1436833980,"C8",116040,1436950020,"2015-07-15 01:47:00"
"6421","20152706122712-540",2,"2015-07-13 17:55:00",1436835300,"C3",78060,1436913360,"2015-07-14 15:36:00"
"3754","20150301040355-981",1,"2015-07-13 17:59:00",1436835540,"C5",521880,1437357420,"2015-07-19 18:57:00"
"207","20155311125300-290",1,"2015-07-13 18:27:00",1436837220,"C8",96420,1436933640,"2015-07-14 21:14:00"
"217","20151005071024-452",1,"2015-07-13 18:44:00",1436838240,"C5",366420,1437204660,"2015-07-18 00:31:00"
"2323","20155812065819-311",1,"2015-07-13 19:06:00",1436839560,"C6",130080,1436969640,"2015-07-15 07:14:00"
"1072","20155228015245-135",2,"2015-07-13 19:55:00",1436842500,"C3",439260,1437281760,"2015-07-18 21:56:00"
"3661","20151106051115-506",3,"2015-07-13 21:30:00",1436848200,"C3",88620,1436936820,"2015-07-14 22:07:00"
"3860","20152810052855-807",1,"2015-07-13 21:47:00",1436849220,"C3",274740,1437123960,"2015-07-17 02:06:00"
"3901","20154712124711-992",2,"2015-07-13 21:49:00",1436849340,"C6",118920,1436968260,"2015-07-15 06:51:00"
"5543","20150405100402-510",1,"2015-07-13 22:06:00",1436850360,"C0",734520,1437584880,"2015-07-22 10:08:00"
"4147","20155812125816-703",3,"2015-07-13 22:37:00",1436852220,"C0",121140,1436973360,"2015-07-15 08:16:00"
"5838","20150510050547-65",1,"2015-07-13 23:09:00",1436854140,"C8",140520,1436994660,"2015-07-15 14:11:00"
"3690","20153711053702-226",3,"2015-07-13 23:27:00",1436855220,"C5",96900,1436952120,"2015-07-15 02:22:00"
"550","20151611051619-74",1,"2015-07-13 23:40:00",1436856000,"C4",97920,1436953920,"2015-07-15 02:52:00"
"849","20155107125107-821",1,"2015-07-14 00:00:00",1436857200,"C5",186180,1437043380,"2015-07-16 03:43:00"
"599","20155003015007-18",1,"2015-07-14 01:00:00",1436860800,"C8",452100,1437312900,"2015-07-19 06:35:00"
"5819","20155810065842-768",2,"2015-07-14 01:34:00",1436862840,"C2",108720,1436971560,"2015-07-15 07:46:00"
"5607","20150905010927-978",2,"2015-07-14 01:40:00",1436863200,"C5",105180,1436968380,"2015-07-15 06:53:00"
"5440","20153016063038-967",2,"2015-07-14 02:00:00",1436864400,"C6",400500,1437264900,"2015-07-18 17:15:00"
"5493","20153807083832-588",3,"2015-07-14 02:26:00",1436865960,"C2",194160,1437060120,"2015-07-16 08:22:00"
"6129","20150603060632-383",2,"2015-07-14 02:40:00",1436866800,"C5",469020,1437335820,"2015-07-19 12:57:00"
"5320","20151110091107-217",1,"2015-07-14 02:55:00",1436867700,"C5",161520,1437029220,"2015-07-15 23:47:00"
"1797","20155811085816-277",2,"2015-07-14 03:12:00",1436868720,"C4",119220,1436987940,"2015-07-15 12:19:00"
"3263","20152711082701-441",1,"2015-07-14 03:15:00",1436868900,"C8",120240,1436989140,"2015-07-15 12:39:00"
"1208","20155712055713-620",1,"2015-07-14 03:39:00",1436870340,"C4",60660,1436931000,"2015-07-14 20:30:00"
"2307","20152401082424-321",1,"2015-07-14 04:09:00",1436872140,"C8",221580,1437093720,"2015-07-16 17:42:00"
"328","20153606123639-984",3,"2015-07-14 04:14:00",1436872440,"C7",94440,1436966880,"2015-07-15 06:28:00"
"2483","20150215110234-930",2,"2015-07-14 04:17:00",1436872620,"C7",275700,1437148320,"2015-07-17 08:52:00"
"235","20155302055357-472",1,"2015-07-14 05:56:00",1436878560,"C5",331260,1437209820,"2015-07-18 01:57:00"
"1726","20150904030958-830",1,"2015-07-14 06:45:00",1436881500,"C4",104220,1436985720,"2015-07-15 11:42:00"
"4316","20150203060230-10",1,"2015-07-14 07:06:00",1436882760,"C7",136320,1437019080,"2015-07-15 20:58:00"
"529","20154710124711-907",3,"2015-07-14 07:09:00",1436882940,"C3",416760,1437299700,"2015-07-19 02:55:00"
"3587","20153013053056-41",1,"2015-07-14 07:17:00",1436883420,"C0",49620,1436933040,"2015-07-14 21:04:00"
"557","20150810090808-3",2,"2015-07-14 07:35:00",1436884500,"C3",340020,1437224520,"2015-07-18 06:02:00"
"5656","20154405094402-820",1,"2015-07-14 07:36:00",1436884560,"C2",384960,1437269520,"2015-07-18 18:32:00"
"4290","20153712053742-911",2,"2015-07-14 07:57:00",1436885820,"C5",69000,1436954820,"2015-07-15 03:07:00"
"2332","20153701113704-354",1,"2015-07-14 08:03:00",1436886180,"C4",555180,1437441360,"2015-07-20 18:16:00"
"4568","20153619073613-656",2,"2015-07-14 08:06:00",1436886360,"C0",1080900,1437967260,"2015-07-26 20:21:00"
"2792","20150503040507-176",1,"2015-07-14 08:59:00",1436889540,"C0",308280,1437197820,"2015-07-17 22:37:00"
"1886","20151209031242-452",1,"2015-07-14 09:09:00",1436890140,"C6",410220,1437300360,"2015-07-19 03:06:00"
"2101","20153312053318-51",2,"2015-07-14 09:36:00",1436891760,"C4",144180,1437035940,"2015-07-16 01:39:00"
"865","20150110090142-745",2,"2015-07-14 09:51:00",1436892660,"C0",174300,1437066960,"2015-07-16 10:16:00"
"5601","20155209015212-409",3,"2015-07-14 09:56:00",1436892960,"C2",417840,1437310800,"2015-07-19 06:00:00"
"677","20154306084336-628",2,"2015-07-14 09:57:00",1436893020,"C3",1643820,1438536840,"2015-08-02 10:34:00"
"520","20154007094039-158",1,"2015-07-14 10:19:00",1436894340,"C4",457020,1437351360,"2015-07-19 17:16:00"
"374","20155713105709-55",2,"2015-07-14 10:46:00",1436895960,"C0",85740,1436981700,"2015-07-15 10:35:00"
"2542","20151506091506-255",2,"2015-07-14 10:57:00",1436896620,"C1",548220,1437444840,"2015-07-20 19:14:00"
"499","20153508083547-956",1,"2015-07-14 11:39:00",1436899140,"C0",264720,1437163860,"2015-07-17 13:11:00"
"305","20154705114743-724",2,"2015-07-14 12:14:00",1436901240,"C4",259740,1437160980,"2015-07-17 12:23:00"
"5510","20153013023047-224",2,"2015-07-14 12:14:00",1436901240,"C6",333780,1437235020,"2015-07-18 08:57:00"
"5625","20154010034018-964",3,"2015-07-14 12:43:00",1436902980,"C2",334980,1437237960,"2015-07-18 09:46:00"
"369","20155604125644-698",2,"2015-07-14 12:44:00",1436903040,"C5",431640,1437334680,"2015-07-19 12:38:00"
"988","20152921092953-210",2,"2015-07-14 13:05:00",1436904300,"C2",250020,1437154320,"2015-07-17 10:32:00"
"5620","20150808030815-401",1,"2015-07-14 13:08:00",1436904480,"C4",63900,1436968380,"2015-07-15 06:53:00"
"3940","20153410103418-726",2,"2015-07-14 13:36:00",1436906160,"C0",178260,1437084420,"2015-07-16 15:07:00"
"1040","20150005020044-437",1,"2015-07-14 13:50:00",1436907000,"C4",111000,1437018000,"2015-07-15 20:40:00"
"4559","20153908063905-670",3,"2015-07-14 14:23:00",1436908980,"C4",273120,1437182100,"2015-07-17 18:15:00"
"3462","20151321061336-628",2,"2015-07-14 14:33:00",1436909580,"C5",1008600,1437918180,"2015-07-26 06:43:00"
"2711","20152508032527-438",1,"2015-07-14 14:43:00",1436910180,"C6",85980,1436996160,"2015-07-15 14:36:00"
"5886","20154206094218-555",1,"2015-07-14 15:28:00",1436912880,"C2",711960,1437624840,"2015-07-22 21:14:00"
"2544","20153805103821-658",3,"2015-07-14 15:43:00",1436913780,"C5",113700,1437027480,"2015-07-15 23:18:00"
"5083","20154912054955-518",1,"2015-07-14 15:59:00",1436914740,"C3",83100,1436997840,"2015-07-15 15:04:00"
"4800","20150926090945-943",3,"2015-07-14 16:13:00",1436915580,"C5",197580,1437113160,"2015-07-16 23:06:00"
"3432","20154811104853-331",3,"2015-07-14 17:57:00",1436921820,"C4",284940,1437206760,"2015-07-18 01:06:00"
"6057","20150807090832-325",3,"2015-07-14 18:21:00",1436923260,"C8",91140,1437014400,"2015-07-15 19:40:00"
"3464","20155713045735-33",1,"2015-07-14 18:50:00",1436925000,"C2",93180,1437018180,"2015-07-15 20:43:00"
"1804","20155423105427-757",1,"2015-07-14 19:18:00",1436926680,"C3",614880,1437541560,"2015-07-21 22:06:00"
"3994","20152729042736-714",2,"2015-07-14 19:54:00",1436928840,"C0",436140,1437364980,"2015-07-19 21:03:00"
"731","20152813082850-252",1,"2015-07-14 20:21:00",1436930460,"C6",129180,1437059640,"2015-07-16 08:14:00"
"428","20151908071935-977",1,"2015-07-14 20:47:00",1436932020,"C8",283440,1437215460,"2015-07-18 03:31:00"
"6053","20154430034436-879",2,"2015-07-14 21:41:00",1436935260,"C7",175860,1437111120,"2015-07-16 22:32:00"
"638","20153712013720-181",3,"2015-07-14 22:20:00",1436937600,"C6",204180,1437141780,"2015-07-17 07:03:00"
"3461","20150827070855-530",3,"2015-07-14 22:23:00",1436937780,"C8",304740,1437242520,"2015-07-18 11:02:00"
"378","20151008091058-366",1,"2015-07-14 22:28:00",1436938080,"C6",94380,1437032460,"2015-07-16 00:41:00"
"1872","20151511041558-368",1,"2015-07-14 22:55:00",1436939700,"C8",141600,1437081300,"2015-07-16 14:15:00"
"335","20152408122403-570",1,"2015-07-14 23:20:00",1436941200,"C5",79680,1437020880,"2015-07-15 21:28:00"
"6434","20150408120450-64",1,"2015-07-14 23:22:00",1436941320,"C6",93180,1437034500,"2015-07-16 01:15:00"
"3790","20152104072145-815",1,"2015-07-14 23:47:00",1436942820,"C0",131880,1437074700,"2015-07-16 12:25:00"
"6075","20153909013957-769",1,"2015-07-14 23:59:00",1436943540,"C8",234600,1437178140,"2015-07-17 17:09:00"
"1142","20153613013647-912",3,"2015-07-15 00:06:00",1436943960,"C5",62100,1437006060,"2015-07-15 17:21:00"
"6351","20150704050743-697",1,"2015-07-15 00:35:00",1436945700,"C7",445440,1437391140,"2015-07-20 04:19:00"
"2244","20153317013317-798",2,"2015-07-15 00:36:00",1436945760,"C4",338940,1437284700,"2015-07-18 22:45:00"
"1815","20153006063005-968",2,"2015-07-15 01:33:00",1436949180,"C4",108540,1437057720,"2015-07-16 07:42:00"
"3407","20150220040211-856",1,"2015-07-15 02:10:00",1436951400,"C4",263760,1437215160,"2015-07-18 03:26:00"
"2016","20152705092735-661",1,"2015-07-15 02:12:00",1436951520,"C4",119700,1437071220,"2015-07-16 11:27:00"
"3011","20150713020758-120",2,"2015-07-15 02:33:00",1436952780,"C5",65580,1437018360,"2015-07-15 20:46:00"
"6062","20152404072411-614",1,"2015-07-15 02:44:00",1436953440,"C2",116700,1437070140,"2015-07-16 11:09:00"
"1240","20150108100110-534",2,"2015-07-15 03:31:00",1436956260,"C8",290700,1437246960,"2015-07-18 12:16:00"
"6172","20151611111649-796",1,"2015-07-15 04:00:00",1436958000,"C8",159720,1437117720,"2015-07-17 00:22:00"
"5912","20152313032302-271",2,"2015-07-15 04:47:00",1436960820,"C4",67320,1437028140,"2015-07-15 23:29:00"
"4632","20154923014909-680",3,"2015-07-15 05:34:00",1436963640,"C5",623700,1437587340,"2015-07-22 10:49:00"
"3440","20150905070939-279",1,"2015-07-15 05:39:00",1436963940,"C3",286200,1437250140,"2015-07-18 13:09:00"
"4603","20154519024544-322",2,"2015-07-15 06:09:00",1436965740,"C4",201300,1437167040,"2015-07-17 14:04:00"
"4947","20153010083042-172",2,"2015-07-15 06:14:00",1436966040,"C4",211920,1437177960,"2015-07-17 17:06:00"
"1019","20152322112332-133",1,"2015-07-15 06:26:00",1436966760,"C3",281340,1437248100,"2015-07-18 12:35:00"
"4769","20152929022956-198",1,"2015-07-15 06:30:00",1436967000,"C0",193380,1437160380,"2015-07-17 12:13:00"
"3640","20153112063157-147",3,"2015-07-15 06:40:00",1436967600,"C5",86580,1437054180,"2015-07-16 06:43:00"
"5692","20153507043529-286",1,"2015-07-15 07:01:00",1436968860,"C3",656760,1437625620,"2015-07-22 21:27:00"
"3291","20153514073546-814",3,"2015-07-15 07:04:00",1436969040,"C0",84540,1437053580,"2015-07-16 06:33:00"
"610","20152411082436-105",3,"2015-07-15 07:06:00",1436969160,"C0",340920,1437310080,"2015-07-19 05:48:00"
"4363","20151305041331-383",1,"2015-07-15 07:33:00",1436970780,"C8",684960,1437655740,"2015-07-23 05:49:00"
"1642","20152009022052-994",2,"2015-07-15 08:15:00",1436973300,"C8",99300,1437072600,"2015-07-16 11:50:00"
"2774","20152705112730-412",3,"2015-07-15 08:15:00",1436973300,"C2",106560,1437079860,"2015-07-16 13:51:00"
"3877","20153218123229-36",2,"2015-07-15 08:20:00",1436973600,"C5",772560,1437746160,"2015-07-24 06:56:00"
"4306","20151709081703-888",2,"2015-07-15 08:41:00",1436974860,"C8",259920,1437234780,"2015-07-18 08:53:00"
"2396","20155221025244-122",1,"2015-07-15 09:22:00",1436977320,"C4",684600,1437661920,"2015-07-23 07:32:00"
"4600","20151909021907-531",2,"2015-07-15 09:24:00",1436977440,"C8",100140,1437077580,"2015-07-16 13:13:00"
"5677","20153230053236-758",2,"2015-07-15 10:04:00",1436979840,"C5",158640,1437138480,"2015-07-17 06:08:00"
"4","20153111063125-468",2,"2015-07-15 10:13:00",1436980380,"C5",179460,1437159840,"2015-07-17 12:04:00"
"4687","20150629060651-645",3,"2015-07-15 10:48:00",1436982480,"C5",466440,1437448920,"2015-07-20 20:22:00"
"5172","20152605062636-836",1,"2015-07-15 10:58:00",1436983080,"C8",440160,1437423240,"2015-07-20 13:14:00"
"2677","20150524110507-879",2,"2015-07-15 11:14:00",1436984040,"C3",604980,1437589020,"2015-07-22 11:17:00"
"3549","20154409044439-912",3,"2015-07-15 11:58:00",1436986680,"C5",250620,1437237300,"2015-07-18 09:35:00"
"5804","20152811092825-833",1,"2015-07-15 12:05:00",1436987100,"C2",355020,1437342120,"2015-07-19 14:42:00"
"1433","20154613064658-613",1,"2015-07-15 12:08:00",1436987280,"C7",96060,1437083340,"2015-07-16 14:49:00"
"1234","20151301111308-417",1,"2015-07-15 12:44:00",1436989440,"C2",173580,1437163020,"2015-07-17 12:57:00"
"4870","20154209054227-699",1,"2015-07-15 12:44:00",1436989440,"C5",250260,1437239700,"2015-07-18 10:15:00"
"1173","20152511102520-964",3,"2015-07-15 13:09:00",1436990940,"C7",177720,1437168660,"2015-07-17 14:31:00"
"4942","20155307085318-512",3,"2015-07-15 13:09:00",1436990940,"C0",88320,1437079260,"2015-07-16 13:41:00"
"836","20152613022643-189",1,"2015-07-15 13:28:00",1436992080,"C0",84660,1437076740,"2015-07-16 12:59:00"
"16","20152614052608-658",1,"2015-07-15 13:30:00",1436992200,"C4",72240,1437064440,"2015-07-16 09:34:00"
"3416","20153502063540-65",1,"2015-07-15 13:32:00",1436992320,"C4",382740,1437375060,"2015-07-19 23:51:00"
"2603","20151001041004-853",3,"2015-07-15 14:40:00",1436996400,"C8",602100,1437598500,"2015-07-22 13:55:00"
"2821","20151327011349-700",2,"2015-07-15 14:51:00",1436997060,"C5",780540,1437777600,"2015-07-24 15:40:00"
"6249","20151911091902-88",3,"2015-07-15 15:43:00",1437000180,"C4",122880,1437123060,"2015-07-17 01:51:00"
"4945","20154401034422-998",2,"2015-07-15 16:53:00",1437004380,"C5",404580,1437408960,"2015-07-20 09:16:00"
"4586","20151709091702-944",1,"2015-07-15 17:01:00",1437004860,"C4",727080,1437731940,"2015-07-24 02:59:00"
"4811","20155922015952-462",1,"2015-07-15 17:39:00",1437007140,"C8",400080,1437407220,"2015-07-20 08:47:00"
"1442","20152908092908-702",1,"2015-07-15 18:14:00",1437009240,"C5",90900,1437100140,"2015-07-16 19:29:00"
"2403","20155009075029-871",2,"2015-07-15 18:48:00",1437011280,"C7",278940,1437290220,"2015-07-19 00:17:00"
"3692","20155311035305-535",1,"2015-07-15 19:11:00",1437012660,"C4",178740,1437191400,"2015-07-17 20:50:00"
"4404","20152811072856-634",1,"2015-07-15 19:24:00",1437013440,"C4",194280,1437207720,"2015-07-18 01:22:00"
"3405","20151501021548-648",1,"2015-07-15 20:26:00",1437017160,"C4",175980,1437193140,"2015-07-17 21:19:00"
"1563","20154108114121-535",1,"2015-07-15 21:05:00",1437019500,"C6",538440,1437557940,"2015-07-22 02:39:00"
"4447","20154722034718-115",2,"2015-07-15 21:26:00",1437020760,"C2",669180,1437689940,"2015-07-23 15:19:00"
"1298","20150011120023-724",1,"2015-07-15 21:32:00",1437021120,"C5",189960,1437211080,"2015-07-18 02:18:00"
"2514","20152312092334-13",3,"2015-07-15 22:28:00",1437024480,"C6",306300,1437330780,"2015-07-19 11:33:00"
"5476","20151109071101-943",1,"2015-07-15 22:39:00",1437025140,"C5",287040,1437312180,"2015-07-19 06:23:00"
"4877","20151414021427-933",1,"2015-07-15 22:52:00",1437025920,"C2",117480,1437143400,"2015-07-17 07:30:00"
"1178","20154611044614-561",2,"2015-07-15 22:54:00",1437026040,"C3",45960,1437072000,"2015-07-16 11:40:00"
"6216","20152226122251-984",3,"2015-07-15 23:09:00",1437026940,"C5",240060,1437267000,"2015-07-18 17:50:00"
"2942","20154630124651-529",1,"2015-07-15 23:18:00",1437027480,"C3",166740,1437194220,"2015-07-17 21:37:00"
"6187","20155002125000-291",1,"2015-07-15 23:54:00",1437029640,"C0",145380,1437175020,"2015-07-17 16:17:00"
"3802","20151114021156-85",1,"2015-07-16 01:11:00",1437034260,"C6",453000,1437487260,"2015-07-21 07:01:00"
"6210","20153302013336-618",1,"2015-07-16 02:14:00",1437038040,"C2",166980,1437205020,"2015-07-18 00:37:00"
"4432","20155708025739-913",1,"2015-07-16 03:19:00",1437041940,"C5",92760,1437134700,"2015-07-17 05:05:00"
"296","20152514102555-759",3,"2015-07-16 03:37:00",1437043020,"C8",74160,1437117180,"2015-07-17 00:13:00"
"2187","20152010022051-412",2,"2015-07-16 03:41:00",1437043260,"C3",160020,1437203280,"2015-07-18 00:08:00"
"4917","20153010023059-654",1,"2015-07-16 03:54:00",1437044040,"C8",240120,1437284160,"2015-07-18 22:36:00"
"4535","20153125123107-117",2,"2015-07-16 04:25:00",1437045900,"C2",595080,1437640980,"2015-07-23 01:43:00"
"6393","20152008092051-845",2,"2015-07-16 04:50:00",1437047400,"C5",337500,1437384900,"2015-07-20 02:35:00"
"1925","20154205064237-776",2,"2015-07-16 05:10:00",1437048600,"C8",472440,1437521040,"2015-07-21 16:24:00"
"84","20152312122312-603",1,"2015-07-16 05:23:00",1437049380,"C0",970800,1438020180,"2015-07-27 11:03:00"
"772","20151106061100-410",1,"2015-07-16 05:23:00",1437049380,"C0",431640,1437481020,"2015-07-21 05:17:00"
"908","20153502053554-349",2,"2015-07-16 05:30:00",1437049800,"C8",233220,1437283020,"2015-07-18 22:17:00"
"5786","20150514010523-466",1,"2015-07-16 06:09:00",1437052140,"C2",73920,1437126060,"2015-07-17 02:41:00"
"5988","20150407090456-983",1,"2015-07-16 06:13:00",1437052380,"C3",109620,1437162000,"2015-07-17 12:40:00"
"801","20152408032428-524",1,"2015-07-16 06:27:00",1437053220,"C0",94140,1437147360,"2015-07-17 08:36:00"
"4734","20155809065829-220",2,"2015-07-16 06:51:00",1437054660,"C2",86340,1437141000,"2015-07-17 06:50:00"
"322","20150315030313-186",1,"2015-07-16 07:54:00",1437058440,"C3",60660,1437119100,"2015-07-17 00:45:00"
"1232","20154506054509-852",2,"2015-07-16 08:09:00",1437059340,"C7",92160,1437151500,"2015-07-17 09:45:00"
"577","20154303074351-681",1,"2015-07-16 08:31:00",1437060660,"C3",464760,1437525420,"2015-07-21 17:37:00"
"1838","20151617051603-789",1,"2015-07-16 08:34:00",1437060840,"C7",274920,1437335760,"2015-07-19 12:56:00"
"866","20155822125820-486",1,"2015-07-16 08:43:00",1437061380,"C0",686100,1437747480,"2015-07-24 07:18:00"
"2331","20151409111433-68",2,"2015-07-16 08:50:00",1437061800,"C3",298080,1437359880,"2015-07-19 19:38:00"
"5079","20150508050523-569",1,"2015-07-16 09:11:00",1437063060,"C7",331380,1437394440,"2015-07-20 05:14:00"
"6446","20155304065358-506",3,"2015-07-16 10:09:00",1437066540,"C7",524280,1437590820,"2015-07-22 11:47:00"
"5851","20155101075136-111",1,"2015-07-16 10:15:00",1437066900,"C5",163080,1437229980,"2015-07-18 07:33:00"
"680","20154310054327-591",1,"2015-07-16 10:47:00",1437068820,"C8",246720,1437315540,"2015-07-19 07:19:00"
"346","20150716030750-947",1,"2015-07-16 10:52:00",1437069120,"C7",368100,1437437220,"2015-07-20 17:07:00"
"2317","20155012085048-766",2,"2015-07-16 11:02:00",1437069720,"C5",176760,1437246480,"2015-07-18 12:08:00"
"2752","20151601031635-401",3,"2015-07-16 11:27:00",1437071220,"C7",183180,1437254400,"2015-07-18 14:20:00"
"1995","20154911054914-248",1,"2015-07-16 11:31:00",1437071460,"C2",409320,1437480780,"2015-07-21 05:13:00"
"962","20153428103417-553",2,"2015-07-16 11:40:00",1437072000,"C2",519720,1437591720,"2015-07-22 12:02:00"
"5238","20152014052009-210",2,"2015-07-16 11:46:00",1437072360,"C4",152760,1437225120,"2015-07-18 06:12:00"
"5954","20152008092020-195",3,"2015-07-16 12:32:00",1437075120,"C2",351360,1437426480,"2015-07-20 14:08:00"
"6047","20150024090008-901",1,"2015-07-16 13:20:00",1437078000,"C8",383280,1437461280,"2015-07-20 23:48:00"
"1611","20152730022758-606",1,"2015-07-16 13:49:00",1437079740,"C2",197160,1437276900,"2015-07-18 20:35:00"
"2736","20152411032440-684",1,"2015-07-16 15:20:00",1437085200,"C3",431760,1437516960,"2015-07-21 15:16:00"
"4256","20154201084214-252",1,"2015-07-16 15:21:00",1437085260,"C5",439980,1437525240,"2015-07-21 17:34:00"
"1508","20150605080621-713",3,"2015-07-16 15:51:00",1437087060,"C8",195660,1437282720,"2015-07-18 22:12:00"
"5505","20153214083255-828",2,"2015-07-16 16:28:00",1437089280,"C8",100680,1437189960,"2015-07-17 20:26:00"
"3593","20155617035626-878",3,"2015-07-16 16:44:00",1437090240,"C4",313560,1437403800,"2015-07-20 07:50:00"
"5125","20155629125653-788",2,"2015-07-16 16:45:00",1437090300,"C4",594420,1437684720,"2015-07-23 13:52:00"
"3954","20153311033321-730",1,"2015-07-16 17:00:00",1437091200,"C4",62460,1437153660,"2015-07-17 10:21:00"
"3208","20153708073726-600",2,"2015-07-16 17:43:00",1437093780,"C7",363780,1437457560,"2015-07-20 22:46:00"
"1980","20151214101217-551",1,"2015-07-16 17:54:00",1437094440,"C5",100260,1437194700,"2015-07-17 21:45:00"
"2183","20152307122306-159",3,"2015-07-16 18:34:00",1437096840,"C4",799860,1437896700,"2015-07-26 00:45:00"
"3310","20153208073235-389",2,"2015-07-16 18:47:00",1437097620,"C7",81300,1437178920,"2015-07-17 17:22:00"
"4055","20150830110807-384",1,"2015-07-16 18:54:00",1437098040,"C8",201480,1437299520,"2015-07-19 02:52:00"
"6176","20150810010834-148",2,"2015-07-16 19:04:00",1437098640,"C5",269880,1437368520,"2015-07-19 22:02:00"
"5727","20155824105804-483",2,"2015-07-16 20:08:00",1437102480,"C8",386760,1437489240,"2015-07-21 07:34:00"
"5527","20153404113438-674",2,"2015-07-16 20:24:00",1437103440,"C2",534300,1437637740,"2015-07-23 00:49:00"
"348","20153013023021-720",1,"2015-07-16 20:36:00",1437104160,"C4",140580,1437244740,"2015-07-18 11:39:00"
"2757","20155121035116-274",1,"2015-07-16 21:00:00",1437105600,"C4",311220,1437416820,"2015-07-20 11:27:00"
"4108","20153410073455-798",1,"2015-07-16 21:07:00",1437106020,"C5",189060,1437295080,"2015-07-19 01:38:00"
"3397","20154712014753-800",1,"2015-07-16 21:52:00",1437108720,"C8",74940,1437183660,"2015-07-17 18:41:00"
"5882","20153310023320-488",1,"2015-07-16 22:03:00",1437109380,"C7",60600,1437169980,"2015-07-17 14:53:00"
"740","20153814073818-418",1,"2015-07-16 22:30:00",1437111000,"C4",226320,1437337320,"2015-07-19 13:22:00"
"5377","20155705085712-420",1,"2015-07-16 23:02:00",1437112920,"C8",200220,1437313140,"2015-07-19 06:39:00"
"4031","20153917063943-246",1,"2015-07-16 23:09:00",1437113340,"C8",513000,1437626340,"2015-07-22 21:39:00"
"5482","20150024010014-301",2,"2015-07-17 00:00:00",1437116400,"C4",277200,1437393600,"2015-07-20 05:00:00"
"1353","20151911031933-491",1,"2015-07-17 00:01:00",1437116460,"C3",231660,1437348120,"2015-07-19 16:22:00"
"5848","20155122055116-333",1,"2015-07-17 00:42:00",1437118920,"C4",699420,1437818340,"2015-07-25 02:59:00"
"2628","20154408014459-479",2,"2015-07-17 01:19:00",1437121140,"C8",146580,1437267720,"2015-07-18 18:02:00"
"2811","20155515045550-909",1,"2015-07-17 02:05:00",1437123900,"C2",59700,1437183600,"2015-07-17 18:40:00"
"903","20151405111428-942",2,"2015-07-17 02:20:00",1437124800,"C6",167460,1437292260,"2015-07-19 00:51:00"
"2997","20153111043103-266",3,"2015-07-17 02:23:00",1437124980,"C3",58440,1437183420,"2015-07-17 18:37:00"
"6001","20155115055126-836",3,"2015-07-17 02:27:00",1437125220,"C8",58680,1437183900,"2015-07-17 18:45:00"
"666","20155514095514-716",1,"2015-07-17 02:49:00",1437126540,"C5",116820,1437243360,"2015-07-18 11:16:00"
"6246","20155324015326-739",2,"2015-07-17 03:27:00",1437128820,"C8",278520,1437407340,"2015-07-20 08:49:00"
"1977","20151210031224-723",2,"2015-07-17 03:46:00",1437129960,"C5",281820,1437411780,"2015-07-20 10:03:00"
"5915","20150811030814-454",2,"2015-07-17 04:08:00",1437131280,"C5",239400,1437370680,"2015-07-19 22:38:00"
"4109","20152303042327-304",1,"2015-07-17 04:50:00",1437133800,"C8",166860,1437300660,"2015-07-19 03:11:00"
"5840","20151206051246-156",1,"2015-07-17 05:05:00",1437134700,"C3",129540,1437264240,"2015-07-18 17:04:00"
"183","20154615084621-811",3,"2015-07-17 06:14:00",1437138840,"C5",81840,1437220680,"2015-07-18 04:58:00"
"4199","20150213020216-787",3,"2015-07-17 06:18:00",1437139080,"C2",317760,1437456840,"2015-07-20 22:34:00"
"2751","20150105040155-8",1,"2015-07-17 07:09:00",1437142140,"C8",502440,1437644580,"2015-07-23 02:43:00"
"1755","20152816082835-10",1,"2015-07-17 07:45:00",1437144300,"C4",83820,1437228120,"2015-07-18 07:02:00"
"3267","20153414073455-915",3,"2015-07-17 09:30:00",1437150600,"C4",266160,1437416760,"2015-07-20 11:26:00"
"2983","20155405055416-800",1,"2015-07-17 09:38:00",1437151080,"C5",503520,1437654600,"2015-07-23 05:30:00"
"3140","20155908035956-424",2,"2015-07-17 11:03:00",1437156180,"C2",94980,1437251160,"2015-07-18 13:26:00"
"1810","20155911125954-688",1,"2015-07-17 11:12:00",1437156720,"C7",73140,1437229860,"2015-07-18 07:31:00"
"4386","20151115041148-836",2,"2015-07-17 11:43:00",1437158580,"C8",78360,1437236940,"2015-07-18 09:29:00"
"229","20154113074143-823",1,"2015-07-17 13:32:00",1437165120,"C3",122220,1437287340,"2015-07-18 23:29:00"
"692","20154112094107-810",3,"2015-07-17 13:39:00",1437165540,"C6",446280,1437611820,"2015-07-22 17:37:00"
"1946","20153914023918-636",1,"2015-07-17 13:47:00",1437166020,"C0",256080,1437422100,"2015-07-20 12:55:00"
"4159","20153209073227-817",1,"2015-07-17 13:59:00",1437166740,"C4",102060,1437268800,"2015-07-18 18:20:00"
"1160","20154507034519-6",2,"2015-07-17 14:15:00",1437167700,"C8",171720,1437339420,"2015-07-19 13:57:00"
"1749","20154112014114-381",1,"2015-07-17 15:02:00",1437170520,"C6",202380,1437372900,"2015-07-19 23:15:00"
"4916","20155002015002-492",1,"2015-07-17 15:38:00",1437172680,"C5",434160,1437606840,"2015-07-22 16:14:00"
"6454","20150214070205-409",2,"2015-07-17 15:48:00",1437173280,"C4",290760,1437464040,"2015-07-21 00:34:00"
"2864","20152408102406-549",2,"2015-07-17 18:45:00",1437183900,"C5",269220,1437453120,"2015-07-20 21:32:00"
"5859","20152212112239-676",2,"2015-07-17 18:53:00",1437184380,"C4",65580,1437249960,"2015-07-18 13:06:00"
"5000","20153905083900-16",3,"2015-07-17 19:51:00",1437187860,"C4",359040,1437546900,"2015-07-21 23:35:00"
"2477","20153229033240-417",1,"2015-07-17 20:04:00",1437188640,"C5",196440,1437385080,"2015-07-20 02:38:00"
"4327","20153314043314-37",1,"2015-07-17 20:27:00",1437190020,"C2",409320,1437599340,"2015-07-22 14:09:00"
"5228","20153213013210-111",1,"2015-07-17 20:34:00",1437190440,"C4",185460,1437375900,"2015-07-20 00:05:00"
"4625","20152612032640-395",1,"2015-07-17 21:10:00",1437192600,"C2",56580,1437249180,"2015-07-18 12:53:00"
"3216","20152020062041-92",3,"2015-07-17 21:21:00",1437193260,"C2",340980,1437534240,"2015-07-21 20:04:00"
"863","20153415093431-204",2,"2015-07-17 22:06:00",1437195960,"C0",108960,1437304920,"2015-07-19 04:22:00"
"3708","20152716022735-871",1,"2015-07-17 22:15:00",1437196500,"C8",57240,1437253740,"2015-07-18 14:09:00"
"2921","20154409044423-907",1,"2015-07-17 22:23:00",1437196980,"C2",711540,1437908520,"2015-07-26 04:02:00"
"6313","20154404024426-337",2,"2015-07-17 22:36:00",1437197760,"C4",143940,1437341700,"2015-07-19 14:35:00"
"2135","20152507052543-844",2,"2015-07-17 22:57:00",1437199020,"C8",441960,1437640980,"2015-07-23 01:43:00"
"4952","20152614052641-115",1,"2015-07-18 00:44:00",1437205440,"C2",95160,1437300600,"2015-07-19 03:10:00"
"1660","20152729112721-705",2,"2015-07-18 01:03:00",1437206580,"C6",713760,1437920340,"2015-07-26 07:19:00"
"923","20154229014226-973",1,"2015-07-18 01:17:00",1437207420,"C8",319380,1437526800,"2015-07-21 18:00:00"
"3083","20154718034701-35",1,"2015-07-18 01:23:00",1437207780,"C7",362880,1437570660,"2015-07-22 06:11:00"
"2635","20152516122531-638",1,"2015-07-18 02:05:00",1437210300,"C5",67800,1437278100,"2015-07-18 20:55:00"
"2927","20152907052915-532",2,"2015-07-18 03:09:00",1437214140,"C0",128400,1437342540,"2015-07-19 14:49:00"
"1009","20152703072701-166",2,"2015-07-18 03:24:00",1437215040,"C5",427140,1437642180,"2015-07-23 02:03:00"
"882","20154706044718-338",3,"2015-07-18 03:31:00",1437215460,"C5",494520,1437709980,"2015-07-23 20:53:00"
"4601","20153803013812-529",1,"2015-07-18 03:50:00",1437216600,"C7",630360,1437846960,"2015-07-25 10:56:00"
"5112","20150413050412-329",2,"2015-07-18 04:00:00",1437217200,"C3",48120,1437265320,"2015-07-18 17:22:00"
"5468","20155501125529-527",3,"2015-07-18 04:21:00",1437218460,"C8",718980,1437937440,"2015-07-26 12:04:00"
"6097","20150106080113-871",1,"2015-07-18 04:49:00",1437220140,"C2",128160,1437348300,"2015-07-19 16:25:00"
"1843","20154612124636-207",2,"2015-07-18 06:55:00",1437227700,"C5",165780,1437393480,"2015-07-20 04:58:00"
"5884","20152909082925-700",1,"2015-07-18 06:59:00",1437227940,"C5",386100,1437614040,"2015-07-22 18:14:00"
"306","20150207110213-868",3,"2015-07-18 07:08:00",1437228480,"C7",104040,1437332520,"2015-07-19 12:02:00"
"332","20151504021557-531",2,"2015-07-18 07:08:00",1437228480,"C0",169140,1437397620,"2015-07-20 06:07:00"
"9","20151710051755-835",3,"2015-07-18 07:17:00",1437229020,"C5",93600,1437322620,"2015-07-19 09:17:00"
"4682","20150810080815-587",2,"2015-07-18 07:44:00",1437230640,"C5",86220,1437316860,"2015-07-19 07:41:00"
"4664","20154416054424-28",1,"2015-07-18 07:52:00",1437231120,"C4",137280,1437368400,"2015-07-19 22:00:00"
"590","20153617013645-103",3,"2015-07-18 07:54:00",1437231240,"C2",65880,1437297120,"2015-07-19 02:12:00"
"479","20155909075954-808",1,"2015-07-18 08:02:00",1437231720,"C4",259260,1437490980,"2015-07-21 08:03:00"
"3631","20150903100903-596",2,"2015-07-18 08:40:00",1437234000,"C4",184380,1437418380,"2015-07-20 11:53:00"
"4826","20153903123902-205",1,"2015-07-18 08:43:00",1437234180,"C5",183120,1437417300,"2015-07-20 11:35:00"
"3519","20152114062143-72",1,"2015-07-18 08:44:00",1437234240,"C6",354180,1437588420,"2015-07-22 11:07:00"
"6054","20155710075750-214",1,"2015-07-18 08:48:00",1437234480,"C8",99180,1437333660,"2015-07-19 12:21:00"
"1615","20150304120307-360",1,"2015-07-18 09:33:00",1437237180,"C6",632100,1437869280,"2015-07-25 17:08:00"
"4694","20152616032618-514",2,"2015-07-18 10:24:00",1437240240,"C4",77340,1437317580,"2015-07-19 07:53:00"
"6205","20151610051648-803",2,"2015-07-18 11:28:00",1437244080,"C4",223440,1437467520,"2015-07-21 01:32:00"
"2894","20155715075716-596",2,"2015-07-18 11:30:00",1437244200,"C2",90660,1437334860,"2015-07-19 12:41:00"
"2973","20152624072652-602",3,"2015-07-18 11:53:00",1437245580,"C5",696540,1437942120,"2015-07-26 13:22:00"
"368","20152712012712-669",2,"2015-07-18 11:59:00",1437245940,"C5",64140,1437310080,"2015-07-19 05:48:00"
"3999","20154519084549-54",1,"2015-07-18 12:39:00",1437248340,"C6",419940,1437668280,"2015-07-23 09:18:00"
"4295","20154710114715-117",1,"2015-07-18 12:39:00",1437248340,"C5",347160,1437595500,"2015-07-22 13:05:00"
"1907","20151009041023-63",1,"2015-07-18 12:50:00",1437249000,"C2",95700,1437344700,"2015-07-19 15:25:00"
"5324","20152814012834-417",2,"2015-07-18 13:33:00",1437251580,"C3",419700,1437671280,"2015-07-23 10:08:00"
"4847","20154711064739-979",1,"2015-07-18 13:38:00",1437251880,"C0",209820,1437461700,"2015-07-20 23:55:00"
"5346","20155206025244-634",3,"2015-07-18 13:38:00",1437251880,"C4",516180,1437768060,"2015-07-24 13:01:00"
"4541","20154004024021-315",2,"2015-07-18 13:44:00",1437252240,"C5",150780,1437403020,"2015-07-20 07:37:00"
"2020","20155112105111-296",3,"2015-07-18 14:15:00",1437254100,"C0",176880,1437430980,"2015-07-20 15:23:00"
"1013","20152808032826-116",3,"2015-07-18 15:38:00",1437259080,"C5",432300,1437691380,"2015-07-23 15:43:00"
"6539","20153914123913-490",3,"2015-07-18 15:45:00",1437259500,"C7",178380,1437437880,"2015-07-20 17:18:00"
"4588","20153401073437-826",3,"2015-07-18 16:04:00",1437260640,"C5",214200,1437474840,"2015-07-21 03:34:00"
"861","20153623073655-303",2,"2015-07-18 16:24:00",1437261840,"C5",273960,1437535800,"2015-07-21 20:30:00"
"2319","20151210101225-79",2,"2015-07-18 16:28:00",1437262080,"C4",89220,1437351300,"2015-07-19 17:15:00"
"5222","20154715074737-500",2,"2015-07-18 16:29:00",1437262140,"C6",290520,1437552660,"2015-07-22 01:11:00"
"6350","20154712084755-402",1,"2015-07-18 16:50:00",1437263400,"C2",182460,1437445860,"2015-07-20 19:31:00"
"290","20152612122652-844",1,"2015-07-18 17:04:00",1437264240,"C5",76440,1437340680,"2015-07-19 14:18:00"
"2029","20150827020823-652",2,"2015-07-18 17:04:00",1437264240,"C0",228120,1437492360,"2015-07-21 08:26:00"
"3610","20150901060931-375",3,"2015-07-18 17:53:00",1437267180,"C4",188880,1437456060,"2015-07-20 22:21:00"
"4073","20151510081555-297",2,"2015-07-18 18:19:00",1437268740,"C3",103920,1437372660,"2015-07-19 23:11:00"
"1943","20153914043938-754",2,"2015-07-18 18:46:00",1437270360,"C8",50460,1437320820,"2015-07-19 08:47:00"
"660","20150810060851-257",1,"2015-07-18 18:48:00",1437270480,"C4",92100,1437362580,"2015-07-19 20:23:00"
"2568","20154816014841-737",1,"2015-07-18 19:03:00",1437271380,"C4",927900,1438199280,"2015-07-29 12:48:00"
"1407","20155014125011-81",1,"2015-07-18 19:04:00",1437271440,"C4",184020,1437455460,"2015-07-20 22:11:00"
"4410","20155809045856-713",2,"2015-07-18 19:38:00",1437273480,"C3",98400,1437371880,"2015-07-19 22:58:00"
"613","20155420065446-200",3,"2015-07-18 20:26:00",1437276360,"C5",352560,1437628920,"2015-07-22 22:22:00"
"926","20154003074050-280",1,"2015-07-18 20:35:00",1437276900,"C0",944700,1438221600,"2015-07-29 19:00:00"
"4461","20153612073632-445",1,"2015-07-18 20:56:00",1437278160,"C8",283200,1437561360,"2015-07-22 03:36:00"
"3256","20150305030356-98",2,"2015-07-18 21:18:00",1437279480,"C8",229140,1437508620,"2015-07-21 12:57:00"
"4865","20151006071021-877",2,"2015-07-18 21:34:00",1437280440,"C3",136080,1437416520,"2015-07-20 11:22:00"
"297","20154306054321-56",1,"2015-07-18 21:51:00",1437281460,"C2",131460,1437412920,"2015-07-20 10:22:00"
"1785","20155810095859-88",1,"2015-07-18 21:56:00",1437281760,"C4",734280,1438016040,"2015-07-27 09:54:00"
"5682","20153817023845-593",1,"2015-07-18 22:14:00",1437282840,"C5",56880,1437339720,"2015-07-19 14:02:00"
"567","20151415051449-943",1,"2015-07-18 23:08:00",1437286080,"C6",478740,1437764820,"2015-07-24 12:07:00"
"6181","20155709095715-337",3,"2015-07-18 23:30:00",1437287400,"C4",275460,1437562860,"2015-07-22 04:01:00"
"6007","20155617115643-257",1,"2015-07-19 01:06:00",1437293160,"C5",66900,1437360060,"2015-07-19 19:41:00"
"2188","20152826032848-662",1,"2015-07-19 01:58:00",1437296280,"C6",323100,1437619380,"2015-07-22 19:43:00"
"887","20155401025432-410",1,"2015-07-19 02:18:00",1437297480,"C7",754920,1438052400,"2015-07-27 20:00:00"
"2245","20152109052153-334",1,"2015-07-19 02:31:00",1437298260,"C8",162120,1437460380,"2015-07-20 23:33:00"
"2267","20154021014001-277",2,"2015-07-19 03:17:00",1437301020,"C2",340260,1437641280,"2015-07-23 01:48:00"
"1894","20154111114145-439",2,"2015-07-19 03:54:00",1437303240,"C7",94740,1437397980,"2015-07-20 06:13:00"
"2883","20150006070032-991",2,"2015-07-19 04:02:00",1437303720,"C5",556260,1437859980,"2015-07-25 14:33:00"
"1329","20150112060145-428",1,"2015-07-19 04:09:00",1437304140,"C7",85440,1437389580,"2015-07-20 03:53:00"
"4493","20151517081557-258",2,"2015-07-19 04:19:00",1437304740,"C2",79320,1437384060,"2015-07-20 02:21:00"
"3908","20150816060849-742",3,"2015-07-19 04:53:00",1437306780,"C5",84900,1437391680,"2015-07-20 04:28:00"
"5196","20153316063306-527",3,"2015-07-19 05:15:00",1437308100,"C7",127260,1437435360,"2015-07-20 16:36:00"
"4497","20155625025639-594",1,"2015-07-19 05:44:00",1437309840,"C3",255060,1437564900,"2015-07-22 04:35:00"
"2859","20154410024451-978",3,"2015-07-19 06:03:00",1437310980,"C5",106620,1437417600,"2015-07-20 11:40:00"
"13","20151510121543-670",3,"2015-07-19 06:21:00",1437312060,"C2",252120,1437564180,"2015-07-22 04:23:00"
"3240","20152018102004-940",1,"2015-07-19 06:36:00",1437312960,"C0",72960,1437385920,"2015-07-20 02:52:00"
"5273","20151502111546-232",1,"2015-07-19 06:59:00",1437314340,"C4",181680,1437496020,"2015-07-21 09:27:00"
"2872","20150010080038-54",2,"2015-07-19 07:04:00",1437314640,"C2",420780,1437735420,"2015-07-24 03:57:00"
"2577","20153816113806-724",1,"2015-07-19 07:08:00",1437314880,"C5",121500,1437436380,"2015-07-20 16:53:00"
"2556","20155617085640-226",2,"2015-07-19 07:12:00",1437315120,"C8",83280,1437398400,"2015-07-20 06:20:00"
"411","20155303055334-250",2,"2015-07-19 07:21:00",1437315660,"C0",168060,1437483720,"2015-07-21 06:02:00"
"4239","20154417114443-748",1,"2015-07-19 07:36:00",1437316560,"C8",78960,1437395520,"2015-07-20 05:32:00"
"4499","20155516115547-576",2,"2015-07-19 08:15:00",1437318900,"C8",123000,1437441900,"2015-07-20 18:25:00"
"5893","20152305012336-61",3,"2015-07-19 08:47:00",1437320820,"C3",596520,1437917340,"2015-07-26 06:29:00"
"3712","20152201042246-439",2,"2015-07-19 08:52:00",1437321120,"C7",764100,1438085220,"2015-07-28 05:07:00"
"3577","20152001072036-614",1,"2015-07-19 08:56:00",1437321360,"C7",780480,1438101840,"2015-07-28 09:44:00"
"1684","20150517090518-811",3,"2015-07-19 09:25:00",1437323100,"C7",87000,1437410100,"2015-07-20 09:35:00"
"1562","20152909082901-932",1,"2015-07-19 09:29:00",1437323340,"C8",173520,1437496860,"2015-07-21 09:41:00"
"1165","20151911051900-484",1,"2015-07-19 09:58:00",1437325080,"C2",221580,1437546660,"2015-07-21 23:31:00"
"556","20154111024150-826",1,"2015-07-19 10:17:00",1437326220,"C7",96480,1437422700,"2015-07-20 13:05:00"
"1719","20150811050843-334",2,"2015-07-19 11:00:00",1437328800,"C2",83640,1437412440,"2015-07-20 10:14:00"
"1670","20152907092902-279",2,"2015-07-19 11:05:00",1437329100,"C5",1211520,1438540620,"2015-08-02 11:37:00"
"2600","20155524065529-638",3,"2015-07-19 11:49:00",1437331740,"C0",725880,1438057620,"2015-07-27 21:27:00"
"446","20152414072405-565",2,"2015-07-19 12:04:00",1437332640,"C0",434400,1437767040,"2015-07-24 12:44:00"
"3410","20152711032724-725",3,"2015-07-19 12:16:00",1437333360,"C2",679740,1438013100,"2015-07-27 09:05:00"
"5971","20150005110029-714",3,"2015-07-19 12:40:00",1437334800,"C8",243120,1437577920,"2015-07-22 08:12:00"
"6488","20153906123907-891",1,"2015-07-19 13:27:00",1437337620,"C6",187680,1437525300,"2015-07-21 17:35:00"
"4728","20154204034234-400",3,"2015-07-19 13:42:00",1437338520,"C4",161100,1437499620,"2015-07-21 10:27:00"
"1730","20152818092849-712",1,"2015-07-19 14:06:00",1437339960,"C2",103080,1437443040,"2015-07-20 18:44:00"
"934","20155916065950-407",1,"2015-07-19 14:21:00",1437340860,"C8",142860,1437483720,"2015-07-21 06:02:00"
"3186","20150109020137-850",3,"2015-07-19 14:23:00",1437340980,"C8",432660,1437773640,"2015-07-24 14:34:00"
"5010","20153018013026-319",2,"2015-07-19 14:34:00",1437341640,"C2",90240,1437431880,"2015-07-20 15:38:00"
"329","20152509102521-374",1,"2015-07-19 14:49:00",1437342540,"C2",109980,1437452520,"2015-07-20 21:22:00"
"1650","20150903090936-932",1,"2015-07-19 14:53:00",1437342780,"C0",175380,1437518160,"2015-07-21 15:36:00"
"6046","20150415090454-392",1,"2015-07-19 14:58:00",1437343080,"C4",122280,1437465360,"2015-07-21 00:56:00"
"4705","20154703104742-613",1,"2015-07-19 15:17:00",1437344220,"C3",199800,1437544020,"2015-07-21 22:47:00"
"377","20154913124955-986",3,"2015-07-19 16:10:00",1437347400,"C4",75780,1437423180,"2015-07-20 13:13:00"
"3893","20152309092303-862",2,"2015-07-19 16:28:00",1437348480,"C8",177900,1437526380,"2015-07-21 17:53:00"
"1491","20150115100135-182",2,"2015-07-19 16:30:00",1437348600,"C2",368940,1437717540,"2015-07-23 22:59:00"
"2509","20150221080233-162",1,"2015-07-19 16:44:00",1437349440,"C5",816840,1438166280,"2015-07-29 03:38:00"
"645","20154312014352-916",1,"2015-07-19 17:06:00",1437350760,"C8",88140,1437438900,"2015-07-20 17:35:00"
"3616","20154210014220-695",3,"2015-07-19 18:24:00",1437355440,"C5",264840,1437620280,"2015-07-22 19:58:00"
"3096","20150708030735-179",1,"2015-07-19 18:31:00",1437355860,"C2",320880,1437676740,"2015-07-23 11:39:00"
"1926","20155517085542-741",3,"2015-07-19 18:50:00",1437357000,"C0",208500,1437565500,"2015-07-22 04:45:00"
"3776","20151203101246-894",2,"2015-07-19 19:03:00",1437357780,"C5",471420,1437829200,"2015-07-25 06:00:00"
"120","20155603075643-430",1,"2015-07-19 19:47:00",1437360420,"C2",203580,1437564000,"2015-07-22 04:20:00"
"1036","20154809104801-644",3,"2015-07-19 20:16:00",1437362160,"C5",112260,1437474420,"2015-07-21 03:27:00"
"469","20153310033332-410",2,"2015-07-19 20:29:00",1437362940,"C4",99420,1437462360,"2015-07-21 00:06:00"
"1512","20151315121354-235",1,"2015-07-19 20:37:00",1437363420,"C6",375840,1437739260,"2015-07-24 05:01:00"
"3292","20153407083404-718",2,"2015-07-19 21:01:00",1437364860,"C7",120180,1437485040,"2015-07-21 06:24:00"
"3990","20154813094806-514",2,"2015-07-19 21:47:00",1437367620,"C4",80220,1437447840,"2015-07-20 20:04:00"
"2739","20150818050836-609",2,"2015-07-19 22:04:00",1437368640,"C5",52080,1437420720,"2015-07-20 12:32:00"
"158","20151817011850-621",1,"2015-07-19 22:49:00",1437371340,"C4",207060,1437578400,"2015-07-22 08:20:00"
"1502","20150605120608-125",3,"2015-07-20 00:21:00",1437376860,"C8",250740,1437627600,"2015-07-22 22:00:00"
"147","20150027120012-20",3,"2015-07-20 00:31:00",1437377460,"C4",277980,1437655440,"2015-07-23 05:44:00"
"371","20154309074338-532",2,"2015-07-20 00:37:00",1437377820,"C5",462420,1437840240,"2015-07-25 09:04:00"
"4709","20151202011253-62",3,"2015-07-20 00:48:00",1437378480,"C4",188820,1437567300,"2015-07-22 05:15:00"
"1099","20154417114443-51",1,"2015-07-20 01:10:00",1437379800,"C8",110580,1437490380,"2015-07-21 07:53:00"
"2279","20154107114151-839",2,"2015-07-20 01:23:00",1437380580,"C8",155160,1437535740,"2015-07-21 20:29:00"
"892","20151501031546-207",3,"2015-07-20 01:53:00",1437382380,"C2",796740,1438179120,"2015-07-29 07:12:00"
"387","20151412051446-871",1,"2015-07-20 01:59:00",1437382740,"C2",90900,1437473640,"2015-07-21 03:14:00"
"1999","20152403122407-918",2,"2015-07-20 02:18:00",1437383880,"C5",716220,1438100100,"2015-07-28 09:15:00"
"6034","20152112022147-274",2,"2015-07-20 02:29:00",1437384540,"C8",324240,1437708780,"2015-07-23 20:33:00"
"1102","20150207050259-178",1,"2015-07-20 03:07:00",1437386820,"C4",153300,1437540120,"2015-07-21 21:42:00"
"5146","20155707095706-832",1,"2015-07-20 03:47:00",1437389220,"C8",550500,1437939720,"2015-07-26 12:42:00"
"263","20155704025719-973",1,"2015-07-20 04:15:00",1437390900,"C5",671940,1438062840,"2015-07-27 22:54:00"
"4719","20151906061932-564",3,"2015-07-20 04:20:00",1437391200,"C7",171780,1437562980,"2015-07-22 04:03:00"
"4286","20153012103050-559",1,"2015-07-20 04:34:00",1437392040,"C7",334920,1437726960,"2015-07-24 01:36:00"
"5064","20155415065439-614",1,"2015-07-20 05:02:00",1437393720,"C8",431040,1437824760,"2015-07-25 04:46:00"
"2269","20152517032501-916",1,"2015-07-20 05:23:00",1437394980,"C5",111540,1437506520,"2015-07-21 12:22:00"
"2276","20151027121025-240",1,"2015-07-20 05:46:00",1437396360,"C5",982080,1438378440,"2015-07-31 14:34:00"
"1356","20153015053016-75",1,"2015-07-20 06:00:00",1437397200,"C4",130200,1437527400,"2015-07-21 18:10:00"
"3956","20152211042210-394",2,"2015-07-20 06:27:00",1437398820,"C8",148380,1437547200,"2015-07-21 23:40:00"
"656","20151305011309-201",2,"2015-07-20 06:34:00",1437399240,"C3",424020,1437823260,"2015-07-25 04:21:00"
"4741","20154903044916-720",1,"2015-07-20 06:43:00",1437399780,"C2",477480,1437877260,"2015-07-25 19:21:00"
"822","20154604094636-292",2,"2015-07-20 07:04:00",1437401040,"C4",457560,1437858600,"2015-07-25 14:10:00"
"5974","20150616070612-761",2,"2015-07-20 08:10:00",1437405000,"C5",174720,1437579720,"2015-07-22 08:42:00"
"593","20153204093236-149",2,"2015-07-20 08:46:00",1437407160,"C2",689820,1438096980,"2015-07-28 08:23:00"
"5055","20153616023658-518",2,"2015-07-20 08:48:00",1437407280,"C2",162360,1437569640,"2015-07-22 05:54:00"
"227","20154212114201-175",2,"2015-07-20 09:50:00",1437411000,"C5",85560,1437496560,"2015-07-21 09:36:00"
"3613","20151212021252-485",3,"2015-07-20 10:20:00",1437412800,"C6",84660,1437497460,"2015-07-21 09:51:00"
"2671","20150115050115-511",2,"2015-07-20 10:24:00",1437413040,"C0",408180,1437821220,"2015-07-25 03:47:00"
"4712","20153717083746-738",1,"2015-07-20 10:26:00",1437413160,"C2",265740,1437678900,"2015-07-23 12:15:00"
"2381","20153102093104-707",2,"2015-07-20 10:46:00",1437414360,"C3",519900,1437934260,"2015-07-26 11:11:00"
"5492","20151314051327-38",1,"2015-07-20 10:51:00",1437414660,"C7",247740,1437662400,"2015-07-23 07:40:00"
"6514","20151212121250-641",1,"2015-07-20 11:24:00",1437416640,"C5",86040,1437502680,"2015-07-21 11:18:00"
"2359","20152113062104-747",2,"2015-07-20 11:57:00",1437418620,"C8",312480,1437731100,"2015-07-24 02:45:00"
"4160","20154405074442-509",2,"2015-07-20 12:16:00",1437419760,"C4",164040,1437583800,"2015-07-22 09:50:00"
"1521","20155414025452-910",1,"2015-07-20 12:42:00",1437421320,"C5",255240,1437676560,"2015-07-23 11:36:00"
"4186","20152120042149-770",2,"2015-07-20 13:01:00",1437422460,"C2",322500,1437744960,"2015-07-24 06:36:00"
"562","20153910123921-997",1,"2015-07-20 13:03:00",1437422580,"C4",108180,1437530760,"2015-07-21 19:06:00"
"4079","20151707051702-432",1,"2015-07-20 13:12:00",1437423120,"C8",221700,1437644820,"2015-07-23 02:47:00"
"1089","20155216015226-188",2,"2015-07-20 13:46:00",1437425160,"C5",979080,1438404240,"2015-07-31 21:44:00"
"2890","20151512111517-621",1,"2015-07-20 14:27:00",1437427620,"C8",351360,1437778980,"2015-07-24 16:03:00"
"3516","20155520035557-954",1,"2015-07-20 14:43:00",1437428580,"C7",585120,1438013700,"2015-07-27 09:15:00"
"4851","20153311113332-277",2,"2015-07-20 14:53:00",1437429180,"C2",98700,1437527880,"2015-07-21 18:18:00"
"2461","20150518090500-717",3,"2015-07-20 16:00:00",1437433200,"C4",197700,1437630900,"2015-07-22 22:55:00"
"1568","20153012083039-675",1,"2015-07-20 16:06:00",1437433560,"C6",119760,1437553320,"2015-07-22 01:22:00"
"2142","20155415015401-576",1,"2015-07-20 16:06:00",1437433560,"C4",146640,1437580200,"2015-07-22 08:50:00"
"4380","20155004015003-341",3,"2015-07-20 17:24:00",1437438240,"C7",199320,1437637560,"2015-07-23 00:46:00"
"1988","20153015053056-910",2,"2015-07-20 18:01:00",1437440460,"C2",61980,1437502440,"2015-07-21 11:14:00"
"4007","20153916033930-668",3,"2015-07-20 18:01:00",1437440460,"C4",177060,1437617520,"2015-07-22 19:12:00"
"4464","20154117054141-402",1,"2015-07-20 18:25:00",1437441900,"C5",130920,1437572820,"2015-07-22 06:47:00"
"6184","20155715045720-815",2,"2015-07-20 18:25:00",1437441900,"C0",437280,1437879180,"2015-07-25 19:53:00"
"609","20151614071608-934",1,"2015-07-20 19:15:00",1437444900,"C7",80220,1437525120,"2015-07-21 17:32:00"
"664","20155915055956-404",3,"2015-07-20 19:17:00",1437445020,"C0",145560,1437590580,"2015-07-22 11:43:00"
"6411","20155417045444-36",1,"2015-07-20 19:37:00",1437446220,"C2",268980,1437715200,"2015-07-23 22:20:00"
"1944","20150509030549-76",1,"2015-07-20 20:05:00",1437447900,"C4",322800,1437770700,"2015-07-24 13:45:00"
"1661","20150217080254-664",2,"2015-07-20 20:06:00",1437447960,"C4",302640,1437750600,"2015-07-24 08:10:00"
"3234","20155108075139-964",2,"2015-07-20 20:06:00",1437447960,"C8",216180,1437664140,"2015-07-23 08:09:00"
"5539","20151514111514-132",3,"2015-07-20 20:27:00",1437449220,"C5",275760,1437724980,"2015-07-24 01:03:00"
"1474","20154919034934-127",2,"2015-07-20 20:41:00",1437450060,"C8",51960,1437502020,"2015-07-21 11:07:00"
"4902","20153810053835-229",1,"2015-07-20 21:16:00",1437452160,"C8",438540,1437890700,"2015-07-25 23:05:00"
"5700","20153716053741-328",1,"2015-07-20 21:27:00",1437452820,"C8",179700,1437632520,"2015-07-22 23:22:00"
"4180","20153512063509-117",1,"2015-07-20 22:29:00",1437456540,"C2",106920,1437563460,"2015-07-22 04:11:00"
"5432","20154411064440-435",1,"2015-07-20 23:16:00",1437459360,"C2",104640,1437564000,"2015-07-22 04:20:00"
"3467","20152117022136-22",1,"2015-07-20 23:21:00",1437459660,"C4",97200,1437556860,"2015-07-22 02:21:00"
"6352","20153712063756-502",2,"2015-07-20 23:25:00",1437459900,"C3",93960,1437553860,"2015-07-22 01:31:00"
"1933","20154516034505-603",1,"2015-07-20 23:35:00",1437460500,"C8",74760,1437535260,"2015-07-21 20:21:00"
"715","20151812021854-880",2,"2015-07-21 00:32:00",1437463920,"C2",364020,1437827940,"2015-07-25 05:39:00"
"4836","20151418111432-774",3,"2015-07-21 00:46:00",1437464760,"C7",110760,1437575520,"2015-07-22 07:32:00"
"2844","20150517010500-796",2,"2015-07-21 00:55:00",1437465300,"C0",150900,1437616200,"2015-07-22 18:50:00"
"1965","20151504071559-733",3,"2015-07-21 01:33:00",1437467580,"C3",482760,1437950340,"2015-07-26 15:39:00"
"3289","20152518042537-745",2,"2015-07-21 01:33:00",1437467580,"C0",102840,1437570420,"2015-07-22 06:07:00"
"5412","20155315015313-84",1,"2015-07-21 01:53:00",1437468780,"C8",95040,1437563820,"2015-07-22 04:17:00"
"4685","20151618021648-198",2,"2015-07-21 02:28:00",1437470880,"C8",108360,1437579240,"2015-07-22 08:34:00"
"2513","20152012012031-178",2,"2015-07-21 02:47:00",1437472020,"C4",105660,1437577680,"2015-07-22 08:08:00"
"2024","20151621011631-58",1,"2015-07-21 03:00:00",1437472800,"C5",319380,1437792180,"2015-07-24 19:43:00"
"2898","20153407043429-914",1,"2015-07-21 03:16:00",1437473760,"C7",165960,1437639720,"2015-07-23 01:22:00"
"6000","20155508105537-280",1,"2015-07-21 03:41:00",1437475260,"C8",548580,1438023840,"2015-07-27 12:04:00"
"6069","20150908080915-434",3,"2015-07-21 04:29:00",1437478140,"C8",222000,1437700140,"2015-07-23 18:09:00"
"3642","20153312063341-591",3,"2015-07-21 04:41:00",1437478860,"C4",96360,1437575220,"2015-07-22 07:27:00"
"6081","20151919061928-62",3,"2015-07-21 04:57:00",1437479820,"C3",83940,1437563760,"2015-07-22 04:16:00"
"4722","20150315040346-314",1,"2015-07-21 05:13:00",1437480780,"C8",239700,1437720480,"2015-07-23 23:48:00"
"5479","20155817085808-370",1,"2015-07-21 05:22:00",1437481320,"C5",110880,1437592200,"2015-07-22 12:10:00"
"3057","20150303080344-262",1,"2015-07-21 05:37:00",1437482220,"C7",220920,1437703140,"2015-07-23 18:59:00"
"1231","20150103100107-497",1,"2015-07-21 05:45:00",1437482700,"C6",192480,1437675180,"2015-07-23 11:13:00"
"6475","20155219035228-248",1,"2015-07-21 05:52:00",1437483120,"C8",68400,1437551520,"2015-07-22 00:52:00"
"6496","20153318113337-404",3,"2015-07-21 06:09:00",1437484140,"C7",119880,1437604020,"2015-07-22 15:27:00"
"2915","20154018024000-428",1,"2015-07-21 07:26:00",1437488760,"C4",233160,1437721920,"2015-07-24 00:12:00"
"3377","20151020031037-765",2,"2015-07-21 07:26:00",1437488760,"C3",58560,1437547320,"2015-07-21 23:42:00"
"3751","20153824083801-208",1,"2015-07-21 07:58:00",1437490680,"C4",291300,1437781980,"2015-07-24 16:53:00"
"1974","20150514120512-102",1,"2015-07-21 08:29:00",1437492540,"C7",295920,1437788460,"2015-07-24 18:41:00"
"4141","20154219094203-849",2,"2015-07-21 08:38:00",1437493080,"C8",84480,1437577560,"2015-07-22 08:06:00"
"5312","20150105010142-777",3,"2015-07-21 08:53:00",1437493980,"C2",195360,1437689340,"2015-07-23 15:09:00"
"5872","20155118115127-143",1,"2015-07-21 09:00:00",1437494400,"C3",82980,1437577380,"2015-07-22 08:03:00"
"1323","20153801073845-972",1,"2015-07-21 09:22:00",1437495720,"C2",216780,1437712500,"2015-07-23 21:35:00"
"1039","20151612031639-61",1,"2015-07-21 10:11:00",1437498660,"C8",151860,1437650520,"2015-07-23 04:22:00"
"3882","20151920101933-665",1,"2015-07-21 10:28:00",1437499680,"C5",892980,1438392660,"2015-07-31 18:31:00"
"3934","20153718113750-118",2,"2015-07-21 10:55:00",1437501300,"C4",85560,1437586860,"2015-07-22 10:41:00"
"6017","20153719063729-533",1,"2015-07-21 12:21:00",1437506460,"C5",96720,1437603180,"2015-07-22 15:13:00"
"6404","20152709072703-969",1,"2015-07-21 12:21:00",1437506460,"C6",607740,1438114200,"2015-07-28 13:10:00"
"4520","20151816061843-103",1,"2015-07-21 13:14:00",1437509640,"C5",228480,1437738120,"2015-07-24 04:42:00"
"3058","20152413042403-986",3,"2015-07-21 13:24:00",1437510240,"C8",97200,1437607440,"2015-07-22 16:24:00"
"3018","20152614112602-965",3,"2015-07-21 13:53:00",1437511980,"C5",87660,1437599640,"2015-07-22 14:14:00"
"265","20151512011521-735",1,"2015-07-21 13:54:00",1437512040,"C4",259980,1437772020,"2015-07-24 14:07:00"
"5037","20151215111234-603",2,"2015-07-21 14:16:00",1437513360,"C5",264720,1437778080,"2015-07-24 15:48:00"
"3845","20150319090314-498",2,"2015-07-21 14:21:00",1437513660,"C3",95940,1437609600,"2015-07-22 17:00:00"
"5862","20153505103526-82",1,"2015-07-21 14:44:00",1437515040,"C4",465780,1437980820,"2015-07-27 00:07:00"
"475","20151713011710-914",3,"2015-07-21 14:59:00",1437515940,"C5",348660,1437864600,"2015-07-25 15:50:00"
"2324","20151420041437-875",1,"2015-07-21 16:18:00",1437520680,"C2",86640,1437607320,"2015-07-22 16:22:00"
"4396","20154511114515-568",1,"2015-07-21 16:40:00",1437522000,"C8",176340,1437698340,"2015-07-23 17:39:00"
"184","20151008101045-291",3,"2015-07-21 16:56:00",1437522960,"C2",1147560,1438670520,"2015-08-03 23:42:00"
"2535","20151717121704-659",3,"2015-07-21 17:17:00",1437524220,"C0",181800,1437706020,"2015-07-23 19:47:00"
"2814","20151820101849-472",2,"2015-07-21 17:19:00",1437524340,"C4",111660,1437636000,"2015-07-23 00:20:00"
"3987","20154018034049-540",2,"2015-07-21 17:25:00",1437524700,"C4",265500,1437790200,"2015-07-24 19:10:00"
"4680","20153518113501-500",1,"2015-07-21 17:26:00",1437524760,"C3",93420,1437618180,"2015-07-22 19:23:00"
"1297","20153801123847-62",1,"2015-07-21 17:40:00",1437525600,"C4",873060,1438398660,"2015-07-31 20:11:00"
"4040","20155504065559-69",1,"2015-07-21 17:40:00",1437525600,"C8",301500,1437827100,"2015-07-25 05:25:00"
"6067","20154617064600-936",1,"2015-07-21 17:50:00",1437526200,"C7",192720,1437718920,"2015-07-23 23:22:00"
"6158","20155413095429-78",2,"2015-07-21 18:12:00",1437527520,"C2",360540,1437888060,"2015-07-25 22:21:00"
"5344","20155605125654-111",1,"2015-07-21 18:43:00",1437529380,"C8",200460,1437729840,"2015-07-24 02:24:00"
"3223","20154611014601-555",3,"2015-07-21 18:56:00",1437530160,"C5",441300,1437971460,"2015-07-26 21:31:00"
"900","20150008010023-545",3,"2015-07-21 21:08:00",1437538080,"C2",164640,1437702720,"2015-07-23 18:52:00"
"2369","20150820090811-228",2,"2015-07-21 22:11:00",1437541860,"C0",133380,1437675240,"2015-07-23 11:14:00"
"418","20155809075828-607",1,"2015-07-21 22:34:00",1437543240,"C0",544680,1438087920,"2015-07-28 05:52:00"
"639","20153712013720-181",3,"2015-07-21 22:46:00",1437543960,"C6",205800,1437749760,"2015-07-24 07:56:00"
"4459","20152401092405-316",3,"2015-07-21 23:01:00",1437544860,"C7",253860,1437798720,"2015-07-24 21:32:00"
"3564","20153516073525-833",2,"2015-07-21 23:17:00",1437545820,"C6",81420,1437627240,"2015-07-22 21:54:00"
"6522","20155409035441-881",2,"2015-07-21 23:21:00",1437546060,"C4",354540,1437900600,"2015-07-26 01:50:00"
"4182","20155013065048-240",1,"2015-07-21 23:24:00",1437546240,"C7",375420,1437921660,"2015-07-26 07:41:00"
"4135","20155112125144-954",2,"2015-07-21 23:46:00",1437547560,"C7",116700,1437664260,"2015-07-23 08:11:00"
"4797","20151413081417-823",1,"2015-07-21 23:58:00",1437548280,"C0",93480,1437641760,"2015-07-23 01:56:00"
"3412","20155517115552-543",1,"2015-07-22 00:01:00",1437548460,"C5",194580,1437743040,"2015-07-24 06:04:00"
"4217","20152319052357-61",3,"2015-07-22 01:15:00",1437552900,"C0",349140,1437902040,"2015-07-26 02:14:00"
"6491","20150119010140-843",3,"2015-07-22 01:41:00",1437554460,"C4",109200,1437663660,"2015-07-23 08:01:00"
"1386","20153205073222-529",2,"2015-07-22 02:17:00",1437556620,"C4",483300,1438039920,"2015-07-27 16:32:00"
"2690","20154615114612-209",2,"2015-07-22 03:04:00",1437559440,"C4",286740,1437846180,"2015-07-25 10:43:00"
"1561","20150817120835-419",3,"2015-07-22 03:08:00",1437559680,"C8",79920,1437639600,"2015-07-23 01:20:00"
"1221","20155415105401-84",2,"2015-07-22 03:18:00",1437560280,"C6",72180,1437632460,"2015-07-22 23:21:00"
"1533","20153412063404-685",2,"2015-07-22 03:31:00",1437561060,"C5",121860,1437682920,"2015-07-23 13:22:00"
"1610","20150920090915-26",2,"2015-07-22 03:31:00",1437561060,"C8",76260,1437637320,"2015-07-23 00:42:00"
"6342","20154111074111-452",1,"2015-07-22 03:31:00",1437561060,"C5",467700,1438028760,"2015-07-27 13:26:00"
"3445","20153618113644-795",1,"2015-07-22 04:12:00",1437563520,"C2",106320,1437669840,"2015-07-23 09:44:00"
"4117","20150319020304-688",1,"2015-07-22 04:27:00",1437564420,"C0",112320,1437676740,"2015-07-23 11:39:00"
"1437","20153019043019-743",2,"2015-07-22 04:28:00",1437564480,"C8",107940,1437672420,"2015-07-23 10:27:00"
"5938","20154114054132-501",2,"2015-07-22 05:35:00",1437568500,"C4",92520,1437661020,"2015-07-23 07:17:00"
"3543","20155901125946-822",2,"2015-07-22 07:02:00",1437573720,"C4",256140,1437829860,"2015-07-25 06:11:00"
"3343","20150320010324-914",2,"2015-07-22 07:15:00",1437574500,"C2",151920,1437726420,"2015-07-24 01:27:00"
"669","20155218085232-407",3,"2015-07-22 07:19:00",1437574740,"C2",113340,1437688080,"2015-07-23 14:48:00"
"5208","20153519103528-888",2,"2015-07-22 07:55:00",1437576900,"C0",124800,1437701700,"2015-07-23 18:35:00"
"1428","20151505031524-959",2,"2015-07-22 08:19:00",1437578340,"C3",180480,1437758820,"2015-07-24 10:27:00"
"5052","20151620101652-108",1,"2015-07-22 08:36:00",1437579360,"C7",83400,1437662760,"2015-07-23 07:46:00"
"325","20154508124538-434",2,"2015-07-22 09:43:00",1437583380,"C7",171240,1437754620,"2015-07-24 09:17:00"
"2062","20151314091343-744",1,"2015-07-22 10:13:00",1437585180,"C6",547800,1438132980,"2015-07-28 18:23:00"
"4526","20154416044414-95",2,"2015-07-22 10:16:00",1437585360,"C8",247560,1437832920,"2015-07-25 07:02:00"
"2652","20152813122838-287",2,"2015-07-22 10:20:00",1437585600,"C6",420240,1438005840,"2015-07-27 07:04:00"
"4604","20154519024544-322",2,"2015-07-22 11:00:00",1437588000,"C4",203580,1437791580,"2015-07-24 19:33:00"
"773","20150105060134-242",1,"2015-07-22 11:14:00",1437588840,"C6",1487580,1439076420,"2015-08-08 16:27:00"
"1888","20152516072549-566",1,"2015-07-22 11:43:00",1437590580,"C5",266940,1437857520,"2015-07-25 13:52:00"
"3378","20150011070002-311",3,"2015-07-22 12:46:00",1437594360,"C0",485580,1438079940,"2015-07-28 03:39:00"
"3716","20150716100718-333",1,"2015-07-22 13:07:00",1437595620,"C8",105840,1437701460,"2015-07-23 18:31:00"
"4013","20151520101518-94",3,"2015-07-22 13:27:00",1437596820,"C8",92160,1437688980,"2015-07-23 15:03:00"
"2665","20155319035337-279",1,"2015-07-22 13:35:00",1437597300,"C4",83640,1437680940,"2015-07-23 12:49:00"
"4730","20152117032144-298",1,"2015-07-22 14:00:00",1437598800,"C2",427140,1438025940,"2015-07-27 12:39:00"
"2259","20154505124525-350",1,"2015-07-22 14:45:00",1437601500,"C5",184500,1437786000,"2015-07-24 18:00:00"
"848","20150417070431-372",1,"2015-07-22 14:46:00",1437601560,"C6",459720,1438061280,"2015-07-27 22:28:00"
"4882","20152918122930-367",2,"2015-07-22 14:49:00",1437601740,"C8",177000,1437778740,"2015-07-24 15:59:00"
"2880","20153719053715-589",3,"2015-07-22 15:01:00",1437602460,"C0",83280,1437685740,"2015-07-23 14:09:00"
"2119","20150010020057-694",2,"2015-07-22 15:22:00",1437603720,"C5",520860,1438124580,"2015-07-28 16:03:00"
"6480","20150303120312-233",3,"2015-07-22 15:23:00",1437603780,"C6",206700,1437810480,"2015-07-25 00:48:00"
"2423","20154624094613-438",2,"2015-07-22 17:07:00",1437610020,"C2",349380,1437959400,"2015-07-26 18:10:00"
"3508","20151315091329-68",1,"2015-07-22 17:13:00",1437610380,"C2",79200,1437689580,"2015-07-23 15:13:00"
"4394","20151113061132-529",3,"2015-07-22 17:31:00",1437611460,"C2",818400,1438429860,"2015-08-01 04:51:00"
"6235","20153725083712-151",3,"2015-07-22 17:49:00",1437612540,"C6",394320,1438006860,"2015-07-27 07:21:00"
"4309","20150226090206-282",1,"2015-07-22 18:30:00",1437615000,"C3",285060,1437900060,"2015-07-26 01:41:00"
"5751","20154612014642-990",1,"2015-07-22 19:27:00",1437618420,"C2",884460,1438502880,"2015-08-02 01:08:00"
"4392","20154618064654-392",1,"2015-07-22 19:40:00",1437619200,"C8",196020,1437815220,"2015-07-25 02:07:00"
"3568","20154021044054-397",2,"2015-07-22 20:14:00",1437621240,"C5",49620,1437670860,"2015-07-23 10:01:00"
"2459","20150214020239-72",2,"2015-07-22 21:06:00",1437624360,"C6",413580,1438037940,"2015-07-27 15:59:00"
"635","20155619105610-134",2,"2015-07-22 22:19:00",1437628740,"C6",300180,1437928920,"2015-07-26 09:42:00"
"3225","20154610074635-808",1,"2015-07-23 01:04:00",1437638640,"C6",183180,1437821820,"2015-07-25 03:57:00"
"1141","20154708044728-934",1,"2015-07-23 01:11:00",1437639060,"C4",413280,1438052340,"2015-07-27 19:59:00"
"3906","20150828060845-403",3,"2015-07-23 02:08:00",1437642480,"C8",429120,1438071600,"2015-07-28 01:20:00"
"4168","20150304020357-184",1,"2015-07-23 02:13:00",1437642780,"C3",799500,1438442280,"2015-08-01 08:18:00"
"2093","20150208020258-125",1,"2015-07-23 02:24:00",1437643440,"C2",179160,1437822600,"2015-07-25 04:10:00"
"5511","20154519034526-395",1,"2015-07-23 03:33:00",1437647580,"C3",100560,1437748140,"2015-07-24 07:29:00"
"5638","20153826063809-399",1,"2015-07-23 04:14:00",1437650040,"C7",258240,1437908280,"2015-07-26 03:58:00"
"717","20153111123156-389",1,"2015-07-23 04:31:00",1437651060,"C2",504000,1438155060,"2015-07-29 00:31:00"
"4025","20150604010643-971",3,"2015-07-23 04:34:00",1437651240,"C5",805440,1438456680,"2015-08-01 12:18:00"
"5310","20154123054103-632",1,"2015-07-23 06:29:00",1437658140,"C3",318960,1437977100,"2015-07-26 23:05:00"
"2797","20154203044240-260",1,"2015-07-23 07:31:00",1437661860,"C7",612420,1438274280,"2015-07-30 09:38:00"
"5635","20155319105326-404",2,"2015-07-23 08:01:00",1437663660,"C5",167640,1437831300,"2015-07-25 06:35:00"
"2729","20154821024843-807",2,"2015-07-23 08:48:00",1437666480,"C8",75600,1437742080,"2015-07-24 05:48:00"
"2653","20154818074851-145",1,"2015-07-23 09:30:00",1437669000,"C2",219060,1437888060,"2015-07-25 22:21:00"
"2061","20150519040533-38",2,"2015-07-23 09:56:00",1437670560,"C2",107820,1437778380,"2015-07-24 15:53:00"
"4485","20151410081406-824",1,"2015-07-23 10:28:00",1437672480,"C5",565620,1438238100,"2015-07-29 23:35:00"
"2071","20151121121126-475",1,"2015-07-23 10:37:00",1437673020,"C5",83580,1437756600,"2015-07-24 09:50:00"
"4245","20152809032822-774",1,"2015-07-23 10:58:00",1437674280,"C5",1892700,1439566980,"2015-08-14 08:43:00"
"5442","20151518041531-923",1,"2015-07-23 11:21:00",1437675660,"C5",138120,1437813780,"2015-07-25 01:43:00"
"2077","20153722113733-394",1,"2015-07-23 11:23:00",1437675780,"C0",85560,1437761340,"2015-07-24 11:09:00"
"5132","20150517110524-251",2,"2015-07-23 11:38:00",1437676680,"C5",74340,1437751020,"2015-07-24 08:17:00"
"5920","20151522081519-492",2,"2015-07-23 12:13:00",1437678780,"C4",100680,1437779460,"2015-07-24 16:11:00"
"1110","20150513060545-668",1,"2015-07-23 12:22:00",1437679320,"C4",126660,1437805980,"2015-07-24 23:33:00"
"4750","20152211022237-502",2,"2015-07-23 13:36:00",1437683760,"C3",147720,1437831480,"2015-07-25 06:38:00"
"5609","20154509024548-175",1,"2015-07-23 13:59:00",1437685140,"C4",603420,1438288560,"2015-07-30 13:36:00"
"318","20150722110714-462",3,"2015-07-23 14:21:00",1437686460,"C3",98040,1437784500,"2015-07-24 17:35:00"
"5215","20152512062542-417",1,"2015-07-23 14:25:00",1437686700,"C4",122400,1437809100,"2015-07-25 00:25:00"
"243","20151921051948-603",3,"2015-07-23 14:35:00",1437687300,"C0",81480,1437768780,"2015-07-24 13:13:00"
"1492","20151615061625-429",3,"2015-07-23 15:35:00",1437690900,"C5",473820,1438164720,"2015-07-29 03:12:00"
"829","20155405035411-744",3,"2015-07-23 16:29:00",1437694140,"C8",311460,1438005600,"2015-07-27 07:00:00"
"6473","20154305084350-216",2,"2015-07-23 16:59:00",1437695940,"C5",522120,1438218060,"2015-07-29 18:01:00"
"2951","20153202033251-484",2,"2015-07-23 17:32:00",1437697920,"C5",227700,1437925620,"2015-07-26 08:47:00"
"3597","20153103113118-650",1,"2015-07-23 17:54:00",1437699240,"C4",250140,1437949380,"2015-07-26 15:23:00"
"2141","20153419063421-197",2,"2015-07-23 18:13:00",1437700380,"C2",129180,1437829560,"2015-07-25 06:06:00"
"2755","20151603061640-724",2,"2015-07-23 18:20:00",1437700800,"C8",885720,1438586520,"2015-08-03 00:22:00"
"4494","20152019112015-444",3,"2015-07-23 18:20:00",1437700800,"C4",185400,1437886200,"2015-07-25 21:50:00"
"2439","20153604123646-881",3,"2015-07-23 18:29:00",1437701340,"C5",237540,1437938880,"2015-07-26 12:28:00"
"5673","20152914062912-293",2,"2015-07-23 18:48:00",1437702480,"C7",117420,1437819900,"2015-07-25 03:25:00"
"5676","20153721113747-248",3,"2015-07-23 18:53:00",1437702780,"C4",99480,1437802260,"2015-07-24 22:31:00"
"6277","20151029081008-399",1,"2015-07-23 18:53:00",1437702780,"C7",301740,1438004520,"2015-07-27 06:42:00"
"2235","20153011083029-396",1,"2015-07-23 19:27:00",1437704820,"C5",358740,1438063560,"2015-07-27 23:06:00"
"4319","20152115022106-782",1,"2015-07-23 19:59:00",1437706740,"C5",101640,1437808380,"2015-07-25 00:13:00"
"3214","20155121075125-805",2,"2015-07-23 20:47:00",1437709620,"C4",351420,1438061040,"2015-07-27 22:24:00"
"4161","20154918014930-425",1,"2015-07-23 21:14:00",1437711240,"C8",91740,1437802980,"2015-07-24 22:43:00"
"4932","20152408032407-297",2,"2015-07-23 22:28:00",1437715680,"C5",165180,1437880860,"2015-07-25 20:21:00"
"6323","20152517092529-612",3,"2015-07-23 22:43:00",1437716580,"C6",94380,1437810960,"2015-07-25 00:56:00"
"6394","20154003034016-1",2,"2015-07-23 22:45:00",1437716700,"C8",250500,1437967200,"2015-07-26 20:20:00"
"741","20151526051513-980",1,"2015-07-23 23:38:00",1437719880,"C4",336540,1438056420,"2015-07-27 21:07:00"
"1694","20151109081144-678",3,"2015-07-23 23:56:00",1437720960,"C3",422100,1438143060,"2015-07-28 21:11:00"
"3565","20153609073654-587",1,"2015-07-24 00:02:00",1437721320,"C8",634380,1438355700,"2015-07-31 08:15:00"
"3139","20150615090601-623",2,"2015-07-24 00:15:00",1437722100,"C3",248580,1437970680,"2015-07-26 21:18:00"
"123","20150219060243-351",3,"2015-07-24 01:02:00",1437724920,"C3",138000,1437862920,"2015-07-25 15:22:00"
"5260","20154925034902-555",1,"2015-07-24 01:09:00",1437725340,"C5",350400,1438075740,"2015-07-28 02:29:00"
"5647","20153917023952-510",3,"2015-07-24 01:21:00",1437726060,"C5",79560,1437805620,"2015-07-24 23:27:00"
"3062","20151322051315-282",1,"2015-07-24 01:43:00",1437727380,"C8",58500,1437785880,"2015-07-24 17:58:00"
"5081","20154106054126-881",3,"2015-07-24 02:13:00",1437729180,"C5",187440,1437916620,"2015-07-26 06:17:00"
"2178","20153219083225-701",1,"2015-07-24 03:52:00",1437735120,"C8",207600,1437942720,"2015-07-26 13:32:00"
"5983","20151722101713-627",2,"2015-07-24 05:13:00",1437739980,"C5",77280,1437817260,"2015-07-25 02:41:00"
"6080","20151722051724-428",1,"2015-07-24 05:17:00",1437740220,"C5",340200,1438080420,"2015-07-28 03:47:00"
"1640","20154822114816-84",1,"2015-07-24 05:42:00",1437741720,"C7",75420,1437817140,"2015-07-25 02:39:00"
"4820","20151920081908-214",2,"2015-07-24 05:57:00",1437742620,"C4",168540,1437911160,"2015-07-26 04:46:00"
"5286","20155016015015-241",1,"2015-07-24 06:45:00",1437745500,"C8",95100,1437840600,"2015-07-25 09:10:00"
"2775","20150508030553-514",3,"2015-07-24 07:10:00",1437747000,"C8",270780,1438017780,"2015-07-27 10:23:00"
"3827","20153626053623-916",3,"2015-07-24 07:30:00",1437748200,"C4",794280,1438542480,"2015-08-02 12:08:00"
"2974","20152221102210-862",1,"2015-07-24 08:16:00",1437750960,"C0",125820,1437876780,"2015-07-25 19:13:00"
"5965","20153915073941-58",1,"2015-07-24 08:35:00",1437752100,"C3",390480,1438142580,"2015-07-28 21:03:00"
"4816","20151523061521-500",1,"2015-07-24 08:45:00",1437752700,"C4",95400,1437848100,"2015-07-25 11:15:00"
"4926","20155722025727-208",1,"2015-07-24 08:49:00",1437752940,"C8",75360,1437828300,"2015-07-25 05:45:00"
"2581","20155313085311-65",3,"2015-07-24 08:58:00",1437753480,"C8",190140,1437943620,"2015-07-26 13:47:00"
"236","20155320095336-544",2,"2015-07-24 09:17:00",1437754620,"C2",114480,1437869100,"2015-07-25 17:05:00"
"5978","20152005042050-261",1,"2015-07-24 10:29:00",1437758940,"C5",540180,1438299120,"2015-07-30 16:32:00"
"3116","20155901075938-57",2,"2015-07-24 10:30:00",1437759000,"C8",285180,1438044180,"2015-07-27 17:43:00"
"1723","20155712035738-767",3,"2015-07-24 10:33:00",1437759180,"C4",1017360,1438776540,"2015-08-05 05:09:00"
"2073","20150722090733-194",1,"2015-07-24 10:33:00",1437759180,"C4",177960,1437937140,"2015-07-26 11:59:00"
"1627","20152917012956-923",1,"2015-07-24 11:29:00",1437762540,"C4",199200,1437961740,"2015-07-26 18:49:00"
"1487","20154619054626-112",2,"2015-07-24 11:31:00",1437762660,"C8",81900,1437844560,"2015-07-25 10:16:00"
"6050","20155317105335-21",1,"2015-07-24 12:32:00",1437766320,"C7",67860,1437834180,"2015-07-25 07:23:00"
"1384","20151208041208-309",1,"2015-07-24 12:47:00",1437767220,"C8",274020,1438041240,"2015-07-27 16:54:00"
"3731","20150722040729-834",1,"2015-07-24 12:47:00",1437767220,"C2",160800,1437928020,"2015-07-26 09:27:00"
"2589","20155222035235-759",1,"2015-07-24 12:48:00",1437767280,"C8",80880,1437848160,"2015-07-25 11:16:00"
"3375","20150221060206-207",2,"2015-07-24 12:58:00",1437767880,"C2",142080,1437909960,"2015-07-26 04:26:00"
"1852","20153919053954-565",1,"2015-07-24 13:39:00",1437770340,"C3",139200,1437909540,"2015-07-26 04:19:00"
"5159","20151307081300-707",1,"2015-07-24 15:17:00",1437776220,"C5",510780,1438287000,"2015-07-30 13:10:00"
"4823","20152704022701-232",1,"2015-07-24 15:30:00",1437777000,"C5",577260,1438354260,"2015-07-31 07:51:00"
"6243","20152118082127-664",2,"2015-07-24 16:23:00",1437780180,"C0",273660,1438053840,"2015-07-27 20:24:00"
"6242","20155417075428-77",1,"2015-07-24 16:34:00",1437780840,"C6",79500,1437860340,"2015-07-25 14:39:00"
"2700","20154213044259-545",1,"2015-07-24 16:57:00",1437782220,"C8",135900,1437918120,"2015-07-26 06:42:00"
"4528","20152824112857-18",1,"2015-07-24 16:58:00",1437782280,"C2",870600,1438652880,"2015-08-03 18:48:00"
"1750","20154112014114-381",1,"2015-07-24 17:20:00",1437783600,"C6",203760,1437987360,"2015-07-27 01:56:00"
"6284","20152819062830-519",2,"2015-07-24 17:36:00",1437784560,"C0",472080,1438256640,"2015-07-30 04:44:00"
"631","20152021052037-513",2,"2015-07-24 17:54:00",1437785640,"C5",130620,1437916260,"2015-07-26 06:11:00"
"825","20152216082220-757",1,"2015-07-24 18:26:00",1437787560,"C8",103920,1437891480,"2015-07-25 23:18:00"
"6492","20153817073832-550",2,"2015-07-24 18:41:00",1437788460,"C4",214860,1438003320,"2015-07-27 06:22:00"
"124","20152316052346-175",2,"2015-07-24 18:44:00",1437788640,"C2",232020,1438020660,"2015-07-27 11:11:00"
"5122","20152207082206-772",2,"2015-07-24 18:57:00",1437789420,"C8",301380,1438090800,"2015-07-28 06:40:00"
"1500","20155620065658-617",1,"2015-07-24 19:09:00",1437790140,"C2",425940,1438216080,"2015-07-29 17:28:00"
"3285","20151210101237-47",2,"2015-07-24 20:12:00",1437793920,"C2",415200,1438209120,"2015-07-29 15:32:00"
"897","20152515112517-831",1,"2015-07-24 20:22:00",1437794520,"C0",269940,1438064460,"2015-07-27 23:21:00"
"4985","20153215113217-764",3,"2015-07-24 20:52:00",1437796320,"C2",101400,1437897720,"2015-07-26 01:02:00"
"4408","20152207042208-551",1,"2015-07-24 21:08:00",1437797280,"C8",742980,1438540260,"2015-08-02 11:31:00"
"726","20155705065729-214",2,"2015-07-24 21:09:00",1437797340,"C6",282120,1438079460,"2015-07-28 03:31:00"
"1887","20153310113338-127",2,"2015-07-24 21:35:00",1437798900,"C7",177960,1437976860,"2015-07-26 23:01:00"
"576","20151618051609-530",1,"2015-07-24 21:50:00",1437799800,"C5",267420,1438067220,"2015-07-28 00:07:00"
"3324","20155610125653-388",2,"2015-07-24 23:05:00",1437804300,"C5",178020,1437982320,"2015-07-27 00:32:00"
"376","20155210025230-794",1,"2015-07-24 23:14:00",1437804840,"C4",619860,1438424700,"2015-08-01 03:25:00"
"5068","20152819122847-981",1,"2015-07-25 00:11:00",1437808260,"C7",67740,1437876000,"2015-07-25 19:00:00"
"71","20152909122903-463",1,"2015-07-25 00:21:00",1437808860,"C4",167340,1437976200,"2015-07-26 22:50:00"
"5807","20153125023152-681",2,"2015-07-25 00:31:00",1437809460,"C4",847200,1438656660,"2015-08-03 19:51:00"
"3971","20155905015920-414",1,"2015-07-25 00:47:00",1437810420,"C8",840240,1438650660,"2015-08-03 18:11:00"
"353","20154809124808-913",3,"2015-07-25 00:58:00",1437811080,"C4",191400,1438002480,"2015-07-27 06:08:00"
"140","20154116034139-452",1,"2015-07-25 01:57:00",1437814620,"C0",91020,1437905640,"2015-07-26 03:14:00"
"3001","20154719024718-326",1,"2015-07-25 02:15:00",1437815700,"C5",236640,1438052340,"2015-07-27 19:59:00"
"796","20151722091759-375",2,"2015-07-25 02:47:00",1437817620,"C0",78600,1437896220,"2015-07-26 00:37:00"
"1985","20150516080500-163",1,"2015-07-25 02:51:00",1437817860,"C4",379380,1438197240,"2015-07-29 12:14:00"
"2460","20152517072551-546",1,"2015-07-25 02:54:00",1437818040,"C0",96420,1437914460,"2015-07-26 05:41:00"
"2","20153118013100-425",2,"2015-07-25 02:55:00",1437818100,"C7",283320,1438101420,"2015-07-28 09:37:00"
"6254","20152817062846-890",2,"2015-07-25 03:01:00",1437818460,"C0",226260,1438044720,"2015-07-27 17:52:00"
"2830","20151211061235-957",2,"2015-07-25 03:17:00",1437819420,"C5",171300,1437990720,"2015-07-27 02:52:00"
"6507","20155614075656-559",1,"2015-07-25 04:10:00",1437822600,"C8",468420,1438291020,"2015-07-30 14:17:00"
"6549","20150019010017-785",2,"2015-07-25 04:48:00",1437824880,"C4",244440,1438069320,"2015-07-28 00:42:00"
"5279","20153324063329-147",1,"2015-07-25 06:04:00",1437829440,"C6",84660,1437914100,"2015-07-26 05:35:00"
"1210","20151724081751-413",2,"2015-07-25 06:12:00",1437829920,"C4",78900,1437908820,"2015-07-26 04:07:00"
"831","20150408090423-286",1,"2015-07-25 06:24:00",1437830640,"C2",182400,1438013040,"2015-07-27 09:04:00"
"5900","20150123070109-172",2,"2015-07-25 06:25:00",1437830700,"C4",170640,1438001340,"2015-07-27 05:49:00"
"453","20152119092102-380",1,"2015-07-25 06:31:00",1437831060,"C7",72600,1437903660,"2015-07-26 02:41:00"
"3300","20152118022105-958",1,"2015-07-25 06:51:00",1437832260,"C2",577800,1438410060,"2015-07-31 23:21:00"
"869","20154109074131-62",2,"2015-07-25 07:10:00",1437833400,"C7",197220,1438030620,"2015-07-27 13:57:00"
"5202","20153117063125-391",3,"2015-07-25 08:39:00",1437838740,"C4",87360,1437926100,"2015-07-26 08:55:00"
"2167","20154819044802-78",2,"2015-07-25 08:58:00",1437839880,"C8",245100,1438084980,"2015-07-28 05:03:00"
"3088","20152120032107-809",1,"2015-07-25 09:13:00",1437840780,"C2",51240,1437892020,"2015-07-25 23:27:00"
"4098","20154823074803-769",1,"2015-07-25 09:29:00",1437841740,"C4",178860,1438020600,"2015-07-27 11:10:00"
"4736","20151319041336-619",2,"2015-07-25 10:49:00",1437846540,"C6",83160,1437929700,"2015-07-26 09:55:00"
"4776","20150409070446-883",2,"2015-07-25 10:49:00",1437846540,"C8",279180,1438125720,"2015-07-28 16:22:00"
"2130","20155203065228-993",1,"2015-07-25 11:22:00",1437848520,"C8",383400,1438231920,"2015-07-29 21:52:00"
"3794","20153717113702-835",1,"2015-07-25 11:37:00",1437849420,"C5",86400,1437935820,"2015-07-26 11:37:00"
"2891","20151523091548-948",2,"2015-07-25 12:07:00",1437851220,"C4",91560,1437942780,"2015-07-26 13:33:00"
"2021","20151721111744-664",1,"2015-07-25 12:19:00",1437851940,"C8",174660,1438026600,"2015-07-27 12:50:00"
"5391","20153723103744-695",1,"2015-07-25 12:27:00",1437852420,"C3",89700,1437942120,"2015-07-26 13:22:00"
"4532","20154103084141-252",3,"2015-07-25 13:38:00",1437856680,"C4",639540,1438496220,"2015-08-01 23:17:00"
"1626","20151918061901-392",3,"2015-07-25 14:31:00",1437859860,"C8",317160,1438177020,"2015-07-29 06:37:00"
"3109","20151811041814-115",2,"2015-07-25 15:01:00",1437861660,"C4",172140,1438033800,"2015-07-27 14:50:00"
"5771","20154320014349-634",1,"2015-07-25 15:07:00",1437862020,"C5",432720,1438294740,"2015-07-30 15:19:00"
"2419","20155522055527-809",1,"2015-07-25 15:58:00",1437865080,"C0",84060,1437949140,"2015-07-26 15:19:00"
"5408","20154421044426-552",1,"2015-07-25 16:16:00",1437866160,"C7",171960,1438038120,"2015-07-27 16:02:00"
"5206","20152005092047-998",2,"2015-07-25 16:18:00",1437866280,"C5",250440,1438116720,"2015-07-28 13:52:00"
"3201","20153322083304-339",2,"2015-07-25 16:36:00",1437867360,"C2",288180,1438155540,"2015-07-29 00:39:00"
"5923","20153428103458-866",2,"2015-07-25 18:02:00",1437872520,"C4",294960,1438167480,"2015-07-29 03:58:00"
"899","20153920073949-207",1,"2015-07-25 18:23:00",1437873780,"C5",437520,1438311300,"2015-07-30 19:55:00"
"5910","20152217032234-627",2,"2015-07-25 18:34:00",1437874440,"C5",87840,1437962280,"2015-07-26 18:58:00"
"1674","20155704065719-686",1,"2015-07-25 18:47:00",1437875220,"C8",371400,1438246620,"2015-07-30 01:57:00"
"2971","20152723112739-990",3,"2015-07-25 18:51:00",1437875460,"C8",99720,1437975180,"2015-07-26 22:33:00"
"3541","20152917092938-198",1,"2015-07-25 19:53:00",1437879180,"C5",91080,1437970260,"2015-07-26 21:11:00"
"12","20154219104241-223",1,"2015-07-25 20:00:00",1437879600,"C2",183960,1438063560,"2015-07-27 23:06:00"
"4163","20152721082743-391",1,"2015-07-25 20:12:00",1437880320,"C4",129300,1438009620,"2015-07-27 08:07:00"
"5809","20154217044214-559",1,"2015-07-25 20:24:00",1437881040,"C5",234840,1438115880,"2015-07-28 13:38:00"
"1060","20155920055919-29",1,"2015-07-25 20:32:00",1437881520,"C7",49020,1437930540,"2015-07-26 10:09:00"
"1106","20154824044810-764",1,"2015-07-25 20:50:00",1437882600,"C8",50460,1437933060,"2015-07-26 10:51:00"
"5503","20153915073941-756",1,"2015-07-25 21:03:00",1437883380,"C8",456120,1438339500,"2015-07-31 03:45:00"
"5595","20154422084401-555",2,"2015-07-25 21:11:00",1437883860,"C5",101340,1437985200,"2015-07-27 01:20:00"
"3486","20150311010308-753",3,"2015-07-25 21:59:00",1437886740,"C5",620880,1438507620,"2015-08-02 02:27:00"
"3886","20154324024355-579",3,"2015-07-25 22:01:00",1437886860,"C8",56340,1437943200,"2015-07-26 13:40:00"
"2001","20155919085959-705",1,"2015-07-25 22:08:00",1437887280,"C5",80820,1437968100,"2015-07-26 20:35:00"
"3600","20155518095558-521",1,"2015-07-25 22:25:00",1437888300,"C4",216600,1438104900,"2015-07-28 10:35:00"
"2962","20154715084738-41",2,"2015-07-25 23:03:00",1437890580,"C2",438420,1438329000,"2015-07-31 00:50:00"
"6087","20150619110604-788",1,"2015-07-26 00:10:00",1437894600,"C5",282720,1438177320,"2015-07-29 06:42:00"
"1180","20153909083938-573",2,"2015-07-26 00:47:00",1437896820,"C5",180060,1438076880,"2015-07-28 02:48:00"
"4471","20150411110416-472",2,"2015-07-26 00:50:00",1437897000,"C2",179880,1438076880,"2015-07-28 02:48:00"
"2209","20154219114228-262",2,"2015-07-26 01:22:00",1437898920,"C8",113520,1438012440,"2015-07-27 08:54:00"
"6419","20152817062832-264",2,"2015-07-26 01:40:00",1437900000,"C5",380160,1438280160,"2015-07-30 11:16:00"
"1954","20151820101815-744",2,"2015-07-26 01:45:00",1437900300,"C5",69660,1437969960,"2015-07-26 21:06:00"
"5658","20154922084949-200",3,"2015-07-26 01:52:00",1437900720,"C0",106860,1438007580,"2015-07-27 07:33:00"
"4530","20150723070741-205",2,"2015-07-26 02:16:00",1437902160,"C5",80580,1437982740,"2015-07-27 00:39:00"
"798","20151116031103-753",1,"2015-07-26 02:37:00",1437903420,"C8",409380,1438312800,"2015-07-30 20:20:00"
"5466","20152416012433-808",1,"2015-07-26 02:39:00",1437903540,"C4",275100,1438178640,"2015-07-29 07:04:00"
"835","20155706075759-768",2,"2015-07-26 03:41:00",1437907260,"C2",214080,1438121340,"2015-07-28 15:09:00"
"2504","20155717065720-517",1,"2015-07-26 03:45:00",1437907500,"C6",127680,1438035180,"2015-07-27 15:13:00"
"1209","20155416105428-103",2,"2015-07-26 04:19:00",1437909540,"C8",168060,1438077600,"2015-07-28 03:00:00"
"3595","20155217115255-205",1,"2015-07-26 05:06:00",1437912360,"C5",376620,1438288980,"2015-07-30 13:43:00"
"2400","20155005065043-343",1,"2015-07-26 06:20:00",1437916800,"C4",604200,1438521000,"2015-08-02 06:10:00"
"1564","20154421044450-831",3,"2015-07-26 07:00:00",1437919200,"C4",396960,1438316160,"2015-07-30 21:16:00"
"2741","20153623113600-392",1,"2015-07-26 07:23:00",1437920580,"C6",244020,1438164600,"2015-07-29 03:10:00"
"4234","20154704014703-466",1,"2015-07-26 07:47:00",1437922020,"C6",234900,1438156920,"2015-07-29 01:02:00"
"5119","20150922110928-182",1,"2015-07-26 08:59:00",1437926340,"C5",168900,1438095240,"2015-07-28 07:54:00"
"5336","20151922121927-280",2,"2015-07-26 09:43:00",1437928980,"C5",168120,1438097100,"2015-07-28 08:25:00"
"2957","20153020023013-76",1,"2015-07-26 09:52:00",1437929520,"C4",441960,1438371480,"2015-07-31 12:38:00"
"162","20154324014347-139",1,"2015-07-26 10:01:00",1437930060,"C5",79740,1438009800,"2015-07-27 08:10:00"
"3345","20153324083337-471",3,"2015-07-26 10:09:00",1437930540,"C2",89280,1438019820,"2015-07-27 10:57:00"
"2354","20151510031519-222",1,"2015-07-26 10:20:00",1437931200,"C8",272940,1438204140,"2015-07-29 14:09:00"
"6261","20154216104239-427",3,"2015-07-26 10:34:00",1437932040,"C8",123360,1438055400,"2015-07-27 20:50:00"
"1695","20151602031635-816",1,"2015-07-26 11:00:00",1437933600,"C3",257280,1438190880,"2015-07-29 10:28:00"
"5808","20155513115543-669",1,"2015-07-26 11:19:00",1437934740,"C6",186840,1438121580,"2015-07-28 15:13:00"
"3041","20154708064723-472",3,"2015-07-26 11:42:00",1437936120,"C4",224700,1438160820,"2015-07-29 02:07:00"
"2458","20150922070941-505",3,"2015-07-26 11:48:00",1437936480,"C4",120780,1438057260,"2015-07-27 21:21:00"
"2916","20153113043100-622",2,"2015-07-26 12:15:00",1437938100,"C4",1107840,1439045940,"2015-08-08 07:59:00"
"2391","20154323064305-880",1,"2015-07-26 12:27:00",1437938820,"C0",139920,1438078740,"2015-07-28 03:19:00"
"1159","20151710081736-544",3,"2015-07-26 13:05:00",1437941100,"C5",174960,1438116060,"2015-07-28 13:41:00"
"3649","20151521011536-810",2,"2015-07-26 13:35:00",1437942900,"C8",86640,1438029540,"2015-07-27 13:39:00"
"2543","20152724022714-969",3,"2015-07-26 14:44:00",1437947040,"C4",173820,1438120860,"2015-07-28 15:01:00"
"6364","20151413021408-91",2,"2015-07-26 14:44:00",1437947040,"C6",187500,1438134540,"2015-07-28 18:49:00"
"1700","20155616075650-682",1,"2015-07-26 14:46:00",1437947160,"C8",177720,1438124880,"2015-07-28 16:08:00"
"2151","20150312110353-306",1,"2015-07-26 14:47:00",1437947220,"C5",152880,1438100100,"2015-07-28 09:15:00"
"5045","20153317083347-992",1,"2015-07-26 14:52:00",1437947520,"C0",800340,1438747860,"2015-08-04 21:11:00"
"4237","20150420090410-374",3,"2015-07-26 15:06:00",1437948360,"C4",77160,1438025520,"2015-07-27 12:32:00"
"2858","20151216041200-755",1,"2015-07-26 15:38:00",1437950280,"C5",430980,1438381260,"2015-07-31 15:21:00"
"4452","20155812015855-673",3,"2015-07-26 15:50:00",1437951000,"C5",152040,1438103040,"2015-07-28 10:04:00"
"1189","20154513114555-897",1,"2015-07-26 16:27:00",1437953220,"C5",380040,1438333260,"2015-07-31 02:01:00"
"356","20153012023040-460",1,"2015-07-26 16:50:00",1437954600,"C7",174000,1438128600,"2015-07-28 17:10:00"
"4950","20150007090049-931",2,"2015-07-26 17:10:00",1437955800,"C2",609000,1438564800,"2015-08-02 18:20:00"
"2302","20155620115651-849",1,"2015-07-26 17:22:00",1437956520,"C8",268980,1438225500,"2015-07-29 20:05:00"
"5667","20154929114937-129",2,"2015-07-26 17:23:00",1437956580,"C3",336120,1438292700,"2015-07-30 14:45:00"
"3950","20153418033431-409",1,"2015-07-26 17:42:00",1437957720,"C4",87360,1438045080,"2015-07-27 17:58:00"
"1732","20155126035129-589",2,"2015-07-26 19:27:00",1437964020,"C5",325620,1438289640,"2015-07-30 13:54:00"
"3085","20152715102715-129",2,"2015-07-26 19:45:00",1437965100,"C4",327960,1438293060,"2015-07-30 14:51:00"
"1779","20152824122825-461",2,"2015-07-26 20:22:00",1437967320,"C4",931080,1438898400,"2015-08-06 15:00:00"
"2546","20152216022232-679",1,"2015-07-26 21:18:00",1437970680,"C3",111120,1438081800,"2015-07-28 04:10:00"
"975","20152610062612-425",1,"2015-07-26 21:56:00",1437972960,"C8",287640,1438260600,"2015-07-30 05:50:00"
"4066","20152816102825-722",1,"2015-07-26 22:01:00",1437973260,"C5",301860,1438275120,"2015-07-30 09:52:00"
"4220","20151429051412-750",1,"2015-07-26 22:20:00",1437974400,"C8",335880,1438310280,"2015-07-30 19:38:00"
"5219","20154005114042-468",1,"2015-07-26 22:45:00",1437975900,"C4",264900,1438240800,"2015-07-30 00:20:00"
"2666","20154025124046-991",1,"2015-07-26 23:26:00",1437978360,"C3",62580,1438040940,"2015-07-27 16:49:00"
"242","20151923041923-108",2,"2015-07-27 01:33:00",1437985980,"C8",146220,1438132200,"2015-07-28 18:10:00"
"4344","20151920101907-951",1,"2015-07-27 02:19:00",1437988740,"C2",72000,1438060740,"2015-07-27 22:19:00"
"2158","20153523083548-153",1,"2015-07-27 02:38:00",1437989880,"C2",108060,1438097940,"2015-07-28 08:39:00"
"1292","20152921092932-891",1,"2015-07-27 02:41:00",1437990060,"C5",246960,1438237020,"2015-07-29 23:17:00"
"1228","20151801041821-719",2,"2015-07-27 02:42:00",1437990120,"C7",313920,1438304040,"2015-07-30 17:54:00"
"705","20150111030116-821",1,"2015-07-27 02:50:00",1437990600,"C0",191220,1438181820,"2015-07-29 07:57:00"
"2795","20154018034028-142",1,"2015-07-27 02:56:00",1437990960,"C8",365880,1438356840,"2015-07-31 08:34:00"
"4198","20150403120428-179",2,"2015-07-27 04:22:00",1437996120,"C2",681960,1438678080,"2015-08-04 01:48:00"
"6344","20154819014838-806",2,"2015-07-27 04:28:00",1437996480,"C5",82200,1438078680,"2015-07-28 03:18:00"
"5477","20151522091559-339",1,"2015-07-27 04:31:00",1437996660,"C0",207480,1438204140,"2015-07-29 14:09:00"
"4438","20151001091034-497",1,"2015-07-27 04:40:00",1437997200,"C1",371700,1438368900,"2015-07-31 11:55:00"
"5019","20153602043607-343",1,"2015-07-27 05:16:00",1437999360,"C4",264900,1438264260,"2015-07-30 06:51:00"
"4874","20155823115812-779",1,"2015-07-27 05:31:00",1438000260,"C4",107460,1438107720,"2015-07-28 11:22:00"
"239","20152625102655-249",1,"2015-07-27 06:12:00",1438002720,"C4",78780,1438081500,"2015-07-28 04:05:00"
"6355","20152020062024-190",1,"2015-07-27 06:24:00",1438003440,"C8",302520,1438305960,"2015-07-30 18:26:00"
"2036","20153017103045-244",1,"2015-07-27 06:40:00",1438004400,"C8",170040,1438174440,"2015-07-29 05:54:00"
"6333","20151322101302-482",1,"2015-07-27 07:39:00",1438007940,"C5",211380,1438219320,"2015-07-29 18:22:00"
"5715","20154002114020-604",2,"2015-07-27 08:04:00",1438009440,"C5",268380,1438277820,"2015-07-30 10:37:00"
"2126","20153017103047-976",1,"2015-07-27 08:10:00",1438009800,"C0",427800,1438437600,"2015-08-01 07:00:00"
"5397","20151222061237-438",3,"2015-07-27 08:14:00",1438010040,"C3",219660,1438229700,"2015-07-29 21:15:00"
"4653","20154023044021-772",2,"2015-07-27 08:38:00",1438011480,"C3",158340,1438169820,"2015-07-29 04:37:00"
"2237","20154208034244-0",1,"2015-07-27 08:45:00",1438011900,"C4",230940,1438242840,"2015-07-30 00:54:00"
"3786","20150320030349-572",1,"2015-07-27 09:10:00",1438013400,"C5",453660,1438467060,"2015-08-01 15:11:00"
"3213","20150704100721-493",2,"2015-07-27 09:15:00",1438013700,"C3",283440,1438297140,"2015-07-30 15:59:00"
"2045","20153317093336-203",2,"2015-07-27 09:53:00",1438015980,"C7",123600,1438139580,"2015-07-28 20:13:00"
"4975","20153718113730-766",1,"2015-07-27 09:53:00",1438015980,"C2",420420,1438436400,"2015-08-01 06:40:00"
"43","20151617011611-701",1,"2015-07-27 10:12:00",1438017120,"C3",426480,1438443600,"2015-08-01 08:40:00"
"3941","20155021015058-471",1,"2015-07-27 10:16:00",1438017360,"C6",505560,1438522920,"2015-08-02 06:42:00"
"1914","20151501041530-577",2,"2015-07-27 10:39:00",1438018740,"C4",742080,1438760820,"2015-08-05 00:47:00"
"3177","20150308110350-292",2,"2015-07-27 10:57:00",1438019820,"C6",273540,1438293360,"2015-07-30 14:56:00"
"1655","20152416072430-9",3,"2015-07-27 11:09:00",1438020540,"C8",192780,1438213320,"2015-07-29 16:42:00"
"3402","20150910060904-59",2,"2015-07-27 11:16:00",1438020960,"C7",212460,1438233420,"2015-07-29 22:17:00"
"2083","20152119072136-180",1,"2015-07-27 11:28:00",1438021680,"C8",100860,1438122540,"2015-07-28 15:29:00"
"4435","20151921021945-394",3,"2015-07-27 11:40:00",1438022400,"C0",169620,1438192020,"2015-07-29 10:47:00"
"6354","20151621121625-608",3,"2015-07-27 11:51:00",1438023060,"C8",103380,1438126440,"2015-07-28 16:34:00"
"3067","20151623091621-956",1,"2015-07-27 12:43:00",1438026180,"C2",119340,1438145520,"2015-07-28 21:52:00"
"5806","20150306080327-887",2,"2015-07-27 12:50:00",1438026600,"C7",261660,1438288260,"2015-07-30 13:31:00"
"4501","20152616042649-259",1,"2015-07-27 13:04:00",1438027440,"C3",134040,1438161480,"2015-07-29 02:18:00"
"2417","20153603093633-912",2,"2015-07-27 13:26:00",1438028760,"C8",417480,1438446240,"2015-08-01 09:24:00"
"5050","20152917082925-523",1,"2015-07-27 13:26:00",1438028760,"C2",293940,1438322700,"2015-07-30 23:05:00"
"2517","20151526051501-87",1,"2015-07-27 14:12:00",1438031520,"C4",75420,1438106940,"2015-07-28 11:09:00"
"5522","20153322053343-539",1,"2015-07-27 14:28:00",1438032480,"C2",420900,1438453380,"2015-08-01 11:23:00"
"2136","20153217063258-545",2,"2015-07-27 14:56:00",1438034160,"C5",298080,1438332240,"2015-07-31 01:44:00"
"5707","20155623015620-828",1,"2015-07-27 14:56:00",1438034160,"C5",116400,1438150560,"2015-07-28 23:16:00"
"6487","20154413074407-257",1,"2015-07-27 15:36:00",1438036560,"C5",478740,1438515300,"2015-08-02 04:35:00"
"4636","20152519082511-770",2,"2015-07-27 16:15:00",1438038900,"C5",359700,1438398600,"2015-07-31 20:10:00"
"2899","20150817070821-454",2,"2015-07-27 16:28:00",1438039680,"C2",112200,1438151880,"2015-07-28 23:38:00"
"1934","20153021083029-997",3,"2015-07-27 16:50:00",1438041000,"C8",109680,1438150680,"2015-07-28 23:18:00"
"4320","20155121015153-897",1,"2015-07-27 16:55:00",1438041300,"C5",264720,1438306020,"2015-07-30 18:27:00"
"4763","20151518111558-749",2,"2015-07-27 16:59:00",1438041540,"C2",99780,1438141320,"2015-07-28 20:42:00"
"1763","20154417054458-449",1,"2015-07-27 17:06:00",1438041960,"C7",430860,1438472820,"2015-08-01 16:47:00"
"971","20154914104905-829",3,"2015-07-27 17:13:00",1438042380,"C0",382080,1438424460,"2015-08-01 03:21:00"
"6467","20151621031648-283",2,"2015-07-27 17:40:00",1438044000,"C4",65880,1438109880,"2015-07-28 11:58:00"
"1701","20155517065511-650",1,"2015-07-27 17:45:00",1438044300,"C2",129000,1438173300,"2015-07-29 05:35:00"
"4248","20152421062416-977",1,"2015-07-27 17:51:00",1438044660,"C4",559620,1438604280,"2015-08-03 05:18:00"
"1967","20154525054551-322",1,"2015-07-27 18:21:00",1438046460,"C5",87480,1438133940,"2015-07-28 18:39:00"
"1299","20151519021534-355",3,"2015-07-27 18:29:00",1438046940,"C4",100920,1438147860,"2015-07-28 22:31:00"
"6174","20154415064448-712",1,"2015-07-27 20:27:00",1438054020,"C3",1086180,1439140200,"2015-08-09 10:10:00"
"1945","20153423013422-332",2,"2015-07-27 22:19:00",1438060740,"C8",75420,1438136160,"2015-07-28 19:16:00"
"5392","20152513092550-113",1,"2015-07-27 22:43:00",1438062180,"C0",179640,1438241820,"2015-07-30 00:37:00"
"5907","20152923052943-630",1,"2015-07-27 23:15:00",1438064100,"C5",183180,1438247280,"2015-07-30 02:08:00"
"2989","20154926124932-480",1,"2015-07-28 00:09:00",1438067340,"C7",63600,1438130940,"2015-07-28 17:49:00"
"3993","20150517090533-187",1,"2015-07-28 00:17:00",1438067820,"C4",306240,1438374060,"2015-07-31 13:21:00"
"3669","20155605065613-54",2,"2015-07-28 00:56:00",1438070160,"C6",569700,1438639860,"2015-08-03 15:11:00"
"1364","20151424021410-748",3,"2015-07-28 01:58:00",1438073880,"C7",150720,1438224600,"2015-07-29 19:50:00"
"2005","20150418030419-69",1,"2015-07-28 02:49:00",1438076940,"C5",273300,1438350240,"2015-07-31 06:44:00"
"3124","20154321124336-179",1,"2015-07-28 03:09:00",1438078140,"C0",1581180,1439659320,"2015-08-15 10:22:00"
"5363","20153219043201-719",1,"2015-07-28 03:11:00",1438078260,"C7",104220,1438182480,"2015-07-29 08:08:00"
"6408","20151710021746-134",1,"2015-07-28 03:53:00",1438080780,"C4",505920,1438586700,"2015-08-03 00:25:00"
"1775","20155023065033-796",3,"2015-07-28 04:20:00",1438082400,"C4",141000,1438223400,"2015-07-29 19:30:00"
"254","20153425013459-560",1,"2015-07-28 04:30:00",1438083000,"C5",352320,1438435320,"2015-08-01 06:22:00"
"1449","20154317114331-457",1,"2015-07-28 05:03:00",1438084980,"C2",115800,1438200780,"2015-07-29 13:13:00"
"794","20154517044506-783",3,"2015-07-28 05:15:00",1438085700,"C8",181800,1438267500,"2015-07-30 07:45:00"
"5711","20154215124253-8",3,"2015-07-28 05:15:00",1438085700,"C4",365460,1438451160,"2015-08-01 10:46:00"
"885","20150022090025-737",1,"2015-07-28 05:20:00",1438086000,"C8",101040,1438187040,"2015-07-29 09:24:00"
"4566","20153306073311-379",2,"2015-07-28 05:48:00",1438087680,"C8",378900,1438466580,"2015-08-01 15:03:00"
"1460","20153024113026-294",2,"2015-07-28 05:50:00",1438087800,"C5",162600,1438250400,"2015-07-30 03:00:00"
"3819","20151022101006-317",1,"2015-07-28 06:18:00",1438089480,"C4",387060,1438476540,"2015-08-01 17:49:00"
"488","20150001080044-124",1,"2015-07-28 06:45:00",1438091100,"C5",776100,1438867200,"2015-08-06 06:20:00"
"2590","20155621035631-676",2,"2015-07-28 07:08:00",1438092480,"C5",395640,1438488120,"2015-08-01 21:02:00"
"155","20155219085255-410",1,"2015-07-28 07:25:00",1438093500,"C2",110340,1438203840,"2015-07-29 14:04:00"
"1450","20152105062151-555",2,"2015-07-28 07:27:00",1438093620,"C5",995580,1439089200,"2015-08-08 20:00:00"
"5303","20154714074704-144",3,"2015-07-28 07:51:00",1438095060,"C4",543120,1438638180,"2015-08-03 14:43:00"
"2410","20153211103235-736",1,"2015-07-28 07:57:00",1438095420,"C4",208500,1438303920,"2015-07-30 17:52:00"
"5184","20154513074545-202",1,"2015-07-28 08:08:00",1438096080,"C8",185340,1438281420,"2015-07-30 11:37:00"
"2397","20155722085740-393",1,"2015-07-28 08:13:00",1438096380,"C0",257880,1438354260,"2015-07-31 07:51:00"
"2678","20151824121833-994",1,"2015-07-28 08:34:00",1438097640,"C6",332160,1438429800,"2015-08-01 04:50:00"
"2936","20151312101325-662",3,"2015-07-28 09:27:00",1438100820,"C2",689820,1438790640,"2015-08-05 09:04:00"
"1249","20153522073506-41",1,"2015-07-28 09:53:00",1438102380,"C5",175560,1438277940,"2015-07-30 10:39:00"
"5031","20152921082906-529",3,"2015-07-28 10:25:00",1438104300,"C4",457680,1438561980,"2015-08-02 17:33:00"
"5889","20151711081724-536",1,"2015-07-28 10:33:00",1438104780,"C4",184620,1438289400,"2015-07-30 13:50:00"
"2042","20151823031815-439",1,"2015-07-28 10:54:00",1438106040,"C4",52020,1438158060,"2015-07-29 01:21:00"
"6027","20150825070821-784",2,"2015-07-28 11:16:00",1438107360,"C4",137040,1438244400,"2015-07-30 01:20:00"
"190","20150910080926-255",1,"2015-07-28 12:13:00",1438110780,"C8",784920,1438895700,"2015-08-06 14:15:00"
"1324","20152021062038-745",2,"2015-07-28 12:59:00",1438113540,"C4",209580,1438323120,"2015-07-30 23:12:00"
"1093","20154822094857-448",2,"2015-07-28 13:13:00",1438114380,"C8",1160220,1439274600,"2015-08-10 23:30:00"
"3393","20150518020501-460",1,"2015-07-28 14:29:00",1438118940,"C6",432180,1438551120,"2015-08-02 14:32:00"
"3050","20153922013946-38",3,"2015-07-28 14:39:00",1438119540,"C2",174000,1438293540,"2015-07-30 14:59:00"
"2785","20152512062545-262",1,"2015-07-28 14:58:00",1438120680,"C2",471060,1438591740,"2015-08-03 01:49:00"
"5235","20153910033908-495",3,"2015-07-28 15:31:00",1438122660,"C3",518340,1438641000,"2015-08-03 15:30:00"
"1883","20150026110014-327",3,"2015-07-28 15:36:00",1438122960,"C5",94680,1438217640,"2015-07-29 17:54:00"
"1073","20155419055407-635",2,"2015-07-28 15:38:00",1438123080,"C4",96180,1438219260,"2015-07-29 18:21:00"
"2320","20154816064800-119",1,"2015-07-28 15:54:00",1438124040,"C5",523080,1438647120,"2015-08-03 17:12:00"
"4862","20153726023718-952",1,"2015-07-28 15:56:00",1438124160,"C3",177540,1438301700,"2015-07-30 17:15:00"
"824","20155017105044-579",1,"2015-07-28 16:10:00",1438125000,"C8",193920,1438318920,"2015-07-30 22:02:00"
"4866","20153424103412-281",2,"2015-07-28 16:30:00",1438126200,"C5",183480,1438309680,"2015-07-30 19:28:00"
"4861","20152524032503-334",3,"2015-07-28 17:05:00",1438128300,"C4",175800,1438304100,"2015-07-30 17:55:00"
"3939","20151723091752-582",1,"2015-07-28 17:25:00",1438129500,"C4",461280,1438590780,"2015-08-03 01:33:00"
"5911","20153126013121-122",3,"2015-07-28 17:29:00",1438129740,"C7",93540,1438223280,"2015-07-29 19:28:00"
"3810","20154706014712-28",2,"2015-07-28 17:47:00",1438130820,"C2",273600,1438404420,"2015-07-31 21:47:00"
"4151","20154315094344-834",2,"2015-07-28 18:43:00",1438134180,"C2",385200,1438519380,"2015-08-02 05:43:00"
"4238","20150807050820-790",1,"2015-07-28 19:43:00",1438137780,"C8",883140,1439020920,"2015-08-08 01:02:00"
"5217","20152421072403-434",3,"2015-07-28 19:54:00",1438138440,"C8",129960,1438268400,"2015-07-30 08:00:00"
"3230","20155723025701-227",1,"2015-07-28 20:06:00",1438139160,"C2",150180,1438289340,"2015-07-30 13:49:00"
"1549","20153610043627-233",2,"2015-07-28 20:12:00",1438139520,"C5",522720,1438662240,"2015-08-03 21:24:00"
"4398","20151704071753-165",1,"2015-07-28 20:13:00",1438139580,"C5",302880,1438442460,"2015-08-01 08:21:00"
"2946","20155724065712-217",1,"2015-07-28 20:18:00",1438139880,"C2",131220,1438271100,"2015-07-30 08:45:00"
"100","20153313023303-282",3,"2015-07-28 20:28:00",1438140480,"C8",263460,1438403940,"2015-07-31 21:39:00"
"2706","20150806030837-471",1,"2015-07-28 20:39:00",1438141140,"C5",274380,1438415520,"2015-08-01 00:52:00"
"6510","20155426095420-438",2,"2015-07-28 20:56:00",1438142160,"C8",106260,1438248420,"2015-07-30 02:27:00"
"2211","20153504073526-319",1,"2015-07-28 21:45:00",1438145100,"C8",424920,1438570020,"2015-08-02 19:47:00"
"3557","20151501041514-837",1,"2015-07-28 21:56:00",1438145760,"C7",336180,1438481940,"2015-08-01 19:19:00"
"3447","20150923050915-668",1,"2015-07-28 22:13:00",1438146780,"C0",64320,1438211100,"2015-07-29 16:05:00"
"4474","20150523010518-241",1,"2015-07-28 22:41:00",1438148460,"C2",58320,1438206780,"2015-07-29 14:53:00"
"640","20153712013720-181",3,"2015-07-28 22:51:00",1438149060,"C6",206700,1438355760,"2015-07-31 08:16:00"
"1786","20153424123435-575",2,"2015-07-28 23:58:00",1438153080,"C7",193320,1438346400,"2015-07-31 05:40:00"
"6357","20153920123932-501",2,"2015-07-29 00:04:00",1438153440,"C8",664860,1438818300,"2015-08-05 16:45:00"
"1473","20154825104838-640",2,"2015-07-29 00:51:00",1438156260,"C5",103260,1438259520,"2015-07-30 05:32:00"
"3531","20153211063223-512",1,"2015-07-29 00:56:00",1438156560,"C5",191880,1438348440,"2015-07-31 06:14:00"
"4666","20154626064610-637",1,"2015-07-29 01:12:00",1438157520,"C8",119580,1438277100,"2015-07-30 10:25:00"
"5162","20155917015932-755",3,"2015-07-29 01:33:00",1438158780,"C8",496020,1438654800,"2015-08-03 19:20:00"
"4197","20155123015131-999",1,"2015-07-29 01:51:00",1438159860,"C5",158400,1438318260,"2015-07-30 21:51:00"
"2875","20155327105347-925",1,"2015-07-29 02:03:00",1438160580,"C8",70500,1438231080,"2015-07-29 21:38:00"
"3131","20152219092238-393",3,"2015-07-29 02:31:00",1438162260,"C2",279780,1438442040,"2015-08-01 08:14:00"
"5670","20155306095352-482",3,"2015-07-29 02:43:00",1438162980,"C5",280200,1438443180,"2015-08-01 08:33:00"
"1370","20153925023931-202",2,"2015-07-29 03:05:00",1438164300,"C5",151980,1438316280,"2015-07-30 21:18:00"
"761","20155526125517-937",1,"2015-07-29 03:35:00",1438166100,"C8",112800,1438278900,"2015-07-30 10:55:00"
"1471","20152525042519-381",2,"2015-07-29 03:52:00",1438167120,"C2",100140,1438267260,"2015-07-30 07:41:00"
"538","20152126032100-410",3,"2015-07-29 04:15:00",1438168500,"C4",73080,1438241580,"2015-07-30 00:33:00"
"5860","20151622041646-326",1,"2015-07-29 04:26:00",1438169160,"C8",281100,1438450260,"2015-08-01 10:31:00"
"533","20153622103615-743",2,"2015-07-29 04:27:00",1438169220,"C4",194220,1438363440,"2015-07-31 10:24:00"
"4179","20155303025331-674",1,"2015-07-29 04:35:00",1438169700,"C6",368220,1438537920,"2015-08-02 10:52:00"
"4114","20155008095000-690",2,"2015-07-29 05:17:00",1438172220,"C0",256860,1438429080,"2015-08-01 04:38:00"
"3688","20152824012815-413",1,"2015-07-29 05:38:00",1438173480,"C2",201900,1438375380,"2015-07-31 13:43:00"
"3528","20151127091156-609",3,"2015-07-29 07:21:00",1438179660,"C8",83100,1438262760,"2015-07-30 06:26:00"
"477","20155914045934-20",2,"2015-07-29 07:31:00",1438180260,"C2",481740,1438662000,"2015-08-03 21:20:00"
"226","20152322092332-533",3,"2015-07-29 07:55:00",1438181700,"C0",74940,1438256640,"2015-07-30 04:44:00"
"4605","20154519024544-322",2,"2015-07-29 08:13:00",1438182780,"C4",202140,1438384920,"2015-07-31 16:22:00"
"4891","20153824043829-635",3,"2015-07-29 08:33:00",1438183980,"C8",80580,1438264560,"2015-07-30 06:56:00"
"2296","20155206025224-627",2,"2015-07-29 08:36:00",1438184160,"C0",245580,1438429740,"2015-08-01 04:49:00"
"4661","20155009035026-293",1,"2015-07-29 08:40:00",1438184400,"C2",851100,1439035500,"2015-08-08 05:05:00"
"4152","20155424105453-864",1,"2015-07-29 08:54:00",1438185240,"C1",212400,1438397640,"2015-07-31 19:54:00"
"2622","20152028022013-691",1,"2015-07-29 09:15:00",1438186500,"C6",68100,1438254600,"2015-07-30 04:10:00"
"5996","20153419013456-499",2,"2015-07-29 09:22:00",1438186920,"C2",424440,1438611360,"2015-08-03 07:16:00"
"5944","20154121094145-294",1,"2015-07-29 09:50:00",1438188600,"C0",691740,1438880340,"2015-08-06 09:59:00"
"471","20150528080517-604",1,"2015-07-29 10:31:00",1438191060,"C6",95160,1438286220,"2015-07-30 12:57:00"
"4092","20155027085049-858",2,"2015-07-29 11:22:00",1438194120,"C8",90960,1438285080,"2015-07-30 12:38:00"
"2189","20155325045321-836",1,"2015-07-29 11:45:00",1438195500,"C0",327120,1438522620,"2015-08-02 06:37:00"
"454","20155209085255-542",3,"2015-07-29 11:46:00",1438195560,"C6",289740,1438485300,"2015-08-01 20:15:00"
"252","20153624073615-56",1,"2015-07-29 12:04:00",1438196640,"C3",224040,1438420680,"2015-08-01 02:18:00"
"2420","20153611043604-222",2,"2015-07-29 12:04:00",1438196640,"C0",219840,1438416480,"2015-08-01 01:08:00"
"307","20155216055209-787",2,"2015-07-29 13:08:00",1438200480,"C6",1106160,1439306640,"2015-08-11 08:24:00"
"3630","20150105080122-729",1,"2015-07-29 13:29:00",1438201740,"C5",299040,1438500780,"2015-08-02 00:33:00"
"160","20150717050734-803",1,"2015-07-29 13:43:00",1438202580,"C5",512280,1438714860,"2015-08-04 12:01:00"
"4992","20150820090851-701",2,"2015-07-29 13:45:00",1438202700,"C8",113460,1438316160,"2015-07-30 21:16:00"
"258","20150624060606-582",1,"2015-07-29 14:28:00",1438205280,"C7",231060,1438436340,"2015-08-01 06:39:00"
"523","20152130052126-284",1,"2015-07-29 14:42:00",1438206120,"C5",356580,1438562700,"2015-08-02 17:45:00"
"5074","20150825050807-78",1,"2015-07-29 15:14:00",1438208040,"C4",338760,1438546800,"2015-08-02 13:20:00"
"3556","20151811021803-685",1,"2015-07-29 15:16:00",1438208160,"C5",779340,1438987500,"2015-08-07 15:45:00"
"2750","20153328073330-51",1,"2015-07-29 15:43:00",1438209780,"C4",115800,1438325580,"2015-07-30 23:53:00"
"14","20152923102955-348",2,"2015-07-29 16:24:00",1438212240,"C8",77100,1438289340,"2015-07-30 13:49:00"
"1856","20154812054846-708",1,"2015-07-29 16:36:00",1438212960,"C2",488160,1438701120,"2015-08-04 08:12:00"
"1326","20153228033232-771",1,"2015-07-29 17:32:00",1438216320,"C2",93600,1438309920,"2015-07-30 19:32:00"
"4188","20152528012542-188",1,"2015-07-29 17:44:00",1438217040,"C4",101940,1438318980,"2015-07-30 22:03:00"
"137","20150826100844-912",2,"2015-07-29 17:53:00",1438217580,"C5",95700,1438313280,"2015-07-30 20:28:00"
"2295","20151219051238-555",2,"2015-07-29 18:59:00",1438221540,"C6",870420,1439091960,"2015-08-08 20:46:00"
"1490","20152726032754-124",1,"2015-07-29 19:00:00",1438221600,"C5",409140,1438630740,"2015-08-03 12:39:00"
"6413","20155026125036-291",2,"2015-07-29 19:15:00",1438222500,"C2",282300,1438504800,"2015-08-02 01:40:00"
"3807","20150910090926-819",1,"2015-07-29 19:27:00",1438223220,"C6",279780,1438503000,"2015-08-02 01:10:00"
"2025","20155317125332-60",2,"2015-07-29 19:47:00",1438224420,"C4",1061640,1439286060,"2015-08-11 02:41:00"
"2846","20150923090925-163",3,"2015-07-29 20:12:00",1438225920,"C5",79740,1438305660,"2015-07-30 18:21:00"
"1764","20150624030614-941",1,"2015-07-29 21:06:00",1438229160,"C8",64800,1438293960,"2015-07-30 15:06:00"
"5745","20155724025757-642",2,"2015-07-29 21:30:00",1438230600,"C5",151860,1438382460,"2015-07-31 15:41:00"
"4189","20151920081921-606",3,"2015-07-29 21:41:00",1438231260,"C5",117960,1438349220,"2015-07-31 06:27:00"
"3986","20153423013440-640",1,"2015-07-29 21:50:00",1438231800,"C3",68520,1438300320,"2015-07-30 16:52:00"
"1374","20152926022953-770",1,"2015-07-29 22:01:00",1438232460,"C3",143160,1438375620,"2015-07-31 13:47:00"
"4009","20150925050919-689",3,"2015-07-29 22:33:00",1438234380,"C7",182520,1438416900,"2015-08-01 01:15:00"
"5200","20151121031117-949",1,"2015-07-29 23:14:00",1438236840,"C4",240060,1438476900,"2015-08-01 17:55:00"
"5339","20152709082754-396",1,"2015-07-29 23:14:00",1438236840,"C7",254460,1438491300,"2015-08-01 21:55:00"
"4085","20153922073948-796",1,"2015-07-29 23:24:00",1438237440,"C3",220500,1438457940,"2015-08-01 12:39:00"
"5127","20155724015759-778",1,"2015-07-29 23:49:00",1438238940,"C7",233760,1438472700,"2015-08-01 16:45:00"
"3086","20150915010905-807",2,"2015-07-29 23:53:00",1438239180,"C2",178320,1438417500,"2015-08-01 01:25:00"
"5149","20154526024508-653",1,"2015-07-30 00:20:00",1438240800,"C8",58740,1438299540,"2015-07-30 16:39:00"
"711","20151612101618-908",3,"2015-07-30 00:22:00",1438240920,"C6",253260,1438494180,"2015-08-01 22:43:00"
"4778","20154217104217-430",1,"2015-07-30 00:38:00",1438241880,"C2",155280,1438397160,"2015-07-31 19:46:00"
"250","20153227033233-52",1,"2015-07-30 01:08:00",1438243680,"C4",69120,1438312800,"2015-07-30 20:20:00"
"3406","20152207112247-321",3,"2015-07-30 02:02:00",1438246920,"C4",244200,1438491120,"2015-08-01 21:52:00"
"1146","20152012092008-483",1,"2015-07-30 02:07:00",1438247220,"C5",218460,1438465680,"2015-08-01 14:48:00"
"6477","20154212064205-889",2,"2015-07-30 02:34:00",1438248840,"C6",192540,1438441380,"2015-08-01 08:03:00"
"6206","20152205022233-507",2,"2015-07-30 02:54:00",1438250040,"C0",264840,1438514880,"2015-08-02 04:28:00"
"2930","20155822115853-505",1,"2015-07-30 03:30:00",1438252200,"C7",330360,1438582560,"2015-08-02 23:16:00"
"2528","20155514015554-802",2,"2015-07-30 03:34:00",1438252440,"C7",149460,1438401900,"2015-07-31 21:05:00"
"4713","20151224121210-614",2,"2015-07-30 04:06:00",1438254360,"C5",163080,1438417440,"2015-08-01 01:24:00"
"976","20153324033341-637",2,"2015-07-30 04:09:00",1438254540,"C4",238680,1438493220,"2015-08-01 22:27:00"
"5421","20154221064205-207",1,"2015-07-30 04:37:00",1438256220,"C7",480300,1438736520,"2015-08-04 18:02:00"
"2810","20153123103101-33",2,"2015-07-30 05:23:00",1438258980,"C8",83760,1438342740,"2015-07-31 04:39:00"
"4620","20155618095623-707",1,"2015-07-30 05:26:00",1438259160,"C3",340200,1438599360,"2015-08-03 03:56:00"
"6400","20151621091605-465",1,"2015-07-30 05:30:00",1438259400,"C7",382020,1438641420,"2015-08-03 15:37:00"
"32","20152902022959-436",1,"2015-07-30 06:39:00",1438263540,"C0",1195500,1439459040,"2015-08-13 02:44:00"
"2474","20151318101338-951",2,"2015-07-30 06:47:00",1438264020,"C7",512220,1438776240,"2015-08-05 05:04:00"
"2493","20150117060105-392",1,"2015-07-30 07:29:00",1438266540,"C5",141060,1438407600,"2015-07-31 22:40:00"
"3830","20155929045944-214",1,"2015-07-30 07:55:00",1438268100,"C0",330720,1438598820,"2015-08-03 03:47:00"
"4626","20151923121906-266",3,"2015-07-30 09:01:00",1438272060,"C5",197640,1438469700,"2015-08-01 15:55:00"
"491","20154805104835-68",3,"2015-07-30 09:12:00",1438272720,"C2",269280,1438542000,"2015-08-02 12:00:00"
"1595","20153816023820-577",2,"2015-07-30 09:33:00",1438273980,"C8",238260,1438512240,"2015-08-02 03:44:00"
"2102","20153026053002-255",3,"2015-07-30 09:35:00",1438274100,"C4",45300,1438319400,"2015-07-30 22:10:00"
"2161","20150925110937-663",3,"2015-07-30 09:38:00",1438274280,"C6",426540,1438700820,"2015-08-04 08:07:00"
"4420","20154218024228-691",1,"2015-07-30 10:02:00",1438275720,"C4",510000,1438785720,"2015-08-05 07:42:00"
"74","20152824082844-651",3,"2015-07-30 10:34:00",1438277640,"C8",262980,1438540620,"2015-08-02 11:37:00"
"4099","20151105091109-417",2,"2015-07-30 11:05:00",1438279500,"C6",361140,1438640640,"2015-08-03 15:24:00"
"864","20152520092520-405",2,"2015-07-30 11:23:00",1438280580,"C3",124440,1438405020,"2015-07-31 21:57:00"
"5536","20155230115226-97",3,"2015-07-30 11:40:00",1438281600,"C8",1295640,1439577240,"2015-08-14 11:34:00"
"642","20154724114756-664",2,"2015-07-30 12:03:00",1438282980,"C6",64920,1438347900,"2015-07-31 06:05:00"
"4771","20153623073647-385",3,"2015-07-30 13:54:00",1438289640,"C5",89640,1438379280,"2015-07-31 14:48:00"
"2805","20153404053446-388",1,"2015-07-30 14:07:00",1438290420,"C2",319140,1438609560,"2015-08-03 06:46:00"
"2837","20153706033723-432",3,"2015-07-30 14:09:00",1438290540,"C3",582540,1438873080,"2015-08-06 07:58:00"
"3536","20153526063512-278",1,"2015-07-30 15:13:00",1438294380,"C8",188340,1438482720,"2015-08-01 19:32:00"
"2173","20150719120749-370",1,"2015-07-30 15:32:00",1438295520,"C8",192540,1438488060,"2015-08-01 21:01:00"
"6527","20152624102605-26",1,"2015-07-30 15:46:00",1438296360,"C8",268800,1438565160,"2015-08-02 18:26:00"
"1802","20154101014157-341",1,"2015-07-30 16:03:00",1438297380,"C7",359160,1438656540,"2015-08-03 19:49:00"
"3933","20155825015847-776",3,"2015-07-30 16:07:00",1438297620,"C2",62820,1438360440,"2015-07-31 09:34:00"
"2845","20150918090928-755",2,"2015-07-30 16:29:00",1438298940,"C5",531600,1438830540,"2015-08-05 20:09:00"
"2335","20150217100259-352",1,"2015-07-30 17:28:00",1438302480,"C2",164280,1438466760,"2015-08-01 15:06:00"
"2356","20150923010916-544",3,"2015-07-30 17:42:00",1438303320,"C0",88740,1438392060,"2015-07-31 18:21:00"
"6128","20153225093249-352",1,"2015-07-30 17:47:00",1438303620,"C8",92340,1438395960,"2015-07-31 19:26:00"
"4635","20152601112611-300",2,"2015-07-30 17:53:00",1438303980,"C4",361260,1438665240,"2015-08-03 22:14:00"
"6028","20150223090243-726",3,"2015-07-30 17:54:00",1438304040,"C0",90960,1438395000,"2015-07-31 19:10:00"
"1994","20151426111428-477",2,"2015-07-30 18:26:00",1438305960,"C2",185760,1438491720,"2015-08-01 22:02:00"
"1830","20150122050120-946",1,"2015-07-30 18:59:00",1438307940,"C4",349140,1438657080,"2015-08-03 19:58:00"
"1621","20150817040833-849",2,"2015-07-30 19:15:00",1438308900,"C8",162060,1438470960,"2015-08-01 16:16:00"
"4470","20155820065827-219",2,"2015-07-30 19:54:00",1438311240,"C2",130080,1438441320,"2015-08-01 08:02:00"
"2965","20155705025745-109",1,"2015-07-30 20:03:00",1438311780,"C7",242040,1438553820,"2015-08-02 15:17:00"
"159","20155424015436-907",3,"2015-07-30 21:13:00",1438315980,"C2",77820,1438393800,"2015-07-31 18:50:00"
"3471","20151428031458-998",1,"2015-07-30 21:24:00",1438316640,"C8",97500,1438414140,"2015-08-01 00:29:00"
"4506","20154726064756-747",1,"2015-07-30 21:59:00",1438318740,"C7",200160,1438518900,"2015-08-02 05:35:00"
"3443","20154023084005-11",1,"2015-07-30 22:25:00",1438320300,"C4",218100,1438538400,"2015-08-02 11:00:00"
"4212","20155804035844-100",3,"2015-07-30 22:40:00",1438321200,"C5",324360,1438645560,"2015-08-03 16:46:00"
"1814","20155724015737-87",3,"2015-07-30 22:45:00",1438321500,"C3",275040,1438596540,"2015-08-03 03:09:00"
"940","20153726073704-996",3,"2015-07-30 23:01:00",1438322460,"C5",133680,1438456140,"2015-08-01 12:09:00"
"2922","20152301022309-569",2,"2015-07-30 23:17:00",1438323420,"C5",362520,1438685940,"2015-08-04 03:59:00"
"210","20155710015717-292",2,"2015-07-30 23:36:00",1438324560,"C5",587580,1438912140,"2015-08-06 18:49:00"
"4337","20150112110147-385",1,"2015-07-31 00:13:00",1438326780,"C6",699120,1439025900,"2015-08-08 02:25:00"
"4906","20153617033658-794",3,"2015-07-31 01:29:00",1438331340,"C5",165540,1438496880,"2015-08-01 23:28:00"
"70","20151924091930-39",1,"2015-07-31 01:47:00",1438332420,"C5",288840,1438621260,"2015-08-03 10:01:00"
"2473","20150004010010-724",2,"2015-07-31 02:14:00",1438334040,"C3",327720,1438661760,"2015-08-03 21:16:00"
"504","20153404123427-942",1,"2015-07-31 02:49:00",1438336140,"C0",765900,1439102040,"2015-08-08 23:34:00"
"1892","20152208032247-227",1,"2015-07-31 03:14:00",1438337640,"C0",242940,1438580580,"2015-08-02 22:43:00"
"4774","20151124031108-240",1,"2015-07-31 03:24:00",1438338240,"C2",80340,1438418580,"2015-08-01 01:43:00"
"5790","20154818114855-997",1,"2015-07-31 03:26:00",1438338360,"C5",546540,1438884900,"2015-08-06 11:15:00"
"6389","20150426070452-144",1,"2015-07-31 04:04:00",1438340640,"C8",84240,1438424880,"2015-08-01 03:28:00"
"6085","20155109045104-759",3,"2015-07-31 04:31:00",1438342260,"C4",265200,1438607460,"2015-08-03 06:11:00"
"3656","20152024062006-883",3,"2015-07-31 04:38:00",1438342680,"C5",299340,1438642020,"2015-08-03 15:47:00"
"6465","20153223113200-303",1,"2015-07-31 05:18:00",1438345080,"C3",334380,1438679460,"2015-08-04 02:11:00"
"2857","20151119031125-461",2,"2015-07-31 05:20:00",1438345200,"C2",333780,1438678980,"2015-08-04 02:03:00"
"5723","20150804100804-119",1,"2015-07-31 05:40:00",1438346400,"C7",330960,1438677360,"2015-08-04 01:36:00"
"6099","20150115080143-276",2,"2015-07-31 05:45:00",1438346700,"C7",687120,1439033820,"2015-08-08 04:37:00"
"2388","20153423073421-295",3,"2015-07-31 05:56:00",1438347360,"C8",342660,1438690020,"2015-08-04 05:07:00"
"3072","20155029045031-175",2,"2015-07-31 06:07:00",1438348020,"C3",134220,1438482240,"2015-08-01 19:24:00"
"6149","20152626062625-468",1,"2015-07-31 06:11:00",1438348260,"C5",143700,1438491960,"2015-08-01 22:06:00"
"6494","20154926124914-356",1,"2015-07-31 06:35:00",1438349700,"C2",204780,1438554480,"2015-08-02 15:28:00"
"6396","20154721044741-483",2,"2015-07-31 06:41:00",1438350060,"C4",413820,1438763880,"2015-08-05 01:38:00"
"1368","20155230025233-218",1,"2015-07-31 07:15:00",1438352100,"C6",58980,1438411080,"2015-07-31 23:38:00"
"1756","20154924014948-415",1,"2015-07-31 07:37:00",1438353420,"C6",97080,1438450500,"2015-08-01 10:35:00"
"5569","20154428094403-173",1,"2015-07-31 07:58:00",1438354680,"C7",126420,1438481100,"2015-08-01 19:05:00"
"6300","20151221091244-979",2,"2015-07-31 08:22:00",1438356120,"C7",430500,1438786620,"2015-08-05 07:57:00"
"4115","20153510103502-685",1,"2015-07-31 08:26:00",1438356360,"C5",602220,1438958580,"2015-08-07 07:43:00"
"3205","20150103020130-343",1,"2015-07-31 08:41:00",1438357260,"C4",624000,1438981260,"2015-08-07 14:01:00"
"5054","20154517094500-459",2,"2015-07-31 08:53:00",1438357980,"C8",542640,1438900620,"2015-08-06 15:37:00"
"791","20151029071056-312",1,"2015-07-31 10:06:00",1438362360,"C8",91680,1438454040,"2015-08-01 11:34:00"
"2035","20154107104138-147",2,"2015-07-31 10:47:00",1438364820,"C2",296280,1438661100,"2015-08-03 21:05:00"
"670","20150029080012-457",2,"2015-07-31 12:04:00",1438369440,"C5",93720,1438463160,"2015-08-01 14:06:00"
"4665","20153927083929-384",1,"2015-07-31 12:09:00",1438369740,"C4",119400,1438489140,"2015-08-01 21:19:00"
"4972","20152727032734-400",2,"2015-07-31 12:11:00",1438369860,"C8",166920,1438536780,"2015-08-02 10:33:00"
"4729","20153123063158-685",1,"2015-07-31 12:44:00",1438371840,"C0",101940,1438473780,"2015-08-01 17:03:00"
"2827","20155317095355-5",1,"2015-07-31 13:29:00",1438374540,"C6",203760,1438578300,"2015-08-02 22:05:00"
"1751","20154112014114-381",1,"2015-07-31 14:15:00",1438377300,"C6",201840,1438579140,"2015-08-02 22:19:00"
"3316","20153817033857-516",1,"2015-07-31 14:25:00",1438377900,"C2",1205220,1439583120,"2015-08-14 13:12:00"
"1090","20150216030218-144",1,"2015-07-31 14:41:00",1438378860,"C5",431580,1438810440,"2015-08-05 14:34:00"
"2131","20150727070729-782",1,"2015-07-31 15:07:00",1438380420,"C2",374400,1438754820,"2015-08-04 23:07:00"
"4582","20154821044806-248",2,"2015-07-31 15:58:00",1438383480,"C4",430500,1438813980,"2015-08-05 15:33:00"
"1104","20155229095223-993",1,"2015-07-31 16:30:00",1438385400,"C6",196680,1438582080,"2015-08-02 23:08:00"
"3398","20151422011417-46",1,"2015-07-31 16:48:00",1438386480,"C7",112920,1438499400,"2015-08-02 00:10:00"
"3750","20155225025231-666",2,"2015-07-31 17:16:00",1438388160,"C4",65880,1438454040,"2015-08-01 11:34:00"
"3337","20155818035853-341",2,"2015-07-31 17:38:00",1438389480,"C5",531600,1438921080,"2015-08-06 21:18:00"
"1902","20155726085710-998",2,"2015-07-31 17:45:00",1438389900,"C4",463680,1438853580,"2015-08-06 02:33:00"
"2998","20150124090106-75",1,"2015-07-31 17:46:00",1438389960,"C3",212100,1438602060,"2015-08-03 04:41:00"
"5155","20151125121136-226",2,"2015-07-31 17:56:00",1438390560,"C5",179700,1438570260,"2015-08-02 19:51:00"
"6038","20151824041829-872",1,"2015-07-31 18:11:00",1438391460,"C0",611580,1439003040,"2015-08-07 20:04:00"
"2196","20154908044958-492",1,"2015-07-31 18:19:00",1438391940,"C2",664200,1439056140,"2015-08-08 10:49:00"
"3574","20150530110520-639",3,"2015-07-31 18:41:00",1438393260,"C2",113760,1438507020,"2015-08-02 02:17:00"
"747","20154615054615-774",3,"2015-07-31 19:22:00",1438395720,"C5",173520,1438569240,"2015-08-02 19:34:00"
"3927","20150526060526-540",2,"2015-07-31 19:32:00",1438396320,"C0",480420,1438876740,"2015-08-06 08:59:00"
"2638","20151426021410-715",1,"2015-07-31 19:45:00",1438397100,"C3",451860,1438848960,"2015-08-06 01:16:00"
"3599","20155304035331-275",1,"2015-07-31 19:45:00",1438397100,"C8",1173360,1439570460,"2015-08-14 09:41:00"
"187","20151328091352-263",1,"2015-07-31 19:52:00",1438397520,"C5",99180,1438496700,"2015-08-01 23:25:00"
"842","20150316030333-652",2,"2015-07-31 19:52:00",1438397520,"C5",187620,1438585140,"2015-08-02 23:59:00"
"4448","20155123035157-563",2,"2015-07-31 20:47:00",1438400820,"C2",101280,1438502100,"2015-08-02 00:55:00"
"3130","20150425050434-33",1,"2015-07-31 20:56:00",1438401360,"C6",532320,1438933680,"2015-08-07 00:48:00"
"2195","20154423094459-117",2,"2015-07-31 21:28:00",1438403280,"C3",366720,1438770000,"2015-08-05 03:20:00"
"6219","20151329051347-815",3,"2015-07-31 22:43:00",1438407780,"C8",96300,1438504080,"2015-08-02 01:28:00"
"910","20155427065441-961",1,"2015-07-31 22:58:00",1438408680,"C0",201720,1438610400,"2015-08-03 07:00:00"
"911","20154625084640-549",1,"2015-07-31 23:12:00",1438409520,"C4",81480,1438491000,"2015-08-01 21:50:00"
"150","20154211034247-278",1,"2015-08-01 00:20:00",1438413600,"C8",879540,1439293140,"2015-08-11 04:39:00"
"969","20154725114714-121",3,"2015-08-01 00:21:00",1438413660,"C7",80520,1438494180,"2015-08-01 22:43:00"
"6486","20150830090823-240",1,"2015-08-01 00:59:00",1438415940,"C8",390780,1438806720,"2015-08-05 13:32:00"
"3840","20153901033952-705",3,"2015-08-01 01:21:00",1438417260,"C5",875640,1439292900,"2015-08-11 04:35:00"
"3143","20155625055644-429",1,"2015-08-01 01:22:00",1438417320,"C2",77880,1438495200,"2015-08-01 23:00:00"
"4565","20154124104119-137",3,"2015-08-01 01:23:00",1438417380,"C8",93960,1438511340,"2015-08-02 03:29:00"
"4133","20155227085257-55",1,"2015-08-01 01:26:00",1438417560,"C2",202620,1438620180,"2015-08-03 09:43:00"
"6247","20154107124133-326",2,"2015-08-01 01:37:00",1438418220,"C5",589020,1439007240,"2015-08-07 21:14:00"
"3427","20151916101912-704",2,"2015-08-01 02:04:00",1438419840,"C2",450900,1438870740,"2015-08-06 07:19:00"
"6552","20151229041225-130",1,"2015-08-01 03:25:00",1438424700,"C2",400740,1438825440,"2015-08-05 18:44:00"
"4990","20155424065455-846",2,"2015-08-01 03:26:00",1438424760,"C7",96960,1438521720,"2015-08-02 06:22:00"
"341","20151326031334-997",1,"2015-08-01 03:33:00",1438425180,"C8",95280,1438520460,"2015-08-02 06:01:00"
"1029","20154905084932-890",3,"2015-08-01 03:55:00",1438426500,"C0",771720,1439198220,"2015-08-10 02:17:00"
"3294","20153018053053-129",2,"2015-08-01 04:26:00",1438428360,"C7",166080,1438594440,"2015-08-03 02:34:00"
"1271","20150703080734-840",2,"2015-08-01 04:32:00",1438428720,"C2",356100,1438784820,"2015-08-05 07:27:00"
"5964","20151819091842-213",1,"2015-08-01 04:47:00",1438429620,"C3",528420,1438958040,"2015-08-07 07:34:00"
"4657","20150624050603-927",3,"2015-08-01 04:58:00",1438430280,"C8",323760,1438754040,"2015-08-04 22:54:00"
"3290","20150725030751-337",1,"2015-08-01 05:26:00",1438431960,"C4",81420,1438513380,"2015-08-02 04:03:00"
"1383","20150021080000-521",3,"2015-08-01 05:28:00",1438432080,"C3",470640,1438902720,"2015-08-06 16:12:00"
"774","20151317071311-118",3,"2015-08-01 05:43:00",1438432980,"C8",258120,1438691100,"2015-08-04 05:25:00"
"5016","20153622083653-391",1,"2015-08-01 06:14:00",1438434840,"C5",427740,1438862580,"2015-08-06 05:03:00"
"2103","20152405122436-184",3,"2015-08-01 06:24:00",1438435440,"C2",288900,1438724340,"2015-08-04 14:39:00"
"1821","20153924083911-558",2,"2015-08-01 06:31:00",1438435860,"C5",341760,1438777620,"2015-08-05 05:27:00"
"5316","20153117083124-431",2,"2015-08-01 06:34:00",1438436040,"C7",184140,1438620180,"2015-08-03 09:43:00"
"6084","20152731082747-677",1,"2015-08-01 06:36:00",1438436160,"C2",79740,1438515900,"2015-08-02 04:45:00"
"3815","20155627055642-893",2,"2015-08-01 07:48:00",1438440480,"C5",49440,1438489920,"2015-08-01 21:32:00"
"1391","20153730013710-947",1,"2015-08-01 08:02:00",1438441320,"C3",152700,1438594020,"2015-08-03 02:27:00"
"6255","20155729095756-876",3,"2015-08-01 08:51:00",1438444260,"C5",127620,1438571880,"2015-08-02 20:18:00"
"178","20155407085436-987",2,"2015-08-01 09:26:00",1438446360,"C5",270240,1438716600,"2015-08-04 12:30:00"
"6154","20152118042118-402",3,"2015-08-01 09:42:00",1438447320,"C2",169380,1438616700,"2015-08-03 08:45:00"
"896","20151824101840-224",2,"2015-08-01 09:50:00",1438447800,"C8",344760,1438792560,"2015-08-05 09:36:00"
"5348","20151102031156-128",2,"2015-08-01 09:51:00",1438447860,"C8",514560,1438962420,"2015-08-07 08:47:00"
"2994","20152529092534-521",3,"2015-08-01 10:41:00",1438450860,"C8",131880,1438582740,"2015-08-02 23:19:00"
"5289","20152830082817-542",1,"2015-08-01 11:00:00",1438452000,"C6",181920,1438633920,"2015-08-03 13:32:00"
"5294","20154029064002-238",1,"2015-08-01 11:01:00",1438452060,"C4",274860,1438726920,"2015-08-04 15:22:00"
"1542","20155509065515-933",2,"2015-08-01 12:01:00",1438455660,"C7",222840,1438678500,"2015-08-04 01:55:00"
"619","20152027072040-298",1,"2015-08-01 13:40:00",1438461600,"C7",227400,1438689000,"2015-08-04 04:50:00"
"6523","20155418045421-624",1,"2015-08-01 13:54:00",1438462440,"C4",599400,1439061840,"2015-08-08 12:24:00"
"3885","20150828090834-36",2,"2015-08-01 14:20:00",1438464000,"C5",182160,1438646160,"2015-08-03 16:56:00"
"1518","20151623071615-935",2,"2015-08-01 16:22:00",1438471320,"C0",270120,1438741440,"2015-08-04 19:24:00"
"3351","20150031030030-236",1,"2015-08-01 16:35:00",1438472100,"C2",92100,1438564200,"2015-08-02 18:10:00"
"1406","20150725040701-369",2,"2015-08-01 16:47:00",1438472820,"C5",75900,1438548720,"2015-08-02 13:52:00"
"2651","20154530054541-361",2,"2015-08-01 16:51:00",1438473060,"C5",84780,1438557840,"2015-08-02 16:24:00"
"4706","20154119074113-792",1,"2015-08-01 18:02:00",1438477320,"C5",165780,1438643100,"2015-08-03 16:05:00"
"2594","20154129034133-355",1,"2015-08-01 18:53:00",1438480380,"C5",90240,1438570620,"2015-08-02 19:57:00"
"1757","20153011023048-461",3,"2015-08-01 19:03:00",1438480980,"C5",261540,1438742520,"2015-08-04 19:42:00"
"1792","20153722023710-935",2,"2015-08-01 19:21:00",1438482060,"C0",440520,1438922580,"2015-08-06 21:43:00"
"4130","20150209060231-540",1,"2015-08-01 19:31:00",1438482660,"C5",290820,1438773480,"2015-08-05 04:18:00"
"1472","20155129045107-400",2,"2015-08-01 19:57:00",1438484220,"C3",90120,1438574340,"2015-08-02 20:59:00"
"1197","20155625015652-201",2,"2015-08-01 20:18:00",1438485480,"C2",459960,1438945440,"2015-08-07 04:04:00"
"3106","20152330112320-637",1,"2015-08-01 21:05:00",1438488300,"C2",69240,1438557540,"2015-08-02 16:19:00"
"1761","20155028105016-754",3,"2015-08-01 21:28:00",1438489680,"C2",191940,1438681620,"2015-08-04 02:47:00"
"844","20153321033321-89",1,"2015-08-01 21:33:00",1438489980,"C5",324000,1438813980,"2015-08-05 15:33:00"
"39","20154625054615-85",3,"2015-08-01 21:44:00",1438490640,"C2",309540,1438800180,"2015-08-05 11:43:00"
"293","20155628055649-858",1,"2015-08-01 22:58:00",1438495080,"C0",51960,1438547040,"2015-08-02 13:24:00"
"5110","20152505102539-470",3,"2015-08-01 23:05:00",1438495500,"C2",621300,1439116800,"2015-08-09 03:40:00"
"2935","20153913013912-134",2,"2015-08-01 23:30:00",1438497000,"C4",239580,1438736580,"2015-08-04 18:03:00"
"4629","20151804111828-884",1,"2015-08-01 23:42:00",1438497720,"C8",1231920,1439729640,"2015-08-16 05:54:00"
"6356","20152830032844-398",2,"2015-08-01 23:44:00",1438497840,"C8",101280,1438599120,"2015-08-03 03:52:00"
"4793","20155226125229-218",3,"2015-08-01 23:48:00",1438498080,"C3",79680,1438577760,"2015-08-02 21:56:00"
"549","20151927091933-671",2,"2015-08-01 23:49:00",1438498140,"C6",512700,1439010840,"2015-08-07 22:14:00"
"1588","20152227032235-207",1,"2015-08-01 23:49:00",1438498140,"C0",66060,1438564200,"2015-08-02 18:10:00"
"164","20152830022802-299",1,"2015-08-01 23:52:00",1438498320,"C2",103320,1438601640,"2015-08-03 04:34:00"
"4118","20150410080439-253",3,"2015-08-02 00:05:00",1438499100,"C5",279780,1438778880,"2015-08-05 05:48:00"
"4922","20152813042802-5",2,"2015-08-02 00:08:00",1438499280,"C8",333840,1438833120,"2015-08-05 20:52:00"
"304","20155918045905-885",3,"2015-08-02 00:15:00",1438499700,"C5",617880,1439117580,"2015-08-09 03:53:00"
"2764","20151231121203-449",2,"2015-08-02 00:16:00",1438499760,"C5",64920,1438564680,"2015-08-02 18:18:00"
"2348","20151626121657-196",2,"2015-08-02 01:01:00",1438502460,"C3",188100,1438690560,"2015-08-04 05:16:00"
"3774","20150224010207-397",2,"2015-08-02 01:02:00",1438502520,"C0",415800,1438918320,"2015-08-06 20:32:00"
"5193","20152628082657-500",3,"2015-08-02 01:10:00",1438503000,"C5",202920,1438705920,"2015-08-04 09:32:00"
"6126","20153628093659-387",1,"2015-08-02 01:40:00",1438504800,"C5",201720,1438706520,"2015-08-04 09:42:00"
"3320","20153022073058-275",1,"2015-08-02 01:55:00",1438505700,"C8",186060,1438691760,"2015-08-04 05:36:00"
"3045","20155827095826-435",1,"2015-08-02 02:04:00",1438506240,"C8",440280,1438946520,"2015-08-07 04:22:00"
"2217","20152711032704-985",2,"2015-08-02 02:11:00",1438506660,"C3",264720,1438771380,"2015-08-05 03:43:00"
"4224","20150124050126-399",3,"2015-08-02 02:26:00",1438507560,"C8",145020,1438652580,"2015-08-03 18:43:00"
"4258","20155118055120-195",1,"2015-08-02 02:33:00",1438507980,"C5",620460,1439128440,"2015-08-09 06:54:00"
"2879","20154931034945-124",3,"2015-08-02 02:51:00",1438509060,"C7",63060,1438572120,"2015-08-02 20:22:00"
"5195","20154218114238-384",1,"2015-08-02 02:52:00",1438509120,"C5",180600,1438689720,"2015-08-04 05:02:00"
"5153","20153521083522-988",1,"2015-08-02 03:39:00",1438511940,"C5",127380,1438639320,"2015-08-03 15:02:00"
"537","20152008052025-846",2,"2015-08-02 03:44:00",1438512240,"C3",263880,1438776120,"2015-08-05 05:02:00"
"1098","20150231010230-879",1,"2015-08-02 03:50:00",1438512600,"C8",69840,1438582440,"2015-08-02 23:14:00"
"2782","20154130124118-316",1,"2015-08-02 04:21:00",1438514460,"C7",114600,1438629060,"2015-08-03 12:11:00"
"1284","20152217012232-158",3,"2015-08-02 04:31:00",1438515060,"C2",450180,1438965240,"2015-08-07 09:34:00"
"5916","20154530104517-465",1,"2015-08-02 04:42:00",1438515720,"C0",79140,1438594860,"2015-08-03 02:41:00"
"6385","20153125033101-388",2,"2015-08-02 04:42:00",1438515720,"C7",93180,1438608900,"2015-08-03 06:35:00"
"1574","20150626110605-541",1,"2015-08-02 05:24:00",1438518240,"C2",1058760,1439577000,"2015-08-14 11:30:00"
"5385","20155908025926-104",2,"2015-08-02 05:39:00",1438519140,"C6",265800,1438784940,"2015-08-05 07:29:00"
"5458","20155620125614-440",1,"2015-08-02 06:23:00",1438521780,"C4",366540,1438888320,"2015-08-06 12:12:00"
"4842","20155910035954-864",1,"2015-08-02 07:11:00",1438524660,"C8",279360,1438804020,"2015-08-05 12:47:00"
"3988","20152210032211-174",3,"2015-08-02 07:37:00",1438526220,"C4",279900,1438806120,"2015-08-05 13:22:00"
"204","20155417065414-463",1,"2015-08-02 08:22:00",1438528920,"C0",173460,1438702380,"2015-08-04 08:33:00"
"5347","20153224123257-617",1,"2015-08-02 08:56:00",1438530960,"C5",254880,1438785840,"2015-08-05 07:44:00"
"6109","20153617013601-315",1,"2015-08-02 09:02:00",1438531320,"C8",682980,1439214300,"2015-08-10 06:45:00"
"134","20155701025756-944",2,"2015-08-02 10:15:00",1438535700,"C4",69480,1438605180,"2015-08-03 05:33:00"
"1591","20153709093756-988",1,"2015-08-02 11:07:00",1438538820,"C8",415800,1438954620,"2015-08-07 06:37:00"
"4686","20153928053942-429",3,"2015-08-02 11:12:00",1438539120,"C0",408780,1438947900,"2015-08-07 04:45:00"
"2840","20150201060238-845",2,"2015-08-02 11:15:00",1438539300,"C3",105180,1438644480,"2015-08-03 16:28:00"
"148","20151231031233-897",2,"2015-08-02 11:22:00",1438539720,"C3",159000,1438698720,"2015-08-04 07:32:00"
"5590","20152001012059-836",1,"2015-08-02 11:29:00",1438540140,"C4",79740,1438619880,"2015-08-03 09:38:00"
"194","20154428124429-300",2,"2015-08-02 11:30:00",1438540200,"C7",61080,1438601280,"2015-08-03 04:28:00"
"2338","20153226073247-72",1,"2015-08-02 11:44:00",1438541040,"C2",88560,1438629600,"2015-08-03 12:20:00"
"5461","20154122054140-30",1,"2015-08-02 11:59:00",1438541940,"C5",132840,1438674780,"2015-08-04 00:53:00"
"231","20155223015236-307",3,"2015-08-02 12:18:00",1438543080,"C8",429180,1438972260,"2015-08-07 11:31:00"
"1259","20155631125645-432",1,"2015-08-02 12:24:00",1438543440,"C4",85440,1438628880,"2015-08-03 12:08:00"
"233","20151731021708-898",2,"2015-08-02 12:52:00",1438545120,"C0",167700,1438712820,"2015-08-04 11:27:00"
"5972","20154111034148-335",1,"2015-08-02 12:55:00",1438545300,"C0",270120,1438815420,"2015-08-05 15:57:00"
"6358","20151227041255-244",3,"2015-08-02 12:58:00",1438545480,"C0",506760,1439052240,"2015-08-08 09:44:00"
"584","20153029033042-152",1,"2015-08-02 13:34:00",1438547640,"C7",169320,1438716960,"2015-08-04 12:36:00"
"629","20153601103622-897",1,"2015-08-02 14:11:00",1438549860,"C6",99300,1438649160,"2015-08-03 17:46:00"
"3379","20155625015640-843",2,"2015-08-02 14:17:00",1438550220,"C5",230820,1438781040,"2015-08-05 06:24:00"
"354","20153327123320-68",1,"2015-08-02 14:27:00",1438550820,"C6",87540,1438638360,"2015-08-03 14:46:00"
"1475","20150121020117-781",1,"2015-08-02 14:28:00",1438550880,"C5",346140,1438897020,"2015-08-06 14:37:00"
"1535","20150829100839-801",1,"2015-08-02 14:36:00",1438551360,"C2",180840,1438732200,"2015-08-04 16:50:00"
"291","20151429041405-463",1,"2015-08-02 14:48:00",1438552080,"C5",418920,1438971000,"2015-08-07 11:10:00"
"1138","20155827015856-404",3,"2015-08-02 15:19:00",1438553940,"C5",174420,1438728360,"2015-08-04 15:46:00"
"5012","20151008121044-244",1,"2015-08-02 15:28:00",1438554480,"C7",529320,1439083800,"2015-08-08 18:30:00"
"5157","20152027062003-395",2,"2015-08-02 15:36:00",1438554960,"C0",275880,1438830840,"2015-08-05 20:14:00"
"6215","20152726042723-397",1,"2015-08-02 16:06:00",1438556760,"C8",86220,1438642980,"2015-08-03 16:03:00"
"4096","20152818022812-310",3,"2015-08-02 16:52:00",1438559520,"C4",163080,1438722600,"2015-08-04 14:10:00"
"633","20150206080212-82",1,"2015-08-02 16:59:00",1438559940,"C4",788340,1439348280,"2015-08-11 19:58:00"
"4032","20152709092720-465",2,"2015-08-02 17:11:00",1438560660,"C2",262680,1438823340,"2015-08-05 18:09:00"
"4753","20155430115403-341",1,"2015-08-02 17:30:00",1438561800,"C0",93120,1438654920,"2015-08-03 19:22:00"
"3465","20152819042821-876",1,"2015-08-02 17:40:00",1438562400,"C5",151740,1438714140,"2015-08-04 11:49:00"
"4571","20153323043307-820",2,"2015-08-02 18:05:00",1438563900,"C8",434760,1438998660,"2015-08-07 18:51:00"
"4946","20152913082912-781",1,"2015-08-02 18:35:00",1438565700,"C5",882180,1439447880,"2015-08-12 23:38:00"
"2437","20151301021340-472",2,"2015-08-02 19:23:00",1438568580,"C2",105000,1438673580,"2015-08-04 00:33:00"
"2455","20153931123943-847",3,"2015-08-02 20:17:00",1438571820,"C5",100140,1438671960,"2015-08-04 00:06:00"
"3813","20155704015728-85",1,"2015-08-02 20:24:00",1438572240,"C4",361260,1438933500,"2015-08-07 00:45:00"
"3592","20155201035213-815",2,"2015-08-02 20:30:00",1438572600,"C0",103080,1438675680,"2015-08-04 01:08:00"
"1915","20151503041535-262",3,"2015-08-02 21:11:00",1438575060,"C0",326220,1438901280,"2015-08-06 15:48:00"
"4805","20155309115343-721",3,"2015-08-02 22:41:00",1438580460,"C5",588060,1439168520,"2015-08-09 18:02:00"
"1580","20151826021816-332",1,"2015-08-02 23:06:00",1438581960,"C2",79560,1438661520,"2015-08-03 21:12:00"
"1315","20153704073745-278",2,"2015-08-02 23:12:00",1438582320,"C8",512340,1439094660,"2015-08-08 21:31:00"
"5781","20155025015032-304",3,"2015-08-02 23:15:00",1438582500,"C8",145020,1438727520,"2015-08-04 15:32:00"
"4940","20151801021811-599",1,"2015-08-02 23:26:00",1438583160,"C4",1398840,1439982000,"2015-08-19 04:00:00"
"1634","20155130035117-109",3,"2015-08-02 23:35:00",1438583700,"C5",143520,1438727220,"2015-08-04 15:27:00"
"5413","20151820041854-851",3,"2015-08-03 00:34:00",1438587240,"C2",144120,1438731360,"2015-08-04 16:36:00"
"223","20155314125319-412",3,"2015-08-03 01:53:00",1438591980,"C7",241200,1438833180,"2015-08-05 20:53:00"
"1682","20155019115035-365",1,"2015-08-03 02:10:00",1438593000,"C7",630600,1439223600,"2015-08-10 09:20:00"
"3699","20152701022725-153",3,"2015-08-03 02:15:00",1438593300,"C2",401040,1438994340,"2015-08-07 17:39:00"
"2182","20150801120848-517",1,"2015-08-03 02:20:00",1438593600,"C5",68760,1438662360,"2015-08-03 21:26:00"
"6030","20155323075349-302",2,"2015-08-03 03:56:00",1438599360,"C0",133740,1438733100,"2015-08-04 17:05:00"
"269","20153025093014-930",1,"2015-08-03 04:36:00",1438601760,"C4",253320,1438855080,"2015-08-06 02:58:00"
"2052","20154524114509-609",1,"2015-08-03 04:37:00",1438601820,"C5",119760,1438721580,"2015-08-04 13:53:00"
"6036","20153414123429-267",1,"2015-08-03 04:39:00",1438601940,"C8",339900,1438941840,"2015-08-07 03:04:00"
"1782","20151124111122-818",1,"2015-08-03 05:14:00",1438604040,"C2",280860,1438884900,"2015-08-06 11:15:00"
"5584","20150325060300-912",1,"2015-08-03 05:46:00",1438605960,"C4",110940,1438716900,"2015-08-04 12:35:00"
"5201","20153802053827-252",1,"2015-08-03 06:14:00",1438607640,"C2",45360,1438653000,"2015-08-03 18:50:00"
"1638","20151507011530-88",1,"2015-08-03 07:23:00",1438611780,"C5",288960,1438900740,"2015-08-06 15:39:00"
"4738","20152128072158-862",1,"2015-08-03 07:30:00",1438612200,"C2",172980,1438785180,"2015-08-05 07:33:00"
"2039","20154801104828-144",2,"2015-08-03 07:36:00",1438612560,"C5",80640,1438693200,"2015-08-04 06:00:00"
"4377","20154431124423-688",2,"2015-08-03 08:14:00",1438614840,"C4",81000,1438695840,"2015-08-04 06:44:00"
"722","20155401015444-439",1,"2015-08-03 08:18:00",1438615080,"C4",152640,1438767720,"2015-08-05 02:42:00"
"1123","20152928122936-347",2,"2015-08-03 08:35:00",1438616100,"C5",168120,1438784220,"2015-08-05 07:17:00"
"4341","20155326105308-899",1,"2015-08-03 09:01:00",1438617660,"C2",684480,1439302140,"2015-08-11 07:09:00"
"4403","20150501090516-171",3,"2015-08-03 09:21:00",1438618860,"C2",86880,1438705740,"2015-08-04 09:29:00"
"6120","20150818050817-70",1,"2015-08-03 09:22:00",1438618920,"C4",677220,1439296140,"2015-08-11 05:29:00"
"1770","20154901124955-525",2,"2015-08-03 09:49:00",1438620540,"C4",162000,1438782540,"2015-08-05 06:49:00"
"2380","20150619040651-207",2,"2015-08-03 09:51:00",1438620660,"C5",424500,1439045160,"2015-08-08 07:46:00"
"5909","20153007073050-177",1,"2015-08-03 10:10:00",1438621800,"C0",616800,1439238600,"2015-08-10 13:30:00"
"1618","20153501083518-306",1,"2015-08-03 10:35:00",1438623300,"C8",90000,1438713300,"2015-08-04 11:35:00"
"2463","20150228020203-565",3,"2015-08-03 11:28:00",1438626480,"C4",509160,1439135640,"2015-08-09 08:54:00"
"855","20153019033053-367",2,"2015-08-03 11:50:00",1438627800,"C8",256560,1438884360,"2015-08-06 11:06:00"
"3242","20154626054643-936",2,"2015-08-03 11:51:00",1438627860,"C4",95700,1438723560,"2015-08-04 14:26:00"
"4970","20152123022155-571",1,"2015-08-03 12:48:00",1438631280,"C4",505260,1439136540,"2015-08-09 09:09:00"
"6204","20151031101009-945",1,"2015-08-03 13:04:00",1438632240,"C4",89880,1438722120,"2015-08-04 14:02:00"
"5325","20152031102058-485",1,"2015-08-03 13:11:00",1438632660,"C4",89820,1438722480,"2015-08-04 14:08:00"
"5803","20153121043157-485",1,"2015-08-03 13:11:00",1438632660,"C8",222240,1438854900,"2015-08-06 02:55:00"
"5","20154502084548-823",3,"2015-08-03 13:32:00",1438633920,"C0",103620,1438737540,"2015-08-04 18:19:00"
"1714","20154520064525-417",3,"2015-08-03 13:48:00",1438634880,"C7",137220,1438772100,"2015-08-05 03:55:00"
"3473","20153329053307-752",2,"2015-08-03 13:49:00",1438634940,"C5",52320,1438687260,"2015-08-04 04:21:00"
"5011","20152430032437-581",2,"2015-08-03 13:52:00",1438635120,"C5",170040,1438805160,"2015-08-05 13:06:00"
"5645","20154915104900-986",2,"2015-08-03 14:17:00",1438636620,"C6",530760,1439167380,"2015-08-09 17:43:00"
"3470","20154502054501-178",1,"2015-08-03 14:41:00",1438638060,"C4",75360,1438713420,"2015-08-04 11:37:00"
"800","20154120014128-465",1,"2015-08-03 15:12:00",1438639920,"C5",173580,1438813500,"2015-08-05 15:25:00"
"4540","20152823122846-410",1,"2015-08-03 15:16:00",1438640160,"C4",120060,1438760220,"2015-08-05 00:37:00"
"4384","20151102121127-564",2,"2015-08-03 15:24:00",1438640640,"C2",97980,1438738620,"2015-08-04 18:37:00"
"6371","20155726015743-944",2,"2015-08-03 15:33:00",1438641180,"C2",348480,1438989660,"2015-08-07 16:21:00"
"3063","20154217104228-732",1,"2015-08-03 15:41:00",1438641660,"C4",1486740,1440128400,"2015-08-20 20:40:00"
"1049","20154201104219-611",1,"2015-08-03 16:08:00",1438643280,"C4",96180,1438739460,"2015-08-04 18:51:00"
"991","20155926125915-298",3,"2015-08-03 16:19:00",1438643940,"C8",351600,1438995540,"2015-08-07 17:59:00"
"4431","20153115033133-708",1,"2015-08-03 17:02:00",1438646520,"C2",605580,1439252100,"2015-08-10 17:15:00"
"3902","20150827060823-4",1,"2015-08-03 17:32:00",1438648320,"C2",215280,1438863600,"2015-08-06 05:20:00"
"4903","20154326034342-937",2,"2015-08-03 18:05:00",1438650300,"C0",99960,1438750260,"2015-08-04 21:51:00"
"5396","20152728102719-723",3,"2015-08-03 18:18:00",1438651080,"C2",546660,1439197740,"2015-08-10 02:09:00"
"967","20155916045900-996",2,"2015-08-03 18:24:00",1438651440,"C7",222900,1438874340,"2015-08-06 08:19:00"
"316","20155526025520-19",1,"2015-08-03 18:46:00",1438652760,"C3",235020,1438887780,"2015-08-06 12:03:00"
"5266","20153402113431-964",2,"2015-08-03 20:02:00",1438657320,"C4",116880,1438774200,"2015-08-05 04:30:00"
"2913","20150620030629-901",1,"2015-08-03 20:11:00",1438657860,"C8",245580,1438903440,"2015-08-06 16:24:00"
"637","20152502112545-83",1,"2015-08-03 20:13:00",1438657980,"C4",118080,1438776060,"2015-08-05 05:01:00"
"110","20154226054249-628",1,"2015-08-03 20:28:00",1438658880,"C4",350580,1439009460,"2015-08-07 21:51:00"
"6445","20152614072648-135",1,"2015-08-03 20:42:00",1438659720,"C7",253680,1438913400,"2015-08-06 19:10:00"
"6542","20150003020050-522",2,"2015-08-03 20:48:00",1438660080,"C5",337860,1438997940,"2015-08-07 18:39:00"
"3158","20154625104616-641",2,"2015-08-03 21:13:00",1438661580,"C5",271740,1438933320,"2015-08-07 00:42:00"
"5277","20150701060721-840",1,"2015-08-03 21:16:00",1438661760,"C2",227340,1438889100,"2015-08-06 12:25:00"
"1263","20154022104050-662",1,"2015-08-03 21:22:00",1438662120,"C5",358440,1439020560,"2015-08-08 00:56:00"
"5631","20150831010810-141",1,"2015-08-03 21:35:00",1438662900,"C2",289620,1438952520,"2015-08-07 06:02:00"
"2027","20150816060823-385",3,"2015-08-03 21:44:00",1438663440,"C3",805680,1439469120,"2015-08-13 05:32:00"
"2186","20150431030458-145",3,"2015-08-03 22:09:00",1438664940,"C4",284700,1438949640,"2015-08-07 05:14:00"
"1703","20150213100244-187",1,"2015-08-03 22:32:00",1438666320,"C2",619800,1439286120,"2015-08-11 02:42:00"
"5102","20155716015702-925",3,"2015-08-03 22:51:00",1438667460,"C6",696540,1439364000,"2015-08-12 00:20:00"
"4623","20150828090847-178",1,"2015-08-03 22:53:00",1438667580,"C8",113580,1438781160,"2015-08-05 06:26:00"
"4995","20153802053822-860",3,"2015-08-03 23:22:00",1438669320,"C7",53520,1438722840,"2015-08-04 14:14:00"
"17","20152715102727-628",3,"2015-08-04 00:17:00",1438672620,"C8",338280,1439010900,"2015-08-07 22:15:00"
"372","20155401115443-339",2,"2015-08-04 00:26:00",1438673160,"C7",108960,1438782120,"2015-08-05 06:42:00"
"2559","20152411112403-168",1,"2015-08-04 00:28:00",1438673280,"C8",1043520,1439716800,"2015-08-16 02:20:00"
"4332","20155730085755-371",1,"2015-08-04 00:31:00",1438673460,"C7",200820,1438874280,"2015-08-06 08:18:00"
"5775","20150327100356-183",1,"2015-08-04 01:03:00",1438675380,"C5",329400,1439004780,"2015-08-07 20:33:00"
"526","20155431045446-47",1,"2015-08-04 01:20:00",1438676400,"C3",144780,1438821180,"2015-08-05 17:33:00"
"2926","20151128051129-591",1,"2015-08-04 02:22:00",1438680120,"C8",78780,1438758900,"2015-08-05 00:15:00"
"799","20150527050515-636",2,"2015-08-04 02:33:00",1438680780,"C8",319440,1439000220,"2015-08-07 19:17:00"
"4822","20154202034222-47",2,"2015-08-04 03:32:00",1438684320,"C4",64500,1438748820,"2015-08-04 21:27:00"
"3428","20150626070610-771",1,"2015-08-04 03:48:00",1438685280,"C4",382860,1439068140,"2015-08-08 14:09:00"
"2526","20150122090132-684",1,"2015-08-04 03:49:00",1438685340,"C5",462060,1439147400,"2015-08-09 12:10:00"
"2467","20150730030734-264",1,"2015-08-04 03:51:00",1438685460,"C2",195720,1438881180,"2015-08-06 10:13:00"
"4553","20154320064328-347",2,"2015-08-04 04:33:00",1438687980,"C2",644100,1439332080,"2015-08-11 15:28:00"
"1516","20155825095828-312",3,"2015-08-04 04:56:00",1438689360,"C7",120840,1438810200,"2015-08-05 14:30:00"
"5161","20151529031505-215",2,"2015-08-04 05:07:00",1438690020,"C3",60240,1438750260,"2015-08-04 21:51:00"
"5987","20151127061136-939",2,"2015-08-04 05:31:00",1438691460,"C5",344400,1439035860,"2015-08-08 05:11:00"
"765","20155602105614-229",1,"2015-08-04 06:18:00",1438694280,"C4",78060,1438772340,"2015-08-05 03:59:00"
"4835","20154003074029-430",1,"2015-08-04 06:24:00",1438694640,"C4",394320,1439088960,"2015-08-08 19:56:00"
"4825","20154228074250-471",3,"2015-08-04 06:27:00",1438694820,"C4",600300,1439295120,"2015-08-11 05:12:00"
"1261","20154305014335-971",3,"2015-08-04 06:33:00",1438695180,"C5",366600,1439061780,"2015-08-08 12:23:00"
"3501","20150030050037-993",1,"2015-08-04 07:00:00",1438696800,"C4",49500,1438746300,"2015-08-04 20:45:00"
"424","20153602033634-853",1,"2015-08-04 07:02:00",1438696920,"C5",70980,1438767900,"2015-08-05 02:45:00"
"5891","20152703012733-565",3,"2015-08-04 07:04:00",1438697040,"C6",63420,1438760460,"2015-08-05 00:41:00"
"5826","20153723013743-159",1,"2015-08-04 07:46:00",1438699560,"C5",338580,1439038140,"2015-08-08 05:49:00"
"5861","20152901062908-724",1,"2015-08-04 08:02:00",1438700520,"C2",264780,1438965300,"2015-08-07 09:35:00"
"3372","20154214064232-812",2,"2015-08-04 08:34:00",1438702440,"C0",260160,1438962600,"2015-08-07 08:50:00"
"2672","20155410115442-469",2,"2015-08-04 08:58:00",1438703880,"C3",268680,1438972560,"2015-08-07 11:36:00"
"4472","20155825075830-372",3,"2015-08-04 09:01:00",1438704060,"C0",289260,1438993320,"2015-08-07 17:22:00"
"3275","20153431073442-374",1,"2015-08-04 09:12:00",1438704720,"C8",175740,1438880460,"2015-08-06 10:01:00"
"5966","20154726014714-186",2,"2015-08-04 09:31:00",1438705860,"C4",95280,1438801140,"2015-08-05 11:59:00"
"1244","20150126050104-378",1,"2015-08-04 10:29:00",1438709340,"C4",754080,1439463420,"2015-08-13 03:57:00"
"3439","20152829102829-430",2,"2015-08-04 11:04:00",1438711440,"C5",260280,1438971720,"2015-08-07 11:22:00"
"1119","20155525115532-571",1,"2015-08-04 11:39:00",1438713540,"C0",431520,1439145060,"2015-08-09 11:31:00"
"2401","20151201061251-794",3,"2015-08-04 11:47:00",1438714020,"C6",279300,1438993320,"2015-08-07 17:22:00"
"57","20155726065746-437",3,"2015-08-04 11:48:00",1438714080,"C7",113580,1438827660,"2015-08-05 19:21:00"
"6192","20151421031443-290",2,"2015-08-04 12:32:00",1438716720,"C7",599940,1439316660,"2015-08-11 11:11:00"
"139","20152830082847-300",2,"2015-08-04 12:38:00",1438717080,"C8",223500,1438940580,"2015-08-07 02:43:00"
"4113","20154903084903-690",2,"2015-08-04 13:07:00",1438718820,"C0",101880,1438820700,"2015-08-05 17:25:00"
"5561","20154523124510-943",1,"2015-08-04 13:09:00",1438718940,"C4",148320,1438867260,"2015-08-06 06:21:00"
"2498","20155502025511-119",2,"2015-08-04 13:47:00",1438721220,"C2",84360,1438805580,"2015-08-05 13:13:00"
"3298","20152330112343-14",1,"2015-08-04 13:58:00",1438721880,"C8",88260,1438810140,"2015-08-05 14:29:00"
"33","20154729054707-256",2,"2015-08-04 14:09:00",1438722540,"C4",252660,1438975200,"2015-08-07 12:20:00"
"6297","20152328052341-673",3,"2015-08-04 15:15:00",1438726500,"C2",597120,1439323620,"2015-08-11 13:07:00"
"531","20150802090855-889",2,"2015-08-04 15:17:00",1438726620,"C6",194940,1438921560,"2015-08-06 21:26:00"
"575","20150808090842-727",1,"2015-08-04 15:20:00",1438726800,"C6",824520,1439551320,"2015-08-14 04:22:00"
"5844","20151906011943-68",2,"2015-08-04 15:27:00",1438727220,"C2",359040,1439086260,"2015-08-08 19:11:00"
"6231","20155111095142-349",1,"2015-08-04 15:35:00",1438727700,"C4",261780,1438989480,"2015-08-07 16:18:00"
"78","20155824015804-38",1,"2015-08-04 15:43:00",1438728180,"C4",318900,1439047080,"2015-08-08 08:18:00"
"3389","20155013085022-330",2,"2015-08-04 16:26:00",1438730760,"C5",565020,1439295780,"2015-08-11 05:23:00"
"482","20150231060233-191",1,"2015-08-04 16:35:00",1438731300,"C5",127860,1438859160,"2015-08-06 04:06:00"
"5148","20153402093448-712",1,"2015-08-04 17:02:00",1438732920,"C2",199680,1438932600,"2015-08-07 00:30:00"
"5164","20150325010306-666",3,"2015-08-04 17:19:00",1438733940,"C4",439680,1439173620,"2015-08-09 19:27:00"
"5100","20155924015914-772",2,"2015-08-04 17:50:00",1438735800,"C6",87660,1438823460,"2015-08-05 18:11:00"
"2435","20154024044050-101",2,"2015-08-04 17:52:00",1438735920,"C2",318240,1439054160,"2015-08-08 10:16:00"
"3955","20151431101444-411",1,"2015-08-04 18:58:00",1438739880,"C5",188520,1438928400,"2015-08-06 23:20:00"
"2076","20155626095622-144",3,"2015-08-04 19:34:00",1438742040,"C3",116040,1438858080,"2015-08-06 03:48:00"
"1248","20152431022403-301",2,"2015-08-04 20:15:00",1438744500,"C0",52380,1438796880,"2015-08-05 10:48:00"
"5934","20150425010459-670",1,"2015-08-04 20:32:00",1438745520,"C3",111360,1438856880,"2015-08-06 03:28:00"
"5176","20151029031046-528",2,"2015-08-04 20:37:00",1438745820,"C0",179340,1438925160,"2015-08-06 22:26:00"
"5134","20155729095741-271",1,"2015-08-04 21:18:00",1438748280,"C5",450180,1439198460,"2015-08-10 02:21:00"
"4549","20150503030532-116",1,"2015-08-04 21:34:00",1438749240,"C6",109740,1438858980,"2015-08-06 04:03:00"
"197","20152931062933-133",2,"2015-08-04 21:38:00",1438749480,"C3",133380,1438882860,"2015-08-06 10:41:00"
"95","20151103021143-224",1,"2015-08-04 22:00:00",1438750800,"C3",114540,1438865340,"2015-08-06 05:49:00"
"3862","20151231081203-407",2,"2015-08-04 22:06:00",1438751160,"C4",131880,1438883040,"2015-08-06 10:44:00"
"5129","20150802090811-979",1,"2015-08-04 22:20:00",1438752000,"C5",110160,1438862160,"2015-08-06 04:56:00"
"641","20153712013720-181",3,"2015-08-04 22:28:00",1438752480,"C6",203940,1438956420,"2015-08-07 07:07:00"
"2907","20151730011708-691",3,"2015-08-04 23:39:00",1438756740,"C5",234660,1438991400,"2015-08-07 16:50:00"
"4023","20153813103815-223",1,"2015-08-04 23:48:00",1438757280,"C7",974100,1439731380,"2015-08-16 06:23:00"
"1833","20151902061935-596",3,"2015-08-04 23:49:00",1438757340,"C0",117900,1438875240,"2015-08-06 08:34:00"
"3757","20151626021639-5",1,"2015-08-05 00:00:00",1438758000,"C4",406320,1439164320,"2015-08-09 16:52:00"
"4263","20150019010004-372",1,"2015-08-05 00:58:00",1438761480,"C7",203640,1438965120,"2015-08-07 09:32:00"
"3544","20153411103404-448",1,"2015-08-05 01:34:00",1438763640,"C6",354600,1439118240,"2015-08-09 04:04:00"
"4468","20152030112000-524",1,"2015-08-05 02:23:00",1438766580,"C2",162060,1438928640,"2015-08-06 23:24:00"
"216","20154431124424-721",1,"2015-08-05 02:28:00",1438766880,"C7",197520,1438964400,"2015-08-07 09:20:00"
"709","20151704041733-844",1,"2015-08-05 03:29:00",1438770540,"C5",339840,1439110380,"2015-08-09 01:53:00"
"2842","20155431125443-408",1,"2015-08-05 03:34:00",1438770840,"C0",199200,1438970040,"2015-08-07 10:54:00"
"2506","20151929111952-130",2,"2015-08-05 03:41:00",1438771260,"C4",288660,1439059920,"2015-08-08 11:52:00"
"3215","20151907011937-909",3,"2015-08-05 03:54:00",1438772040,"C8",494340,1439266380,"2015-08-10 21:13:00"
"3762","20155724055744-118",2,"2015-08-05 04:35:00",1438774500,"C7",141240,1438915740,"2015-08-06 19:49:00"
"6092","20154514034553-145",2,"2015-08-05 04:49:00",1438775340,"C5",232680,1439008020,"2015-08-07 21:27:00"
"5169","20154728034746-685",2,"2015-08-05 05:39:00",1438778340,"C4",59520,1438837860,"2015-08-05 22:11:00"
"734","20151901091942-196",1,"2015-08-05 06:07:00",1438780020,"C4",167040,1438947060,"2015-08-07 04:31:00"
"1922","20152423072412-875",1,"2015-08-05 06:18:00",1438780680,"C0",373080,1439153760,"2015-08-09 13:56:00"
"4436","20153004113046-680",3,"2015-08-05 06:40:00",1438782000,"C4",69000,1438851000,"2015-08-06 01:50:00"
"4606","20154519024544-322",2,"2015-08-05 06:48:00",1438782480,"C4",201480,1438983960,"2015-08-07 14:46:00"
"320","20153407113449-132",1,"2015-08-05 07:17:00",1438784220,"C8",355740,1439139960,"2015-08-09 10:06:00"
"5984","20154225044228-490",2,"2015-08-05 08:17:00",1438787820,"C8",184020,1438971840,"2015-08-07 11:24:00"
"399","20150415070401-918",2,"2015-08-05 08:42:00",1438789320,"C4",260040,1439049360,"2015-08-08 08:56:00"
"6213","20155328125314-729",1,"2015-08-05 08:53:00",1438789980,"C5",84600,1438874580,"2015-08-06 08:23:00"
"818","20151003011029-293",3,"2015-08-05 09:00:00",1438790400,"C5",78900,1438869300,"2015-08-06 06:55:00"
"1668","20150829110854-562",2,"2015-08-05 09:02:00",1438790520,"C4",85320,1438875840,"2015-08-06 08:44:00"
"121","20155330125308-863",3,"2015-08-05 10:59:00",1438797540,"C2",255780,1439053320,"2015-08-08 10:02:00"
"5186","20150013110015-112",2,"2015-08-05 11:08:00",1438798080,"C3",248460,1439046540,"2015-08-08 08:09:00"
"6137","20150010120037-8",1,"2015-08-05 11:50:00",1438800600,"C2",1122900,1439923500,"2015-08-18 11:45:00"
"3265","20153102063100-491",1,"2015-08-05 12:35:00",1438803300,"C4",281040,1439084340,"2015-08-08 18:39:00"
"1686","20150010030002-664",2,"2015-08-05 12:52:00",1438804320,"C3",279840,1439084160,"2015-08-08 18:36:00"
"1654","20155522095506-197",2,"2015-08-05 13:11:00",1438805460,"C7",174480,1438979940,"2015-08-07 13:39:00"
"3188","20150815100857-72",1,"2015-08-05 13:52:00",1438807920,"C5",261120,1439069040,"2015-08-08 14:24:00"
"3660","20154701104706-898",1,"2015-08-05 15:03:00",1438812180,"C2",180480,1438992660,"2015-08-07 17:11:00"
"778","20151731051740-917",3,"2015-08-05 15:08:00",1438812480,"C2",424260,1439236740,"2015-08-10 12:59:00"
"4084","20152123012154-34",2,"2015-08-05 15:09:00",1438812540,"C5",376560,1439189100,"2015-08-09 23:45:00"
"1882","20152513102558-161",2,"2015-08-05 15:29:00",1438813740,"C2",250680,1439064420,"2015-08-08 13:07:00"
"3569","20150901080955-679",1,"2015-08-05 16:12:00",1438816320,"C3",124860,1438941180,"2015-08-07 02:53:00"
"4367","20150420100416-232",1,"2015-08-05 17:09:00",1438819740,"C6",1407900,1440227640,"2015-08-22 00:14:00"
"2393","20150618050611-599",2,"2015-08-05 17:14:00",1438820040,"C3",222240,1439042280,"2015-08-08 06:58:00"
"5033","20155601125604-18",1,"2015-08-05 17:18:00",1438820280,"C7",180660,1439000940,"2015-08-07 19:29:00"
"2007","20154723054713-268",1,"2015-08-05 19:41:00",1438828860,"C7",531720,1439360580,"2015-08-11 23:23:00"
"5881","20150530020556-90",1,"2015-08-05 19:51:00",1438829460,"C5",269580,1439099040,"2015-08-08 22:44:00"
"6338","20153408093405-996",1,"2015-08-05 20:39:00",1438832340,"C2",351300,1439183640,"2015-08-09 22:14:00"
"1659","20150224100248-221",1,"2015-08-05 20:42:00",1438832520,"C8",215040,1439047560,"2015-08-08 08:26:00"
"5439","20155702055701-405",3,"2015-08-05 21:11:00",1438834260,"C7",135420,1438969680,"2015-08-07 10:48:00"
"5244","20155129055147-431",1,"2015-08-05 21:55:00",1438836900,"C8",309720,1439146620,"2015-08-09 11:57:00"
"500","20150201080243-358",2,"2015-08-05 22:26:00",1438838760,"C5",198720,1439037480,"2015-08-08 05:38:00"
"3921","20153426053424-13",1,"2015-08-06 01:54:00",1438851240,"C8",697200,1439548440,"2015-08-14 03:34:00"
"3510","20153827043838-171",1,"2015-08-06 01:56:00",1438851360,"C0",405540,1439256900,"2015-08-10 18:35:00"
"5358","20154302084358-573",1,"2015-08-06 01:58:00",1438851480,"C2",107100,1438958580,"2015-08-07 07:43:00"
"2597","20150405090426-651",2,"2015-08-06 03:34:00",1438857240,"C8",549000,1439406240,"2015-08-12 12:04:00"
"3911","20154930044907-211",1,"2015-08-06 03:37:00",1438857420,"C4",69660,1438927080,"2015-08-06 22:58:00"
"6285","20155019065049-871",3,"2015-08-06 04:02:00",1438858920,"C6",193140,1439052060,"2015-08-08 09:41:00"
"3238","20152714062757-568",3,"2015-08-06 04:11:00",1438859460,"C5",282720,1439142180,"2015-08-09 10:43:00"
"1256","20155124035131-240",1,"2015-08-06 04:39:00",1438861140,"C7",541440,1439402580,"2015-08-12 11:03:00"
"4668","20155323025342-343",1,"2015-08-06 04:51:00",1438861860,"C8",586740,1439448600,"2015-08-12 23:50:00"
"1780","20154530034541-167",1,"2015-08-06 06:21:00",1438867260,"C5",190320,1439057580,"2015-08-08 11:13:00"
"792","20153828073820-71",1,"2015-08-06 06:42:00",1438868520,"C8",387120,1439255640,"2015-08-10 18:14:00"
"4053","20150521120547-745",1,"2015-08-06 07:25:00",1438871100,"C8",273120,1439144220,"2015-08-09 11:17:00"
"676","20155631115626-437",3,"2015-08-06 08:26:00",1438874760,"C5",252900,1439127660,"2015-08-09 06:41:00"
"721","20155501065521-181",2,"2015-08-06 08:45:00",1438875900,"C8",219300,1439095200,"2015-08-08 21:40:00"
"3760","20152131082145-700",2,"2015-08-06 09:45:00",1438879500,"C6",87240,1438966740,"2015-08-07 09:59:00"
"878","20153602053648-835",1,"2015-08-06 09:50:00",1438879800,"C5",158820,1439038620,"2015-08-08 05:57:00"
"748","20151031021043-605",2,"2015-08-06 10:10:00",1438881000,"C5",252000,1439133000,"2015-08-09 08:10:00"
"6198","20151728111711-22",1,"2015-08-06 10:14:00",1438881240,"C5",257940,1439139180,"2015-08-09 09:53:00"
"3027","20151313051340-385",2,"2015-08-06 10:18:00",1438881480,"C8",409740,1439291220,"2015-08-11 04:07:00"
"4302","20150326090318-883",1,"2015-08-06 10:25:00",1438881900,"C5",477660,1439359560,"2015-08-11 23:06:00"
"6553","20151727081750-912",1,"2015-08-06 10:27:00",1438882020,"C8",174360,1439056380,"2015-08-08 10:53:00"
"929","20151128071144-68",3,"2015-08-06 11:20:00",1438885200,"C2",264180,1439149380,"2015-08-09 12:43:00"
"5104","20155202025227-496",1,"2015-08-06 11:48:00",1438886880,"C3",167280,1439054160,"2015-08-08 10:16:00"
"1399","20150001100019-538",1,"2015-08-06 12:06:00",1438887960,"C6",73260,1438961220,"2015-08-07 08:27:00"
"5605","20150623110625-496",3,"2015-08-06 12:16:00",1438888560,"C4",173400,1439061960,"2015-08-08 12:26:00"
"5810","20153015023001-696",2,"2015-08-06 13:03:00",1438891380,"C5",631860,1439523240,"2015-08-13 20:34:00"
"6498","20153431103412-743",1,"2015-08-06 14:30:00",1438896600,"C4",76080,1438972680,"2015-08-07 11:38:00"
"4579","20150702020750-193",2,"2015-08-06 14:55:00",1438898100,"C0",116160,1439014260,"2015-08-07 23:11:00"
"1835","20155224025254-187",1,"2015-08-06 15:24:00",1438899840,"C4",140640,1439040480,"2015-08-08 06:28:00"
"3314","20155505035539-722",3,"2015-08-06 16:04:00",1438902240,"C2",86940,1438989180,"2015-08-07 16:13:00"
"4655","20155708025703-505",3,"2015-08-06 16:09:00",1438902540,"C0",313740,1439216280,"2015-08-10 07:18:00"
"5689","20151624031658-684",3,"2015-08-06 16:10:00",1438902600,"C8",160920,1439063520,"2015-08-08 12:52:00"
"1625","20151008061031-83",1,"2015-08-06 16:28:00",1438903680,"C7",363240,1439266920,"2015-08-10 21:22:00"
"4379","20155904025922-23",1,"2015-08-06 17:24:00",1438907040,"C2",181500,1439088540,"2015-08-08 19:49:00"
"6525","20155623095618-430",1,"2015-08-06 17:52:00",1438908720,"C5",619080,1439527800,"2015-08-13 21:50:00"
"698","20152605012634-824",1,"2015-08-06 19:11:00",1438913460,"C4",185700,1439099160,"2015-08-08 22:46:00"
"5617","20151704061733-850",1,"2015-08-06 19:13:00",1438913580,"C8",109680,1439023260,"2015-08-08 01:41:00"
"5036","20153011023028-435",1,"2015-08-06 19:50:00",1438915800,"C6",283200,1439199000,"2015-08-10 02:30:00"
"1319","20155630105651-729",2,"2015-08-06 20:00:00",1438916400,"C2",79680,1438996080,"2015-08-07 18:08:00"
"1949","20154831094847-710",1,"2015-08-06 20:08:00",1438916880,"C8",111120,1439028000,"2015-08-08 03:00:00"
"2982","20152012042036-344",1,"2015-08-06 20:35:00",1438918500,"C8",435060,1439353560,"2015-08-11 21:26:00"
"727","20155926095918-705",1,"2015-08-06 20:39:00",1438918740,"C4",123600,1439042340,"2015-08-08 06:59:00"
"2781","20152027032011-806",2,"2015-08-06 20:40:00",1438918800,"C2",441600,1439360400,"2015-08-11 23:20:00"
"5818","20150509050552-677",1,"2015-08-06 21:17:00",1438921020,"C7",270480,1439191500,"2015-08-10 00:25:00"
"5268","20150811050851-143",2,"2015-08-06 21:20:00",1438921200,"C7",251280,1439172480,"2015-08-09 19:08:00"
"5136","20155229095213-604",1,"2015-08-06 22:00:00",1438923600,"C5",91860,1439015460,"2015-08-07 23:31:00"
"4288","20150429080442-199",2,"2015-08-06 22:07:00",1438924020,"C6",741780,1439665800,"2015-08-15 12:10:00"
"4812","20150323030348-749",1,"2015-08-06 22:43:00",1438926180,"C4",618600,1439544780,"2015-08-14 02:33:00"
"6106","20154301074308-402",1,"2015-08-06 22:53:00",1438926780,"C8",97320,1439024100,"2015-08-08 01:55:00"
"3091","20155625015640-270",2,"2015-08-06 23:47:00",1438930020,"C0",153180,1439083200,"2015-08-08 18:20:00"
"3944","20150922010936-575",1,"2015-08-07 02:15:00",1438938900,"C4",191880,1439130780,"2015-08-09 07:33:00"
"2414","20155731055752-472",2,"2015-08-07 02:54:00",1438941240,"C4",78660,1439019900,"2015-08-08 00:45:00"
"2893","20154325114323-182",1,"2015-08-07 03:59:00",1438945140,"C0",156480,1439101620,"2015-08-08 23:27:00"
"3241","20152804122805-486",2,"2015-08-07 04:04:00",1438945440,"C4",76320,1439021760,"2015-08-08 01:16:00"
"943","20153613053658-337",1,"2015-08-07 04:11:00",1438945860,"C8",422340,1439368200,"2015-08-12 01:30:00"
"1545","20153905113904-390",2,"2015-08-07 04:15:00",1438946100,"C6",470760,1439416860,"2015-08-12 15:01:00"
"625","20151828051857-513",3,"2015-08-07 05:30:00",1438950600,"C2",273840,1439224440,"2015-08-10 09:34:00"
"5315","20150621090620-651",2,"2015-08-07 06:10:00",1438953000,"C0",506280,1439459280,"2015-08-13 02:48:00"
"1860","20154127084151-732",2,"2015-08-07 06:33:00",1438954380,"C3",117840,1439072220,"2015-08-08 15:17:00"
"2112","20150904060946-997",1,"2015-08-07 06:33:00",1438954380,"C0",130320,1439084700,"2015-08-08 18:45:00"
"1683","20154706044711-22",1,"2015-08-07 07:47:00",1438958820,"C3",54000,1439012820,"2015-08-07 22:47:00"
"1289","20155701085744-294",1,"2015-08-07 07:48:00",1438958880,"C5",171420,1439130300,"2015-08-09 07:25:00"
"2010","20150503070532-763",3,"2015-08-07 07:58:00",1438959480,"C4",348780,1439308260,"2015-08-11 08:51:00"
"2284","20150329030344-472",2,"2015-08-07 08:12:00",1438960320,"C0",250980,1439211300,"2015-08-10 05:55:00"
"6324","20155307125327-646",1,"2015-08-07 08:28:00",1438961280,"C8",532500,1439493780,"2015-08-13 12:23:00"
"3184","20154703044709-708",1,"2015-08-07 08:51:00",1438962660,"C3",427920,1439390580,"2015-08-12 07:43:00"
"2271","20152905062952-3",1,"2015-08-07 09:24:00",1438964640,"C4",183300,1439147940,"2015-08-09 12:19:00"
"2133","20153401123448-154",1,"2015-08-07 09:48:00",1438966080,"C5",254220,1439220300,"2015-08-10 08:25:00"
"248","20150030100046-714",2,"2015-08-07 10:54:00",1438970040,"C7",347220,1439317260,"2015-08-11 11:21:00"
"1041","20154606054615-464",2,"2015-08-07 10:54:00",1438970040,"C7",391440,1439361480,"2015-08-11 23:38:00"
"4583","20153616093612-196",1,"2015-08-07 11:03:00",1438970580,"C4",635340,1439605920,"2015-08-14 19:32:00"
"6452","20150517100545-515",1,"2015-08-07 11:05:00",1438970700,"C6",303000,1439273700,"2015-08-10 23:15:00"
"994","20151603061654-187",1,"2015-08-07 11:13:00",1438971180,"C2",121140,1439092320,"2015-08-08 20:52:00"
"2817","20155906055936-524",1,"2015-08-07 11:47:00",1438973220,"C2",64080,1439037300,"2015-08-08 05:35:00"
"3235","20152331032358-34",3,"2015-08-07 11:47:00",1438973220,"C6",98640,1439071860,"2015-08-08 15:11:00"
"1998","20152525102559-950",2,"2015-08-07 11:55:00",1438973700,"C7",125400,1439099100,"2015-08-08 22:45:00"
"617","20154506054510-602",3,"2015-08-07 12:31:00",1438975860,"C3",392280,1439368140,"2015-08-12 01:29:00"
"5057","20151431021452-330",1,"2015-08-07 13:10:00",1438978200,"C5",75120,1439053320,"2015-08-08 10:02:00"
"6500","20155119025114-185",2,"2015-08-07 14:06:00",1438981560,"C8",327780,1439309340,"2015-08-11 09:09:00"
"4156","20150104050127-736",1,"2015-08-07 14:43:00",1438983780,"C0",83640,1439067420,"2015-08-08 13:57:00"
"5870","20150604040619-38",1,"2015-08-07 15:16:00",1438985760,"C6",256200,1439241960,"2015-08-10 14:26:00"
"1752","20154112014114-381",1,"2015-08-07 16:20:00",1438989600,"C6",203280,1439192880,"2015-08-10 00:48:00"
"4442","20151003111052-171",1,"2015-08-07 16:22:00",1438989720,"C4",364320,1439354040,"2015-08-11 21:34:00"
"1305","20153206033254-715",2,"2015-08-07 16:42:00",1438990920,"C4",90600,1439081520,"2015-08-08 17:52:00"
"3855","20152028072036-773",3,"2015-08-07 17:28:00",1438993680,"C5",112560,1439106240,"2015-08-09 00:44:00"
"1861","20151725041726-478",2,"2015-08-07 18:14:00",1438996440,"C3",161460,1439157900,"2015-08-09 15:05:00"
"3868","20155530035556-433",2,"2015-08-07 18:15:00",1438996500,"C8",349800,1439346300,"2015-08-11 19:25:00"
"5124","20154126024158-664",2,"2015-08-07 18:49:00",1438998540,"C3",150240,1439148780,"2015-08-09 12:33:00"
"1187","20152705042730-318",2,"2015-08-07 18:51:00",1438998660,"C4",90720,1439089380,"2015-08-08 20:03:00"
"5318","20151730061703-165",2,"2015-08-07 19:05:00",1438999500,"C5",92160,1439091660,"2015-08-08 20:41:00"
"6401","20152629022625-52",1,"2015-08-07 20:50:00",1439005800,"C2",424080,1439429880,"2015-08-12 18:38:00"
"5753","20152706112749-394",2,"2015-08-07 21:19:00",1439007540,"C4",121920,1439129460,"2015-08-09 07:11:00"
"2367","20154604044619-717",2,"2015-08-07 21:44:00",1439009040,"C6",277080,1439286120,"2015-08-11 02:42:00"
"6275","20151601101604-955",2,"2015-08-07 22:08:00",1439010480,"C0",80160,1439090640,"2015-08-08 20:24:00"
"6185","20151625101651-52",1,"2015-08-07 22:33:00",1439011980,"C3",537060,1439549040,"2015-08-14 03:44:00"
"4008","20155129085126-994",2,"2015-08-07 22:48:00",1439012880,"C7",118260,1439131140,"2015-08-09 07:39:00"
"3068","20153113063149-619",2,"2015-08-07 22:49:00",1439012940,"C4",687240,1439700180,"2015-08-15 21:43:00"
"1528","20154429124439-546",3,"2015-08-08 01:59:00",1439024340,"C0",117900,1439142240,"2015-08-09 10:44:00"
"551","20154718044706-170",1,"2015-08-08 02:26:00",1439025960,"C5",251820,1439277780,"2015-08-11 00:23:00"
"359","20151001041055-580",1,"2015-08-08 02:52:00",1439027520,"C7",278460,1439305980,"2015-08-11 08:13:00"
"2226","20152221072217-797",1,"2015-08-08 03:46:00",1439030760,"C7",220320,1439251080,"2015-08-10 16:58:00"
"3650","20155929065908-355",1,"2015-08-08 03:49:00",1439030940,"C7",121800,1439152740,"2015-08-09 13:39:00"
"3502","20150406040417-783",1,"2015-08-08 04:38:00",1439033880,"C8",65820,1439099700,"2015-08-08 22:55:00"
"5570","20152102082141-663",1,"2015-08-08 05:19:00",1439036340,"C7",253740,1439290080,"2015-08-11 03:48:00"
"1812","20150708100721-172",3,"2015-08-08 05:43:00",1439037780,"C5",332820,1439370600,"2015-08-12 02:10:00"
"2799","20150717060746-729",3,"2015-08-08 06:07:00",1439039220,"C7",950400,1439989620,"2015-08-19 06:07:00"
"5462","20155227125212-315",3,"2015-08-08 06:50:00",1439041800,"C7",507540,1439549340,"2015-08-14 03:49:00"
"4794","20155004035020-880",3,"2015-08-08 07:25:00",1439043900,"C8",63060,1439106960,"2015-08-09 00:56:00"
"1462","20150102080153-960",2,"2015-08-08 08:45:00",1439048700,"C5",260520,1439309220,"2015-08-11 09:07:00"
"720","20151001051049-770",1,"2015-08-08 08:46:00",1439048760,"C3",71820,1439120580,"2015-08-09 04:43:00"
"1622","20155330095334-363",2,"2015-08-08 08:49:00",1439048940,"C4",96720,1439145660,"2015-08-09 11:41:00"
"1853","20153203113245-908",1,"2015-08-08 09:00:00",1439049600,"C5",211440,1439261040,"2015-08-10 19:44:00"
"1405","20150702020734-303",1,"2015-08-08 09:33:00",1439051580,"C2",501960,1439553540,"2015-08-14 04:59:00"
"6337","20154128094123-201",1,"2015-08-08 09:41:00",1439052060,"C5",442800,1439494860,"2015-08-13 12:41:00"
"6101","20154118114130-34",1,"2015-08-08 10:31:00",1439055060,"C8",362040,1439417100,"2015-08-12 15:05:00"
"5853","20153530053501-879",2,"2015-08-08 10:50:00",1439056200,"C8",150660,1439206860,"2015-08-10 04:41:00"
"6178","20153801063819-939",1,"2015-08-08 10:54:00",1439056440,"C5",310080,1439366520,"2015-08-12 01:02:00"
"688","20155431025449-131",3,"2015-08-08 11:33:00",1439058780,"C2",97020,1439155800,"2015-08-09 14:30:00"
"4766","20152922072959-445",3,"2015-08-08 11:54:00",1439060040,"C0",212100,1439272140,"2015-08-10 22:49:00"
"6458","20151101121144-520",2,"2015-08-08 12:03:00",1439060580,"C4",410340,1439470920,"2015-08-13 06:02:00"
"2740","20150427060448-246",3,"2015-08-08 12:24:00",1439061840,"C7",529800,1439591640,"2015-08-14 15:34:00"
"6240","20152922022915-661",2,"2015-08-08 13:01:00",1439064060,"C5",182940,1439247000,"2015-08-10 15:50:00"
"2023","20150929080924-256",2,"2015-08-08 13:37:00",1439066220,"C5",110460,1439176680,"2015-08-09 20:18:00"
"1718","20154423014424-392",1,"2015-08-08 13:58:00",1439067480,"C2",691620,1439759100,"2015-08-16 14:05:00"
"2108","20155330095316-775",3,"2015-08-08 14:23:00",1439068980,"C0",264600,1439333580,"2015-08-11 15:53:00"
"1825","20151230021228-117",1,"2015-08-08 14:24:00",1439069040,"C2",259440,1439328480,"2015-08-11 14:28:00"
"5367","20152030032051-557",2,"2015-08-08 18:26:00",1439083560,"C4",262920,1439346480,"2015-08-11 19:28:00"
"5370","20153403083413-579",3,"2015-08-08 18:43:00",1439084580,"C3",468540,1439553120,"2015-08-14 04:52:00"
"5328","20151303081343-855",1,"2015-08-08 18:45:00",1439084700,"C4",469920,1439554620,"2015-08-14 05:17:00"
"4894","20150725010752-511",1,"2015-08-08 19:39:00",1439087940,"C4",176160,1439264100,"2015-08-10 20:35:00"
"6071","20155703055759-244",2,"2015-08-08 19:59:00",1439089140,"C2",62760,1439151900,"2015-08-09 13:25:00"
"498","20154430054442-410",2,"2015-08-08 20:19:00",1439090340,"C8",157380,1439247720,"2015-08-10 16:02:00"
"5867","20155914105910-953",1,"2015-08-08 20:19:00",1439090340,"C4",274200,1439364540,"2015-08-12 00:29:00"
"5395","20152903032937-233",3,"2015-08-08 21:39:00",1439095140,"C5",227100,1439322240,"2015-08-11 12:44:00"
"6108","20155725075727-219",1,"2015-08-08 21:43:00",1439095380,"C4",179880,1439275260,"2015-08-10 23:41:00"
"4496","20150607040626-348",2,"2015-08-08 22:06:00",1439096760,"C0",54000,1439150760,"2015-08-09 13:06:00"
"4138","20153710023741-996",1,"2015-08-08 22:13:00",1439097180,"C4",316620,1439413800,"2015-08-12 14:10:00"
"2124","20154705044710-733",2,"2015-08-08 22:47:00",1439099220,"C6",46800,1439146020,"2015-08-09 11:47:00"
"3889","20153007013003-908",1,"2015-08-08 23:22:00",1439101320,"C5",350040,1439451360,"2015-08-13 00:36:00"
"4044","20155402045434-428",2,"2015-08-09 00:18:00",1439104680,"C5",272520,1439377200,"2015-08-12 04:00:00"
"3435","20151318051330-957",3,"2015-08-09 02:15:00",1439111700,"C7",923460,1440035160,"2015-08-19 18:46:00"
"345","20151002041036-991",1,"2015-08-09 02:22:00",1439112120,"C3",277560,1439389680,"2015-08-12 07:28:00"
"363","20153107033125-767",1,"2015-08-09 02:35:00",1439112900,"C5",63120,1439176020,"2015-08-09 20:07:00"
"6225","20150521080528-185",1,"2015-08-09 02:37:00",1439113020,"C6",526740,1439639760,"2015-08-15 04:56:00"
"3103","20151202101257-746",1,"2015-08-09 02:44:00",1439113440,"C0",82560,1439196000,"2015-08-10 01:40:00"
"5082","20151002021015-986",1,"2015-08-09 03:14:00",1439115240,"C5",282720,1439397960,"2015-08-12 09:46:00"
"4979","20152217062234-111",3,"2015-08-09 03:17:00",1439115420,"C4",282300,1439397720,"2015-08-12 09:42:00"
"2996","20150701070729-336",1,"2015-08-09 03:31:00",1439116260,"C5",226080,1439342340,"2015-08-11 18:19:00"
"2532","20153222103251-804",1,"2015-08-09 03:48:00",1439117280,"C5",765480,1439882760,"2015-08-18 00:26:00"
"846","20150917110936-396",3,"2015-08-09 03:59:00",1439117940,"C4",280200,1439398140,"2015-08-12 09:49:00"
"1083","20154125044106-999",1,"2015-08-09 04:21:00",1439119260,"C2",178800,1439298060,"2015-08-11 06:01:00"
"465","20154425094430-276",1,"2015-08-09 04:28:00",1439119680,"C2",638520,1439758200,"2015-08-16 13:50:00"
"5678","20151002071039-91",1,"2015-08-09 04:36:00",1439120160,"C8",297780,1439417940,"2015-08-12 15:19:00"
"4659","20150206110226-989",2,"2015-08-09 05:23:00",1439122980,"C4",79620,1439202600,"2015-08-10 03:30:00"
"4271","20152831082802-61",1,"2015-08-09 06:16:00",1439126160,"C6",128280,1439254440,"2015-08-10 17:54:00"
"1084","20152028062056-368",3,"2015-08-09 06:41:00",1439127660,"C0",346020,1439473680,"2015-08-13 06:48:00"
"6311","20150102020155-899",1,"2015-08-09 06:54:00",1439128440,"C4",82740,1439211180,"2015-08-10 05:53:00"
"1854","20152106092141-219",1,"2015-08-09 07:01:00",1439128860,"C5",125400,1439254260,"2015-08-10 17:51:00"
"1865","20154020024044-998",3,"2015-08-09 07:03:00",1439128980,"C5",242940,1439371920,"2015-08-12 02:32:00"
"2373","20154131064108-797",1,"2015-08-09 07:08:00",1439129280,"C2",259740,1439389020,"2015-08-12 07:17:00"
"1696","20150122100136-869",1,"2015-08-09 07:37:00",1439131020,"C2",515520,1439646540,"2015-08-15 06:49:00"
"4006","20154726114709-355",1,"2015-08-09 07:56:00",1439132160,"C4",170820,1439302980,"2015-08-11 07:23:00"
"6294","20154028074004-866",1,"2015-08-09 07:56:00",1439132160,"C5",129720,1439261880,"2015-08-10 19:58:00"
"5484","20150607050608-159",2,"2015-08-09 08:06:00",1439132760,"C2",140400,1439273160,"2015-08-10 23:06:00"
"1669","20155731015742-412",1,"2015-08-09 09:30:00",1439137800,"C5",253860,1439391660,"2015-08-12 08:01:00"
"3741","20151001091013-536",1,"2015-08-09 09:33:00",1439137980,"C2",98940,1439236920,"2015-08-10 13:02:00"
"5014","20151907021947-595",2,"2015-08-09 10:38:00",1439141880,"C0",159540,1439301420,"2015-08-11 06:57:00"
"2895","20151112011137-325",1,"2015-08-09 11:19:00",1439144340,"C2",344640,1439488980,"2015-08-13 11:03:00"
"2644","20155607015659-126",2,"2015-08-09 11:26:00",1439144760,"C7",81900,1439226660,"2015-08-10 10:11:00"
"4219","20152022082028-22",2,"2015-08-09 11:28:00",1439144880,"C5",783240,1439928120,"2015-08-18 13:02:00"
"2349","20152830062810-554",1,"2015-08-09 11:46:00",1439145960,"C2",294360,1439440320,"2015-08-12 21:32:00"
"1485","20154912084916-322",1,"2015-08-09 12:09:00",1439147340,"C6",303900,1439451240,"2015-08-13 00:34:00"
"3114","20152707022754-808",3,"2015-08-09 12:30:00",1439148600,"C6",165780,1439314380,"2015-08-11 10:33:00"
"3831","20154202074243-737",1,"2015-08-09 12:50:00",1439149800,"C4",311640,1439461440,"2015-08-13 03:24:00"
"5305","20153122093107-869",1,"2015-08-09 13:15:00",1439151300,"C5",196080,1439347380,"2015-08-11 19:43:00"
"2392","20152821042813-361",2,"2015-08-09 13:57:00",1439153820,"C3",233220,1439387040,"2015-08-12 06:44:00"
"6113","20150324060332-594",2,"2015-08-09 15:03:00",1439157780,"C8",282960,1439440740,"2015-08-12 21:39:00"
"4370","20151428111428-181",3,"2015-08-09 15:04:00",1439157840,"C8",210120,1439367960,"2015-08-12 01:26:00"
"519","20150405080425-970",2,"2015-08-09 15:11:00",1439158260,"C5",435660,1439593920,"2015-08-14 16:12:00"
"2180","20152716122736-950",1,"2015-08-09 15:15:00",1439158500,"C1",347280,1439505780,"2015-08-13 15:43:00"
"3182","20152531072521-938",3,"2015-08-09 16:01:00",1439161260,"C4",269520,1439430780,"2015-08-12 18:53:00"
"6321","20150902110946-207",1,"2015-08-09 16:03:00",1439161380,"C7",88920,1439250300,"2015-08-10 16:45:00"
"373","20155807125802-565",1,"2015-08-09 16:14:00",1439162040,"C0",92280,1439254320,"2015-08-10 17:52:00"
"3077","20154622054623-743",3,"2015-08-09 16:30:00",1439163000,"C7",775320,1439938320,"2015-08-18 15:52:00"
"881","20153508033513-874",1,"2015-08-09 17:24:00",1439166240,"C2",92940,1439259180,"2015-08-10 19:13:00"
"2030","20153703073756-936",1,"2015-08-09 17:47:00",1439167620,"C3",555000,1439722620,"2015-08-16 03:57:00"
"5290","20150206080226-163",1,"2015-08-09 18:47:00",1439171220,"C5",99300,1439270520,"2015-08-10 22:22:00"
"4065","20152806032847-86",3,"2015-08-09 19:12:00",1439172720,"C3",368880,1439541600,"2015-08-14 01:40:00"
"6485","20150406120427-726",3,"2015-08-09 19:37:00",1439174220,"C3",423540,1439597760,"2015-08-14 17:16:00"
"2137","20150923010958-595",3,"2015-08-09 20:12:00",1439176320,"C5",583740,1439760060,"2015-08-16 14:21:00"
"834","20155407095436-165",2,"2015-08-09 20:56:00",1439178960,"C4",106260,1439285220,"2015-08-11 02:27:00"
"4720","20151025071006-134",3,"2015-08-09 21:04:00",1439179440,"C6",224340,1439403780,"2015-08-12 11:23:00"
"5784","20155204125243-368",2,"2015-08-09 21:05:00",1439179500,"C8",65940,1439245440,"2015-08-10 15:24:00"
"2247","20154931014916-410",2,"2015-08-09 22:17:00",1439183820,"C0",115440,1439299260,"2015-08-11 06:21:00"
"5007","20155520045513-443",2,"2015-08-09 22:22:00",1439184120,"C8",249660,1439433780,"2015-08-12 19:43:00"
"434","20152626032621-951",3,"2015-08-09 22:41:00",1439185260,"C3",411900,1439597160,"2015-08-14 17:06:00"
"6286","20155307115300-161",1,"2015-08-09 22:50:00",1439185800,"C4",70740,1439256540,"2015-08-10 18:29:00"
"3302","20154026024058-952",2,"2015-08-09 23:04:00",1439186640,"C4",177120,1439363760,"2015-08-12 00:16:00"
"3560","20154103084118-72",1,"2015-08-10 00:49:00",1439192940,"C8",288240,1439481180,"2015-08-13 08:53:00"
"2286","20154402034401-435",2,"2015-08-10 00:50:00",1439193000,"C8",91080,1439284080,"2015-08-11 02:08:00"
"4953","20152008102034-994",1,"2015-08-10 00:50:00",1439193000,"C8",69300,1439262300,"2015-08-10 20:05:00"
"2385","20155507025512-789",2,"2015-08-10 01:03:00",1439193780,"C5",104640,1439298420,"2015-08-11 06:07:00"
"2708","20151607061640-872",1,"2015-08-10 01:14:00",1439194440,"C7",120540,1439314980,"2015-08-11 10:43:00"
"1311","20153724023747-163",1,"2015-08-10 01:15:00",1439194500,"C7",710340,1439904840,"2015-08-18 06:34:00"
"4061","20150228010235-447",2,"2015-08-10 01:27:00",1439195220,"C3",154500,1439349720,"2015-08-11 20:22:00"
"1345","20150108120140-67",1,"2015-08-10 02:03:00",1439197380,"C5",68460,1439265840,"2015-08-10 21:04:00"
"5343","20150218120246-220",1,"2015-08-10 02:46:00",1439199960,"C0",279120,1439479080,"2015-08-13 08:18:00"
"2402","20155706045723-418",1,"2015-08-10 02:51:00",1439200260,"C8",147420,1439347680,"2015-08-11 19:48:00"
"5760","20150704010749-266",1,"2015-08-10 03:05:00",1439201100,"C7",241140,1439442240,"2015-08-12 22:04:00"
"837","20153707093749-951",2,"2015-08-10 03:57:00",1439204220,"C3",119400,1439323620,"2015-08-11 13:07:00"
"1094","20151805101809-893",1,"2015-08-10 04:13:00",1439205180,"C8",82020,1439287200,"2015-08-11 03:00:00"
"1877","20155525045517-999",1,"2015-08-10 04:23:00",1439205780,"C5",191040,1439396820,"2015-08-12 09:27:00"
"8","20155525065551-662",1,"2015-08-10 04:32:00",1439206320,"C8",196260,1439402580,"2015-08-12 11:03:00"
"3814","20154728094759-13",2,"2015-08-10 04:35:00",1439206500,"C5",368160,1439574660,"2015-08-14 10:51:00"
"392","20154922104905-300",1,"2015-08-10 05:07:00",1439208420,"C7",180120,1439388540,"2015-08-12 07:09:00"
"1590","20153531103551-510",1,"2015-08-10 05:23:00",1439209380,"C2",105660,1439315040,"2015-08-11 10:44:00"
"2297","20151101081109-505",3,"2015-08-10 05:47:00",1439210820,"C5",96120,1439306940,"2015-08-11 08:29:00"
"1338","20151518061551-586",2,"2015-08-10 06:01:00",1439211660,"C0",993180,1440204840,"2015-08-21 17:54:00"
"5021","20150401070439-330",1,"2015-08-10 06:24:00",1439213040,"C4",96900,1439309940,"2015-08-11 09:19:00"
"1330","20153416013430-901",2,"2015-08-10 06:30:00",1439213400,"C2",266820,1439480220,"2015-08-13 08:37:00"
"3896","20150201070216-808",2,"2015-08-10 06:32:00",1439213520,"C4",775800,1439989320,"2015-08-19 06:02:00"
"3367","20151522041501-365",1,"2015-08-10 06:44:00",1439214240,"C4",229620,1439443860,"2015-08-12 22:31:00"
"2157","20154931024946-567",1,"2015-08-10 06:45:00",1439214300,"C7",417480,1439631780,"2015-08-15 02:43:00"
"2199","20155531115507-502",2,"2015-08-10 07:30:00",1439217000,"C8",169620,1439386620,"2015-08-12 06:37:00"
"4855","20150629090627-62",2,"2015-08-10 08:26:00",1439220360,"C0",129300,1439349660,"2015-08-11 20:21:00"
"4233","20153124113131-106",2,"2015-08-10 08:43:00",1439221380,"C4",182340,1439403720,"2015-08-12 11:22:00"
"912","20153308073320-351",1,"2015-08-10 09:29:00",1439224140,"C8",89880,1439314020,"2015-08-11 10:27:00"
"4716","20154408074420-516",1,"2015-08-10 09:36:00",1439224560,"C7",89760,1439314320,"2015-08-11 10:32:00"
"1202","20150109060133-67",1,"2015-08-10 09:46:00",1439225160,"C2",99900,1439325060,"2015-08-11 13:31:00"
"6303","20154309054331-529",3,"2015-08-10 09:48:00",1439225280,"C6",57900,1439283180,"2015-08-11 01:53:00"
"232","20153609033627-164",2,"2015-08-10 09:57:00",1439225820,"C0",66060,1439291880,"2015-08-11 04:18:00"
"5712","20153201063205-376",1,"2015-08-10 10:08:00",1439226480,"C6",131760,1439358240,"2015-08-11 22:44:00"
"1741","20154629034645-799",1,"2015-08-10 10:14:00",1439226840,"C7",508440,1439735280,"2015-08-16 07:28:00"
"2587","20152119042123-730",2,"2015-08-10 10:37:00",1439228220,"C5",235020,1439463240,"2015-08-13 03:54:00"
"1805","20152626022659-583",1,"2015-08-10 10:51:00",1439229060,"C8",183300,1439412360,"2015-08-12 13:46:00"
"2116","20153606053617-896",3,"2015-08-10 11:24:00",1439231040,"C8",161640,1439392680,"2015-08-12 08:18:00"
"6462","20151506031520-642",2,"2015-08-10 11:26:00",1439231160,"C3",331860,1439563020,"2015-08-14 07:37:00"
"2803","20150130030134-783",1,"2015-08-10 11:34:00",1439231640,"C7",104220,1439335860,"2015-08-11 16:31:00"
"3080","20154205034205-330",1,"2015-08-10 11:50:00",1439232600,"C5",52260,1439284860,"2015-08-11 02:21:00"
"1272","20153028093055-321",3,"2015-08-10 12:27:00",1439234820,"C4",377940,1439612760,"2015-08-14 21:26:00"
"1972","20154006014046-882",1,"2015-08-10 12:50:00",1439236200,"C2",171300,1439407500,"2015-08-12 12:25:00"
"1078","20154605024652-886",1,"2015-08-10 13:37:00",1439239020,"C0",142620,1439381640,"2015-08-12 05:14:00"
"1467","20150724010756-126",2,"2015-08-10 13:43:00",1439239380,"C6",245160,1439484540,"2015-08-13 09:49:00"
"3614","20155102045128-941",1,"2015-08-10 14:18:00",1439241480,"C7",75780,1439317260,"2015-08-11 11:21:00"
"589","20152517012540-586",2,"2015-08-10 14:29:00",1439242140,"C0",583680,1439825820,"2015-08-17 08:37:00"
"6209","20152608082638-702",2,"2015-08-10 14:32:00",1439242320,"C4",194760,1439437080,"2015-08-12 20:38:00"
"3547","20151606081628-560",1,"2015-08-10 15:12:00",1439244720,"C3",185280,1439430000,"2015-08-12 18:40:00"
"1306","20153108053138-793",1,"2015-08-10 15:31:00",1439245860,"C0",82800,1439328660,"2015-08-11 14:31:00"
"6346","20150701020723-76",1,"2015-08-10 16:08:00",1439248080,"C4",784860,1440032940,"2015-08-19 18:09:00"
"4307","20151023041017-423",1,"2015-08-10 16:28:00",1439249280,"C2",518760,1439768040,"2015-08-16 16:34:00"
"812","20155313015324-374",1,"2015-08-10 16:41:00",1439250060,"C6",404880,1439654940,"2015-08-15 09:09:00"
"2680","20155529045530-793",2,"2015-08-10 17:03:00",1439251380,"C2",129660,1439381040,"2015-08-12 05:04:00"
"2663","20151608091658-472",1,"2015-08-10 17:34:00",1439253240,"C7",101340,1439354580,"2015-08-11 21:43:00"
"5603","20152904022933-687",2,"2015-08-10 17:49:00",1439254140,"C2",401100,1439655240,"2015-08-15 09:14:00"
"2087","20153225063218-391",1,"2015-08-10 17:58:00",1439254680,"C5",711780,1439966460,"2015-08-18 23:41:00"
"142","20154821124856-434",3,"2015-08-10 18:40:00",1439257200,"C8",874560,1440131760,"2015-08-20 21:36:00"
"2990","20151709111735-195",1,"2015-08-10 18:53:00",1439257980,"C5",349020,1439607000,"2015-08-14 19:50:00"
"1441","20155026015047-456",2,"2015-08-10 19:20:00",1439259600,"C3",438600,1439698200,"2015-08-15 21:10:00"
"3233","20154505024531-4",2,"2015-08-10 19:21:00",1439259660,"C6",74760,1439334420,"2015-08-11 16:07:00"
"2309","20150507060531-534",1,"2015-08-10 19:29:00",1439260140,"C0",1859280,1441119420,"2015-09-01 07:57:00"
"3472","20151303091355-495",3,"2015-08-10 20:19:00",1439263140,"C5",214920,1439478060,"2015-08-13 08:01:00"
"93","20154508114523-645",1,"2015-08-10 20:37:00",1439264220,"C2",204720,1439468940,"2015-08-13 05:29:00"
"5431","20154731124720-805",1,"2015-08-10 20:47:00",1439264820,"C5",111600,1439376420,"2015-08-12 03:47:00"
"5472","20150606050653-525",1,"2015-08-10 20:50:00",1439265000,"C4",44880,1439309880,"2015-08-11 09:18:00"
"5333","20155508035530-98",1,"2015-08-10 21:19:00",1439266740,"C0",96120,1439362860,"2015-08-12 00:01:00"
"3207","20153604053608-723",2,"2015-08-10 21:28:00",1439267280,"C0",401340,1439668620,"2015-08-15 12:57:00"
"5062","20155719125713-529",1,"2015-08-10 22:01:00",1439269260,"C4",241680,1439510940,"2015-08-13 17:09:00"
"3076","20150624080630-565",1,"2015-08-10 22:11:00",1439269860,"C8",303900,1439573760,"2015-08-14 10:36:00"
"4961","20150929090919-621",1,"2015-08-10 22:23:00",1439270580,"C8",542220,1439812800,"2015-08-17 05:00:00"
"4486","20151309051316-267",3,"2015-08-11 00:13:00",1439277180,"C5",55800,1439332980,"2015-08-11 15:43:00"
"906","20152209112223-837",2,"2015-08-11 00:24:00",1439277840,"C0",66660,1439344500,"2015-08-11 18:55:00"
"1677","20150115110144-566",1,"2015-08-11 00:29:00",1439278140,"C2",286860,1439565000,"2015-08-14 08:10:00"
"1960","20155108015134-360",3,"2015-08-11 00:37:00",1439278620,"C5",105780,1439384400,"2015-08-12 06:00:00"
"4567","20152718012719-661",3,"2015-08-11 00:39:00",1439278740,"C5",253440,1439532180,"2015-08-13 23:03:00"
"6490","20151409051437-834",2,"2015-08-11 01:12:00",1439280720,"C4",57540,1439338260,"2015-08-11 17:11:00"
"2925","20150112050122-27",1,"2015-08-11 01:27:00",1439281620,"C5",362280,1439643900,"2015-08-15 06:05:00"
"4832","20154127094129-318",1,"2015-08-11 01:32:00",1439281920,"C4",422220,1439704140,"2015-08-15 22:49:00"
"2793","20150223110226-578",1,"2015-08-11 02:06:00",1439283960,"C5",201180,1439485140,"2015-08-13 09:59:00"
"2162","20155622095638-223",2,"2015-08-11 02:36:00",1439285760,"C5",536700,1439822460,"2015-08-17 07:41:00"
"909","20152726032711-587",1,"2015-08-11 02:47:00",1439286420,"C8",267360,1439553780,"2015-08-14 05:03:00"
"330","20152704022721-344",2,"2015-08-11 03:17:00",1439288220,"C8",282300,1439570520,"2015-08-14 09:42:00"
"1637","20154623104653-166",1,"2015-08-11 03:34:00",1439289240,"C5",807840,1440097080,"2015-08-20 11:58:00"
"2549","20152101012104-141",1,"2015-08-11 03:45:00",1439289900,"C2",103680,1439393580,"2015-08-12 08:33:00"
"3250","20152922072911-283",2,"2015-08-11 03:53:00",1439290380,"C5",214380,1439504760,"2015-08-13 15:26:00"
"1928","20155830065855-504",3,"2015-08-11 04:16:00",1439291760,"C6",171180,1439462940,"2015-08-13 03:49:00"
"6018","20155304095343-996",2,"2015-08-11 04:23:00",1439292180,"C7",292500,1439584680,"2015-08-14 13:38:00"
"819","20154328084349-846",1,"2015-08-11 04:51:00",1439293860,"C0",473460,1439767320,"2015-08-16 16:22:00"
"2272","20152803022825-787",3,"2015-08-11 05:24:00",1439295840,"C3",329280,1439625120,"2015-08-15 00:52:00"
"6274","20150207100218-368",1,"2015-08-11 05:38:00",1439296680,"C8",164880,1439461560,"2015-08-13 03:26:00"
"3710","20151929111950-606",1,"2015-08-11 05:52:00",1439297520,"C2",367860,1439665380,"2015-08-15 12:03:00"
"2097","20150405120404-360",2,"2015-08-11 06:04:00",1439298240,"C8",99360,1439397600,"2015-08-12 09:40:00"
"5843","20151503081552-98",2,"2015-08-11 06:23:00",1439299380,"C8",342240,1439641620,"2015-08-15 05:27:00"
"4491","20155407095431-303",3,"2015-08-11 06:39:00",1439300340,"C5",111300,1439411640,"2015-08-12 13:34:00"
"5158","20154303014356-798",2,"2015-08-11 07:11:00",1439302260,"C4",418260,1439720520,"2015-08-16 03:22:00"
"2570","20151621071645-193",3,"2015-08-11 07:16:00",1439302560,"C5",259200,1439561760,"2015-08-14 07:16:00"
"2713","20152205052223-701",2,"2015-08-11 08:14:00",1439306040,"C5",69360,1439375400,"2015-08-12 03:30:00"
"2278","20150303100354-126",2,"2015-08-11 08:33:00",1439307180,"C5",342900,1439650080,"2015-08-15 07:48:00"
"3968","20150925070901-487",2,"2015-08-11 09:49:00",1439311740,"C0",211200,1439522940,"2015-08-13 20:29:00"
"4247","20150818040832-50",2,"2015-08-11 10:02:00",1439312520,"C5",683880,1439996400,"2015-08-19 08:00:00"
"5106","20152307042315-347",2,"2015-08-11 10:16:00",1439313360,"C0",323580,1439636940,"2015-08-15 04:09:00"
"4487","20152109052119-324",1,"2015-08-11 11:15:00",1439316900,"C6",150840,1439467740,"2015-08-13 05:09:00"
"4374","20151719041725-731",1,"2015-08-11 11:23:00",1439317380,"C6",328260,1439645640,"2015-08-15 06:34:00"
"3791","20152928092934-717",3,"2015-08-11 11:49:00",1439318940,"C2",174000,1439492940,"2015-08-13 12:09:00"
"932","20154028084056-791",2,"2015-08-11 12:02:00",1439319720,"C5",610860,1439930580,"2015-08-18 13:43:00"
"4534","20150010080005-370",1,"2015-08-11 12:46:00",1439322360,"C4",103560,1439425920,"2015-08-12 17:32:00"
"3756","20151826071854-437",1,"2015-08-11 12:53:00",1439322780,"C8",280500,1439603280,"2015-08-14 18:48:00"
"79","20151720091715-120",1,"2015-08-11 13:38:00",1439325480,"C8",273780,1439599260,"2015-08-14 17:41:00"
"1905","20155908025917-368",1,"2015-08-11 15:14:00",1439331240,"C6",260100,1439591340,"2015-08-14 15:29:00"
"5684","20154431104451-420",2,"2015-08-11 16:04:00",1439334240,"C8",193920,1439528160,"2015-08-13 21:56:00"
"2092","20152123102144-807",1,"2015-08-11 16:21:00",1439335260,"C5",207900,1439543160,"2015-08-14 02:06:00"
"4171","20150418040454-388",3,"2015-08-11 17:00:00",1439337600,"C5",259620,1439597220,"2015-08-14 17:07:00"
"6111","20151028081039-84",1,"2015-08-11 17:40:00",1439340000,"C5",621900,1439961900,"2015-08-18 22:25:00"
"2664","20153706063755-802",1,"2015-08-11 17:50:00",1439340600,"C0",472380,1439812980,"2015-08-17 05:03:00"
"2798","20154709044740-841",1,"2015-08-11 18:33:00",1439343180,"C4",89580,1439432760,"2015-08-12 19:26:00"
"2399","20151106031107-912",2,"2015-08-11 18:47:00",1439344020,"C2",55620,1439399640,"2015-08-12 10:14:00"
"2914","20153604073634-474",1,"2015-08-11 18:54:00",1439344440,"C0",215160,1439559600,"2015-08-14 06:40:00"
"678","20155423015434-702",2,"2015-08-11 19:12:00",1439345520,"C8",237240,1439582760,"2015-08-14 13:06:00"
"3869","20155230015235-98",1,"2015-08-11 19:14:00",1439345640,"C2",528060,1439873700,"2015-08-17 21:55:00"
"5800","20152412032403-590",3,"2015-08-11 19:48:00",1439347680,"C6",434640,1439782320,"2015-08-16 20:32:00"
"694","20155601065611-898",2,"2015-08-11 20:48:00",1439351280,"C2",114240,1439465520,"2015-08-13 04:32:00"
"1509","20151210021258-493",1,"2015-08-11 21:09:00",1439352540,"C4",111420,1439463960,"2015-08-13 04:06:00"
"1607","20151707041712-312",3,"2015-08-11 21:13:00",1439352780,"C8",181680,1439534460,"2015-08-13 23:41:00"
"2588","20153706123753-969",1,"2015-08-11 21:13:00",1439352780,"C3",462960,1439815740,"2015-08-17 05:49:00"
"2214","20153322063340-765",3,"2015-08-11 21:45:00",1439354700,"C4",222840,1439577540,"2015-08-14 11:39:00"
"4469","20150205050251-251",2,"2015-08-11 22:54:00",1439358840,"C7",269760,1439628600,"2015-08-15 01:50:00"
"4589","20154303024314-609",1,"2015-08-11 23:02:00",1439359320,"C7",103020,1439462340,"2015-08-13 03:39:00"
"5846","20155509115514-291",1,"2015-08-11 23:43:00",1439361780,"C5",107640,1439469420,"2015-08-13 05:37:00"
"4803","20151007011028-996",1,"2015-08-12 00:00:00",1439362800,"C8",76920,1439439720,"2015-08-12 21:22:00"
"5271","20155703055749-564",1,"2015-08-12 00:13:00",1439363580,"C8",1696080,1441059660,"2015-08-31 15:21:00"
"723","20151612081630-430",3,"2015-08-12 00:40:00",1439365200,"C5",378720,1439743920,"2015-08-16 09:52:00"
"6439","20155925035953-311",2,"2015-08-12 01:05:00",1439366700,"C0",500520,1439867220,"2015-08-17 20:07:00"
"916","20155209065239-593",1,"2015-08-12 01:10:00",1439367000,"C5",119340,1439486340,"2015-08-13 10:19:00"
"3938","20154708044711-639",1,"2015-08-12 01:26:00",1439367960,"C2",96780,1439464740,"2015-08-13 04:19:00"
"4102","20153014103053-84",3,"2015-08-12 01:58:00",1439369880,"C3",633360,1440003240,"2015-08-19 09:54:00"
"5233","20151621011611-3",2,"2015-08-12 02:28:00",1439371680,"C4",232740,1439604420,"2015-08-14 19:07:00"
"5469","20151607011652-132",2,"2015-08-12 02:54:00",1439373240,"C5",197340,1439570580,"2015-08-14 09:43:00"
"442","20155710055728-180",3,"2015-08-12 03:43:00",1439376180,"C4",60780,1439436960,"2015-08-12 20:36:00"
"5181","20155529095550-67",1,"2015-08-12 04:11:00",1439377860,"C8",594480,1439972340,"2015-08-19 01:19:00"
"2712","20154527064556-11",3,"2015-08-12 04:53:00",1439380380,"C5",687840,1440068220,"2015-08-20 03:57:00"
"6406","20153802043859-167",1,"2015-08-12 05:10:00",1439381400,"C3",102840,1439484240,"2015-08-13 09:44:00"
"5460","20155709095720-363",1,"2015-08-12 05:36:00",1439382960,"C5",417420,1439800380,"2015-08-17 01:33:00"
"3995","20152831092837-751",1,"2015-08-12 05:43:00",1439383380,"C8",204660,1439588040,"2015-08-14 14:34:00"
"4977","20153909123939-465",3,"2015-08-12 05:48:00",1439383680,"C3",78180,1439461860,"2015-08-13 03:31:00"
"2114","20151330041314-275",2,"2015-08-12 06:29:00",1439386140,"C3",136020,1439522160,"2015-08-13 20:16:00"
"5588","20153122063134-260",1,"2015-08-12 06:35:00",1439386500,"C5",907320,1440293820,"2015-08-22 18:37:00"
"915","20153711073747-446",1,"2015-08-12 06:42:00",1439386920,"C8",552300,1439939220,"2015-08-18 16:07:00"
"1957","20155519095518-431",3,"2015-08-12 07:06:00",1439388360,"C0",294780,1439683140,"2015-08-15 16:59:00"
"6029","20152426062434-212",1,"2015-08-12 07:40:00",1439390400,"C7",210480,1439600880,"2015-08-14 18:08:00"
"2431","20150228040218-159",1,"2015-08-12 08:08:00",1439392080,"C5",181080,1439573160,"2015-08-14 10:26:00"
"5702","20154008044039-692",1,"2015-08-12 08:13:00",1439392380,"C5",105060,1439497440,"2015-08-13 13:24:00"
"2330","20153607053604-567",2,"2015-08-12 09:01:00",1439395260,"C3",57300,1439452560,"2015-08-13 00:56:00"
"6379","20152524072545-996",1,"2015-08-12 09:01:00",1439395260,"C6",205920,1439601180,"2015-08-14 18:13:00"
"4607","20154519024544-322",2,"2015-08-12 09:18:00",1439396280,"C4",202800,1439599080,"2015-08-14 17:38:00"
"4106","20153208123237-878",1,"2015-08-12 12:27:00",1439407620,"C0",345300,1439752920,"2015-08-16 12:22:00"
"2949","20152803082807-792",1,"2015-08-12 12:52:00",1439409120,"C6",99180,1439508300,"2015-08-13 16:25:00"
"2508","20150609030606-244",1,"2015-08-12 13:00:00",1439409600,"C6",251640,1439661240,"2015-08-15 10:54:00"
"3820","20154302094310-152",1,"2015-08-12 13:29:00",1439411340,"C7",438780,1439850120,"2015-08-17 15:22:00"
"3589","20152606022653-437",3,"2015-08-12 14:26:00",1439414760,"C7",259200,1439673960,"2015-08-15 14:26:00"
"5523","20154109014116-716",2,"2015-08-12 15:17:00",1439417820,"C2",88320,1439506140,"2015-08-13 15:49:00"
"1185","20154622104622-839",1,"2015-08-12 15:47:00",1439419620,"C3",261780,1439681400,"2015-08-15 16:30:00"
"3481","20152109022102-894",3,"2015-08-12 16:16:00",1439421360,"C4",266100,1439687460,"2015-08-15 18:11:00"
"1979","20152607092603-350",2,"2015-08-12 16:23:00",1439421780,"C6",457020,1439878800,"2015-08-17 23:20:00"
"4455","20152502092544-104",1,"2015-08-12 17:23:00",1439425380,"C8",446340,1439871720,"2015-08-17 21:22:00"
"6417","20151110101156-652",2,"2015-08-12 18:01:00",1439427660,"C5",100500,1439528160,"2015-08-13 21:56:00"
"186","20152304012310-843",1,"2015-08-12 19:35:00",1439433300,"C4",237840,1439671140,"2015-08-15 13:39:00"
"4093","20151030091029-116",2,"2015-08-12 19:42:00",1439433720,"C5",469140,1439902860,"2015-08-18 06:01:00"
"2055","20151407071448-332",1,"2015-08-12 21:04:00",1439438640,"C8",96360,1439535000,"2015-08-13 23:50:00"
"4581","20151013041011-524",1,"2015-08-12 21:22:00",1439439720,"C8",870240,1440309960,"2015-08-22 23:06:00"
"1351","20150217070227-343",1,"2015-08-12 21:34:00",1439440440,"C4",287340,1439727780,"2015-08-16 05:23:00"
"4745","20150031060051-429",1,"2015-08-12 21:36:00",1439440560,"C5",364320,1439804880,"2015-08-17 02:48:00"
"522","20150407050402-325",1,"2015-08-12 22:21:00",1439443260,"C3",451020,1439894280,"2015-08-18 03:38:00"
"4385","20151902011959-320",1,"2015-08-12 22:31:00",1439443860,"C3",112140,1439556000,"2015-08-14 05:40:00"
"1845","20150127110109-336",1,"2015-08-12 22:46:00",1439444760,"C8",284940,1439729700,"2015-08-16 05:55:00"
"1198","20154530024516-715",3,"2015-08-12 22:51:00",1439445060,"C2",1152360,1440597420,"2015-08-26 06:57:00"
"20","20155430085434-503",1,"2015-08-12 23:36:00",1439447760,"C7",418680,1439866440,"2015-08-17 19:54:00"
"6186","20150804040846-173",1,"2015-08-12 23:36:00",1439447760,"C3",359040,1439806800,"2015-08-17 03:20:00"
"1722","20154211104241-339",1,"2015-08-13 00:52:00",1439452320,"C5",68700,1439521020,"2015-08-13 19:57:00"
"1065","20151324061307-900",2,"2015-08-13 01:25:00",1439454300,"C6",537840,1439992140,"2015-08-19 06:49:00"
"5060","20153926083915-568",3,"2015-08-13 01:48:00",1439455680,"C2",1374180,1440829860,"2015-08-28 23:31:00"
"3306","20150329080354-90",3,"2015-08-13 02:01:00",1439456460,"C4",182040,1439638500,"2015-08-15 04:35:00"
"2937","20153711013755-30",1,"2015-08-13 02:17:00",1439457420,"C4",66000,1439523420,"2015-08-13 20:37:00"
"435","20154304074334-798",1,"2015-08-13 02:47:00",1439459220,"C3",429780,1439889000,"2015-08-18 02:10:00"
"4824","20154309044344-578",3,"2015-08-13 03:01:00",1439460060,"C6",49380,1439509440,"2015-08-13 16:44:00"
"5387","20150709120708-806",3,"2015-08-13 03:28:00",1439461680,"C5",104820,1439566500,"2015-08-14 08:35:00"
"4999","20150831030801-105",2,"2015-08-13 03:53:00",1439463180,"C4",360900,1439824080,"2015-08-17 08:08:00"
"3276","20153320043305-28",2,"2015-08-13 04:01:00",1439463660,"C2",577560,1440041220,"2015-08-19 20:27:00"
"4148","20152526082520-23",3,"2015-08-13 04:41:00",1439466060,"C5",192720,1439658780,"2015-08-15 10:13:00"
"4671","20150726030718-420",2,"2015-08-13 05:55:00",1439470500,"C8",761040,1440231540,"2015-08-22 01:19:00"
"6180","20153002083005-261",1,"2015-08-13 05:57:00",1439470620,"C7",104580,1439575200,"2015-08-14 11:00:00"
"2436","20153107123119-251",1,"2015-08-13 06:19:00",1439471940,"C8",248040,1439719980,"2015-08-16 03:13:00"
"3346","20153710073716-970",1,"2015-08-13 06:28:00",1439472480,"C3",85020,1439557500,"2015-08-14 06:05:00"
"1241","20153722113716-211",1,"2015-08-13 06:52:00",1439473920,"C2",269100,1439743020,"2015-08-16 09:37:00"
"5126","20154517094544-833",2,"2015-08-13 06:54:00",1439474040,"C4",774180,1440248220,"2015-08-22 05:57:00"
"5425","20155904015930-845",3,"2015-08-13 07:17:00",1439475420,"C4",107640,1439583060,"2015-08-14 13:11:00"
"5075","20151510051559-717",1,"2015-08-13 07:41:00",1439476860,"C2",224760,1439701620,"2015-08-15 22:07:00"
"2242","20152331102327-0",1,"2015-08-13 08:01:00",1439478060,"C7",159240,1439637300,"2015-08-15 04:15:00"
"1021","20151418011444-201",3,"2015-08-13 08:42:00",1439480520,"C4",278760,1439759280,"2015-08-16 14:08:00"
"5443","20150024060019-914",1,"2015-08-13 08:48:00",1439480880,"C5",541260,1440022140,"2015-08-19 15:09:00"
"6409","20153310073359-286",3,"2015-08-13 09:03:00",1439481780,"C2",88200,1439569980,"2015-08-14 09:33:00"
"2944","20154113114117-693",2,"2015-08-13 09:06:00",1439481960,"C7",381300,1439863260,"2015-08-17 19:01:00"
"3997","20153731083734-496",1,"2015-08-13 09:16:00",1439482560,"C5",375180,1439857740,"2015-08-17 17:29:00"
"6387","20155525045542-362",3,"2015-08-13 09:31:00",1439483460,"C5",538320,1440021780,"2015-08-19 15:03:00"
"1459","20153626093628-77",2,"2015-08-13 10:00:00",1439485200,"C2",518580,1440003780,"2015-08-19 10:03:00"
"2969","20153525023538-936",2,"2015-08-13 10:59:00",1439488740,"C6",271440,1439760180,"2015-08-16 14:23:00"
"3479","20150609050629-558",3,"2015-08-13 11:36:00",1439490960,"C6",54300,1439545260,"2015-08-14 02:41:00"
"91","20153813033817-519",2,"2015-08-13 12:44:00",1439495040,"C6",444660,1439939700,"2015-08-18 16:15:00"
"6218","20153303113325-724",1,"2015-08-13 13:09:00",1439496540,"C0",434880,1439931420,"2015-08-18 13:57:00"
"3430","20155501115503-638",2,"2015-08-13 13:57:00",1439499420,"C8",149160,1439648580,"2015-08-15 07:23:00"
"1952","20150310050337-557",1,"2015-08-13 14:18:00",1439500680,"C3",83100,1439583780,"2015-08-14 13:23:00"
"5892","20152131042143-820",2,"2015-08-13 14:20:00",1439500800,"C8",159420,1439660220,"2015-08-15 10:37:00"
"1524","20155310055324-613",1,"2015-08-13 15:42:00",1439505720,"C2",251340,1439757060,"2015-08-16 13:31:00"
"2903","20151211061241-520",1,"2015-08-13 15:42:00",1439505720,"C6",207000,1439712720,"2015-08-16 01:12:00"
"2212","20153818113831-85",1,"2015-08-13 16:00:00",1439506800,"C4",323160,1439829960,"2015-08-17 09:46:00"
"3339","20154311044358-220",2,"2015-08-13 16:42:00",1439509320,"C2",172740,1439682060,"2015-08-15 16:41:00"
"1130","20154428104404-828",1,"2015-08-13 17:34:00",1439512440,"C8",281400,1439793840,"2015-08-16 23:44:00"
"46","20150109040106-69",3,"2015-08-13 18:06:00",1439514360,"C8",70620,1439584980,"2015-08-14 13:43:00"
"2800","20151113121156-771",2,"2015-08-13 18:16:00",1439514960,"C8",540060,1440055020,"2015-08-20 00:17:00"
"2901","20150917070930-301",3,"2015-08-13 18:19:00",1439515140,"C5",339000,1439854140,"2015-08-17 16:29:00"
"4445","20153924013929-447",1,"2015-08-13 18:42:00",1439516520,"C4",619740,1440136260,"2015-08-20 22:51:00"
"4599","20153629093621-951",1,"2015-08-13 19:28:00",1439519280,"C4",166440,1439685720,"2015-08-15 17:42:00"
"6118","20152407022444-628",1,"2015-08-13 20:45:00",1439523900,"C5",180420,1439704320,"2015-08-15 22:52:00"
"4400","20152216102203-558",1,"2015-08-13 21:03:00",1439524980,"C5",721380,1440246360,"2015-08-22 05:26:00"
"4437","20153710023738-627",1,"2015-08-13 21:14:00",1439525640,"C4",283020,1439808660,"2015-08-17 03:51:00"
"5435","20151501051519-505",1,"2015-08-13 21:31:00",1439526660,"C6",131520,1439658180,"2015-08-15 10:03:00"
"3138","20154711064710-266",3,"2015-08-13 21:41:00",1439527260,"C7",113220,1439640480,"2015-08-15 05:08:00"
"2345","20155610055653-905",2,"2015-08-13 21:44:00",1439527440,"C3",90960,1439618400,"2015-08-14 23:00:00"
"5933","20151723021731-685",3,"2015-08-13 21:59:00",1439528340,"C5",263160,1439791500,"2015-08-16 23:05:00"
"3803","20155804085814-147",1,"2015-08-13 22:10:00",1439529000,"C5",103140,1439632140,"2015-08-15 02:49:00"
"1862","20150307020308-823",1,"2015-08-13 22:27:00",1439530020,"C6",68580,1439598600,"2015-08-14 17:30:00"
"5084","20154813034829-169",1,"2015-08-13 22:48:00",1439531280,"C8",1351800,1440883080,"2015-08-29 14:18:00"
"4457","20155117075129-610",2,"2015-08-13 23:03:00",1439532180,"C6",397920,1439930100,"2015-08-18 13:35:00"
"6100","20154018084053-456",1,"2015-08-14 00:18:00",1439536680,"C7",699240,1440235920,"2015-08-22 02:32:00"
"3281","20153126023103-958",2,"2015-08-14 00:25:00",1439537100,"C7",795420,1440332520,"2015-08-23 05:22:00"
"4176","20151305041332-847",3,"2015-08-14 00:35:00",1439537700,"C5",360660,1439898360,"2015-08-18 04:46:00"
"6320","20151431041410-501",3,"2015-08-14 01:04:00",1439539440,"C4",165000,1439704440,"2015-08-15 22:54:00"
"432","20155903065939-454",3,"2015-08-14 01:45:00",1439541900,"C8",133080,1439674980,"2015-08-15 14:43:00"
"3099","20152813072833-760",1,"2015-08-14 02:56:00",1439546160,"C2",343560,1439889720,"2015-08-18 02:22:00"
"4259","20154702084714-863",1,"2015-08-14 05:14:00",1439554440,"C5",341340,1439895780,"2015-08-18 04:03:00"
"3764","20154708044705-32",1,"2015-08-14 05:35:00",1439555700,"C8",239040,1439794740,"2015-08-16 23:59:00"
"3793","20154030094014-979",1,"2015-08-14 06:04:00",1439557440,"C2",160380,1439717820,"2015-08-16 02:37:00"
"5970","20150825040838-487",1,"2015-08-14 06:41:00",1439559660,"C7",188220,1439747880,"2015-08-16 10:58:00"
"4806","20151429111451-30",3,"2015-08-14 06:42:00",1439559720,"C5",170760,1439730480,"2015-08-16 06:08:00"
"6349","20154525024508-630",2,"2015-08-14 07:29:00",1439562540,"C5",243120,1439805660,"2015-08-17 03:01:00"
"2364","20154107124142-501",1,"2015-08-14 07:41:00",1439563260,"C8",117360,1439680620,"2015-08-15 16:17:00"
"3243","20150601070655-151",1,"2015-08-14 07:54:00",1439564040,"C5",475560,1440039600,"2015-08-19 20:00:00"
"5832","20153526053516-741",2,"2015-08-14 07:57:00",1439564220,"C2",229560,1439793780,"2015-08-16 23:43:00"
"6166","20150411120449-453",2,"2015-08-14 08:08:00",1439564880,"C4",122520,1439687400,"2015-08-15 18:10:00"
"327","20154804044849-878",3,"2015-08-14 08:32:00",1439566320,"C2",439080,1440005400,"2015-08-19 10:30:00"
"5594","20154011084036-355",3,"2015-08-14 09:20:00",1439569200,"C5",420000,1439989200,"2015-08-19 06:00:00"
"1166","20151511081530-342",1,"2015-08-14 09:23:00",1439569380,"C2",131640,1439701020,"2015-08-15 21:57:00"
"2352","20155613045650-872",1,"2015-08-14 09:32:00",1439569920,"C4",59760,1439629680,"2015-08-15 02:08:00"
"319","20151031071048-450",1,"2015-08-14 09:58:00",1439571480,"C5",174240,1439745720,"2015-08-16 10:22:00"
"4670","20152004082011-358",1,"2015-08-14 10:28:00",1439573280,"C2",443760,1440017040,"2015-08-19 13:44:00"
"1543","20153701093702-509",1,"2015-08-14 11:03:00",1439575380,"C2",564180,1440139560,"2015-08-20 23:46:00"
"2515","20152911062908-132",3,"2015-08-14 11:29:00",1439576940,"C2",138600,1439715540,"2015-08-16 01:59:00"
"1584","20150304070342-20",2,"2015-08-14 11:59:00",1439578740,"C0",445020,1440023760,"2015-08-19 15:36:00"
"2519","20153406113422-942",1,"2015-08-14 12:04:00",1439579040,"C8",346500,1439925540,"2015-08-18 12:19:00"
"5404","20150003080058-668",3,"2015-08-14 12:05:00",1439579100,"C0",520500,1440099600,"2015-08-20 12:40:00"
"3851","20154312114332-412",1,"2015-08-14 12:07:00",1439579220,"C3",87120,1439666340,"2015-08-15 12:19:00"
"4162","20155809115800-678",1,"2015-08-14 13:10:00",1439583000,"C4",1038240,1440621240,"2015-08-26 13:34:00"
"163","20153011093025-374",1,"2015-08-14 14:30:00",1439587800,"C4",92400,1439680200,"2015-08-15 16:10:00"
"6451","20155208075242-780",3,"2015-08-14 14:31:00",1439587860,"C4",180780,1439768640,"2015-08-16 16:44:00"
"4335","20155907045941-874",3,"2015-08-14 14:51:00",1439589060,"C2",409440,1439998500,"2015-08-19 08:35:00"
"4323","20153209023251-83",1,"2015-08-14 16:48:00",1439596080,"C8",62880,1439658960,"2015-08-15 10:16:00"
"6431","20154408124457-555",2,"2015-08-14 17:08:00",1439597280,"C5",267120,1439864400,"2015-08-17 19:20:00"
"5750","20151106071155-474",1,"2015-08-14 17:36:00",1439598960,"C7",104100,1439703060,"2015-08-15 22:31:00"
"6214","20155308045321-417",1,"2015-08-14 18:13:00",1439601180,"C8",104640,1439705820,"2015-08-15 23:17:00"
"2822","20153208083206-395",2,"2015-08-14 18:46:00",1439603160,"C5",79320,1439682480,"2015-08-15 16:48:00"
"85","20154008014020-3",2,"2015-08-14 18:50:00",1439603400,"C3",268500,1439871900,"2015-08-17 21:25:00"
"1541","20152610112615-740",1,"2015-08-14 19:24:00",1439605440,"C2",187140,1439792580,"2015-08-16 23:23:00"
"2371","20151206061257-541",2,"2015-08-14 19:56:00",1439607360,"C4",370320,1439977680,"2015-08-19 02:48:00"
"5239","20153111053127-294",2,"2015-08-14 20:11:00",1439608260,"C7",134400,1439742660,"2015-08-16 09:31:00"
"333","20150726110738-643",1,"2015-08-14 20:40:00",1439610000,"C4",558660,1440168660,"2015-08-21 07:51:00"
"5608","20153910113938-766",3,"2015-08-14 20:49:00",1439610540,"C8",189300,1439799840,"2015-08-17 01:24:00"
"5483","20150429010400-59",1,"2015-08-14 20:57:00",1439611020,"C8",201540,1439812560,"2015-08-17 04:56:00"
"1255","20153320083339-666",1,"2015-08-14 20:58:00",1439611080,"C8",440940,1440052020,"2015-08-19 23:27:00"
"1245","20150202040220-736",3,"2015-08-14 21:18:00",1439612280,"C4",527880,1440140160,"2015-08-20 23:56:00"
"5763","20150430110428-833",2,"2015-08-14 21:57:00",1439614620,"C7",190740,1439805360,"2015-08-17 02:56:00"
"5905","20152126102142-711",1,"2015-08-14 22:31:00",1439616660,"C8",337080,1439953740,"2015-08-18 20:09:00"
"5454","20154307124353-199",1,"2015-08-14 23:09:00",1439618940,"C7",844680,1440463620,"2015-08-24 17:47:00"
"2980","20153604073602-444",1,"2015-08-14 23:50:00",1439621400,"C5",461220,1440082620,"2015-08-20 07:57:00"
"1424","20155008055031-646",1,"2015-08-15 00:02:00",1439622120,"C8",270360,1439892480,"2015-08-18 03:08:00"
"1055","20150509010550-822",2,"2015-08-15 00:50:00",1439625000,"C3",158100,1439783100,"2015-08-16 20:45:00"
"1375","20151808051800-604",1,"2015-08-15 01:47:00",1439628420,"C7",78420,1439706840,"2015-08-15 23:34:00"
"904","20152619052654-46",3,"2015-08-15 01:59:00",1439629140,"C4",759060,1440388200,"2015-08-23 20:50:00"
"4550","20155611085614-73",1,"2015-08-15 02:28:00",1439630880,"C4",161160,1439792040,"2015-08-16 23:14:00"
"4280","20152805082823-737",2,"2015-08-15 02:34:00",1439631240,"C5",280920,1439912160,"2015-08-18 08:36:00"
"1565","20155916015917-666",1,"2015-08-15 02:35:00",1439631300,"C1",425160,1440056460,"2015-08-20 00:41:00"
"3079","20151124081114-91",1,"2015-08-15 02:37:00",1439631420,"C8",268680,1439900100,"2015-08-18 05:15:00"
"528","20154414024400-712",1,"2015-08-15 02:52:00",1439632320,"C3",340260,1439972580,"2015-08-19 01:23:00"
"3419","20150207030221-800",2,"2015-08-15 02:56:00",1439632560,"C4",323820,1439956380,"2015-08-18 20:53:00"
"5332","20155903075911-687",1,"2015-08-15 03:17:00",1439633820,"C2",509940,1440143760,"2015-08-21 00:56:00"
"4221","20155608105623-726",3,"2015-08-15 03:41:00",1439635260,"C5",465300,1440100560,"2015-08-20 12:56:00"
"4230","20152707102724-384",1,"2015-08-15 03:59:00",1439636340,"C8",333960,1439970300,"2015-08-19 00:45:00"
"4538","20152102102155-887",1,"2015-08-15 04:05:00",1439636700,"C5",550320,1440187020,"2015-08-21 12:57:00"
"3100","20150112080120-851",2,"2015-08-15 04:16:00",1439637360,"C3",81900,1439719260,"2015-08-16 03:01:00"
"4202","20155829085817-23",1,"2015-08-15 04:18:00",1439637480,"C8",726000,1440363480,"2015-08-23 13:58:00"
"1379","20155631045627-683",1,"2015-08-15 04:50:00",1439639400,"C4",178920,1439818320,"2015-08-17 06:32:00"
"6227","20152530082532-866",3,"2015-08-15 05:22:00",1439641320,"C4",457140,1440098460,"2015-08-20 12:21:00"
"5429","20151402081427-528",2,"2015-08-15 05:26:00",1439641560,"C2",473940,1440115500,"2015-08-20 17:05:00"
"5399","20152211072207-967",1,"2015-08-15 05:44:00",1439642640,"C7",169860,1439812500,"2015-08-17 04:55:00"
"3737","20155205095236-132",1,"2015-08-15 07:19:00",1439648340,"C2",284940,1439933280,"2015-08-18 14:28:00"
"3023","20151324041317-432",1,"2015-08-15 07:37:00",1439649420,"C7",267120,1439916540,"2015-08-18 09:49:00"
"5521","20150908080923-414",3,"2015-08-15 07:57:00",1439650620,"C4",604080,1440254700,"2015-08-22 07:45:00"
"4756","20150704110737-327",1,"2015-08-15 08:11:00",1439651460,"C5",117480,1439768940,"2015-08-16 16:49:00"
"853","20153005123012-657",1,"2015-08-15 08:16:00",1439651760,"C8",424380,1440076140,"2015-08-20 06:09:00"
"3456","20155824085808-856",3,"2015-08-15 08:18:00",1439651880,"C7",271200,1439923080,"2015-08-18 11:38:00"
"437","20155012025014-139",1,"2015-08-15 08:25:00",1439652300,"C6",236100,1439888400,"2015-08-18 02:00:00"
"2940","20154209044216-651",2,"2015-08-15 09:19:00",1439655540,"C5",70260,1439725800,"2015-08-16 04:50:00"
"4057","20155410035426-585",1,"2015-08-15 09:19:00",1439655540,"C8",81660,1439737200,"2015-08-16 08:00:00"
"5135","20151631031602-96",2,"2015-08-15 09:35:00",1439656500,"C7",182220,1439838720,"2015-08-17 12:12:00"
"4318","20154828014808-208",2,"2015-08-15 09:48:00",1439657280,"C2",516600,1440173880,"2015-08-21 09:18:00"
"3915","20152712082719-296",1,"2015-08-15 09:53:00",1439657580,"C8",132180,1439789760,"2015-08-16 22:36:00"
"4204","20155805085848-703",3,"2015-08-15 10:21:00",1439659260,"C7",124140,1439783400,"2015-08-16 20:50:00"
"3784","20150809010801-971",1,"2015-08-15 10:47:00",1439660820,"C2",169980,1439830800,"2015-08-17 10:00:00"
"1672","20154912014924-804",2,"2015-08-15 11:39:00",1439663940,"C2",251400,1439915340,"2015-08-18 09:29:00"
"649","20151826121830-361",3,"2015-08-15 11:46:00",1439664360,"C5",863040,1440527400,"2015-08-25 11:30:00"
"2050","20153529033559-238",1,"2015-08-15 11:59:00",1439665140,"C5",505980,1440171120,"2015-08-21 08:32:00"
"6052","20150018020030-238",3,"2015-08-15 12:43:00",1439667780,"C8",344940,1440012720,"2015-08-19 12:32:00"
"3772","20151513041529-826",3,"2015-08-15 12:49:00",1439668140,"C4",80220,1439748360,"2015-08-16 11:06:00"
"4021","20155110125158-386",1,"2015-08-15 12:53:00",1439668380,"C2",444360,1440112740,"2015-08-20 16:19:00"
"659","20152713122742-24",1,"2015-08-15 13:27:00",1439670420,"C8",88200,1439758620,"2015-08-16 13:57:00"
"3615","20154426054401-248",1,"2015-08-15 14:18:00",1439673480,"C8",857820,1440531300,"2015-08-25 12:35:00"
"578","20151307021320-869",1,"2015-08-15 15:25:00",1439677500,"C2",99360,1439776860,"2015-08-16 19:01:00"
"884","20153010043052-895",2,"2015-08-15 15:44:00",1439678640,"C3",61320,1439739960,"2015-08-16 08:46:00"
"5811","20154027014057-847",1,"2015-08-15 15:50:00",1439679000,"C8",329880,1440008880,"2015-08-19 11:28:00"
"3704","20154507064517-275",1,"2015-08-15 16:00:00",1439679600,"C4",103500,1439783100,"2015-08-16 20:45:00"
"559","20153507033523-248",2,"2015-08-15 16:23:00",1439680980,"C6",86760,1439767740,"2015-08-16 16:29:00"
"2147","20150911060927-249",2,"2015-08-15 16:47:00",1439682420,"C8",191940,1439874360,"2015-08-17 22:06:00"
"5481","20150314100300-561",2,"2015-08-15 17:21:00",1439684460,"C6",112680,1439797140,"2015-08-17 00:39:00"
"4957","20153601083623-683",1,"2015-08-15 17:36:00",1439685360,"C8",248400,1439933760,"2015-08-18 14:36:00"
"5240","20155405125402-226",1,"2015-08-15 17:49:00",1439686140,"C8",176340,1439862480,"2015-08-17 18:48:00"
"308","20150312070334-705",1,"2015-08-15 17:54:00",1439686440,"C4",99420,1439785860,"2015-08-16 21:31:00"
"5069","20154709044702-412",3,"2015-08-15 18:03:00",1439686980,"C7",261480,1439948460,"2015-08-18 18:41:00"
"5071","20151114071121-782",2,"2015-08-15 18:47:00",1439689620,"C0",128160,1439817780,"2015-08-17 06:23:00"
"1111","20150309030327-506",3,"2015-08-15 19:53:00",1439693580,"C5",53580,1439747160,"2015-08-16 10:46:00"
"2815","20154403054427-199",2,"2015-08-15 20:00:00",1439694000,"C7",149280,1439843280,"2015-08-17 13:28:00"
"5698","20153029063040-935",2,"2015-08-15 20:29:00",1439695740,"C5",217020,1439912760,"2015-08-18 08:46:00"
"6410","20151028111000-621",2,"2015-08-15 20:46:00",1439696760,"C6",264960,1439961720,"2015-08-18 22:22:00"
"3474","20153610123659-887",3,"2015-08-15 21:10:00",1439698200,"C7",66120,1439764320,"2015-08-16 15:32:00"
"693","20155410075450-130",1,"2015-08-15 22:19:00",1439702340,"C2",483900,1440186240,"2015-08-21 12:44:00"
"5589","20155910035914-610",3,"2015-08-15 22:57:00",1439704620,"C8",228540,1439933160,"2015-08-18 14:26:00"
"2425","20155206105220-877",1,"2015-08-15 23:00:00",1439704800,"C4",437460,1440142260,"2015-08-21 00:31:00"
"2960","20151225031208-655",1,"2015-08-15 23:43:00",1439707380,"C5",263580,1439970960,"2015-08-19 00:56:00"
"1970","20154910024932-203",1,"2015-08-16 00:37:00",1439710620,"C5",233640,1439944260,"2015-08-18 17:31:00"
"543","20155707125735-181",2,"2015-08-16 01:27:00",1439713620,"C2",245400,1439959020,"2015-08-18 21:37:00"
"588","20152330112343-461",1,"2015-08-16 01:39:00",1439714340,"C2",179220,1439893560,"2015-08-18 03:26:00"
"4242","20153609113649-758",1,"2015-08-16 01:41:00",1439714460,"C4",81300,1439795760,"2015-08-17 00:16:00"
"5721","20155303045356-851",1,"2015-08-16 02:29:00",1439717340,"C2",535680,1440253020,"2015-08-22 07:17:00"
"4405","20152509072510-961",1,"2015-08-16 02:46:00",1439718360,"C4",196020,1439914380,"2015-08-18 09:13:00"
"2314","20153706123730-475",2,"2015-08-16 02:47:00",1439718420,"C8",1219800,1440938220,"2015-08-30 05:37:00"
"5393","20153302123354-327",1,"2015-08-16 03:33:00",1439721180,"C8",235440,1439956620,"2015-08-18 20:57:00"
"4524","20150108050153-619",3,"2015-08-16 04:13:00",1439723580,"C0",92160,1439815740,"2015-08-17 05:49:00"
"2689","20155720095723-531",2,"2015-08-16 04:15:00",1439723700,"C6",385380,1440109080,"2015-08-20 15:18:00"
"4051","20150509110512-433",2,"2015-08-16 04:23:00",1439724180,"C5",290340,1440014520,"2015-08-19 13:02:00"
"1024","20150702040744-309",2,"2015-08-16 04:31:00",1439724660,"C5",145980,1439870640,"2015-08-17 21:04:00"
"1439","20152008042053-423",1,"2015-08-16 05:06:00",1439726760,"C7",325380,1440052140,"2015-08-19 23:29:00"
"3839","20154303074311-913",1,"2015-08-16 05:51:00",1439729460,"C4",558240,1440287700,"2015-08-22 16:55:00"
"3246","20150302120354-207",2,"2015-08-16 05:55:00",1439729700,"C4",148440,1439878140,"2015-08-17 23:09:00"
"5962","20151309041300-869",1,"2015-08-16 06:04:00",1439730240,"C3",81180,1439811420,"2015-08-17 04:37:00"
"5925","20150514030514-420",1,"2015-08-16 06:25:00",1439731500,"C2",352500,1440084000,"2015-08-20 08:20:00"
"6083","20152502062553-799",3,"2015-08-16 06:44:00",1439732640,"C3",1210740,1440943380,"2015-08-30 07:03:00"
"2552","20153417043413-536",2,"2015-08-16 07:18:00",1439734680,"C7",365520,1440100200,"2015-08-20 12:50:00"
"817","20151409111437-111",2,"2015-08-16 07:28:00",1439735280,"C7",295620,1440030900,"2015-08-19 17:35:00"
"448","20153731093738-268",2,"2015-08-16 07:35:00",1439735700,"C8",196440,1439932140,"2015-08-18 14:09:00"
"212","20154122074105-174",2,"2015-08-16 08:03:00",1439737380,"C3",308760,1440046140,"2015-08-19 21:49:00"
"2571","20151914011913-652",3,"2015-08-16 09:40:00",1439743200,"C2",159660,1439902860,"2015-08-18 06:01:00"
"1658","20150514090525-937",3,"2015-08-16 10:11:00",1439745060,"C5",88380,1439833440,"2015-08-17 10:44:00"
"2215","20155020045059-811",1,"2015-08-16 10:50:00",1439747400,"C5",770400,1440517800,"2015-08-25 08:50:00"
"6072","20150613070601-595",2,"2015-08-16 11:14:00",1439748840,"C8",137040,1439885880,"2015-08-18 01:18:00"
"4165","20153401073445-361",2,"2015-08-16 11:34:00",1439750040,"C0",187200,1439937240,"2015-08-18 15:34:00"
"2120","20155314085317-744",3,"2015-08-16 12:10:00",1439752200,"C2",184620,1439936820,"2015-08-18 15:27:00"
"686","20153511073525-756",1,"2015-08-16 13:13:00",1439755980,"C8",447240,1440203220,"2015-08-21 17:27:00"
"4086","20155704085706-777",3,"2015-08-16 13:45:00",1439757900,"C4",527040,1440284940,"2015-08-22 16:09:00"
"4760","20151315011308-405",1,"2015-08-16 13:53:00",1439758380,"C0",88800,1439847180,"2015-08-17 14:33:00"
"1559","20154504094510-630",1,"2015-08-16 14:23:00",1439760180,"C5",526740,1440286920,"2015-08-22 16:42:00"
"4215","20153729093742-70",1,"2015-08-16 14:25:00",1439760300,"C4",196560,1439956860,"2015-08-18 21:01:00"
"4918","20150112110110-857",1,"2015-08-16 14:36:00",1439760960,"C2",358500,1440119460,"2015-08-20 18:11:00"
"5247","20153205073220-30",1,"2015-08-16 15:17:00",1439763420,"C2",978300,1440741720,"2015-08-27 23:02:00"
"6560","20153229043251-293",1,"2015-08-16 15:23:00",1439763780,"C2",517020,1440280800,"2015-08-22 15:00:00"
"281","20151710111713-168",3,"2015-08-16 15:57:00",1439765820,"C8",107040,1439872860,"2015-08-17 21:41:00"
"3483","20155201035224-590",1,"2015-08-16 16:56:00",1439769360,"C0",497280,1440266640,"2015-08-22 11:04:00"
"3262","20150823060803-803",1,"2015-08-16 17:04:00",1439769840,"C3",264120,1440033960,"2015-08-19 18:26:00"
"2697","20153014043029-662",2,"2015-08-16 17:18:00",1439770680,"C4",58560,1439829240,"2015-08-17 09:34:00"
"3719","20151531021539-858",2,"2015-08-16 17:55:00",1439772900,"C8",279120,1440052020,"2015-08-19 23:27:00"
"1075","20155829125801-230",2,"2015-08-16 17:56:00",1439772960,"C0",786540,1440559500,"2015-08-25 20:25:00"
"6217","20151608061603-479",1,"2015-08-16 18:10:00",1439773800,"C8",367020,1440140820,"2015-08-21 00:07:00"
"1061","20153013113037-790",1,"2015-08-16 20:16:00",1439781360,"C3",290760,1440072120,"2015-08-20 05:02:00"
"5446","20151114121111-116",2,"2015-08-16 20:33:00",1439782380,"C8",101460,1439883840,"2015-08-18 00:44:00"
"5794","20152215092246-386",1,"2015-08-16 22:30:00",1439789400,"C2",133680,1439923080,"2015-08-18 11:38:00"
"1540","20150615050655-209",3,"2015-08-16 23:02:00",1439791320,"C8",53880,1439845200,"2015-08-17 14:00:00"
"652","20154009074056-552",1,"2015-08-16 23:10:00",1439791800,"C8",132120,1439923920,"2015-08-18 11:52:00"
"5602","20152408052435-531",2,"2015-08-16 23:33:00",1439793180,"C5",237780,1440030960,"2015-08-19 17:36:00"
"5960","20154412024403-809",1,"2015-08-16 23:48:00",1439794080,"C7",189120,1439983200,"2015-08-19 04:20:00"
"4265","20155521125533-941",1,"2015-08-17 01:13:00",1439799180,"C5",763560,1440562740,"2015-08-25 21:19:00"
"6170","20152412032434-101",1,"2015-08-17 01:13:00",1439799180,"C4",54420,1439853600,"2015-08-17 16:20:00"
"285","20155815125829-147",1,"2015-08-17 01:26:00",1439799960,"C5",65640,1439865600,"2015-08-17 19:40:00"
"3852","20155814095824-763",1,"2015-08-17 01:34:00",1439800440,"C4",114480,1439914920,"2015-08-18 09:22:00"
"208","20154501084500-257",2,"2015-08-17 01:49:00",1439801340,"C4",193920,1439995260,"2015-08-19 07:41:00"
"3537","20154212044243-346",1,"2015-08-17 02:06:00",1439802360,"C7",189720,1439992080,"2015-08-19 06:48:00"
"1465","20152631112623-34",3,"2015-08-17 02:16:00",1439802960,"C8",287160,1440090120,"2015-08-20 10:02:00"
"2661","20153521103532-680",3,"2015-08-17 03:15:00",1439806500,"C4",288300,1440094800,"2015-08-20 11:20:00"
"1560","20152315102309-132",2,"2015-08-17 03:23:00",1439806980,"C2",73800,1439880780,"2015-08-17 23:53:00"
"4885","20155213095235-98",2,"2015-08-17 03:46:00",1439808360,"C4",161820,1439970180,"2015-08-19 00:43:00"
"6138","20153821043846-584",2,"2015-08-17 04:21:00",1439810460,"C8",326940,1440137400,"2015-08-20 23:10:00"
"2075","20150006080007-531",3,"2015-08-17 05:40:00",1439815200,"C7",471000,1440286200,"2015-08-22 16:30:00"
"4748","20150010040007-631",2,"2015-08-17 06:42:00",1439818920,"C6",95220,1439914140,"2015-08-18 09:09:00"
"4954","20153931053905-915",2,"2015-08-17 06:48:00",1439819280,"C3",476580,1440295860,"2015-08-22 19:11:00"
"3598","20154314064318-347",2,"2015-08-17 06:56:00",1439819760,"C4",259980,1440079740,"2015-08-20 07:09:00"
"1050","20152805012826-73",1,"2015-08-17 07:37:00",1439822220,"C2",338580,1440160800,"2015-08-21 05:40:00"
"4072","20152007102018-450",1,"2015-08-17 07:45:00",1439822700,"C7",122100,1439944800,"2015-08-18 17:40:00"
"5613","20153222073236-42",1,"2015-08-17 07:56:00",1439823360,"C4",280980,1440104340,"2015-08-20 13:59:00"
"5221","20150014030027-293",2,"2015-08-17 08:12:00",1439824320,"C4",78240,1439902560,"2015-08-18 05:56:00"
"3523","20150914110948-268",1,"2015-08-17 08:18:00",1439824680,"C7",325260,1440149940,"2015-08-21 02:39:00"
"5118","20155117065115-489",3,"2015-08-17 09:06:00",1439827560,"C0",179100,1440006660,"2015-08-19 10:51:00"
"2261","20151726061756-646",1,"2015-08-17 09:26:00",1439828760,"C4",637380,1440466140,"2015-08-24 18:29:00"
"1846","20152419022425-210",1,"2015-08-17 10:07:00",1439831220,"C7",355740,1440186960,"2015-08-21 12:56:00"
"2079","20154315064331-937",1,"2015-08-17 10:41:00",1439833260,"C5",93540,1439926800,"2015-08-18 12:40:00"
"3409","20155804015811-880",1,"2015-08-17 10:46:00",1439833560,"C4",797760,1440631320,"2015-08-26 16:22:00"
"225","20151109101115-984",1,"2015-08-17 10:51:00",1439833860,"C4",86700,1439920560,"2015-08-18 10:56:00"
"3779","20152001122012-967",1,"2015-08-17 11:00:00",1439834400,"C8",275520,1440109920,"2015-08-20 15:32:00"
"806","20150113120141-485",1,"2015-08-17 11:03:00",1439834580,"C8",171060,1440005640,"2015-08-19 10:34:00"
"402","20153007113051-98",2,"2015-08-17 11:12:00",1439835120,"C5",431460,1440266580,"2015-08-22 11:03:00"
"1859","20154607094631-516",2,"2015-08-17 11:14:00",1439835240,"C5",434640,1440269880,"2015-08-22 11:58:00"
"6239","20153915043953-171",2,"2015-08-17 11:23:00",1439835780,"C4",153840,1439989620,"2015-08-19 06:07:00"
"311","20155030075000-793",2,"2015-08-17 11:32:00",1439836320,"C5",522840,1440359160,"2015-08-23 12:46:00"
"6073","20154927084959-505",2,"2015-08-17 11:49:00",1439837340,"C0",912600,1440749940,"2015-08-28 01:19:00"
"1754","20151114081116-872",2,"2015-08-17 12:11:00",1439838660,"C4",369000,1440207660,"2015-08-21 18:41:00"
"6110","20154415014417-163",2,"2015-08-17 13:40:00",1439844000,"C2",172560,1440016560,"2015-08-19 13:36:00"
"4331","20150208100221-140",3,"2015-08-17 13:43:00",1439844180,"C7",112980,1439957160,"2015-08-18 21:06:00"
"3676","20153408043401-757",3,"2015-08-17 14:04:00",1439845440,"C5",51240,1439896680,"2015-08-18 04:18:00"
"3887","20153402013445-750",1,"2015-08-17 15:28:00",1439850480,"C0",186120,1440036600,"2015-08-19 19:10:00"
"4598","20155222025217-753",1,"2015-08-17 15:30:00",1439850600,"C8",321240,1440171840,"2015-08-21 08:44:00"
"1020","20153503063500-934",2,"2015-08-17 15:48:00",1439851680,"C7",177540,1440029220,"2015-08-19 17:07:00"
"1616","20153013113059-327",1,"2015-08-17 16:03:00",1439852580,"C7",434340,1440286920,"2015-08-22 16:42:00"
"5326","20151823021857-278",3,"2015-08-17 16:34:00",1439854440,"C0",271020,1440125460,"2015-08-20 19:51:00"
"4717","20155615065643-355",3,"2015-08-17 16:39:00",1439854740,"C4",207780,1440062520,"2015-08-20 02:22:00"
"5280","20154830024817-212",3,"2015-08-17 16:48:00",1439855280,"C5",520800,1440376080,"2015-08-23 17:28:00"
"3071","20154610024627-393",3,"2015-08-17 16:59:00",1439855940,"C8",87540,1439943480,"2015-08-18 17:18:00"
"3127","20150812050800-581",1,"2015-08-17 17:04:00",1439856240,"C7",61680,1439917920,"2015-08-18 10:12:00"
"3500","20151505101551-848",3,"2015-08-17 17:07:00",1439856420,"C5",530760,1440387180,"2015-08-23 20:33:00"
"2804","20153731033739-510",2,"2015-08-17 17:21:00",1439857260,"C4",184380,1440041640,"2015-08-19 20:34:00"
"1823","20154319044337-154",1,"2015-08-17 17:41:00",1439858460,"C8",358440,1440216900,"2015-08-21 21:15:00"
"4418","20150903050915-821",1,"2015-08-17 19:49:00",1439866140,"C5",152400,1440018540,"2015-08-19 14:09:00"
"6182","20155426075432-816",2,"2015-08-17 20:32:00",1439868720,"C4",278040,1440146760,"2015-08-21 01:46:00"
"5107","20155816065857-340",1,"2015-08-17 21:17:00",1439871420,"C4",137940,1440009360,"2015-08-19 11:36:00"
"2470","20152707072751-974",1,"2015-08-17 21:19:00",1439871540,"C8",130560,1440002100,"2015-08-19 09:35:00"
"872","20151425111443-882",3,"2015-08-17 21:27:00",1439872020,"C5",289140,1440161160,"2015-08-21 05:46:00"
"2565","20151329111340-193",2,"2015-08-17 22:33:00",1439875980,"C5",210300,1440086280,"2015-08-20 08:58:00"
"2334","20154011014002-294",1,"2015-08-17 23:01:00",1439877660,"C0",184020,1440061680,"2015-08-20 02:08:00"
"4105","20152010062058-60",1,"2015-08-17 23:08:00",1439878080,"C4",221760,1440099840,"2015-08-20 12:44:00"
"5796","20151514111535-583",1,"2015-08-18 00:39:00",1439883540,"C0",153720,1440037260,"2015-08-19 19:21:00"
"2475","20152917072944-998",1,"2015-08-18 00:58:00",1439884680,"C4",391620,1440276300,"2015-08-22 13:45:00"
"5353","20152504102511-329",2,"2015-08-18 01:31:00",1439886660,"C4",1285320,1441171980,"2015-09-01 22:33:00"
"416","20153509033522-770",1,"2015-08-18 01:41:00",1439887260,"C5",363780,1440251040,"2015-08-22 06:44:00"
"1879","20152305112331-211",1,"2015-08-18 02:59:00",1439891940,"C7",121440,1440013380,"2015-08-19 12:43:00"
"1550","20151911041901-689",3,"2015-08-18 03:31:00",1439893860,"C6",69840,1439963700,"2015-08-18 22:55:00"
"1834","20153324083347-572",2,"2015-08-18 03:53:00",1439895180,"C2",1071600,1440966780,"2015-08-30 13:33:00"
"2722","20151612121658-752",1,"2015-08-18 04:32:00",1439897520,"C8",70080,1439967600,"2015-08-19 00:00:00"
"2408","20151211091201-575",2,"2015-08-18 05:24:00",1439900640,"C7",295560,1440196200,"2015-08-21 15:30:00"
"5792","20150411020405-25",3,"2015-08-18 05:32:00",1439901120,"C4",287040,1440188160,"2015-08-21 13:16:00"
"1781","20151914041953-619",1,"2015-08-18 05:59:00",1439902740,"C5",154200,1440056940,"2015-08-20 00:49:00"
"4840","20151528061539-192",1,"2015-08-18 06:15:00",1439903700,"C8",362880,1440266580,"2015-08-22 11:03:00"
"784","20153915063956-914",3,"2015-08-18 06:17:00",1439903820,"C8",128940,1440032760,"2015-08-19 18:06:00"
"3805","20150321080345-584",2,"2015-08-18 07:23:00",1439907780,"C4",302100,1440209880,"2015-08-21 19:18:00"
"1340","20152501032501-316",1,"2015-08-18 07:37:00",1439908620,"C7",160080,1440068700,"2015-08-20 04:05:00"
"5953","20150207100246-511",1,"2015-08-18 07:42:00",1439908920,"C8",188400,1440097320,"2015-08-20 12:02:00"
"1971","20151019101010-336",1,"2015-08-18 08:30:00",1439911800,"C8",517200,1440429000,"2015-08-24 08:10:00"
"1128","20155216055230-781",1,"2015-08-18 09:38:00",1439915880,"C3",71580,1439987460,"2015-08-19 05:31:00"
"4868","20155529075511-496",1,"2015-08-18 09:55:00",1439916900,"C0",216900,1440133800,"2015-08-20 22:10:00"
"3534","20153603053617-529",3,"2015-08-18 09:56:00",1439916960,"C8",253680,1440170640,"2015-08-21 08:24:00"
"5633","20155602125643-208",2,"2015-08-18 10:08:00",1439917680,"C5",171540,1440089220,"2015-08-20 09:47:00"
"4484","20154307124354-819",2,"2015-08-18 10:43:00",1439919780,"C5",117900,1440037680,"2015-08-19 19:28:00"
"6559","20151307121323-821",1,"2015-08-18 10:45:00",1439919900,"C4",118140,1440038040,"2015-08-19 19:34:00"
"3480","20150909120927-426",1,"2015-08-18 10:59:00",1439920740,"C6",773400,1440694140,"2015-08-27 09:49:00"
"5174","20152414112403-762",2,"2015-08-18 11:09:00",1439921340,"C5",114900,1440036240,"2015-08-19 19:04:00"
"5229","20153715093725-365",1,"2015-08-18 11:33:00",1439922780,"C7",133080,1440055860,"2015-08-20 00:31:00"
"102","20155109115123-786",1,"2015-08-18 12:15:00",1439925300,"C4",259680,1440184980,"2015-08-21 12:23:00"
"1144","20152716102734-529",1,"2015-08-18 12:17:00",1439925420,"C7",89700,1440015120,"2015-08-19 13:12:00"
"4100","20152509052554-869",1,"2015-08-18 12:40:00",1439926800,"C2",253500,1440180300,"2015-08-21 11:05:00"
"206","20153318013311-102",2,"2015-08-18 13:01:00",1439928060,"C5",334560,1440262620,"2015-08-22 09:57:00"
"3137","20154215114244-418",2,"2015-08-18 13:27:00",1439929620,"C0",88500,1440018120,"2015-08-19 14:02:00"
"876","20151116021105-602",1,"2015-08-18 13:53:00",1439931180,"C5",407160,1440338340,"2015-08-23 06:59:00"
"922","20153412103450-486",1,"2015-08-18 14:04:00",1439931840,"C3",531000,1440462840,"2015-08-24 17:34:00"
"3732","20154605074608-859",2,"2015-08-18 14:26:00",1439933160,"C4",478200,1440411360,"2015-08-24 03:16:00"
"3864","20150714090715-693",1,"2015-08-18 14:40:00",1439934000,"C6",365580,1440299580,"2015-08-22 20:13:00"
"5685","20151129101109-424",3,"2015-08-18 15:35:00",1439937300,"C6",291240,1440228540,"2015-08-22 00:29:00"
"3913","20152815042814-977",2,"2015-08-18 16:00:00",1439938800,"C6",257520,1440196320,"2015-08-21 15:32:00"
"2984","20153510103505-180",2,"2015-08-18 16:27:00",1439940420,"C4",423840,1440364260,"2015-08-23 14:11:00"
"5434","20154729074714-800",2,"2015-08-18 16:27:00",1439940420,"C8",351840,1440292260,"2015-08-22 18:11:00"
"3038","20153316013306-455",1,"2015-08-18 16:56:00",1439942160,"C0",184980,1440127140,"2015-08-20 20:19:00"
"816","20155325075339-490",2,"2015-08-18 17:33:00",1439944380,"C5",301200,1440245580,"2015-08-22 05:13:00"
"3905","20152816122841-313",1,"2015-08-18 17:44:00",1439945040,"C0",95880,1440040920,"2015-08-19 20:22:00"
"2843","20151910031914-568",1,"2015-08-18 18:59:00",1439949540,"C8",352200,1440301740,"2015-08-22 20:49:00"
"2873","20154231084240-825",2,"2015-08-18 19:21:00",1439950860,"C7",177060,1440127920,"2015-08-20 20:32:00"
"973","20155208085206-672",2,"2015-08-18 19:22:00",1439950920,"C5",300600,1440251520,"2015-08-22 06:52:00"
"6312","20150514060535-722",1,"2015-08-18 19:41:00",1439952060,"C6",394560,1440346620,"2015-08-23 09:17:00"
"2218","20151225091206-465",2,"2015-08-18 19:48:00",1439952480,"C2",301680,1440254160,"2015-08-22 07:36:00"
"1312","20152030112009-638",2,"2015-08-18 19:54:00",1439952840,"C8",238920,1440191760,"2015-08-21 14:16:00"
"44","20154917014946-993",3,"2015-08-18 20:26:00",1439954760,"C4",110220,1440064980,"2015-08-20 03:03:00"
"2602","20151812061805-214",1,"2015-08-18 22:26:00",1439961960,"C2",288240,1440250200,"2015-08-22 06:30:00"
"2794","20155019085012-883",2,"2015-08-18 22:26:00",1439961960,"C4",377280,1440339240,"2015-08-23 07:14:00"
"3052","20155027045016-281",2,"2015-08-18 22:42:00",1439962920,"C5",240240,1440203160,"2015-08-21 17:26:00"
"4507","20154407104408-451",2,"2015-08-18 22:53:00",1439963580,"C4",331380,1440294960,"2015-08-22 18:56:00"
"2134","20150007020012-126",1,"2015-08-18 23:36:00",1439966160,"C3",492480,1440458640,"2015-08-24 16:24:00"
"6151","20155318075328-481",3,"2015-08-19 00:33:00",1439969580,"C5",342300,1440311880,"2015-08-22 23:38:00"
"1679","20153722083744-703",1,"2015-08-19 01:01:00",1439971260,"C4",298980,1440270240,"2015-08-22 12:04:00"
"4677","20152212112246-498",1,"2015-08-19 01:04:00",1439971440,"C5",283860,1440255300,"2015-08-22 07:55:00"
"6328","20154003094041-201",1,"2015-08-19 01:08:00",1439971680,"C2",503760,1440475440,"2015-08-24 21:04:00"
"3206","20154423074437-690",2,"2015-08-19 01:36:00",1439973360,"C2",288840,1440262200,"2015-08-22 09:50:00"
"5896","20150425060412-481",2,"2015-08-19 02:07:00",1439975220,"C8",306540,1440281760,"2015-08-22 15:16:00"
"902","20155914045902-906",1,"2015-08-19 02:27:00",1439976420,"C8",189840,1440166260,"2015-08-21 07:11:00"
"2945","20154505014505-202",2,"2015-08-19 02:33:00",1439976780,"C6",804960,1440781740,"2015-08-28 10:09:00"
"1620","20151212051226-954",3,"2015-08-19 02:51:00",1439977860,"C4",79020,1440056880,"2015-08-20 00:48:00"
"6327","20154517024507-611",1,"2015-08-19 04:47:00",1439984820,"C4",68460,1440053280,"2015-08-19 23:48:00"
"3789","20150914030948-203",2,"2015-08-19 05:31:00",1439987460,"C3",56760,1440044220,"2015-08-19 21:17:00"
"2563","20155618085617-440",2,"2015-08-19 05:56:00",1439988960,"C6",459000,1440447960,"2015-08-24 13:26:00"
"1303","20151630041632-789",1,"2015-08-19 05:58:00",1439989080,"C2",241560,1440230640,"2015-08-22 01:04:00"
"1544","20153717103748-173",3,"2015-08-19 06:17:00",1439990220,"C4",157200,1440147420,"2015-08-21 01:57:00"
"4123","20154824034807-478",2,"2015-08-19 06:20:00",1439990400,"C5",276540,1440266940,"2015-08-22 11:09:00"
"1735","20151217101248-377",3,"2015-08-19 06:58:00",1439992680,"C8",80580,1440073260,"2015-08-20 05:21:00"
"3942","20153316073319-342",3,"2015-08-19 07:05:00",1439993100,"C7",128760,1440121860,"2015-08-20 18:51:00"
"5622","20153707123730-758",3,"2015-08-19 07:31:00",1439994660,"C6",169740,1440164400,"2015-08-21 06:40:00"
"4981","20154127124144-803",3,"2015-08-19 07:51:00",1439995860,"C2",281400,1440277260,"2015-08-22 14:01:00"
"4413","20151115121122-695",3,"2015-08-19 09:01:00",1440000060,"C2",167100,1440167160,"2015-08-21 07:26:00"
"6202","20150116070109-391",1,"2015-08-19 09:02:00",1440000120,"C6",266460,1440266580,"2015-08-22 11:03:00"
"4675","20150217030209-500",2,"2015-08-19 09:26:00",1440001560,"C2",76320,1440077880,"2015-08-20 06:38:00"
"4608","20154519024544-322",2,"2015-08-19 09:49:00",1440002940,"C4",202980,1440205920,"2015-08-21 18:12:00"
"2254","20150106030143-319",1,"2015-08-19 11:15:00",1440008100,"C2",158520,1440166620,"2015-08-21 07:17:00"
"4593","20154715054748-43",2,"2015-08-19 11:30:00",1440009000,"C2",46140,1440055140,"2015-08-20 00:19:00"
"2562","20152310062340-347",1,"2015-08-19 12:03:00",1440010980,"C7",114000,1440124980,"2015-08-20 19:43:00"
"1003","20154931054946-146",1,"2015-08-19 12:19:00",1440011940,"C8",324360,1440336300,"2015-08-23 06:25:00"
"4997","20151813031829-984",2,"2015-08-19 12:22:00",1440012120,"C0",63480,1440075600,"2015-08-20 06:00:00"
"3373","20154427024429-109",1,"2015-08-19 13:08:00",1440014880,"C4",247680,1440262560,"2015-08-22 09:56:00"
"5464","20151516011512-70",1,"2015-08-19 13:30:00",1440016200,"C2",260100,1440276300,"2015-08-22 13:45:00"
"5237","20151716071747-621",1,"2015-08-19 13:31:00",1440016260,"C2",281640,1440297900,"2015-08-22 19:45:00"
"3977","20155028125010-618",1,"2015-08-19 14:44:00",1440020640,"C5",272520,1440293160,"2015-08-22 18:26:00"
"4450","20154116074134-300",3,"2015-08-19 14:56:00",1440021360,"C4",285300,1440306660,"2015-08-22 22:11:00"
"5030","20151514031512-498",1,"2015-08-19 15:32:00",1440023520,"C8",61860,1440085380,"2015-08-20 08:43:00"
"5077","20152314082352-547",2,"2015-08-19 15:42:00",1440024120,"C4",458340,1440482460,"2015-08-24 23:01:00"
"5756","20152317012342-801",2,"2015-08-19 15:53:00",1440024780,"C3",90900,1440115680,"2015-08-20 17:08:00"
"4136","20153818123807-188",1,"2015-08-19 16:07:00",1440025620,"C6",98940,1440124560,"2015-08-20 19:36:00"
"2726","20154229104255-661",3,"2015-08-19 17:28:00",1440030480,"C0",262680,1440293160,"2015-08-22 18:26:00"
"5504","20150126050104-905",3,"2015-08-19 17:52:00",1440031920,"C5",692220,1440724140,"2015-08-27 18:09:00"
"4791","20155616025653-750",1,"2015-08-19 18:08:00",1440032880,"C4",270720,1440303600,"2015-08-22 21:20:00"
"2294","20151318061334-243",2,"2015-08-19 18:46:00",1440035160,"C0",131580,1440166740,"2015-08-21 07:19:00"
"2521","20150518040539-572",3,"2015-08-19 18:58:00",1440035880,"C2",96780,1440132660,"2015-08-20 21:51:00"
"6150","20152405122407-516",1,"2015-08-19 18:59:00",1440035940,"C8",246660,1440282600,"2015-08-22 15:30:00"
"3110","20151125071146-648",2,"2015-08-19 19:31:00",1440037860,"C8",440880,1440478740,"2015-08-24 21:59:00"
"2067","20151411101443-797",1,"2015-08-19 19:59:00",1440039540,"C8",680940,1440720480,"2015-08-27 17:08:00"
"480","20151607071627-500",1,"2015-08-19 20:20:00",1440040800,"C4",541920,1440582720,"2015-08-26 02:52:00"
"1056","20154212044215-152",1,"2015-08-19 20:22:00",1440040920,"C4",309000,1440349920,"2015-08-23 10:12:00"
"3837","20150525050525-344",3,"2015-08-19 20:57:00",1440043020,"C0",310560,1440353580,"2015-08-23 11:13:00"
"3566","20150606090640-663",1,"2015-08-19 21:12:00",1440043920,"C0",166680,1440210600,"2015-08-21 19:30:00"
"3094","20154117054153-286",2,"2015-08-19 21:13:00",1440043980,"C8",92760,1440136740,"2015-08-20 22:59:00"
"2877","20152118032137-233",2,"2015-08-19 21:58:00",1440046680,"C4",110220,1440156900,"2015-08-21 04:35:00"
"420","20155519125535-358",1,"2015-08-19 22:01:00",1440046860,"C6",451860,1440498720,"2015-08-25 03:32:00"
"5362","20151907011912-142",1,"2015-08-19 22:10:00",1440047400,"C5",356220,1440403620,"2015-08-24 01:07:00"
"1743","20152207052205-192",1,"2015-08-19 22:53:00",1440049980,"C2",96060,1440146040,"2015-08-21 01:34:00"
"810","20155114095131-368",2,"2015-08-19 23:19:00",1440051540,"C2",68640,1440120180,"2015-08-20 18:23:00"
"5940","20152115072114-129",1,"2015-08-19 23:49:00",1440053340,"C5",202440,1440255780,"2015-08-22 08:03:00"
"4974","20152731042731-228",3,"2015-08-19 23:51:00",1440053460,"C5",834120,1440887580,"2015-08-29 15:33:00"
"4910","20154316124308-991",1,"2015-08-20 00:39:00",1440056340,"C4",151080,1440207420,"2015-08-21 18:37:00"
"1250","20154630124653-489",1,"2015-08-20 00:45:00",1440056700,"C4",253020,1440309720,"2015-08-22 23:02:00"
"4054","20152101072110-270",1,"2015-08-20 00:53:00",1440057180,"C5",809160,1440866340,"2015-08-29 09:39:00"
"3371","20152116012117-783",1,"2015-08-20 00:57:00",1440057420,"C2",150480,1440207900,"2015-08-21 18:45:00"
"5101","20150713090739-797",1,"2015-08-20 01:15:00",1440058500,"C8",288240,1440346740,"2015-08-23 09:19:00"
"4321","20152714022709-931",2,"2015-08-20 03:03:00",1440064980,"C5",159120,1440224100,"2015-08-21 23:15:00"
"3989","20150214110230-668",1,"2015-08-20 03:18:00",1440065880,"C0",245280,1440311160,"2015-08-22 23:26:00"
"4127","20150205030232-909",1,"2015-08-20 03:18:00",1440065880,"C8",626880,1440692760,"2015-08-27 09:26:00"
"1320","20151403101408-211",1,"2015-08-20 03:54:00",1440068040,"C0",589200,1440657240,"2015-08-26 23:34:00"
"1523","20150207080240-722",1,"2015-08-20 04:16:00",1440069360,"C8",554820,1440624180,"2015-08-26 14:23:00"
"4439","20151916021928-359",1,"2015-08-20 04:39:00",1440070740,"C8",62160,1440132900,"2015-08-20 21:55:00"
"2464","20154115044115-752",1,"2015-08-20 04:49:00",1440071340,"C8",194640,1440265980,"2015-08-22 10:53:00"
"5596","20154424084414-48",1,"2015-08-20 06:12:00",1440076320,"C4",614460,1440690780,"2015-08-27 08:53:00"
"5420","20150112080156-678",3,"2015-08-20 06:31:00",1440077460,"C7",342900,1440420360,"2015-08-24 05:46:00"
"657","20152115052114-277",1,"2015-08-20 07:15:00",1440080100,"C6",65940,1440146040,"2015-08-21 01:34:00"
"167","20150516060520-936",2,"2015-08-20 07:29:00",1440080940,"C3",116880,1440197820,"2015-08-21 15:57:00"
"6199","20155206035248-482",3,"2015-08-20 07:44:00",1440081840,"C0",147540,1440229380,"2015-08-22 00:43:00"
"3923","20152823092842-19",1,"2015-08-20 08:16:00",1440083760,"C5",301860,1440385620,"2015-08-23 20:07:00"
"3891","20154703044754-258",3,"2015-08-20 09:44:00",1440089040,"C4",481140,1440570180,"2015-08-25 23:23:00"
"2216","20154216104223-278",1,"2015-08-20 10:32:00",1440091920,"C5",172500,1440264420,"2015-08-22 10:27:00"
"6503","20150707060746-607",2,"2015-08-20 11:02:00",1440093720,"C8",228180,1440321900,"2015-08-23 02:25:00"
"3518","20151518011542-627",3,"2015-08-20 11:07:00",1440094020,"C5",82560,1440176580,"2015-08-21 10:03:00"
"495","20150231120236-701",1,"2015-08-20 11:32:00",1440095520,"C7",246600,1440342120,"2015-08-23 08:02:00"
"738","20150418120408-87",3,"2015-08-20 11:32:00",1440095520,"C6",170880,1440266400,"2015-08-22 11:00:00"
"6132","20153808033819-967",3,"2015-08-20 11:38:00",1440095880,"C3",786600,1440882480,"2015-08-29 14:08:00"
"6443","20154115084152-940",1,"2015-08-20 12:03:00",1440097380,"C2",222060,1440319440,"2015-08-23 01:44:00"
"3107","20152318082356-512",1,"2015-08-20 12:11:00",1440097860,"C5",93240,1440191100,"2015-08-21 14:05:00"
"1252","20154024064023-567",1,"2015-08-20 12:25:00",1440098700,"C8",989100,1441087800,"2015-08-31 23:10:00"
"4155","20152421122448-609",1,"2015-08-20 12:49:00",1440100140,"C2",370500,1440470640,"2015-08-24 19:44:00"
"1716","20151717021725-292",1,"2015-08-20 13:02:00",1440100920,"C2",977700,1441078620,"2015-08-31 20:37:00"
"6348","20152710022715-872",1,"2015-08-20 13:06:00",1440101160,"C7",95460,1440196620,"2015-08-21 15:37:00"
"1047","20150412070442-715",2,"2015-08-20 13:32:00",1440102720,"C4",714480,1440817200,"2015-08-28 20:00:00"
"566","20152510092527-332",1,"2015-08-20 13:37:00",1440103020,"C8",439560,1440542580,"2015-08-25 15:43:00"
"1357","20153102043137-348",1,"2015-08-20 14:26:00",1440105960,"C5",221100,1440327060,"2015-08-23 03:51:00"
"1689","20153918123921-858",1,"2015-08-20 14:39:00",1440106740,"C2",357300,1440464040,"2015-08-24 17:54:00"
"6370","20155511105504-943",1,"2015-08-20 15:07:00",1440108420,"C3",792720,1440901140,"2015-08-29 19:19:00"
"6402","20154612104653-119",1,"2015-08-20 15:18:00",1440109080,"C5",423240,1440532320,"2015-08-25 12:52:00"
"200","20150316120315-424",1,"2015-08-20 15:25:00",1440109500,"C5",178860,1440288360,"2015-08-22 17:06:00"
"5491","20153418023443-272",2,"2015-08-20 16:50:00",1440114600,"C5",90480,1440205080,"2015-08-21 17:58:00"
"2852","20152630102651-351",3,"2015-08-20 16:56:00",1440114960,"C8",367560,1440482520,"2015-08-24 23:02:00"
"5774","20151218101204-383",3,"2015-08-20 17:30:00",1440117000,"C5",99540,1440216540,"2015-08-21 21:09:00"
"1766","20155611055605-588",3,"2015-08-20 17:40:00",1440117600,"C6",776640,1440894240,"2015-08-29 17:24:00"
"3171","20151416101435-915",1,"2015-08-20 17:54:00",1440118440,"C8",186600,1440305040,"2015-08-22 21:44:00"
"4292","20152818012813-881",1,"2015-08-20 17:57:00",1440118620,"C0",409620,1440528240,"2015-08-25 11:44:00"
"3922","20152312112319-869",2,"2015-08-20 19:03:00",1440122580,"C7",359400,1440481980,"2015-08-24 22:53:00"
"4479","20152801032847-862",2,"2015-08-20 19:16:00",1440123360,"C6",275880,1440399240,"2015-08-23 23:54:00"
"970","20153114033108-799",1,"2015-08-20 19:46:00",1440125160,"C8",106740,1440231900,"2015-08-22 01:25:00"
"1380","20151415041441-660",3,"2015-08-20 20:21:00",1440127260,"C7",446460,1440573720,"2015-08-26 00:22:00"
"5028","20150016120041-181",3,"2015-08-20 20:44:00",1440128640,"C5",188520,1440317160,"2015-08-23 01:06:00"
"1444","20155111095109-411",1,"2015-08-20 20:47:00",1440128820,"C5",436920,1440565740,"2015-08-25 22:09:00"
"2398","20153409013402-796",1,"2015-08-20 21:40:00",1440132000,"C5",489780,1440621780,"2015-08-26 13:43:00"
"60","20154114034126-781",1,"2015-08-20 21:43:00",1440132180,"C8",270060,1440402240,"2015-08-24 00:44:00"
"3488","20155123095125-681",2,"2015-08-20 22:10:00",1440133800,"C3",722220,1440856020,"2015-08-29 06:47:00"
"5009","20151514111539-957",1,"2015-08-20 23:00:00",1440136800,"C5",186900,1440323700,"2015-08-23 02:55:00"
"6147","20152027122000-634",2,"2015-08-20 23:08:00",1440137280,"C2",264060,1440401340,"2015-08-24 00:29:00"
"4693","20152307032337-327",1,"2015-08-20 23:21:00",1440138060,"C4",575940,1440714000,"2015-08-27 15:20:00"
"1233","20152031082031-756",1,"2015-08-20 23:32:00",1440138720,"C4",891360,1441030080,"2015-08-31 07:08:00"
"4358","20153219033258-970",3,"2015-08-20 23:42:00",1440139320,"C5",57900,1440197220,"2015-08-21 15:47:00"
"5758","20152814062834-4",1,"2015-08-20 23:52:00",1440139920,"C2",290520,1440430440,"2015-08-24 08:34:00"
"1283","20151025031037-733",1,"2015-08-21 00:37:00",1440142620,"C4",760140,1440902760,"2015-08-29 19:46:00"
"1015","20151318101343-137",1,"2015-08-21 01:23:00",1440145380,"C4",113700,1440259080,"2015-08-22 08:58:00"
"2954","20152915072932-837",1,"2015-08-21 01:39:00",1440146340,"C8",99480,1440245820,"2015-08-22 05:17:00"
"3579","20151616091623-588",1,"2015-08-21 01:40:00",1440146400,"C5",202320,1440348720,"2015-08-23 09:52:00"
"5879","20153804013823-112",1,"2015-08-21 01:48:00",1440146880,"C8",713100,1440859980,"2015-08-29 07:53:00"
"5546","20152109072151-681",1,"2015-08-21 03:01:00",1440151260,"C8",204240,1440355500,"2015-08-23 11:45:00"
"228","20154201024259-199",2,"2015-08-21 03:45:00",1440153900,"C7",485220,1440639120,"2015-08-26 18:32:00"
"2762","20155618065604-631",2,"2015-08-21 03:52:00",1440154320,"C7",124080,1440278400,"2015-08-22 14:20:00"
"4827","20152921082952-995",2,"2015-08-21 04:59:00",1440158340,"C1",444300,1440602640,"2015-08-26 08:24:00"
"3161","20154805094814-860",2,"2015-08-21 06:15:00",1440162900,"C5",195660,1440358560,"2015-08-23 12:36:00"
"1120","20150330050315-215",1,"2015-08-21 06:23:00",1440163380,"C5",232800,1440396180,"2015-08-23 23:03:00"
"3254","20150722110730-245",1,"2015-08-21 06:45:00",1440164700,"C8",368040,1440532740,"2015-08-25 12:59:00"
"6019","20155812115832-295",1,"2015-08-21 07:03:00",1440165780,"C8",151980,1440317760,"2015-08-23 01:16:00"
"5046","20154602014652-42",1,"2015-08-21 07:17:00",1440166620,"C7",231180,1440397800,"2015-08-23 23:30:00"
"6148","20154708104711-651",2,"2015-08-21 07:26:00",1440167160,"C0",370380,1440537540,"2015-08-25 14:19:00"
"580","20155414075423-495",1,"2015-08-21 07:51:00",1440168660,"C5",201540,1440370200,"2015-08-23 15:50:00"
"1453","20153602043658-257",3,"2015-08-21 07:54:00",1440168840,"C6",268380,1440437220,"2015-08-24 10:27:00"
"6361","20153017023011-609",1,"2015-08-21 08:00:00",1440169200,"C6",322200,1440491400,"2015-08-25 01:30:00"
"1707","20154114104153-864",1,"2015-08-21 08:23:00",1440170580,"C0",198840,1440369420,"2015-08-23 15:37:00"
"3","20150909100908-893",1,"2015-08-21 08:25:00",1440170700,"C5",128820,1440299520,"2015-08-22 20:12:00"
"5249","20150420090434-499",1,"2015-08-21 10:22:00",1440177720,"C6",91080,1440268800,"2015-08-22 11:40:00"
"1355","20150514090518-434",2,"2015-08-21 10:50:00",1440179400,"C5",203700,1440383100,"2015-08-23 19:25:00"
"370","20150616020625-232",1,"2015-08-21 11:21:00",1440181260,"C5",60300,1440241560,"2015-08-22 04:06:00"
"2749","20154714074732-183",3,"2015-08-21 11:43:00",1440182580,"C8",309480,1440492060,"2015-08-25 01:41:00"
"3931","20155116025119-682",1,"2015-08-21 12:34:00",1440185640,"C3",60540,1440246180,"2015-08-22 05:23:00"
"1280","20150311040324-846",3,"2015-08-21 12:38:00",1440185880,"C3",504300,1440690180,"2015-08-27 08:43:00"
"3090","20152317122348-82",3,"2015-08-21 12:41:00",1440186060,"C2",346680,1440532740,"2015-08-25 12:59:00"
"4088","20153214063240-340",1,"2015-08-21 12:49:00",1440186540,"C6",627420,1440813960,"2015-08-28 19:06:00"
"5573","20153226033231-156",3,"2015-08-21 13:08:00",1440187680,"C4",319680,1440507360,"2015-08-25 05:56:00"
"1555","20150922030934-439",1,"2015-08-21 13:54:00",1440190440,"C8",517500,1440707940,"2015-08-27 13:39:00"
"1698","20152913092907-731",1,"2015-08-21 14:59:00",1440194340,"C6",118500,1440312840,"2015-08-22 23:54:00"
"5470","20152310122332-782",2,"2015-08-21 15:43:00",1440196980,"C6",455100,1440652080,"2015-08-26 22:08:00"
"3283","20153114093133-433",2,"2015-08-21 16:34:00",1440200040,"C7",70020,1440270060,"2015-08-22 12:01:00"
"4622","20150409090411-319",1,"2015-08-21 17:02:00",1440201720,"C5",532740,1440734460,"2015-08-27 21:01:00"
"4033","20150911080911-37",2,"2015-08-21 17:18:00",1440202680,"C4",298980,1440501660,"2015-08-25 04:21:00"
"2031","20152019052023-769",1,"2015-08-21 17:23:00",1440202980,"C5",57660,1440260640,"2015-08-22 09:24:00"
"1503","20150115020146-483",3,"2015-08-21 17:29:00",1440203340,"C2",66360,1440269700,"2015-08-22 11:55:00"
"3524","20155206095205-734",1,"2015-08-21 18:32:00",1440207120,"C5",165900,1440373020,"2015-08-23 16:37:00"
"5949","20151630081603-922",1,"2015-08-21 18:36:00",1440207360,"C4",969000,1441176360,"2015-09-01 23:46:00"
"72","20153601023624-894",1,"2015-08-21 19:40:00",1440211200,"C3",873120,1441084320,"2015-08-31 22:12:00"
"5304","20155115095152-620",1,"2015-08-21 19:57:00",1440212220,"C2",277380,1440489600,"2015-08-25 01:00:00"
"4934","20151806101819-946",1,"2015-08-21 20:10:00",1440213000,"C6",166440,1440379440,"2015-08-23 18:24:00"
"4177","20153107103116-521",1,"2015-08-21 20:11:00",1440213060,"C8",622200,1440835260,"2015-08-29 01:01:00"
"3490","20151115041109-804",1,"2015-08-21 20:21:00",1440213660,"C0",76200,1440289860,"2015-08-22 17:31:00"
"2905","20151708101713-388",1,"2015-08-21 20:47:00",1440215220,"C5",387000,1440602220,"2015-08-26 08:17:00"
"103","20151804021836-532",1,"2015-08-21 21:40:00",1440218400,"C5",747660,1440966060,"2015-08-30 13:21:00"
"4443","20150904090957-319",2,"2015-08-21 21:51:00",1440219060,"C3",216360,1440435420,"2015-08-24 09:57:00"
"4504","20153617103638-247",1,"2015-08-21 21:56:00",1440219360,"C7",193200,1440412560,"2015-08-24 03:36:00"
"2660","20153612043651-254",1,"2015-08-21 22:21:00",1440220860,"C8",159660,1440380520,"2015-08-23 18:42:00"
"1300","20153312023359-569",1,"2015-08-21 22:35:00",1440221700,"C3",806520,1441028220,"2015-08-31 06:37:00"
"3060","20151410061424-60",1,"2015-08-21 23:10:00",1440223800,"C5",126420,1440350220,"2015-08-23 10:17:00"
"4888","20152925032929-380",1,"2015-08-21 23:17:00",1440224220,"C5",1180440,1441404660,"2015-09-04 15:11:00"
"1006","20151817051852-380",1,"2015-08-21 23:18:00",1440224280,"C3",183600,1440407880,"2015-08-24 02:18:00"
"3423","20153329073300-377",1,"2015-08-21 23:49:00",1440226140,"C6",255720,1440481860,"2015-08-24 22:51:00"
"3458","20152016012038-49",1,"2015-08-22 00:08:00",1440227280,"C2",156960,1440384240,"2015-08-23 19:44:00"
"3163","20152603092611-468",1,"2015-08-22 00:14:00",1440227640,"C4",804240,1441031880,"2015-08-31 07:38:00"
"4064","20152015102054-215",3,"2015-08-22 00:39:00",1440229140,"C7",81420,1440310560,"2015-08-22 23:16:00"
"4679","20153712043748-60",3,"2015-08-22 01:57:00",1440233820,"C5",436200,1440670020,"2015-08-27 03:07:00"
"4272","20155018015058-838",1,"2015-08-22 02:58:00",1440237480,"C5",153240,1440390720,"2015-08-23 21:32:00"
"6222","20154518104543-3",1,"2015-08-22 03:24:00",1440239040,"C5",106380,1440345420,"2015-08-23 08:57:00"
"1294","20153707063710-587",1,"2015-08-22 03:37:00",1440239820,"C8",257040,1440496860,"2015-08-25 03:01:00"
"430","20153815113857-329",3,"2015-08-22 03:42:00",1440240120,"C0",288120,1440528240,"2015-08-25 11:44:00"
"665","20152003102027-431",1,"2015-08-22 04:12:00",1440241920,"C6",537240,1440779160,"2015-08-28 09:26:00"
"814","20152204122238-160",2,"2015-08-22 05:34:00",1440246840,"C2",526140,1440772980,"2015-08-28 07:43:00"
"5583","20153813083855-252",1,"2015-08-22 05:36:00",1440246960,"C4",383340,1440630300,"2015-08-26 16:05:00"
"5495","20153915113920-94",3,"2015-08-22 05:39:00",1440247140,"C5",194400,1440441540,"2015-08-24 11:39:00"
"273","20152614122614-782",2,"2015-08-22 06:32:00",1440250320,"C6",111660,1440361980,"2015-08-23 13:33:00"
"2754","20155321125321-407",2,"2015-08-22 06:36:00",1440250560,"C6",63780,1440314340,"2015-08-23 00:19:00"
"767","20150220080208-953",1,"2015-08-22 06:50:00",1440251400,"C5",84240,1440335640,"2015-08-23 06:14:00"
"4107","20151926091952-816",3,"2015-08-22 08:29:00",1440257340,"C8",465960,1440723300,"2015-08-27 17:55:00"
"4561","20154407014405-908",2,"2015-08-22 09:19:00",1440260340,"C8",256020,1440516360,"2015-08-25 08:26:00"
"856","20152018072024-196",1,"2015-08-22 09:33:00",1440261180,"C3",353580,1440614760,"2015-08-26 11:46:00"
"5329","20153111043111-321",2,"2015-08-22 09:49:00",1440262140,"C4",308760,1440570900,"2015-08-25 23:35:00"
"6381","20153604033631-714",3,"2015-08-22 10:36:00",1440264960,"C4",1537200,1441802160,"2015-09-09 05:36:00"
"6556","20153518113519-608",1,"2015-08-22 10:41:00",1440265260,"C3",171180,1440436440,"2015-08-24 10:14:00"
"76","20152309042301-368",2,"2015-08-22 10:45:00",1440265500,"C4",157560,1440423060,"2015-08-24 06:31:00"
"4965","20150916010956-355",3,"2015-08-22 10:59:00",1440266340,"C5",255300,1440521640,"2015-08-25 09:54:00"
"5619","20154116094115-530",1,"2015-08-22 11:15:00",1440267300,"C5",262020,1440529320,"2015-08-25 12:02:00"
"6306","20154214044236-934",2,"2015-08-22 11:45:00",1440269100,"C0",224460,1440493560,"2015-08-25 02:06:00"
"6422","20152023122039-382",1,"2015-08-22 12:24:00",1440271440,"C7",370320,1440641760,"2015-08-26 19:16:00"
"2043","20152005092011-809",1,"2015-08-22 13:08:00",1440274080,"C6",247080,1440521160,"2015-08-25 09:46:00"
"978","20152919122944-137",3,"2015-08-22 13:09:00",1440274140,"C8",588000,1440862140,"2015-08-29 08:29:00"
"185","20150714060734-528",1,"2015-08-22 13:11:00",1440274260,"C4",358320,1440632580,"2015-08-26 16:43:00"
"4897","20155304095307-596",2,"2015-08-22 13:29:00",1440275340,"C4",196020,1440471360,"2015-08-24 19:56:00"
"6056","20152412092409-540",2,"2015-08-22 15:34:00",1440282840,"C8",712920,1440995760,"2015-08-30 21:36:00"
"2228","20153816123820-926",1,"2015-08-22 15:38:00",1440283080,"C7",264600,1440547680,"2015-08-25 17:08:00"
"805","20155602045649-200",1,"2015-08-22 15:58:00",1440284280,"C4",862260,1441146540,"2015-09-01 15:29:00"
"1759","20151019011020-645",3,"2015-08-22 15:58:00",1440284280,"C3",368460,1440652740,"2015-08-26 22:19:00"
"3151","20153711093723-390",1,"2015-08-22 16:01:00",1440284460,"C5",121680,1440406140,"2015-08-24 01:49:00"
"6229","20151021011047-387",1,"2015-08-22 16:31:00",1440286260,"C4",98460,1440384720,"2015-08-23 19:52:00"
"569","20152724032744-453",2,"2015-08-22 16:32:00",1440286320,"C8",501900,1440788220,"2015-08-28 11:57:00"
"169","20155810125837-406",1,"2015-08-22 17:34:00",1440290040,"C0",351120,1440641160,"2015-08-26 19:06:00"
"2416","20151018101055-192",2,"2015-08-22 18:22:00",1440292920,"C8",187560,1440480480,"2015-08-24 22:28:00"
"3181","20150207100251-836",1,"2015-08-22 18:42:00",1440294120,"C2",165900,1440460020,"2015-08-24 16:47:00"
"1840","20154920044939-697",2,"2015-08-22 19:27:00",1440296820,"C5",91140,1440387960,"2015-08-23 20:46:00"
"5147","20150620030643-457",2,"2015-08-22 19:32:00",1440297120,"C4",188760,1440485880,"2015-08-24 23:58:00"
"1225","20150218020205-444",1,"2015-08-22 19:35:00",1440297300,"C3",365580,1440662880,"2015-08-27 01:08:00"
"337","20154016054003-520",2,"2015-08-22 20:02:00",1440298920,"C2",263460,1440562380,"2015-08-25 21:13:00"
"981","20153219093204-479",1,"2015-08-22 20:06:00",1440299160,"C0",297240,1440596400,"2015-08-26 06:40:00"
"1578","20153517083522-960",2,"2015-08-22 21:06:00",1440302760,"C4",450780,1440753540,"2015-08-28 02:19:00"
"2144","20150115080147-541",1,"2015-08-22 21:19:00",1440303540,"C4",217560,1440521100,"2015-08-25 09:45:00"
"2009","20154909074911-878",1,"2015-08-22 21:43:00",1440304980,"C6",195540,1440500520,"2015-08-25 04:02:00"
"5044","20150024110036-855",1,"2015-08-22 22:18:00",1440307080,"C3",848760,1441155840,"2015-09-01 18:04:00"
"450","20154224024247-121",2,"2015-08-22 22:47:00",1440308820,"C2",362100,1440670920,"2015-08-27 03:22:00"
"5592","20150422010448-761",1,"2015-08-23 00:10:00",1440313800,"C6",453060,1440766860,"2015-08-28 06:01:00"
"1136","20154502094535-864",3,"2015-08-23 00:18:00",1440314280,"C2",254340,1440568620,"2015-08-25 22:57:00"
"3514","20154516014531-348",2,"2015-08-23 01:23:00",1440318180,"C7",280140,1440598320,"2015-08-26 07:12:00"
"6368","20154707014750-447",2,"2015-08-23 02:11:00",1440321060,"C5",191520,1440512580,"2015-08-25 07:23:00"
"3147","20152220042220-374",1,"2015-08-23 02:30:00",1440322200,"C5",104640,1440426840,"2015-08-24 07:34:00"
"3632","20150214020240-113",1,"2015-08-23 03:08:00",1440324480,"C2",105480,1440429960,"2015-08-24 08:26:00"
"3183","20152913112925-155",1,"2015-08-23 03:45:00",1440326700,"C5",104520,1440431220,"2015-08-24 08:47:00"
"2046","20150319120301-287",3,"2015-08-23 03:57:00",1440327420,"C7",332760,1440660180,"2015-08-27 00:23:00"
"4547","20151221021214-964",2,"2015-08-23 03:58:00",1440327480,"C4",67980,1440395460,"2015-08-23 22:51:00"
"2263","20153609013658-819",3,"2015-08-23 04:37:00",1440329820,"C5",168180,1440498000,"2015-08-25 03:20:00"
"5457","20153802063824-325",3,"2015-08-23 04:52:00",1440330720,"C8",640920,1440971640,"2015-08-30 14:54:00"
"1264","20153213013249-868",1,"2015-08-23 05:42:00",1440333720,"C5",417900,1440751620,"2015-08-28 01:47:00"
"4049","20150125080138-74",3,"2015-08-23 06:25:00",1440336300,"C7",357120,1440693420,"2015-08-27 09:37:00"
"3522","20151315121331-773",1,"2015-08-23 06:28:00",1440336480,"C0",670500,1441006980,"2015-08-31 00:43:00"
"2384","20150722040736-505",1,"2015-08-23 06:30:00",1440336600,"C4",51780,1440388380,"2015-08-23 20:53:00"
"1671","20153320073331-255",1,"2015-08-23 06:37:00",1440337020,"C0",366780,1440703800,"2015-08-27 12:30:00"
"804","20154826114830-851",2,"2015-08-23 06:54:00",1440338040,"C4",343080,1440681120,"2015-08-27 06:12:00"
"394","20153813123814-541",1,"2015-08-23 07:10:00",1440339000,"C4",105540,1440444540,"2015-08-24 12:29:00"
"1520","20155118115128-12",1,"2015-08-23 07:43:00",1440340980,"C5",208560,1440549540,"2015-08-25 17:39:00"
"4059","20150219040226-843",1,"2015-08-23 08:45:00",1440344700,"C5",798540,1441143240,"2015-09-01 14:34:00"
"3468","20152322042319-725",2,"2015-08-23 09:08:00",1440346080,"C4",60300,1440406380,"2015-08-24 01:53:00"
"2171","20153614113645-637",1,"2015-08-23 10:48:00",1440352080,"C6",96840,1440448920,"2015-08-24 13:42:00"
"1435","20150503040553-197",2,"2015-08-23 11:37:00",1440355020,"C7",244560,1440599580,"2015-08-26 07:33:00"
"2241","20152504042522-96",2,"2015-08-23 12:15:00",1440357300,"C8",615000,1440972300,"2015-08-30 15:05:00"
"2910","20153822023828-796",2,"2015-08-23 12:18:00",1440357480,"C4",78000,1440435480,"2015-08-24 09:58:00"
"2207","20153217083226-786",2,"2015-08-23 12:42:00",1440358920,"C0",76200,1440435120,"2015-08-24 09:52:00"
"5276","20154920074921-321",1,"2015-08-23 13:10:00",1440360600,"C5",92820,1440453420,"2015-08-24 14:57:00"
"1819","20154906014902-527",1,"2015-08-23 13:33:00",1440361980,"C5",183480,1440545460,"2015-08-25 16:31:00"
"1425","20153322063352-729",2,"2015-08-23 13:45:00",1440362700,"C4",348840,1440711540,"2015-08-27 14:39:00"
"5773","20150016090035-720",1,"2015-08-23 13:48:00",1440362880,"C3",77760,1440440640,"2015-08-24 11:24:00"
"1900","20151714061754-756",1,"2015-08-23 14:19:00",1440364740,"C4",403260,1440768000,"2015-08-28 06:20:00"
"3916","20155321105314-535",2,"2015-08-23 14:41:00",1440366060,"C2",93240,1440459300,"2015-08-24 16:35:00"
"1214","20150815120847-511",1,"2015-08-23 14:48:00",1440366480,"C2",87600,1440454080,"2015-08-24 15:08:00"
"2796","20150617100636-148",1,"2015-08-23 14:50:00",1440366600,"C5",267720,1440634320,"2015-08-26 17:12:00"
"1035","20151319061333-620",1,"2015-08-23 14:51:00",1440366660,"C4",436440,1440803100,"2015-08-28 16:05:00"
"4773","20155107025107-822",1,"2015-08-23 14:51:00",1440366660,"C8",276480,1440643140,"2015-08-26 19:39:00"
"939","20153519023513-548",3,"2015-08-23 15:24:00",1440368640,"C2",432420,1440801060,"2015-08-28 15:31:00"
"2049","20152218052241-425",1,"2015-08-23 15:31:00",1440369060,"C2",425340,1440794400,"2015-08-28 13:40:00"
"4322","20153315073301-37",3,"2015-08-23 16:01:00",1440370860,"C8",360840,1440731700,"2015-08-27 20:15:00"
"5959","20152130072111-229",2,"2015-08-23 17:15:00",1440375300,"C0",301320,1440676620,"2015-08-27 04:57:00"
"938","20151522081515-994",1,"2015-08-23 17:37:00",1440376620,"C6",120120,1440496740,"2015-08-25 02:59:00"
"2081","20153921023939-728",2,"2015-08-23 17:56:00",1440377760,"C3",184620,1440562380,"2015-08-25 21:13:00"
"3665","20155624115628-693",1,"2015-08-23 18:28:00",1440379680,"C5",326940,1440706620,"2015-08-27 13:17:00"
"3540","20152719032729-250",1,"2015-08-23 18:29:00",1440379740,"C0",356520,1440736260,"2015-08-27 21:31:00"
"5140","20154521054515-644",2,"2015-08-23 19:49:00",1440384540,"C2",180240,1440564780,"2015-08-25 21:53:00"
"68","20151722051720-973",1,"2015-08-23 21:01:00",1440388860,"C3",347280,1440736140,"2015-08-27 21:29:00"
"433","20150919080932-475",1,"2015-08-23 21:55:00",1440392100,"C4",439080,1440831180,"2015-08-28 23:53:00"
"5061","20154211064241-592",1,"2015-08-23 22:15:00",1440393300,"C4",538740,1440932040,"2015-08-30 03:54:00"
"6269","20150419040419-734",1,"2015-08-23 23:28:00",1440397680,"C4",186120,1440583800,"2015-08-26 03:10:00"
"4365","20153914043919-947",1,"2015-08-23 23:45:00",1440398700,"C3",401580,1440800280,"2015-08-28 15:18:00"
"1203","20150511080548-765",3,"2015-08-23 23:56:00",1440399360,"C3",364620,1440763980,"2015-08-28 05:13:00"
"2034","20150328070321-554",1,"2015-08-24 00:07:00",1440400020,"C0",288480,1440688500,"2015-08-27 08:15:00"
"1177","20153004013007-217",3,"2015-08-24 00:20:00",1440400800,"C8",336120,1440736920,"2015-08-27 21:42:00"
"5714","20155415015459-549",1,"2015-08-24 00:29:00",1440401340,"C7",857100,1441258440,"2015-09-02 22:34:00"
"3175","20154606044639-126",3,"2015-08-24 00:54:00",1440402840,"C3",749040,1441151880,"2015-09-01 16:58:00"
"1239","20153811123837-345",3,"2015-08-24 01:20:00",1440404400,"C6",180420,1440584820,"2015-08-26 03:27:00"
"4359","20150105090139-623",1,"2015-08-24 03:06:00",1440410760,"C0",614100,1441024860,"2015-08-31 05:41:00"
"544","20153526043555-14",1,"2015-08-24 03:40:00",1440412800,"C8",491820,1440904620,"2015-08-29 20:17:00"
"3960","20153930043916-979",1,"2015-08-24 04:06:00",1440414360,"C3",704940,1441119300,"2015-09-01 07:55:00"
"2758","20151122081111-931",3,"2015-08-24 04:59:00",1440417540,"C5",80640,1440498180,"2015-08-25 03:23:00"
"2143","20153914023947-993",1,"2015-08-24 05:53:00",1440420780,"C4",416220,1440837000,"2015-08-29 01:30:00"
"3222","20152925102911-696",3,"2015-08-24 06:35:00",1440423300,"C7",368280,1440791580,"2015-08-28 12:53:00"
"1813","20152026042055-270",1,"2015-08-24 07:40:00",1440427200,"C3",309300,1440736500,"2015-08-27 21:35:00"
"4913","20153317103355-433",1,"2015-08-24 07:51:00",1440427860,"C5",198360,1440626220,"2015-08-26 14:57:00"
"3070","20152329032334-147",3,"2015-08-24 08:37:00",1440430620,"C5",1111020,1441541640,"2015-09-06 05:14:00"
"2438","20152507072524-315",2,"2015-08-24 08:48:00",1440431280,"C3",210540,1440641820,"2015-08-26 19:17:00"
"3957","20151623041622-269",2,"2015-08-24 08:59:00",1440431940,"C3",60180,1440492120,"2015-08-25 01:42:00"
"5580","20154115114122-286",1,"2015-08-24 09:03:00",1440432180,"C5",384060,1440816240,"2015-08-28 19:44:00"
"2383","20151021011021-123",3,"2015-08-24 09:10:00",1440432600,"C5",974400,1441407000,"2015-09-04 15:50:00"
"5489","20155518075547-219",1,"2015-08-24 09:17:00",1440433020,"C5",261660,1440694680,"2015-08-27 09:58:00"
"5117","20152015112055-777",1,"2015-08-24 09:30:00",1440433800,"C4",385500,1440819300,"2015-08-28 20:35:00"
"2612","20153721083755-788",3,"2015-08-24 09:45:00",1440434700,"C8",131640,1440566340,"2015-08-25 22:19:00"
"5272","20153521033513-856",2,"2015-08-24 09:57:00",1440435420,"C2",238920,1440674340,"2015-08-27 04:19:00"
"913","20155525025541-454",1,"2015-08-24 09:58:00",1440435480,"C5",367740,1440803220,"2015-08-28 16:07:00"
"3022","20153931123938-639",2,"2015-08-24 11:27:00",1440440820,"C6",258660,1440699480,"2015-08-27 11:18:00"
"690","20153118123109-283",1,"2015-08-24 13:18:00",1440447480,"C0",74460,1440521940,"2015-08-25 09:59:00"
"2125","20151023091027-655",3,"2015-08-24 13:22:00",1440447720,"C2",101520,1440549240,"2015-08-25 17:34:00"
"4678","20151717061717-630",2,"2015-08-24 13:23:00",1440447780,"C4",315180,1440762960,"2015-08-28 04:56:00"
"366","20155418075447-174",2,"2015-08-24 14:42:00",1440452520,"C5",271440,1440723960,"2015-08-27 18:06:00"
"2558","20150209060231-719",1,"2015-08-24 15:17:00",1440454620,"C8",1319940,1441774560,"2015-09-08 21:56:00"
"3821","20150602070645-93",1,"2015-08-24 15:18:00",1440454680,"C5",643440,1441098120,"2015-09-01 02:02:00"
"6049","20150018110057-525",1,"2015-08-24 15:30:00",1440455400,"C4",178200,1440633600,"2015-08-26 17:00:00"
"1216","20155820025827-627",2,"2015-08-24 16:26:00",1440458760,"C5",175440,1440634200,"2015-08-26 17:10:00"
"2415","20150721010748-517",1,"2015-08-24 17:07:00",1440461220,"C5",91200,1440552420,"2015-08-25 18:27:00"
"4076","20153412053414-307",3,"2015-08-24 17:34:00",1440462840,"C6",172800,1440635640,"2015-08-26 17:34:00"
"965","20150509020558-681",1,"2015-08-24 17:59:00",1440464340,"C7",145560,1440609900,"2015-08-26 10:25:00"
"4489","20154515054549-826",1,"2015-08-24 18:00:00",1440464400,"C8",155700,1440620100,"2015-08-26 13:15:00"
"4813","20151614121612-952",1,"2015-08-24 18:56:00",1440467760,"C6",111000,1440578760,"2015-08-26 01:46:00"
"3111","20153129013121-858",2,"2015-08-24 19:17:00",1440469020,"C5",323880,1440792900,"2015-08-28 13:15:00"
"658","20152207072213-862",3,"2015-08-24 19:36:00",1440470160,"C0",216120,1440686280,"2015-08-27 07:38:00"
"5555","20154614114643-419",1,"2015-08-24 19:42:00",1440470520,"C8",446280,1440916800,"2015-08-29 23:40:00"
"4294","20151913121932-661",3,"2015-08-24 20:02:00",1440471720,"C0",978180,1441449900,"2015-09-05 03:45:00"
"2596","20152122082127-299",1,"2015-08-24 20:39:00",1440473940,"C7",108540,1440582480,"2015-08-26 02:48:00"
"5850","20152815022839-704",1,"2015-08-24 21:02:00",1440475320,"C5",400620,1440875940,"2015-08-29 12:19:00"
"3322","20150115060113-519",3,"2015-08-24 21:31:00",1440477060,"C2",277800,1440754860,"2015-08-28 02:41:00"
"5131","20150423040436-953",1,"2015-08-24 21:34:00",1440477240,"C5",53100,1440530340,"2015-08-25 12:19:00"
"830","20152318102340-546",2,"2015-08-25 00:07:00",1440486420,"C8",81120,1440567540,"2015-08-25 22:39:00"
"1536","20153223113254-722",1,"2015-08-25 00:22:00",1440487320,"C3",66300,1440553620,"2015-08-25 18:47:00"
"2301","20151907011919-265",1,"2015-08-25 00:53:00",1440489180,"C4",755220,1441244400,"2015-09-02 18:40:00"
"2993","20155318045348-403",2,"2015-08-25 00:59:00",1440489540,"C3",182520,1440672060,"2015-08-27 03:41:00"
"3317","20150214070255-757",1,"2015-08-25 00:59:00",1440489540,"C7",132660,1440622200,"2015-08-26 13:50:00"
"3191","20151507041515-490",1,"2015-08-25 01:03:00",1440489780,"C3",187560,1440677340,"2015-08-27 05:09:00"
"4731","20150809060853-307",2,"2015-08-25 01:08:00",1440490080,"C8",272880,1440762960,"2015-08-28 04:56:00"
"3668","20155009105054-571",2,"2015-08-25 01:46:00",1440492360,"C2",674880,1441167240,"2015-09-01 21:14:00"
"1807","20152009032045-131",3,"2015-08-25 02:34:00",1440495240,"C0",668220,1441163460,"2015-09-01 20:11:00"
"3685","20151721041729-734",1,"2015-08-25 02:56:00",1440496560,"C0",99180,1440595740,"2015-08-26 06:29:00"
"788","20153022043047-509",2,"2015-08-25 03:00:00",1440496800,"C0",70200,1440567000,"2015-08-25 22:30:00"
"5445","20153310053343-896",3,"2015-08-25 03:01:00",1440496860,"C4",155460,1440652320,"2015-08-26 22:12:00"
"1331","20155618025650-853",1,"2015-08-25 03:30:00",1440498600,"C4",80520,1440579120,"2015-08-26 01:52:00"
"4444","20153112113145-165",2,"2015-08-25 04:09:00",1440500940,"C2",548340,1441049280,"2015-08-31 12:28:00"
"684","20154108034131-291",1,"2015-08-25 04:13:00",1440501180,"C5",178440,1440679620,"2015-08-27 05:47:00"
"6459","20155813075840-171",2,"2015-08-25 04:14:00",1440501240,"C2",462720,1440963960,"2015-08-30 12:46:00"
"1975","20155211075244-304",1,"2015-08-25 04:15:00",1440501300,"C4",170940,1440672240,"2015-08-27 03:44:00"
"5485","20151415121445-482",1,"2015-08-25 04:36:00",1440502560,"C5",418260,1440920820,"2015-08-30 00:47:00"
"6360","20155615035612-506",2,"2015-08-25 04:36:00",1440502560,"C6",102900,1440605460,"2015-08-26 09:11:00"
"1069","20154319104353-504",3,"2015-08-25 04:51:00",1440503460,"C8",71040,1440574500,"2015-08-26 00:35:00"
"2615","20155403015401-677",2,"2015-08-25 05:38:00",1440506280,"C2",233880,1440740160,"2015-08-27 22:36:00"
"2249","20152207122249-225",3,"2015-08-25 05:50:00",1440507000,"C4",191460,1440698460,"2015-08-27 11:01:00"
"193","20154731044702-403",1,"2015-08-25 06:18:00",1440508680,"C8",303180,1440811860,"2015-08-28 18:31:00"
"3943","20155219075248-264",1,"2015-08-25 06:22:00",1440508920,"C5",171000,1440679920,"2015-08-27 05:52:00"
"407","20155615105630-534",3,"2015-08-25 06:36:00",1440509760,"C8",121200,1440630960,"2015-08-26 16:16:00"
"4483","20150619060603-933",1,"2015-08-25 06:36:00",1440509760,"C8",639720,1441149480,"2015-09-01 16:18:00"
"2992","20153311113346-259",1,"2015-08-25 06:46:00",1440510360,"C4",170340,1440680700,"2015-08-27 06:05:00"
"4412","20153023053020-213",2,"2015-08-25 06:52:00",1440510720,"C7",67260,1440577980,"2015-08-26 01:33:00"
"5517","20151511111500-654",3,"2015-08-25 07:25:00",1440512700,"C7",597900,1441110600,"2015-09-01 05:30:00"
"2829","20154515064509-76",2,"2015-08-25 08:06:00",1440515160,"C5",289620,1440804780,"2015-08-28 16:33:00"
"5895","20152208112234-845",1,"2015-08-25 08:16:00",1440515760,"C8",728820,1441244580,"2015-09-02 18:43:00"
"6260","20155616035612-493",1,"2015-08-25 08:17:00",1440515820,"C8",489780,1441005600,"2015-08-31 00:20:00"
"362","20150526110553-791",2,"2015-08-25 08:26:00",1440516360,"C4",1724820,1442241180,"2015-09-14 07:33:00"
"775","20153920073940-995",1,"2015-08-25 09:33:00",1440520380,"C8",219420,1440739800,"2015-08-27 22:30:00"
"6263","20151220061227-950",1,"2015-08-25 09:37:00",1440520620,"C8",88860,1440609480,"2015-08-26 10:18:00"
"119","20153723103750-402",3,"2015-08-25 09:48:00",1440521280,"C0",169860,1440691140,"2015-08-27 08:59:00"
"5836","20154420094443-603",3,"2015-08-25 09:56:00",1440521760,"C6",72120,1440593880,"2015-08-26 05:58:00"
"6442","20150210100228-734",1,"2015-08-25 09:59:00",1440521940,"C2",431940,1440953880,"2015-08-30 09:58:00"
"5216","20153624073607-630",3,"2015-08-25 10:23:00",1440523380,"C4",96420,1440619800,"2015-08-26 13:10:00"
"2963","20151723051709-947",1,"2015-08-25 10:26:00",1440523560,"C2",49380,1440572940,"2015-08-26 00:09:00"
"5906","20150411110416-875",1,"2015-08-25 10:49:00",1440524940,"C4",555300,1441080240,"2015-08-31 21:04:00"
"1253","20155010025035-931",3,"2015-08-25 11:57:00",1440529020,"C5",183660,1440712680,"2015-08-27 14:58:00"
"3730","20151116121132-353",1,"2015-08-25 13:11:00",1440533460,"C2",260400,1440793860,"2015-08-28 13:31:00"
"468","20151329101325-617",2,"2015-08-25 13:33:00",1440534780,"C5",293100,1440827880,"2015-08-28 22:58:00"
"2928","20153123053121-598",2,"2015-08-25 14:11:00",1440537060,"C0",80400,1440617460,"2015-08-26 12:31:00"
"583","20152023022026-39",1,"2015-08-25 14:26:00",1440537960,"C7",86580,1440624540,"2015-08-26 14:29:00"
"5170","20153223063219-462",1,"2015-08-25 14:28:00",1440538080,"C6",201360,1440739440,"2015-08-27 22:24:00"
"3671","20153220053251-142",3,"2015-08-25 14:32:00",1440538320,"C8",619920,1441158240,"2015-09-01 18:44:00"
"782","20154918094949-366",1,"2015-08-25 15:30:00",1440541800,"C2",625260,1441167060,"2015-09-01 21:11:00"
"3919","20150223060208-554",3,"2015-08-25 15:38:00",1440542280,"C7",103680,1440645960,"2015-08-26 20:26:00"
"5995","20152822122853-937",2,"2015-08-25 16:50:00",1440546600,"C4",274920,1440821520,"2015-08-28 21:12:00"
"1269","20153224043244-563",1,"2015-08-25 16:56:00",1440546960,"C2",87840,1440634800,"2015-08-26 17:20:00"
"1382","20152619072610-850",2,"2015-08-25 17:24:00",1440548640,"C2",554280,1441102920,"2015-09-01 03:22:00"
"1129","20154812014855-638",2,"2015-08-25 17:56:00",1440550560,"C2",142260,1440692820,"2015-08-27 09:27:00"
"1546","20155621035652-898",2,"2015-08-25 18:02:00",1440550920,"C8",176580,1440727500,"2015-08-27 19:05:00"
"2433","20153631043604-397",2,"2015-08-25 18:44:00",1440553440,"C5",270960,1440824400,"2015-08-28 22:00:00"
"4081","20152220092213-786",3,"2015-08-25 18:53:00",1440553980,"C2",466260,1441020240,"2015-08-31 04:24:00"
"2933","20153222073210-586",1,"2015-08-25 18:56:00",1440554160,"C4",300240,1440854400,"2015-08-29 06:20:00"
"38","20155520105535-51",1,"2015-08-25 20:03:00",1440558180,"C8",449040,1441007220,"2015-08-31 00:47:00"
"3354","20151025061010-490",2,"2015-08-25 20:10:00",1440558600,"C2",532080,1441090680,"2015-08-31 23:58:00"
"2986","20151705091722-67",3,"2015-08-25 20:13:00",1440558780,"C5",555720,1441114500,"2015-09-01 06:35:00"
"189","20153115123154-557",1,"2015-08-25 20:51:00",1440561060,"C4",447000,1441008060,"2015-08-31 01:01:00"
"1429","20153906043931-40",2,"2015-08-25 20:54:00",1440561240,"C8",236700,1440797940,"2015-08-28 14:39:00"
"942","20152919022949-193",2,"2015-08-25 22:27:00",1440566820,"C5",273540,1440840360,"2015-08-29 02:26:00"
"5246","20152819072857-484",2,"2015-08-25 22:32:00",1440567120,"C2",730380,1441297500,"2015-09-03 09:25:00"
"5632","20153216013236-330",2,"2015-08-25 22:46:00",1440567960,"C5",405420,1440973380,"2015-08-30 15:23:00"
"4425","20152202052214-494",1,"2015-08-25 22:58:00",1440568680,"C4",585720,1441154400,"2015-09-01 17:40:00"
"2059","20150723030707-46",2,"2015-08-25 23:52:00",1440571920,"C2",68100,1440640020,"2015-08-26 18:47:00"
"4724","20152021072036-530",2,"2015-08-26 01:22:00",1440577320,"C8",205260,1440782580,"2015-08-28 10:23:00"
"1776","20155620045633-63",3,"2015-08-26 02:59:00",1440583140,"C4",156060,1440739200,"2015-08-27 22:20:00"
"4371","20155417105422-842",1,"2015-08-26 03:26:00",1440584760,"C4",93840,1440678600,"2015-08-27 05:30:00"
"5982","20153721043705-857",2,"2015-08-26 03:37:00",1440585420,"C4",192600,1440778020,"2015-08-28 09:07:00"
"3258","20150121030143-599",1,"2015-08-26 03:41:00",1440585660,"C5",195600,1440781260,"2015-08-28 10:01:00"
"6298","20154906094920-919",1,"2015-08-26 03:57:00",1440586620,"C3",213360,1440799980,"2015-08-28 15:13:00"
"2070","20155022075049-151",3,"2015-08-26 05:24:00",1440591840,"C1",168420,1440760260,"2015-08-28 04:11:00"
"4609","20154519024544-322",2,"2015-08-26 05:24:00",1440591840,"C4",200880,1440792720,"2015-08-28 13:12:00"
"1693","20150023030012-350",3,"2015-08-26 05:46:00",1440593160,"C7",112980,1440706140,"2015-08-27 13:09:00"
"1302","20152701112759-138",1,"2015-08-26 06:12:00",1440594720,"C7",688500,1441283220,"2015-09-03 05:27:00"
"2447","20151416101425-25",2,"2015-08-26 06:16:00",1440594960,"C5",424860,1441019820,"2015-08-31 04:17:00"
"618","20152202022209-169",1,"2015-08-26 06:45:00",1440596700,"C0",674940,1441271640,"2015-09-03 02:14:00"
"5514","20155717125750-508",1,"2015-08-26 06:55:00",1440597300,"C2",377940,1440975240,"2015-08-30 15:54:00"
"2975","20152415082432-673",2,"2015-08-26 07:24:00",1440599040,"C8",473400,1441072440,"2015-08-31 18:54:00"
"952","20154025094008-773",2,"2015-08-26 08:02:00",1440601320,"C4",80520,1440681840,"2015-08-27 06:24:00"
"737","20154513024507-271",1,"2015-08-26 08:11:00",1440601860,"C4",1099560,1441701420,"2015-09-08 01:37:00"
"92","20152125092114-567",1,"2015-08-26 08:17:00",1440602220,"C5",345120,1440947340,"2015-08-30 08:09:00"
"4083","20155724015758-338",2,"2015-08-26 08:23:00",1440602580,"C5",76380,1440678960,"2015-08-27 05:36:00"
"813","20152522062547-875",1,"2015-08-26 09:07:00",1440605220,"C2",355320,1440960540,"2015-08-30 11:49:00"
"3019","20152424042420-968",1,"2015-08-26 09:30:00",1440606600,"C5",49320,1440655920,"2015-08-26 23:12:00"
"2701","20152719102718-287",1,"2015-08-26 09:33:00",1440606780,"C2",601560,1441208340,"2015-09-02 08:39:00"
"888","20154023064009-80",1,"2015-08-26 09:37:00",1440607020,"C2",269820,1440876840,"2015-08-29 12:34:00"
"1589","20151714081717-477",3,"2015-08-26 09:45:00",1440607500,"C5",130260,1440737760,"2015-08-27 21:56:00"
"2861","20152322022341-751",2,"2015-08-26 09:53:00",1440607980,"C6",54900,1440662880,"2015-08-27 01:08:00"
"3672","20152720112739-23",1,"2015-08-26 10:11:00",1440609060,"C4",256920,1440865980,"2015-08-29 09:33:00"
"6373","20154524044536-939",3,"2015-08-26 10:15:00",1440609300,"C4",74700,1440684000,"2015-08-27 07:00:00"
"983","20151420051444-405",2,"2015-08-26 14:14:00",1440623640,"C2",253800,1440877440,"2015-08-29 12:44:00"
"3623","20154222034228-99",1,"2015-08-26 14:16:00",1440623760,"C8",170220,1440793980,"2015-08-28 13:33:00"
"5001","20154115124146-703",3,"2015-08-26 15:53:00",1440629580,"C4",320640,1440950220,"2015-08-30 08:57:00"
"2601","20154618074635-802",2,"2015-08-26 16:29:00",1440631740,"C6",722580,1441354320,"2015-09-04 01:12:00"
"1643","20151625021627-767",2,"2015-08-26 16:55:00",1440633300,"C4",95940,1440729240,"2015-08-27 19:34:00"
"1507","20151711071703-72",1,"2015-08-26 17:22:00",1440634920,"C8",266460,1440901380,"2015-08-29 19:23:00"
"2961","20151113081103-202",1,"2015-08-26 18:52:00",1440640320,"C5",548580,1441188900,"2015-09-02 03:15:00"
"5554","20152106052156-327",1,"2015-08-26 19:21:00",1440642060,"C6",1167600,1441809660,"2015-09-09 07:41:00"
"1362","20152425092455-910",1,"2015-08-26 19:37:00",1440643020,"C2",123180,1440766200,"2015-08-28 05:50:00"
"421","20154421024437-278",2,"2015-08-26 19:45:00",1440643500,"C0",450060,1441093560,"2015-09-01 00:46:00"
"5372","20151502101538-958",1,"2015-08-26 20:00:00",1440644400,"C8",421740,1441066140,"2015-08-31 17:09:00"
"1783","20150322110349-365",1,"2015-08-26 20:05:00",1440644700,"C2",189060,1440833760,"2015-08-29 00:36:00"
"3228","20155624045618-21",1,"2015-08-26 20:24:00",1440645840,"C0",681960,1441327800,"2015-09-03 17:50:00"
"5433","20153130073133-253",3,"2015-08-26 20:35:00",1440646500,"C0",621480,1441267980,"2015-09-03 01:13:00"
"1470","20155220085241-907",1,"2015-08-26 20:37:00",1440646620,"C8",80100,1440726720,"2015-08-27 18:52:00"
"4542","20153925013947-835",3,"2015-08-26 20:54:00",1440647640,"C4",112500,1440760140,"2015-08-28 04:09:00"
"2224","20152814122805-968",2,"2015-08-26 20:58:00",1440647880,"C0",533700,1441181580,"2015-09-02 01:13:00"
"253","20155101045148-763",2,"2015-08-26 21:39:00",1440650340,"C5",311040,1440961380,"2015-08-30 12:03:00"
"5355","20155418015419-112",1,"2015-08-26 21:40:00",1440650400,"C7",359580,1441009980,"2015-08-31 01:33:00"
"4525","20150114070109-176",2,"2015-08-26 23:09:00",1440655740,"C5",136860,1440792600,"2015-08-28 13:10:00"
"674","20154018114036-212",1,"2015-08-26 23:28:00",1440656880,"C3",1137360,1441794240,"2015-09-09 03:24:00"
"1395","20152723012751-951",1,"2015-08-27 00:29:00",1440660540,"C4",149460,1440810000,"2015-08-28 18:00:00"
"28","20153024053044-807",2,"2015-08-27 01:24:00",1440663840,"C2",67080,1440730920,"2015-08-27 20:02:00"
"785","20150017120055-53",2,"2015-08-27 01:50:00",1440665400,"C3",413700,1441079100,"2015-08-31 20:45:00"
"3390","20154728064727-282",3,"2015-08-27 01:50:00",1440665400,"C5",367740,1441033140,"2015-08-31 07:59:00"
"1418","20150129070156-888",1,"2015-08-27 02:09:00",1440666540,"C4",355440,1441021980,"2015-08-31 04:53:00"
"4087","20150415020406-610",3,"2015-08-27 02:09:00",1440666540,"C8",198780,1440865320,"2015-08-29 09:22:00"
"744","20151521031525-991",1,"2015-08-27 03:31:00",1440671460,"C2",238080,1440909540,"2015-08-29 21:39:00"
"574","20155320075307-202",1,"2015-08-27 03:33:00",1440671580,"C5",294600,1440966180,"2015-08-30 13:23:00"
"275","20155303125317-749",1,"2015-08-27 04:20:00",1440674400,"C4",674460,1441348860,"2015-09-03 23:41:00"
"3249","20153620083607-408",1,"2015-08-27 04:20:00",1440674400,"C6",73680,1440748080,"2015-08-28 00:48:00"
"3735","20155824015823-693",1,"2015-08-27 05:28:00",1440678480,"C2",969000,1441647480,"2015-09-07 10:38:00"
"4192","20150922090902-582",3,"2015-08-27 05:33:00",1440678780,"C7",344160,1441022940,"2015-08-31 05:09:00"
"3748","20155825095843-923",2,"2015-08-27 06:22:00",1440681720,"C0",79920,1440761640,"2015-08-28 04:34:00"
"1712","20153912093939-687",1,"2015-08-27 07:19:00",1440685140,"C4",643800,1441328940,"2015-09-03 18:09:00"
"4893","20155822095826-155",2,"2015-08-27 07:20:00",1440685200,"C8",211260,1440896460,"2015-08-29 18:01:00"
"153","20154015074020-606",2,"2015-08-27 07:30:00",1440685800,"C6",1036200,1441722000,"2015-09-08 07:20:00"
"3034","20153711063717-524",1,"2015-08-27 07:51:00",1440687060,"C5",198120,1440885180,"2015-08-29 14:53:00"
"5340","20151625021614-449",1,"2015-08-27 07:52:00",1440687120,"C0",677520,1441364640,"2015-09-04 04:04:00"
"5130","20154320094352-113",3,"2015-08-27 08:54:00",1440690840,"C8",85980,1440776820,"2015-08-28 08:47:00"
"2127","20155919125917-79",2,"2015-08-27 09:10:00",1440691800,"C0",96780,1440788580,"2015-08-28 12:03:00"
"1826","20154222064210-989",2,"2015-08-27 09:54:00",1440694440,"C4",221760,1440916200,"2015-08-29 23:30:00"
"6266","20154716064735-828",3,"2015-08-27 10:32:00",1440696720,"C8",137700,1440834420,"2015-08-29 00:47:00"
"357","20153629093635-690",3,"2015-08-27 10:36:00",1440696960,"C6",850200,1441547160,"2015-09-06 06:46:00"
"4742","20152014122034-385",1,"2015-08-27 10:56:00",1440698160,"C6",632760,1441330920,"2015-09-03 18:42:00"
"5623","20152813042852-20",2,"2015-08-27 11:22:00",1440699720,"C0",397080,1441096800,"2015-09-01 01:40:00"
"984","20151924061918-27",2,"2015-08-27 12:25:00",1440703500,"C5",140580,1440844080,"2015-08-29 03:28:00"
"1662","20153509113502-414",1,"2015-08-27 12:31:00",1440703860,"C4",194820,1440898680,"2015-08-29 18:38:00"
"6014","20151514121511-340",2,"2015-08-27 12:45:00",1440704700,"C8",760680,1441465380,"2015-09-05 08:03:00"
"1218","20153819103829-614",1,"2015-08-27 13:02:00",1440705720,"C6",422280,1441128000,"2015-09-01 10:20:00"
"2776","20154223044243-199",2,"2015-08-27 13:12:00",1440706320,"C6",55500,1440761820,"2015-08-28 04:37:00"
"4533","20154423044431-936",2,"2015-08-27 13:50:00",1440708600,"C0",335160,1441043760,"2015-08-31 10:56:00"
"2834","20155308105343-910",1,"2015-08-27 14:28:00",1440710880,"C8",330900,1441041780,"2015-08-31 10:23:00"
"4071","20155925095934-285",2,"2015-08-27 15:11:00",1440713460,"C5",95760,1440809220,"2015-08-28 17:47:00"
"3053","20150223080232-126",2,"2015-08-27 15:42:00",1440715320,"C4",186600,1440901920,"2015-08-29 19:32:00"
"2911","20150715010737-325",3,"2015-08-27 15:49:00",1440715740,"C2",523260,1441239000,"2015-09-02 17:10:00"
"5719","20153521053544-115",3,"2015-08-27 15:49:00",1440715740,"C8",256020,1440971760,"2015-08-30 14:56:00"
"6","20155924055911-559",1,"2015-08-27 16:42:00",1440718920,"C3",254580,1440973500,"2015-08-30 15:25:00"
"1313","20150917020950-55",3,"2015-08-27 16:51:00",1440719460,"C8",436860,1441156320,"2015-09-01 18:12:00"
"489","20152325032338-563",2,"2015-08-27 17:18:00",1440721080,"C0",179700,1440900780,"2015-08-29 19:13:00"
"2828","20151724031732-555",1,"2015-08-27 18:03:00",1440723780,"C7",421080,1441144860,"2015-09-01 15:01:00"
"3604","20151523031533-237",1,"2015-08-27 20:57:00",1440734220,"C6",61020,1440795240,"2015-08-28 13:54:00"
"4082","20152507082537-2",1,"2015-08-27 21:10:00",1440735000,"C8",354780,1441089780,"2015-08-31 23:43:00"
"1552","20153124063149-216",1,"2015-08-27 21:49:00",1440737340,"C3",104760,1440842100,"2015-08-29 02:55:00"
"2952","20150024010045-514",3,"2015-08-27 21:53:00",1440737580,"C6",291180,1441028760,"2015-08-31 06:46:00"
"2972","20154007124035-405",2,"2015-08-27 22:04:00",1440738240,"C3",634320,1441372560,"2015-09-04 06:16:00"
"4715","20150121060147-159",1,"2015-08-27 22:19:00",1440739140,"C8",288540,1441027680,"2015-08-31 06:28:00"
"3493","20152031042004-676",2,"2015-08-27 22:43:00",1440740580,"C4",336540,1441077120,"2015-08-31 20:12:00"
"2037","20155029035009-826",1,"2015-08-27 23:06:00",1440741960,"C8",361680,1441103640,"2015-09-01 03:34:00"
"1393","20152224012227-459",3,"2015-08-27 23:30:00",1440743400,"C5",371760,1441115160,"2015-09-01 06:46:00"
"3833","20150316010332-387",1,"2015-08-28 00:23:00",1440746580,"C2",458700,1441205280,"2015-09-02 07:48:00"
"4368","20150804090809-57",2,"2015-08-28 00:44:00",1440747840,"C2",255420,1441003260,"2015-08-30 23:41:00"
"3974","20152219112242-277",1,"2015-08-28 01:44:00",1440751440,"C4",371460,1441122900,"2015-09-01 08:55:00"
"347","20154122034142-353",2,"2015-08-28 02:45:00",1440755100,"C8",235920,1440991020,"2015-08-30 20:17:00"
"3172","20154809114818-832",1,"2015-08-28 02:48:00",1440755280,"C7",178800,1440934080,"2015-08-30 04:28:00"
"6191","20154422124407-513",1,"2015-08-28 03:30:00",1440757800,"C0",242580,1441000380,"2015-08-30 22:53:00"
"3874","20152004122028-933",1,"2015-08-28 03:32:00",1440757920,"C5",590040,1441347960,"2015-09-03 23:26:00"
"5720","20155114015106-386",2,"2015-08-28 04:03:00",1440759780,"C6",195720,1440955500,"2015-08-30 10:25:00"
"3013","20154021074026-934",1,"2015-08-28 05:46:00",1440765960,"C8",298980,1441064940,"2015-08-31 16:49:00"
"6152","20150822040817-521",3,"2015-08-28 05:48:00",1440766080,"C8",96240,1440862320,"2015-08-29 08:32:00"
"3433","20153123063116-913",2,"2015-08-28 06:01:00",1440766860,"C5",215100,1440981960,"2015-08-30 17:46:00"
"3450","20152102122135-146",2,"2015-08-28 06:29:00",1440768540,"C2",612960,1441381500,"2015-09-04 08:45:00"
"299","20154408044436-655",2,"2015-08-28 07:04:00",1440770640,"C5",846600,1441617240,"2015-09-07 02:14:00"
"4638","20152221092251-883",2,"2015-08-28 07:36:00",1440772560,"C7",299220,1441071780,"2015-08-31 18:43:00"
"6164","20150527100509-549",2,"2015-08-28 08:00:00",1440774000,"C6",78900,1440852900,"2015-08-29 05:55:00"
"5614","20155704015757-89",1,"2015-08-28 08:05:00",1440774300,"C3",591360,1441365660,"2015-09-04 04:21:00"
"3838","20153014053026-5",1,"2015-08-28 08:15:00",1440774900,"C8",770940,1441545840,"2015-09-06 06:24:00"
"4005","20153129033116-421",1,"2015-08-28 08:27:00",1440775620,"C4",320820,1441096440,"2015-09-01 01:34:00"
"3664","20152225022204-845",1,"2015-08-28 08:52:00",1440777120,"C2",79800,1440856920,"2015-08-29 07:02:00"
"2502","20150521040525-743",1,"2015-08-28 09:17:00",1440778620,"C4",72540,1440851160,"2015-08-29 05:26:00"
"1308","20150624120647-627",3,"2015-08-28 09:24:00",1440779040,"C6",502380,1441281420,"2015-09-03 04:57:00"
"4074","20154527054509-903",1,"2015-08-28 09:37:00",1440779820,"C3",341940,1441121760,"2015-09-01 08:36:00"
"4574","20153317043306-904",3,"2015-08-28 11:19:00",1440785940,"C8",133080,1440919020,"2015-08-30 00:17:00"
"1044","20152925102939-681",1,"2015-08-28 11:38:00",1440787080,"C3",87780,1440874860,"2015-08-29 12:01:00"
"3159","20151122021140-914",1,"2015-08-28 11:39:00",1440787140,"C0",63660,1440850800,"2015-08-29 05:20:00"
"2054","20155323065317-442",1,"2015-08-28 11:43:00",1440787380,"C3",224700,1441012080,"2015-08-31 02:08:00"
"245","20152919082940-780",2,"2015-08-28 12:21:00",1440789660,"C4",395760,1441185420,"2015-09-02 02:17:00"
"3261","20150907070922-234",1,"2015-08-28 12:21:00",1440789660,"C0",563940,1441353600,"2015-09-04 01:00:00"
"5713","20150627100641-287",1,"2015-08-28 12:47:00",1440791220,"C2",96060,1440887280,"2015-08-29 15:28:00"
"5223","20150024120056-588",1,"2015-08-28 13:28:00",1440793680,"C3",175440,1440969120,"2015-08-30 14:12:00"
"2418","20153430083434-174",1,"2015-08-28 13:30:00",1440793800,"C0",360480,1441154280,"2015-09-01 17:38:00"
"4752","20155926125912-498",2,"2015-08-28 13:41:00",1440794460,"C4",87660,1440882120,"2015-08-29 14:02:00"
"2449","20150426010444-611",1,"2015-08-28 13:50:00",1440795000,"C7",87780,1440882780,"2015-08-29 14:13:00"
"4860","20154120094138-417",2,"2015-08-28 13:53:00",1440795180,"C0",353160,1441148340,"2015-09-01 15:59:00"
"315","20153624093600-684",1,"2015-08-28 14:00:00",1440795600,"C5",379980,1441175580,"2015-09-01 23:33:00"
"3021","20153012083040-807",1,"2015-08-28 14:10:00",1440796200,"C4",1402800,1442199000,"2015-09-13 19:50:00"
"1286","20151501071532-943",3,"2015-08-28 14:18:00",1440796680,"C3",786060,1441582740,"2015-09-06 16:39:00"
"1612","20151518031527-459",2,"2015-08-28 14:33:00",1440797580,"C6",861480,1441659060,"2015-09-07 13:51:00"
"80","20152424092415-398",2,"2015-08-28 14:42:00",1440798120,"C3",182340,1440980460,"2015-08-30 17:21:00"
"5029","20152017102041-706",3,"2015-08-28 15:08:00",1440799680,"C0",120960,1440920640,"2015-08-30 00:44:00"
"1053","20153024123008-70",1,"2015-08-28 15:54:00",1440802440,"C5",178920,1440981360,"2015-08-30 17:36:00"
"5270","20150227060225-629",2,"2015-08-28 16:20:00",1440804000,"C4",123480,1440927480,"2015-08-30 02:38:00"
"5524","20155304125320-819",1,"2015-08-28 16:29:00",1440804540,"C2",260820,1441065360,"2015-08-31 16:56:00"
"367","20154330014342-384",2,"2015-08-28 16:54:00",1440806040,"C8",359580,1441165620,"2015-09-01 20:47:00"
"2634","20150307050341-35",3,"2015-08-28 16:56:00",1440806160,"C7",259140,1441065300,"2015-08-31 16:55:00"
"3636","20150002120037-795",1,"2015-08-28 18:08:00",1440810480,"C5",283560,1441094040,"2015-09-01 00:54:00"
"1464","20150720100758-108",2,"2015-08-28 18:33:00",1440811980,"C7",103080,1440915060,"2015-08-29 23:11:00"
"6283","20154201094221-490",3,"2015-08-28 19:13:00",1440814380,"C7",720780,1441535160,"2015-09-06 03:26:00"
"2598","20155526015529-809",1,"2015-08-28 20:05:00",1440817500,"C5",97500,1440915000,"2015-08-29 23:10:00"
"3752","20152122042102-592",3,"2015-08-28 20:45:00",1440819900,"C7",267120,1441087020,"2015-08-31 22:57:00"
"1010","20152801102848-547",2,"2015-08-28 20:52:00",1440820320,"C2",296280,1441116600,"2015-09-01 07:10:00"
"5374","20150906030915-616",1,"2015-08-28 21:47:00",1440823620,"C3",962340,1441785960,"2015-09-09 01:06:00"
"321","20155305065314-246",1,"2015-08-28 23:01:00",1440828060,"C3",255660,1441083720,"2015-08-31 22:02:00"
"5097","20155622015608-652",1,"2015-08-28 23:08:00",1440828480,"C5",403740,1441232220,"2015-09-02 15:17:00"
"3626","20152012032040-682",2,"2015-08-29 00:15:00",1440832500,"C0",584700,1441417200,"2015-09-04 18:40:00"
"2985","20150212030241-721",2,"2015-08-29 01:02:00",1440835320,"C3",512100,1441347420,"2015-09-03 23:17:00"
"5293","20152430012458-590",1,"2015-08-29 01:41:00",1440837660,"C2",364260,1441201920,"2015-09-02 06:52:00"
"5275","20155218085224-640",2,"2015-08-29 02:34:00",1440840840,"C8",515160,1441356000,"2015-09-04 01:40:00"
"1760","20150224010242-67",1,"2015-08-29 02:52:00",1440841920,"C8",197700,1441039620,"2015-08-31 09:47:00"
"4276","20154514114507-203",3,"2015-08-29 03:27:00",1440844020,"C4",633060,1441477080,"2015-09-05 11:18:00"
"5187","20150109100114-5",3,"2015-08-29 03:29:00",1440844140,"C5",213060,1441057200,"2015-08-31 14:40:00"
"3025","20154212104211-65",1,"2015-08-29 05:26:00",1440851160,"C4",207120,1441058280,"2015-08-31 14:58:00"
"3286","20150721050735-636",3,"2015-08-29 05:27:00",1440851220,"C8",129840,1440981060,"2015-08-30 17:31:00"
"1681","20153803043831-603",2,"2015-08-29 05:50:00",1440852600,"C8",315360,1441167960,"2015-09-01 21:26:00"
"5582","20155904105919-416",1,"2015-08-29 05:54:00",1440852840,"C8",428340,1441281180,"2015-09-03 04:53:00"
"6530","20151722061712-453",1,"2015-08-29 05:55:00",1440852900,"C5",301740,1441154640,"2015-09-01 17:44:00"
"875","20152826112825-682",3,"2015-08-29 06:24:00",1440854640,"C8",120480,1440975120,"2015-08-30 15:52:00"
"6159","20150214060215-80",3,"2015-08-29 06:24:00",1440854640,"C8",567960,1441422600,"2015-09-04 20:10:00"
"5837","20150807080814-971",1,"2015-08-29 06:53:00",1440856380,"C8",379260,1441235640,"2015-09-02 16:14:00"
"1092","20154627014626-335",2,"2015-08-29 06:56:00",1440856560,"C0",403800,1441260360,"2015-09-02 23:06:00"
"2208","20153122113109-139",3,"2015-08-29 07:01:00",1440856860,"C2",294300,1441151160,"2015-09-01 16:46:00"
"301","20150424020445-861",2,"2015-08-29 07:10:00",1440857400,"C8",203580,1441060980,"2015-08-31 15:43:00"
"5167","20151709101746-425",1,"2015-08-29 08:01:00",1440860460,"C5",628320,1441488780,"2015-09-05 14:33:00"
"3818","20150122110107-735",2,"2015-08-29 08:11:00",1440861060,"C4",297300,1441158360,"2015-09-01 18:46:00"
"2592","20151317041326-366",1,"2015-08-29 08:29:00",1440862140,"C5",784920,1441647060,"2015-09-07 10:31:00"
"5767","20151412091419-116",1,"2015-08-29 08:50:00",1440863400,"C0",518220,1441381620,"2015-09-04 08:47:00"
"4936","20154623094608-73",2,"2015-08-29 09:00:00",1440864000,"C7",257820,1441121820,"2015-09-01 08:37:00"
"1265","20151620061621-385",1,"2015-08-29 09:02:00",1440864120,"C4",393780,1441257900,"2015-09-02 22:25:00"
"3040","20150227050213-13",1,"2015-08-29 09:36:00",1440866160,"C7",73020,1440939180,"2015-08-30 05:53:00"
"3133","20150303100335-568",2,"2015-08-29 09:55:00",1440867300,"C3",615540,1441482840,"2015-09-05 12:54:00"
"88","20155627105645-424",3,"2015-08-29 09:58:00",1440867480,"C5",84660,1440952140,"2015-08-30 09:29:00"
"736","20150421090407-354",2,"2015-08-29 10:37:00",1440869820,"C7",99540,1440969360,"2015-08-30 14:16:00"
"3539","20155813025810-185",3,"2015-08-29 11:54:00",1440874440,"C4",171420,1441045860,"2015-08-31 11:31:00"
"2008","20152505102515-978",1,"2015-08-29 12:15:00",1440875700,"C5",679800,1441555500,"2015-09-06 09:05:00"
"1342","20151626071648-759",1,"2015-08-29 12:20:00",1440876000,"C5",138720,1441014720,"2015-08-31 02:52:00"
"4236","20150610080607-677",1,"2015-08-29 13:02:00",1440878520,"C6",207420,1441085940,"2015-08-31 22:39:00"
"5797","20154518064540-758",1,"2015-08-29 13:07:00",1440878820,"C3",486660,1441365480,"2015-09-04 04:18:00"
"5994","20150019010055-677",1,"2015-08-29 13:12:00",1440879120,"C4",288240,1441167360,"2015-09-01 21:16:00"
"4397","20153926083902-744",2,"2015-08-29 13:37:00",1440880620,"C6",277080,1441157700,"2015-09-01 18:35:00"
"6168","20150724060708-783",2,"2015-08-29 13:59:00",1440881940,"C5",230160,1441112100,"2015-09-01 05:55:00"
"1254","20150329020331-802",2,"2015-08-29 15:31:00",1440887460,"C4",659460,1441546920,"2015-09-06 06:42:00"
"2321","20150223110259-667",1,"2015-08-29 15:40:00",1440888000,"C2",76440,1440964440,"2015-08-30 12:54:00"
"2406","20155618075600-258",1,"2015-08-29 16:04:00",1440889440,"C4",122460,1441011900,"2015-08-31 02:05:00"
"5787","20152119062102-718",1,"2015-08-29 16:50:00",1440892200,"C4",128820,1441021020,"2015-08-31 04:37:00"
"132","20155227095221-937",1,"2015-08-29 16:53:00",1440892380,"C4",198060,1441090440,"2015-08-31 23:54:00"
"2368","20155427055429-500",1,"2015-08-29 17:02:00",1440892920,"C7",84840,1440977760,"2015-08-30 16:36:00"
"3758","20150123100107-508",1,"2015-08-29 17:06:00",1440893160,"C8",108780,1441001940,"2015-08-30 23:19:00"
"5669","20152826092847-177",1,"2015-08-29 18:04:00",1440896640,"C5",96720,1440993360,"2015-08-30 20:56:00"
"719","20151411031453-479",2,"2015-08-29 18:50:00",1440899400,"C2",522720,1441422120,"2015-09-04 20:02:00"
"793","20153603053623-213",1,"2015-08-29 19:17:00",1440901020,"C5",321780,1441222800,"2015-09-02 12:40:00"
"661","20154104054114-147",1,"2015-08-29 19:33:00",1440901980,"C4",605640,1441507620,"2015-09-05 19:47:00"
"2376","20151409101410-293",2,"2015-08-29 20:00:00",1440903600,"C4",251880,1441155480,"2015-09-01 17:58:00"
"1496","20154311034317-220",1,"2015-08-29 20:13:00",1440904380,"C8",314280,1441218660,"2015-09-02 11:31:00"
"3089","20153326053328-53",1,"2015-08-29 20:18:00",1440904680,"C4",89700,1440994380,"2015-08-30 21:13:00"
"2659","20150825110832-749",1,"2015-08-29 21:03:00",1440907380,"C5",437100,1441344480,"2015-09-03 22:28:00"
"202","20155531065512-853",2,"2015-08-29 21:04:00",1440907440,"C3",365220,1441272660,"2015-09-03 02:31:00"
"3297","20154124024130-878",1,"2015-08-29 21:27:00",1440908820,"C5",228180,1441137000,"2015-09-01 12:50:00"
"1206","20151728041704-292",1,"2015-08-29 22:07:00",1440911220,"C0",107400,1441018620,"2015-08-31 03:57:00"
"5531","20150827120843-66",1,"2015-08-29 22:30:00",1440912600,"C4",105060,1441017660,"2015-08-31 03:41:00"
"3951","20151322091316-1",2,"2015-08-29 22:51:00",1440913860,"C8",476040,1441389900,"2015-09-04 11:05:00"
"486","20150503080511-131",2,"2015-08-29 22:53:00",1440913980,"C6",383280,1441297260,"2015-09-03 09:21:00"
"5452","20153827023814-492",1,"2015-08-29 23:19:00",1440915540,"C8",411780,1441327320,"2015-09-03 17:42:00"
"2412","20151624101641-279",3,"2015-08-30 00:05:00",1440918300,"C8",68820,1440987120,"2015-08-30 19:12:00"
"6058","20152726012729-506",2,"2015-08-30 00:31:00",1440919860,"C8",149520,1441069380,"2015-08-31 18:03:00"
"4018","20155327095347-642",1,"2015-08-30 00:53:00",1440921180,"C5",75600,1440996780,"2015-08-30 21:53:00"
"2978","20154323084319-194",2,"2015-08-30 01:55:00",1440924900,"C5",290160,1441215060,"2015-09-02 10:31:00"
"6127","20150914080950-53",1,"2015-08-30 02:41:00",1440927660,"C5",170340,1441098000,"2015-09-01 02:00:00"
"3244","20151413091400-23",3,"2015-08-30 03:09:00",1440929340,"C8",289380,1441218720,"2015-09-02 11:32:00"
"2243","20155308025321-11",1,"2015-08-30 04:03:00",1440932580,"C5",930900,1441863480,"2015-09-09 22:38:00"
"5754","20151712081746-902",3,"2015-08-30 05:47:00",1440938820,"C0",515400,1441454220,"2015-09-05 04:57:00"
"3176","20153115083101-873",1,"2015-08-30 07:19:00",1440944340,"C6",215280,1441159620,"2015-09-01 19:07:00"
"224","20154024034000-968",2,"2015-08-30 07:40:00",1440945600,"C3",244800,1441190400,"2015-09-02 03:40:00"
"3257","20155920065907-68",2,"2015-08-30 08:22:00",1440948120,"C7",124140,1441072260,"2015-08-31 18:51:00"
"5299","20155123015147-690",2,"2015-08-30 08:48:00",1440949680,"C5",195540,1441145220,"2015-09-01 15:07:00"
"5831","20155631105647-912",2,"2015-08-30 08:50:00",1440949800,"C6",430740,1441380540,"2015-09-04 08:29:00"
"5378","20150920110938-724",2,"2015-08-30 09:41:00",1440952860,"C3",429360,1441382220,"2015-09-04 08:57:00"
"5908","20153228043201-577",2,"2015-08-30 10:08:00",1440954480,"C2",353520,1441308000,"2015-09-03 12:20:00"
"1365","20150326050302-149",2,"2015-08-30 11:07:00",1440958020,"C7",162120,1441120140,"2015-09-01 08:09:00"
"1296","20155629035637-921",1,"2015-08-30 12:04:00",1440961440,"C6",72480,1441033920,"2015-08-31 08:12:00"
"5152","20154325074316-323",2,"2015-08-30 12:39:00",1440963540,"C8",224880,1441188420,"2015-09-02 03:07:00"
"4218","20150104120123-255",2,"2015-08-30 13:00:00",1440964800,"C7",321420,1441286220,"2015-09-03 06:17:00"
"1479","20155524115511-739",3,"2015-08-30 13:01:00",1440964860,"C6",533460,1441498320,"2015-09-05 17:12:00"
"2481","20153026053028-239",2,"2015-08-30 13:40:00",1440967200,"C8",165900,1441133100,"2015-09-01 11:45:00"
"5616","20152501072548-463",3,"2015-08-30 13:45:00",1440967500,"C7",361200,1441328700,"2015-09-03 18:05:00"
"6155","20150603110619-327",2,"2015-08-30 14:12:00",1440969120,"C5",781320,1441750440,"2015-09-08 15:14:00"
"3967","20151722021752-58",1,"2015-08-30 15:14:00",1440972840,"C5",231540,1441204380,"2015-09-02 07:33:00"
"1721","20153426033412-312",3,"2015-08-30 15:34:00",1440974040,"C3",345600,1441319640,"2015-09-03 15:34:00"
"4478","20154224114240-680",1,"2015-08-30 16:29:00",1440977340,"C2",535620,1441512960,"2015-09-05 21:16:00"
"1081","20153122043149-695",2,"2015-08-30 17:31:00",1440981060,"C0",231600,1441212660,"2015-09-02 09:51:00"
"1678","20151326031310-457",1,"2015-08-30 17:53:00",1440982380,"C8",71040,1441053420,"2015-08-31 13:37:00"
"3700","20152327092353-670",3,"2015-08-30 20:08:00",1440990480,"C1",297900,1441288380,"2015-09-03 06:53:00"
"2234","20154429034402-935",3,"2015-08-30 20:35:00",1440992100,"C6",103860,1441095960,"2015-09-01 01:26:00"
"2146","20150423050415-924",1,"2015-08-30 21:36:00",1440995760,"C5",77640,1441073400,"2015-08-31 19:10:00"
"1641","20151624051659-955",3,"2015-08-30 21:37:00",1440995820,"C6",534060,1441529880,"2015-09-06 01:58:00"
"4873","20152424062441-168",2,"2015-08-30 23:12:00",1441001520,"C4",731160,1441732680,"2015-09-08 10:18:00"
"1096","20153329013347-72",2,"2015-08-30 23:29:00",1441002540,"C7",61080,1441063620,"2015-08-31 16:27:00"
"552","20151024111054-335",3,"2015-08-30 23:35:00",1441002900,"C8",112620,1441115520,"2015-09-01 06:52:00"
"586","20154227124221-606",1,"2015-08-31 00:20:00",1441005600,"C8",150540,1441156140,"2015-09-01 18:09:00"
"2586","20151122081111-220",1,"2015-08-31 01:23:00",1441009380,"C4",94140,1441103520,"2015-09-01 03:32:00"
"5936","20152318072357-176",1,"2015-08-31 01:44:00",1441010640,"C5",540180,1441550820,"2015-09-06 07:47:00"
"4225","20155727045735-743",3,"2015-08-31 02:27:00",1441013220,"C4",97800,1441111020,"2015-09-01 05:37:00"
"1436","20151302121348-104",1,"2015-08-31 02:37:00",1441013820,"C7",274560,1441288380,"2015-09-03 06:53:00"
"2441","20150208050254-21",2,"2015-08-31 03:20:00",1441016400,"C5",968940,1441985340,"2015-09-11 08:29:00"
"6483","20155707085753-292",2,"2015-08-31 03:33:00",1441017180,"C0",684720,1441701900,"2015-09-08 01:45:00"
"5258","20151104081118-17",1,"2015-08-31 03:44:00",1441017840,"C2",772260,1441790100,"2015-09-09 02:15:00"
"1127","20150423020418-599",2,"2015-08-31 04:20:00",1441020000,"C8",328080,1441348080,"2015-09-03 23:28:00"
"3798","20155328105351-17",2,"2015-08-31 05:29:00",1441024140,"C3",119880,1441144020,"2015-09-01 14:47:00"
"5087","20151822111805-247",1,"2015-08-31 05:58:00",1441025880,"C5",94800,1441120680,"2015-09-01 08:18:00"
"5039","20153619053636-962",1,"2015-08-31 06:12:00",1441026720,"C2",524880,1441551600,"2015-09-06 08:00:00"
"2723","20152107042148-742",1,"2015-08-31 06:18:00",1441027080,"C2",679140,1441706220,"2015-09-08 02:57:00"
"2885","20151308041318-416",1,"2015-08-31 06:36:00",1441028160,"C3",278940,1441307100,"2015-09-03 12:05:00"
"563","20150728080743-392",1,"2015-08-31 06:55:00",1441029300,"C0",84960,1441114260,"2015-09-01 06:31:00"
"3442","20150904110945-706",1,"2015-08-31 07:43:00",1441032180,"C4",714120,1441746300,"2015-09-08 14:05:00"
"3323","20155820075838-714",1,"2015-08-31 07:58:00",1441033080,"C5",241920,1441275000,"2015-09-03 03:10:00"
"3195","20150429050401-796",2,"2015-08-31 08:58:00",1441036680,"C2",71820,1441108500,"2015-09-01 04:55:00"
"6173","20154310044352-738",1,"2015-08-31 09:43:00",1441039380,"C3",255600,1441294980,"2015-09-03 08:43:00"
"240","20152925092904-816",1,"2015-08-31 10:37:00",1441042620,"C8",261240,1441303860,"2015-09-03 11:11:00"
"1809","20155528075553-143",1,"2015-08-31 11:06:00",1441044360,"C3",791580,1441835940,"2015-09-09 14:59:00"
"3554","20155413065431-352",1,"2015-08-31 12:03:00",1441047780,"C5",224820,1441272600,"2015-09-03 02:30:00"
"5780","20152328082316-929",1,"2015-08-31 12:05:00",1441047900,"C5",136260,1441184160,"2015-09-02 01:56:00"
"2382","20152827022858-442",2,"2015-08-31 12:22:00",1441048920,"C2",169020,1441217940,"2015-09-02 11:19:00"
"2948","20155730045709-115",1,"2015-08-31 12:44:00",1441050240,"C2",71220,1441121460,"2015-09-01 08:31:00"
"6304","20152304092306-366",2,"2015-08-31 13:23:00",1441052580,"C8",469440,1441522020,"2015-09-05 23:47:00"
"718","20153003103059-290",3,"2015-08-31 14:14:00",1441055640,"C0",347520,1441403160,"2015-09-04 14:46:00"
"6441","20154305094304-138",1,"2015-08-31 14:39:00",1441057140,"C0",706080,1441763220,"2015-09-08 18:47:00"
"1224","20152027102031-111",2,"2015-08-31 14:47:00",1441057620,"C4",120540,1441178160,"2015-09-02 00:16:00"
"4785","20154716114727-41",2,"2015-08-31 14:59:00",1441058340,"C6",163440,1441221780,"2015-09-02 12:23:00"
"5776","20155731045731-907",1,"2015-08-31 15:12:00",1441059120,"C8",534420,1441593540,"2015-09-06 19:39:00"
"5041","20155027025003-704",1,"2015-08-31 16:32:00",1441063920,"C8",175860,1441239780,"2015-09-02 17:23:00"
"3924","20153629103642-718",2,"2015-08-31 16:38:00",1441064280,"C8",97260,1441161540,"2015-09-01 19:39:00"
"1966","20155330035349-797",1,"2015-08-31 17:06:00",1441065960,"C2",90780,1441156740,"2015-09-01 18:19:00"
"2876","20150130120133-197",2,"2015-08-31 18:09:00",1441069740,"C4",348360,1441418100,"2015-09-04 18:55:00"
"6251","20153529063501-322",2,"2015-08-31 18:27:00",1441070820,"C4",215520,1441286340,"2015-09-03 06:19:00"
"1855","20154314044331-360",2,"2015-08-31 18:31:00",1441071060,"C5",491760,1441562820,"2015-09-06 11:07:00"
"3499","20150929090940-494",1,"2015-08-31 19:03:00",1441072980,"C5",104220,1441177200,"2015-09-02 00:00:00"
"1932","20150530010559-140",2,"2015-08-31 19:39:00",1441075140,"C0",110040,1441185180,"2015-09-02 02:13:00"
"4449","20152027042059-327",1,"2015-08-31 19:58:00",1441076280,"C7",179340,1441255620,"2015-09-02 21:47:00"
"1906","20154521044507-247",1,"2015-08-31 20:25:00",1441077900,"C8",438600,1441516500,"2015-09-05 22:15:00"
"5389","20151515101538-806",1,"2015-08-31 21:11:00",1441080660,"C5",177720,1441258380,"2015-09-02 22:33:00"
"766","20153516103511-94",1,"2015-08-31 21:31:00",1441081860,"C6",166920,1441248780,"2015-09-02 19:53:00"
"2939","20151022031032-538",2,"2015-08-31 21:38:00",1441082280,"C8",400440,1441482720,"2015-09-05 12:52:00"
"4863","20152824082829-991",3,"2015-08-31 23:52:00",1441090320,"C4",220080,1441310400,"2015-09-03 13:00:00"
"5894","20153912083903-728",1,"2015-09-01 00:07:00",1441091220,"C2",212160,1441303380,"2015-09-03 11:03:00"
"4887","20151102061116-400",1,"2015-09-01 00:46:00",1441093560,"C0",367500,1441461060,"2015-09-05 06:51:00"
"1921","20150707020749-480",2,"2015-09-01 00:47:00",1441093620,"C2",264000,1441357620,"2015-09-04 02:07:00"
"2850","20155023025023-616",3,"2015-09-01 01:15:00",1441095300,"C8",104100,1441199400,"2015-09-02 06:10:00"
"4360","20152129102109-855",2,"2015-09-01 01:17:00",1441095420,"C8",113280,1441208700,"2015-09-02 08:45:00"
"6541","20153828103812-353",1,"2015-09-01 01:38:00",1441096680,"C2",104400,1441201080,"2015-09-02 06:38:00"
"4143","20153520013555-33",1,"2015-09-01 01:50:00",1441097400,"C5",524700,1441622100,"2015-09-07 03:35:00"
"5696","20151926071934-564",3,"2015-09-01 02:31:00",1441099860,"C5",721440,1441821300,"2015-09-09 10:55:00"
"2966","20150311040359-426",1,"2015-09-01 03:55:00",1441104900,"C5",252960,1441357860,"2015-09-04 02:11:00"
"3682","20154928054922-765",1,"2015-09-01 04:31:00",1441107060,"C4",148860,1441255920,"2015-09-02 21:52:00"
"3842","20150308080350-359",2,"2015-09-01 05:00:00",1441108800,"C4",294660,1441403460,"2015-09-04 14:51:00"
"1401","20153826073859-860",3,"2015-09-01 05:29:00",1441110540,"C5",455580,1441566120,"2015-09-06 12:02:00"
"5553","20153031103041-989",1,"2015-09-01 05:42:00",1441111320,"C6",69120,1441180440,"2015-09-02 00:54:00"
"919","20154626024603-797",1,"2015-09-01 06:18:00",1441113480,"C3",243960,1441357440,"2015-09-04 02:04:00"
"5926","20154923124957-839",2,"2015-09-01 06:25:00",1441113900,"C0",251520,1441365420,"2015-09-04 04:17:00"
"5065","20151428061408-195",2,"2015-09-01 06:59:00",1441115940,"C0",348300,1441464240,"2015-09-05 07:44:00"
"2934","20151917071938-502",1,"2015-09-01 07:00:00",1441116000,"C4",184980,1441300980,"2015-09-03 10:23:00"
"3742","20150028060003-741",1,"2015-09-01 07:18:00",1441117080,"C0",350280,1441467360,"2015-09-05 08:36:00"
"3335","20152506122555-795",2,"2015-09-01 07:29:00",1441117740,"C3",613380,1441731120,"2015-09-08 09:52:00"
"1649","20153924093924-473",1,"2015-09-01 07:35:00",1441118100,"C5",97680,1441215780,"2015-09-02 10:43:00"
"2704","20153310073327-373",2,"2015-09-01 07:43:00",1441118580,"C8",1434360,1442552940,"2015-09-17 22:09:00"
"1791","20155627075627-902",2,"2015-09-01 08:54:00",1441122840,"C8",217740,1441340580,"2015-09-03 21:23:00"
"413","20151804041847-645",3,"2015-09-01 10:09:00",1441127340,"C7",266340,1441393680,"2015-09-04 12:08:00"
"889","20155217105212-400",1,"2015-09-01 10:13:00",1441127580,"C5",1324020,1442451600,"2015-09-16 18:00:00"
"2312","20155431095434-843",1,"2015-09-01 11:00:00",1441130400,"C4",90360,1441220760,"2015-09-02 12:06:00"
"3832","20152801052822-733",1,"2015-09-01 11:12:00",1441131120,"C4",331980,1441463100,"2015-09-05 07:25:00"
"5558","20152030042019-172",3,"2015-09-01 12:10:00",1441134600,"C4",157800,1441292400,"2015-09-03 08:00:00"
"4326","20150230100245-923",2,"2015-09-01 13:01:00",1441137660,"C6",183540,1441321200,"2015-09-03 16:00:00"
"2004","20154722114730-650",1,"2015-09-01 13:05:00",1441137900,"C5",289560,1441427460,"2015-09-04 21:31:00"
"4293","20153926103929-911",2,"2015-09-01 13:17:00",1441138620,"C4",263940,1441402560,"2015-09-04 14:36:00"
"1266","20151518051530-830",1,"2015-09-01 13:30:00",1441139400,"C8",239220,1441378620,"2015-09-04 07:57:00"
"1729","20155029015020-507",1,"2015-09-01 13:33:00",1441139580,"C4",258180,1441397760,"2015-09-04 13:16:00"
"6509","20151230091228-162",1,"2015-09-01 14:10:00",1441141800,"C8",95340,1441237140,"2015-09-02 16:39:00"
"685","20153023103028-824",2,"2015-09-01 14:28:00",1441142880,"C5",866040,1442008920,"2015-09-11 15:02:00"
"256","20151622101656-331",2,"2015-09-01 14:40:00",1441143600,"C5",439920,1441583520,"2015-09-06 16:52:00"
"6315","20155221075249-459",3,"2015-09-01 15:10:00",1441145400,"C6",609180,1441754580,"2015-09-08 16:23:00"
"5598","20150724070715-550",3,"2015-09-01 15:15:00",1441145700,"C4",90060,1441235760,"2015-09-02 16:16:00"
"2534","20153930123905-665",1,"2015-09-01 15:18:00",1441145880,"C6",182340,1441328220,"2015-09-03 17:57:00"
"1958","20152030102012-63",1,"2015-09-01 16:40:00",1441150800,"C0",195600,1441346400,"2015-09-03 23:00:00"
"2476","20155930115903-142",1,"2015-09-01 16:53:00",1441151580,"C4",190440,1441342020,"2015-09-03 21:47:00"
"4927","20151019101012-506",1,"2015-09-01 16:53:00",1441151580,"C5",546540,1441698120,"2015-09-08 00:42:00"
"4558","20152228112223-26",1,"2015-09-01 16:58:00",1441151880,"C5",182880,1441334760,"2015-09-03 19:46:00"
"4433","20154629034625-561",1,"2015-09-01 17:58:00",1441155480,"C5",89040,1441244520,"2015-09-02 18:42:00"
"667","20154226054229-220",2,"2015-09-01 18:08:00",1441156080,"C2",519960,1441676040,"2015-09-07 18:34:00"
"4473","20150831020803-228",1,"2015-09-01 18:11:00",1441156260,"C2",100980,1441257240,"2015-09-02 22:14:00"
"4003","20150831110802-88",1,"2015-09-01 18:48:00",1441158480,"C2",114000,1441272480,"2015-09-03 02:28:00"
"2426","20153829073814-789",2,"2015-09-01 19:55:00",1441162500,"C3",303420,1441465920,"2015-09-05 08:12:00"
"5255","20152028032005-469",2,"2015-09-01 19:58:00",1441162680,"C4",181140,1441343820,"2015-09-03 22:17:00"
"4283","20152822082859-49",3,"2015-09-01 20:12:00",1441163520,"C5",113280,1441276800,"2015-09-03 03:40:00"
"3125","20152630092647-226",1,"2015-09-01 20:14:00",1441163640,"C7",105840,1441269480,"2015-09-03 01:38:00"
"1910","20150122090127-897",1,"2015-09-01 20:19:00",1441163940,"C3",452340,1441616280,"2015-09-07 01:58:00"
"2268","20154418044437-34",2,"2015-09-01 20:42:00",1441165320,"C5",174840,1441340160,"2015-09-03 21:16:00"
"2932","20154928074942-377",1,"2015-09-01 21:33:00",1441168380,"C5",197520,1441365900,"2015-09-04 04:25:00"
"1527","20155627015611-22",1,"2015-09-01 21:53:00",1441169580,"C5",153540,1441323120,"2015-09-03 16:32:00"
"5769","20152302122333-628",2,"2015-09-01 22:18:00",1441171080,"C8",525540,1441696620,"2015-09-08 00:17:00"
"171","20154930084931-614",1,"2015-09-01 22:19:00",1441171140,"C0",73800,1441244940,"2015-09-02 18:49:00"
"2378","20151612061624-150",1,"2015-09-01 23:50:00",1441176600,"C7",638520,1441815120,"2015-09-09 09:12:00"
"355","20150524010519-501",2,"2015-09-02 00:25:00",1441178700,"C4",91500,1441270200,"2015-09-03 01:50:00"
"5513","20155924025958-524",2,"2015-09-02 01:49:00",1441183740,"C8",681720,1441865460,"2015-09-09 23:11:00"
"3711","20150030120002-677",2,"2015-09-02 03:14:00",1441188840,"C5",113820,1441302660,"2015-09-03 10:51:00"
"336","20154320014344-198",1,"2015-09-02 03:59:00",1441191540,"C5",538080,1441729620,"2015-09-08 09:27:00"
"4641","20155807095823-910",3,"2015-09-02 04:30:00",1441193400,"C5",278340,1441471740,"2015-09-05 09:49:00"
"3936","20152229092222-160",2,"2015-09-02 05:24:00",1441196640,"C5",165660,1441362300,"2015-09-04 03:25:00"
"1293","20151403071408-116",2,"2015-09-02 05:33:00",1441197180,"C5",369420,1441566600,"2015-09-06 12:10:00"
"6292","20155625025623-196",3,"2015-09-02 05:36:00",1441197360,"C5",82200,1441279560,"2015-09-03 04:26:00"
"4817","20155326105306-68",1,"2015-09-02 06:47:00",1441201620,"C3",295020,1441496640,"2015-09-05 16:44:00"
"6543","20155726105718-69",3,"2015-09-02 06:57:00",1441202220,"C5",295200,1441497420,"2015-09-05 16:57:00"
"5691","20152908112909-319",2,"2015-09-02 07:21:00",1441203660,"C4",602940,1441806600,"2015-09-09 06:50:00"
"4610","20154519024544-322",2,"2015-09-02 08:04:00",1441206240,"C4",202080,1441408320,"2015-09-04 16:12:00"
"4407","20151531031549-230",1,"2015-09-02 09:01:00",1441209660,"C8",75180,1441284840,"2015-09-03 05:54:00"
"840","20153622113605-844",1,"2015-09-02 09:38:00",1441211880,"C5",471660,1441683540,"2015-09-07 20:39:00"
"266","20154126094133-632",1,"2015-09-02 10:39:00",1441215540,"C5",304140,1441519680,"2015-09-05 23:08:00"
"5828","20155922045901-406",1,"2015-09-02 10:59:00",1441216740,"C3",309600,1441526340,"2015-09-06 00:59:00"
"728","20152013022053-492",2,"2015-09-02 11:16:00",1441217760,"C3",245280,1441463040,"2015-09-05 07:24:00"
"5198","20152529022528-642",2,"2015-09-02 11:28:00",1441218480,"C5",111660,1441330140,"2015-09-03 18:29:00"
"1109","20151730081700-38",2,"2015-09-02 11:33:00",1441218780,"C3",270960,1441489740,"2015-09-05 14:49:00"
"4634","20153731113748-614",3,"2015-09-02 12:17:00",1441221420,"C4",87600,1441309020,"2015-09-03 12:37:00"
"6430","20155922045952-606",2,"2015-09-02 12:34:00",1441222440,"C5",133500,1441355940,"2015-09-04 01:39:00"
"2625","20152024032005-799",2,"2015-09-02 14:11:00",1441228260,"C5",257820,1441486080,"2015-09-05 13:48:00"
"3769","20151212081202-125",3,"2015-09-02 14:37:00",1441229820,"C8",903180,1442133000,"2015-09-13 01:30:00"
"141","20155331025312-334",1,"2015-09-02 14:47:00",1441230420,"C0",57480,1441287900,"2015-09-03 06:45:00"
"497","20151217121251-526",1,"2015-09-02 14:57:00",1441231020,"C0",198900,1441429920,"2015-09-04 22:12:00"
"4695","20154424014431-732",1,"2015-09-02 15:38:00",1441233480,"C3",261480,1441494960,"2015-09-05 16:16:00"
"594","20155119115134-6",1,"2015-09-02 16:24:00",1441236240,"C8",175140,1441411380,"2015-09-04 17:03:00"
"2347","20152314062351-552",1,"2015-09-02 17:26:00",1441239960,"C3",560460,1441800420,"2015-09-09 05:07:00"
"5817","20154124024118-504",1,"2015-09-02 17:26:00",1441239960,"C8",157500,1441397460,"2015-09-04 13:11:00"
"4382","20155731065708-964",2,"2015-09-02 17:33:00",1441240380,"C5",105480,1441345860,"2015-09-03 22:51:00"
"1576","20151520101518-905",1,"2015-09-02 17:48:00",1441241280,"C4",164340,1441405620,"2015-09-04 15:27:00"
"3715","20152731032706-323",1,"2015-09-02 20:05:00",1441249500,"C7",94740,1441344240,"2015-09-03 22:24:00"
"5006","20155725035758-59",3,"2015-09-02 20:30:00",1441251000,"C4",235860,1441486860,"2015-09-05 14:01:00"
"6141","20152531032502-40",2,"2015-09-02 20:53:00",1441252380,"C2",96240,1441348620,"2015-09-03 23:37:00"
"4789","20151814091820-723",1,"2015-09-02 21:00:00",1441252800,"C3",623160,1441875960,"2015-09-10 02:06:00"
"1596","20150116100148-276",2,"2015-09-02 21:05:00",1441253100,"C4",188580,1441441680,"2015-09-05 01:28:00"
"466","20150727060728-239",1,"2015-09-02 21:35:00",1441254900,"C4",464640,1441719540,"2015-09-08 06:39:00"
"1152","20152914042953-652",3,"2015-09-02 22:41:00",1441258860,"C6",277320,1441536180,"2015-09-06 03:43:00"
"1281","20154630124612-292",1,"2015-09-02 22:58:00",1441259880,"C2",147960,1441407840,"2015-09-04 16:04:00"
"1025","20150022040009-518",1,"2015-09-02 23:28:00",1441261680,"C0",522240,1441783920,"2015-09-09 00:32:00"
"5968","20152208012227-661",3,"2015-09-02 23:30:00",1441261800,"C6",274560,1441536360,"2015-09-06 03:46:00"
"3744","20152726042751-686",1,"2015-09-03 00:11:00",1441264260,"C5",316320,1441580580,"2015-09-06 16:03:00"
"1397","20150628010656-511",3,"2015-09-03 00:18:00",1441264680,"C5",59040,1441323720,"2015-09-03 16:42:00"
"230","20154016054052-85",1,"2015-09-03 00:28:00",1441265280,"C6",186660,1441451940,"2015-09-05 04:19:00"
"86","20155721045702-819",1,"2015-09-03 00:35:00",1441265700,"C4",152040,1441417740,"2015-09-04 18:49:00"
"4029","20155529095519-855",2,"2015-09-03 00:47:00",1441266420,"C7",199560,1441465980,"2015-09-05 08:13:00"
"30","20153330053323-666",3,"2015-09-03 01:03:00",1441267380,"C8",143100,1441410480,"2015-09-04 16:48:00"
"4390","20154529014544-620",1,"2015-09-03 01:40:00",1441269600,"C8",77700,1441347300,"2015-09-03 23:15:00"
"6230","20151724061714-521",1,"2015-09-03 01:57:00",1441270620,"C7",121200,1441391820,"2015-09-04 11:37:00"
"279","20155610055624-279",1,"2015-09-03 02:16:00",1441271760,"C7",670800,1441942560,"2015-09-10 20:36:00"
"1147","20150823010813-63",1,"2015-09-03 02:26:00",1441272360,"C7",455940,1441728300,"2015-09-08 09:05:00"
"662","20154524044508-686",1,"2015-09-03 02:55:00",1441274100,"C8",162840,1441436940,"2015-09-05 00:09:00"
"3867","20150529010519-318",2,"2015-09-03 03:11:00",1441275060,"C7",198180,1441473240,"2015-09-05 10:14:00"
"4454","20150501030502-599",3,"2015-09-03 03:59:00",1441277940,"C0",66420,1441344360,"2015-09-03 22:26:00"
"5770","20153230033205-767",1,"2015-09-03 04:00:00",1441278000,"C5",152040,1441430040,"2015-09-04 22:14:00"
"2362","20151823071855-858",2,"2015-09-03 04:12:00",1441278720,"C8",469620,1441748340,"2015-09-08 14:39:00"
"1646","20152909022912-907",1,"2015-09-03 06:14:00",1441286040,"C8",961740,1442247780,"2015-09-14 09:23:00"
"1874","20153204023235-178",1,"2015-09-03 06:32:00",1441287120,"C2",320400,1441607520,"2015-09-06 23:32:00"
"3984","20152427042457-76",1,"2015-09-03 06:39:00",1441287540,"C4",189900,1441477440,"2015-09-05 11:24:00"
"4721","20154725054747-248",2,"2015-09-03 07:06:00",1441289160,"C4",488220,1441777380,"2015-09-08 22:43:00"
"4229","20150721100700-126",1,"2015-09-03 07:07:00",1441289220,"C5",370800,1441660020,"2015-09-07 14:07:00"
"3881","20153519123507-498",1,"2015-09-03 07:15:00",1441289700,"C5",159600,1441449300,"2015-09-05 03:35:00"
"5414","20152229062214-724",1,"2015-09-03 07:16:00",1441289760,"C2",435240,1441725000,"2015-09-08 08:10:00"
"2929","20151530051543-867",3,"2015-09-03 07:37:00",1441291020,"C5",155460,1441446480,"2015-09-05 02:48:00"
"6064","20153516013555-105",3,"2015-09-03 09:47:00",1441298820,"C5",513840,1441812660,"2015-09-09 08:31:00"
"2538","20152527022531-64",2,"2015-09-03 10:01:00",1441299660,"C2",73620,1441373280,"2015-09-04 06:28:00"
"3014","20153029033048-19",2,"2015-09-03 10:26:00",1441301160,"C5",51720,1441352880,"2015-09-04 00:48:00"
"5791","20152625082631-507",1,"2015-09-03 10:29:00",1441301340,"C4",112140,1441413480,"2015-09-04 17:38:00"
"4560","20150014100049-755",2,"2015-09-03 10:40:00",1441302000,"C8",346080,1441648080,"2015-09-07 10:48:00"
"1699","20155530055509-649",2,"2015-09-03 11:05:00",1441303500,"C8",64200,1441367700,"2015-09-04 04:55:00"
"431","20151225071221-449",2,"2015-09-03 11:21:00",1441304460,"C4",113220,1441417680,"2015-09-04 18:48:00"
"5621","20152124062158-615",1,"2015-09-03 12:15:00",1441307700,"C0",295080,1441602780,"2015-09-06 22:13:00"
"2253","20150701080732-301",1,"2015-09-03 12:21:00",1441308060,"C4",94020,1441402080,"2015-09-04 14:28:00"
"5644","20154618044618-128",1,"2015-09-03 12:25:00",1441308300,"C7",449460,1441757760,"2015-09-08 17:16:00"
"3816","20153913023914-536",2,"2015-09-03 13:08:00",1441310880,"C5",258420,1441569300,"2015-09-06 12:55:00"
"1727","20153930103903-13",1,"2015-09-03 13:44:00",1441313040,"C6",356700,1441669740,"2015-09-07 16:49:00"
"4587","20154314054309-806",1,"2015-09-03 13:55:00",1441313700,"C8",857160,1442170860,"2015-09-13 12:01:00"
"487","20150531030537-639",1,"2015-09-03 14:41:00",1441316460,"C5",367020,1441683480,"2015-09-07 20:38:00"
"2761","20154419084429-25",1,"2015-09-03 15:17:00",1441318620,"C3",439860,1441758480,"2015-09-08 17:28:00"
"3677","20155102055140-273",3,"2015-09-03 16:12:00",1441321920,"C0",80460,1441402380,"2015-09-04 14:33:00"
"3153","20155125045126-764",1,"2015-09-03 16:39:00",1441323540,"C6",776880,1442100420,"2015-09-12 16:27:00"
"2866","20153220023240-486",1,"2015-09-03 16:40:00",1441323600,"C5",486960,1441810560,"2015-09-09 07:56:00"
"2819","20154920044949-964",2,"2015-09-03 16:53:00",1441324380,"C4",1209840,1442534220,"2015-09-17 16:57:00"
"5497","20155012065005-217",1,"2015-09-03 17:01:00",1441324860,"C3",276780,1441601640,"2015-09-06 21:54:00"
"2000","20153728073721-430",1,"2015-09-03 17:37:00",1441327020,"C3",277200,1441604220,"2015-09-06 22:37:00"
"4639","20151502121502-816",3,"2015-09-03 18:16:00",1441329360,"C6",108060,1441437420,"2015-09-05 00:17:00"
"2818","20150501010554-108",1,"2015-09-03 18:33:00",1441330380,"C2",96240,1441426620,"2015-09-04 21:17:00"
"3770","20155030075008-549",2,"2015-09-03 19:16:00",1441332960,"C8",193380,1441526340,"2015-09-06 00:59:00"
"4035","20154728024720-591",3,"2015-09-03 19:27:00",1441333620,"C3",267600,1441601220,"2015-09-06 21:47:00"
"2198","20152825092803-463",1,"2015-09-03 19:28:00",1441333680,"C4",101700,1441435380,"2015-09-04 23:43:00"
"1664","20152801082834-605",1,"2015-09-03 20:08:00",1441336080,"C8",107400,1441443480,"2015-09-05 01:58:00"
"4933","20155026055055-745",3,"2015-09-03 20:42:00",1441338120,"C3",350760,1441688880,"2015-09-07 22:08:00"
"3937","20150801100806-862",1,"2015-09-03 21:32:00",1441341120,"C8",106920,1441448040,"2015-09-05 03:14:00"
"15","20154727034733-671",2,"2015-09-03 21:37:00",1441341420,"C5",89400,1441430820,"2015-09-04 22:27:00"
"2947","20154631104618-531",1,"2015-09-03 21:52:00",1441342320,"C4",99720,1441442040,"2015-09-05 01:34:00"
"5163","20155130055132-838",1,"2015-09-03 22:47:00",1441345620,"C2",363360,1441708980,"2015-09-08 03:43:00"
"4767","20153426023405-923",2,"2015-09-04 01:14:00",1441354440,"C2",91200,1441445640,"2015-09-05 02:34:00"
"6122","20151031111040-488",2,"2015-09-04 01:40:00",1441356000,"C5",155700,1441511700,"2015-09-05 20:55:00"
"2011","20154127114159-870",2,"2015-09-04 02:13:00",1441357980,"C3",416940,1441774920,"2015-09-08 22:02:00"
"6093","20155523025523-457",2,"2015-09-04 02:45:00",1441359900,"C8",198600,1441558500,"2015-09-06 09:55:00"
"695","20153228023246-901",2,"2015-09-04 05:29:00",1441369740,"C3",190740,1441560480,"2015-09-06 10:28:00"
"1911","20150914040900-949",2,"2015-09-04 06:00:00",1441371600,"C3",253980,1441625580,"2015-09-07 04:33:00"
"2564","20152225012231-425",3,"2015-09-04 07:01:00",1441375260,"C2",280380,1441655640,"2015-09-07 12:54:00"
"4166","20152620032609-833",1,"2015-09-04 07:32:00",1441377120,"C0",181080,1441558200,"2015-09-06 09:50:00"
"2608","20155103115100-856",2,"2015-09-04 08:20:00",1441380000,"C3",73740,1441453740,"2015-09-05 04:49:00"
"2636","20150919070956-883",1,"2015-09-04 08:58:00",1441382280,"C8",198420,1441580700,"2015-09-06 16:05:00"
"276","20154202014210-253",2,"2015-09-04 09:12:00",1441383120,"C3",156600,1441539720,"2015-09-06 04:42:00"
"5726","20151303111344-23",1,"2015-09-04 10:43:00",1441388580,"C3",84600,1441473180,"2015-09-05 10:13:00"
"4744","20154726024709-573",2,"2015-09-04 10:44:00",1441388640,"C4",763020,1442151660,"2015-09-13 06:41:00"
"3476","20152228012256-73",1,"2015-09-04 11:16:00",1441390560,"C6",99540,1441490100,"2015-09-05 14:55:00"
"3227","20152303052328-94",2,"2015-09-04 11:31:00",1441391460,"C4",677760,1442069220,"2015-09-12 07:47:00"
"6280","20155622065626-576",1,"2015-09-04 12:06:00",1441393560,"C8",228360,1441621920,"2015-09-07 03:32:00"
"7","20150229070248-397",1,"2015-09-04 12:48:00",1441396080,"C4",269580,1441665660,"2015-09-07 15:41:00"
"300","20150803030838-612",2,"2015-09-04 13:08:00",1441397280,"C2",79200,1441476480,"2015-09-05 11:08:00"
"1499","20153102063137-742",1,"2015-09-04 13:25:00",1441398300,"C8",98820,1441497120,"2015-09-05 16:52:00"
"1132","20153227063207-318",1,"2015-09-04 14:10:00",1441401000,"C8",359340,1441760340,"2015-09-08 17:59:00"
"3141","20152830052802-839",2,"2015-09-04 14:28:00",1441402080,"C8",84240,1441486320,"2015-09-05 13:52:00"
"5864","20152531082521-227",1,"2015-09-04 14:29:00",1441402140,"C5",183720,1441585860,"2015-09-06 17:31:00"
"871","20153103063126-891",3,"2015-09-04 15:03:00",1441404180,"C3",399360,1441803540,"2015-09-09 05:59:00"
"3883","20150708090712-967",1,"2015-09-04 16:40:00",1441410000,"C2",337140,1441747140,"2015-09-08 14:19:00"
"237","20153209093250-358",3,"2015-09-04 17:56:00",1441414560,"C8",1138320,1442552880,"2015-09-17 22:08:00"
"493","20155024045011-587",3,"2015-09-04 18:14:00",1441415640,"C0",1211280,1442626920,"2015-09-18 18:42:00"
"1639","20155727015757-542",1,"2015-09-04 19:17:00",1441419420,"C2",355200,1441774620,"2015-09-08 21:57:00"
"5056","20155321115343-478",1,"2015-09-04 19:48:00",1441421280,"C8",247620,1441668900,"2015-09-07 16:35:00"
"5789","20151824051853-291",1,"2015-09-04 21:09:00",1441426140,"C4",321420,1441747560,"2015-09-08 14:26:00"
"3625","20150625010640-723",1,"2015-09-04 21:42:00",1441428120,"C6",149160,1441577280,"2015-09-06 15:08:00"
"1504","20152128102128-573",3,"2015-09-04 22:21:00",1441430460,"C6",81000,1441511460,"2015-09-05 20:51:00"
"3812","20151731021746-364",1,"2015-09-04 22:37:00",1441431420,"C8",75120,1441506540,"2015-09-05 19:29:00"
"4020","20153117053105-892",1,"2015-09-04 22:40:00",1441431600,"C7",224820,1441656420,"2015-09-07 13:07:00"
"5092","20155823115852-975",2,"2015-09-04 22:59:00",1441432740,"C4",153780,1441586520,"2015-09-06 17:42:00"
"3453","20152202092258-284",1,"2015-09-04 23:18:00",1441433880,"C8",111480,1441545360,"2015-09-06 06:16:00"
"3413","20150323050310-883",1,"2015-09-04 23:21:00",1441434060,"C4",529740,1441963800,"2015-09-11 02:30:00"
"1811","20154102104114-973",2,"2015-09-05 00:33:00",1441438380,"C7",111360,1441549740,"2015-09-06 07:29:00"
"6201","20150026070015-698",1,"2015-09-05 01:16:00",1441440960,"C8",120480,1441561440,"2015-09-06 10:44:00"
"133","20152001022003-999",1,"2015-09-05 01:26:00",1441441560,"C4",149580,1441591140,"2015-09-06 18:59:00"
"5997","20151927121927-686",3,"2015-09-05 04:04:00",1441451040,"C4",249300,1441700340,"2015-09-08 01:19:00"
"6234","20150517080528-116",3,"2015-09-05 04:31:00",1441452660,"C2",814380,1442267040,"2015-09-14 14:44:00"
"4837","20153130043132-951",1,"2015-09-05 04:47:00",1441453620,"C5",238080,1441691700,"2015-09-07 22:55:00"
"1158","20152930102944-762",1,"2015-09-05 05:19:00",1441455540,"C5",249900,1441705440,"2015-09-08 02:44:00"
"585","20155402095430-944",2,"2015-09-05 05:56:00",1441457760,"C2",244920,1441702680,"2015-09-08 01:58:00"
"1392","20155428025436-507",2,"2015-09-05 05:57:00",1441457820,"C5",94140,1441551960,"2015-09-06 08:06:00"
"3327","20154231024256-741",2,"2015-09-05 06:02:00",1441458120,"C8",1539600,1442997720,"2015-09-23 01:42:00"
"4387","20151209111219-195",2,"2015-09-05 07:26:00",1441463160,"C7",331320,1441794480,"2015-09-09 03:28:00"
"1336","20155409095404-1",1,"2015-09-05 07:30:00",1441463400,"C3",290520,1441753920,"2015-09-08 16:12:00"
"756","20151625011628-348",1,"2015-09-05 07:56:00",1441464960,"C6",116400,1441581360,"2015-09-06 16:16:00"
"5508","20151929081907-753",2,"2015-09-05 08:23:00",1441466580,"C4",302520,1441769100,"2015-09-08 20:25:00"
"3284","20151226121233-295",2,"2015-09-05 08:27:00",1441466820,"C5",121500,1441588320,"2015-09-06 18:12:00"
"6341","20151629101611-370",1,"2015-09-05 08:31:00",1441467060,"C3",85500,1441552560,"2015-09-06 08:16:00"
"4790","20155125115109-261",1,"2015-09-05 08:43:00",1441467780,"C4",469560,1441937340,"2015-09-10 19:09:00"
"614","20150401110417-611",1,"2015-09-05 08:56:00",1441468560,"C0",168960,1441637520,"2015-09-07 07:52:00"
"3007","20155504075536-383",1,"2015-09-05 09:20:00",1441470000,"C5",395700,1441865700,"2015-09-09 23:15:00"
"2086","20152120072110-350",2,"2015-09-05 09:51:00",1441471860,"C5",695700,1442167560,"2015-09-13 11:06:00"
"3198","20150004030017-259",1,"2015-09-05 10:07:00",1441472820,"C4",68820,1441541640,"2015-09-06 05:14:00"
"5015","20152126112132-235",1,"2015-09-05 10:34:00",1441474440,"C6",861180,1442335620,"2015-09-15 09:47:00"
"1577","20155801015824-240",1,"2015-09-05 11:03:00",1441476180,"C8",67020,1441543200,"2015-09-06 05:40:00"
"757","20153303063323-954",1,"2015-09-05 11:53:00",1441479180,"C3",96000,1441575180,"2015-09-06 14:33:00"
"758","20152129102151-57",1,"2015-09-05 12:37:00",1441481820,"C3",612960,1442094780,"2015-09-12 14:53:00"
"391","20150902120906-170",1,"2015-09-05 14:03:00",1441486980,"C3",266040,1441753020,"2015-09-08 15:57:00"
"389","20150204010234-9",1,"2015-09-05 14:26:00",1441488360,"C2",91440,1441579800,"2015-09-06 15:50:00"
"2675","20155504115554-356",1,"2015-09-05 14:28:00",1441488480,"C0",95580,1441584060,"2015-09-06 17:01:00"
"4000","20155926045943-896",2,"2015-09-05 14:31:00",1441488660,"C8",427560,1441916220,"2015-09-10 13:17:00"
"6228","20152924112938-506",3,"2015-09-05 15:05:00",1441490700,"C0",466020,1441956720,"2015-09-11 00:32:00"
"5830","20153017033036-185",1,"2015-09-05 16:15:00",1441494900,"C8",234900,1441729800,"2015-09-08 09:30:00"
"1068","20152125052113-381",3,"2015-09-05 16:26:00",1441495560,"C8",135300,1441630860,"2015-09-07 06:01:00"
"5875","20154102014133-632",3,"2015-09-05 16:29:00",1441495740,"C3",89760,1441585500,"2015-09-06 17:25:00"
"4056","20150031070053-947",1,"2015-09-05 16:36:00",1441496160,"C2",466560,1441962720,"2015-09-11 02:12:00"
"221","20154930094911-931",1,"2015-09-05 20:05:00",1441508700,"C5",69420,1441578120,"2015-09-06 15:22:00"
"412","20154709124756-980",1,"2015-09-05 20:07:00",1441508820,"C4",629700,1442138520,"2015-09-13 03:02:00"
"701","20151001081041-702",1,"2015-09-05 20:10:00",1441509000,"C0",194400,1441703400,"2015-09-08 02:10:00"
"2026","20152409032441-824",2,"2015-09-05 20:44:00",1441511040,"C8",1006080,1442517120,"2015-09-17 12:12:00"
"4988","20151426091421-412",2,"2015-09-05 20:50:00",1441511400,"C5",301920,1441813320,"2015-09-09 08:42:00"
"3689","20151924061907-803",1,"2015-09-05 20:56:00",1441511760,"C2",538260,1442050020,"2015-09-12 02:27:00"
"1832","20150403120405-547",3,"2015-09-05 21:07:00",1441512420,"C0",68460,1441580880,"2015-09-06 16:08:00"
"4920","20154303104350-928",2,"2015-09-05 21:07:00",1441512420,"C7",105120,1441617540,"2015-09-07 02:19:00"
"5180","20152829022835-670",3,"2015-09-05 21:32:00",1441513920,"C4",315120,1441829040,"2015-09-09 13:04:00"
"4575","20153523043519-62",1,"2015-09-05 22:09:00",1441516140,"C8",163320,1441679460,"2015-09-07 19:31:00"
"5977","20153315033346-643",1,"2015-09-05 22:12:00",1441516320,"C2",262620,1441778940,"2015-09-08 23:09:00"
"3637","20155619125653-865",1,"2015-09-05 22:26:00",1441517160,"C3",501000,1442018160,"2015-09-11 17:36:00"
"4850","20151919051957-409",3,"2015-09-05 22:31:00",1441517460,"C2",185940,1441703400,"2015-09-08 02:10:00"
"4502","20154920114956-385",1,"2015-09-05 23:33:00",1441521180,"C2",512880,1442034060,"2015-09-11 22:01:00"
"2547","20151910111953-81",2,"2015-09-05 23:51:00",1441522260,"C4",327360,1441849620,"2015-09-09 18:47:00"
"203","20153127113132-635",1,"2015-09-06 00:01:00",1441522860,"C8",411300,1441934160,"2015-09-10 18:16:00"
"1493","20155514115538-38",1,"2015-09-06 00:19:00",1441523940,"C7",277920,1441801860,"2015-09-09 05:31:00"
"2333","20150129120100-835",1,"2015-09-06 00:23:00",1441524180,"C8",324660,1441848840,"2015-09-09 18:34:00"
"1363","20151004051005-26",1,"2015-09-06 01:08:00",1441526880,"C8",57540,1441584420,"2015-09-06 17:07:00"
"1410","20150321010307-127",1,"2015-09-06 02:19:00",1441531140,"C5",671880,1442203020,"2015-09-13 20:57:00"
"4637","20155201025239-418",2,"2015-09-06 02:22:00",1441531320,"C2",193500,1441724820,"2015-09-08 08:07:00"
"2346","20150213100239-978",2,"2015-09-06 02:33:00",1441531980,"C5",292380,1441824360,"2015-09-09 11:46:00"
"5663","20154729044749-19",1,"2015-09-06 03:59:00",1441537140,"C5",322560,1441859700,"2015-09-09 21:35:00"
"3553","20152229062233-1",1,"2015-09-06 04:32:00",1441539120,"C8",136920,1441676040,"2015-09-07 18:34:00"
"2366","20150631050638-897",2,"2015-09-06 04:42:00",1441539720,"C8",67680,1441607400,"2015-09-06 23:30:00"
"5772","20151320101309-415",1,"2015-09-06 04:57:00",1441540620,"C5",207120,1441747740,"2015-09-08 14:29:00"
"151","20155621045635-67",1,"2015-09-06 05:00:00",1441540800,"C2",669720,1442210520,"2015-09-13 23:02:00"
"1587","20154428114412-322",1,"2015-09-06 05:00:00",1441540800,"C2",376680,1441917480,"2015-09-10 13:38:00"
"6068","20153228033219-364",2,"2015-09-06 05:27:00",1441542420,"C7",105900,1441648320,"2015-09-07 10:52:00"
"2056","20150226090228-180",3,"2015-09-06 05:40:00",1441543200,"C0",469140,1442012340,"2015-09-11 15:59:00"
"2494","20150731120739-57",1,"2015-09-06 06:39:00",1441546740,"C5",249360,1441796100,"2015-09-09 03:55:00"
"4030","20152527102521-92",2,"2015-09-06 06:46:00",1441547160,"C0",850860,1442398020,"2015-09-16 03:07:00"
"3890","20150227070212-936",2,"2015-09-06 06:53:00",1441547580,"C3",287820,1441835400,"2015-09-09 14:50:00"
"5109","20152622012613-387",2,"2015-09-06 06:54:00",1441547640,"C2",636240,1442183880,"2015-09-13 15:38:00"
"4490","20151128091137-757",1,"2015-09-06 08:09:00",1441552140,"C0",386940,1441939080,"2015-09-10 19:38:00"
"4312","20151322111353-436",3,"2015-09-06 08:37:00",1441553820,"C3",643320,1442197140,"2015-09-13 19:19:00"
"2789","20152821032823-470",3,"2015-09-06 09:10:00",1441555800,"C2",679860,1442235660,"2015-09-14 06:01:00"
"3157","20150001080008-525",3,"2015-09-06 09:16:00",1441556160,"C5",218280,1441774440,"2015-09-08 21:54:00"
"1820","20153705113718-477",2,"2015-09-06 10:13:00",1441559580,"C8",1379880,1442939460,"2015-09-22 09:31:00"
"4853","20153404063406-832",1,"2015-09-06 12:44:00",1441568640,"C7",97500,1441666140,"2015-09-07 15:49:00"
"222","20155303075313-600",1,"2015-09-06 13:05:00",1441569900,"C6",369540,1441939440,"2015-09-10 19:44:00"
"1273","20152431122444-914",2,"2015-09-06 14:27:00",1441574820,"C0",175260,1441750080,"2015-09-08 15:08:00"
"597","20150330090357-596",2,"2015-09-06 15:14:00",1441577640,"C7",89580,1441667220,"2015-09-07 16:07:00"
"175","20155922035939-710",2,"2015-09-06 16:29:00",1441582140,"C5",185400,1441767540,"2015-09-08 19:59:00"
"1477","20150817020855-736",1,"2015-09-06 17:23:00",1441585380,"C8",347940,1441933320,"2015-09-10 18:02:00"
"3970","20151304071316-371",2,"2015-09-06 17:57:00",1441587420,"C6",211440,1441798860,"2015-09-09 04:41:00"
"623","20154124044141-426",3,"2015-09-06 18:52:00",1441590720,"C7",161580,1441752300,"2015-09-08 15:45:00"
"2246","20154612024622-150",1,"2015-09-06 18:58:00",1441591080,"C0",693360,1442284440,"2015-09-14 19:34:00"
"4531","20154526064518-551",2,"2015-09-06 20:14:00",1441595640,"C4",895620,1442491260,"2015-09-17 05:01:00"
"6545","20152703072711-146",1,"2015-09-06 20:19:00",1441595940,"C4",305520,1441901460,"2015-09-10 09:11:00"
"452","20155005035047-766",1,"2015-09-06 20:42:00",1441597320,"C8",51960,1441649280,"2015-09-07 11:08:00"
"1333","20153917113956-553",3,"2015-09-06 20:57:00",1441598220,"C2",880740,1442478960,"2015-09-17 01:36:00"
"3733","20151431121439-712",1,"2015-09-06 21:02:00",1441598520,"C2",183360,1441781880,"2015-09-08 23:58:00"
"1017","20150301050357-768",1,"2015-09-06 21:39:00",1441600740,"C0",64080,1441664820,"2015-09-07 15:27:00"
"6319","20155904105902-891",2,"2015-09-06 22:25:00",1441603500,"C5",106980,1441710480,"2015-09-08 04:08:00"
"833","20155418105443-181",1,"2015-09-06 22:30:00",1441603800,"C4",240480,1441844280,"2015-09-09 17:18:00"
"1592","20154504064547-329",1,"2015-09-06 22:31:00",1441603860,"C0",114780,1441718640,"2015-09-08 06:24:00"
"1808","20150930040930-759",1,"2015-09-06 23:03:00",1441605780,"C5",314820,1441920600,"2015-09-10 14:30:00"
"5234","20154504054501-314",2,"2015-09-06 23:15:00",1441606500,"C2",64200,1441670700,"2015-09-07 17:05:00"
"5406","20151903101941-31",1,"2015-09-06 23:34:00",1441607640,"C3",102300,1441709940,"2015-09-08 03:59:00"
"3817","20153705073720-86",2,"2015-09-07 00:17:00",1441610220,"C5",353100,1441963320,"2015-09-11 02:22:00"
"1091","20152812122818-384",3,"2015-09-07 00:44:00",1441611840,"C0",610320,1442222160,"2015-09-14 02:16:00"
"73","20151026041051-922",1,"2015-09-07 00:46:00",1441611960,"C0",490680,1442102640,"2015-09-12 17:04:00"
"4492","20152131072114-536",3,"2015-09-07 01:03:00",1441612980,"C8",83160,1441696140,"2015-09-08 00:09:00"
"4834","20151629101604-17",2,"2015-09-07 01:10:00",1441613400,"C7",372420,1441985820,"2015-09-11 08:37:00"
"1837","20154014024032-779",3,"2015-09-07 01:20:00",1441614000,"C5",253200,1441867200,"2015-09-09 23:40:00"
"1800","20155731115721-967",1,"2015-09-07 03:07:00",1441620420,"C5",286500,1441906920,"2015-09-10 10:42:00"
"6256","20152129012109-280",1,"2015-09-07 03:23:00",1441621380,"C2",105960,1441727340,"2015-09-08 08:49:00"
"2424","20155531015543-259",2,"2015-09-07 05:03:00",1441627380,"C4",81840,1441709220,"2015-09-08 03:47:00"
"3829","20154104114100-580",2,"2015-09-07 06:01:00",1441630860,"C8",119400,1441750260,"2015-09-08 15:11:00"
"438","20153109043127-486",3,"2015-09-07 06:10:00",1441631400,"C2",352620,1441984020,"2015-09-11 08:07:00"
"3826","20152614032611-671",1,"2015-09-07 06:26:00",1441632360,"C4",680400,1442312760,"2015-09-15 03:26:00"
"277","20153230043217-141",2,"2015-09-07 06:30:00",1441632600,"C5",327540,1441960140,"2015-09-11 01:29:00"
"5403","20150501070559-328",3,"2015-09-07 06:59:00",1441634340,"C6",532740,1442167080,"2015-09-13 10:58:00"
"5051","20153508053556-774",1,"2015-09-07 07:03:00",1441634580,"C3",319260,1441953840,"2015-09-10 23:44:00"
"3603","20152317092314-52",1,"2015-09-07 08:11:00",1441638660,"C6",301680,1441940340,"2015-09-10 19:59:00"
"5409","20153219093219-284",1,"2015-09-07 08:38:00",1441640280,"C7",616680,1442256960,"2015-09-14 11:56:00"
"3992","20151631041644-215",1,"2015-09-07 09:31:00",1441643460,"C4",193500,1441836960,"2015-09-09 15:16:00"
"483","20150805020849-559",1,"2015-09-07 10:20:00",1441646400,"C8",405360,1442051760,"2015-09-12 02:56:00"
"4169","20152031092038-925",1,"2015-09-07 11:32:00",1441650720,"C7",470160,1442120880,"2015-09-12 22:08:00"
"4919","20154704054739-174",1,"2015-09-07 11:50:00",1441651800,"C2",237780,1441889580,"2015-09-10 05:53:00"
"6153","20152201082225-621",1,"2015-09-07 12:37:00",1441654620,"C8",106740,1441761360,"2015-09-08 18:16:00"
"2379","20154828014849-145",1,"2015-09-07 13:48:00",1441658880,"C5",432000,1442090880,"2015-09-12 13:48:00"
"620","20153318063343-519",1,"2015-09-07 14:09:00",1441660140,"C4",219420,1441879560,"2015-09-10 03:06:00"
"4955","20150830030855-79",2,"2015-09-07 14:13:00",1441660380,"C8",1191660,1442852040,"2015-09-21 09:14:00"
"2786","20154821044824-752",1,"2015-09-07 14:18:00",1441660680,"C5",486600,1442147280,"2015-09-13 05:28:00"
"3042","20150302060320-142",3,"2015-09-07 14:28:00",1441661280,"C6",462300,1442123580,"2015-09-12 22:53:00"
"1247","20153327063301-504",3,"2015-09-07 14:30:00",1441661400,"C3",139860,1441801260,"2015-09-09 05:21:00"
"3118","20150605090617-10",1,"2015-09-07 14:44:00",1441662240,"C6",193080,1441855320,"2015-09-09 20:22:00"
"4732","20150720100717-213",1,"2015-09-07 14:54:00",1441662840,"C0",607260,1442270100,"2015-09-14 15:35:00"
"5512","20151306121325-748",2,"2015-09-07 15:01:00",1441663260,"C7",779040,1442442300,"2015-09-16 15:25:00"
"5929","20153325123355-404",1,"2015-09-07 15:15:00",1441664100,"C6",635220,1442299320,"2015-09-14 23:42:00"
"314","20151823061856-404",2,"2015-09-07 16:36:00",1441668960,"C4",444360,1442113320,"2015-09-12 20:02:00"
"4214","20151113031115-28",1,"2015-09-07 16:42:00",1441669320,"C3",691980,1442361300,"2015-09-15 16:55:00"
"4339","20154011014020-687",2,"2015-09-07 16:52:00",1441669920,"C5",627840,1442297760,"2015-09-14 23:16:00"
"1344","20150904110914-670",3,"2015-09-07 16:57:00",1441670220,"C4",93360,1441763580,"2015-09-08 18:53:00"
"5520","20154604024619-103",1,"2015-09-07 17:10:00",1441671000,"C3",368280,1442039280,"2015-09-11 23:28:00"
"2791","20154321074307-245",2,"2015-09-07 17:11:00",1441671060,"C2",187860,1441858920,"2015-09-09 21:22:00"
"3167","20154303094318-187",3,"2015-09-07 17:13:00",1441671180,"C2",124200,1441795380,"2015-09-09 03:43:00"
"5188","20154828094837-453",2,"2015-09-07 17:51:00",1441673460,"C4",297660,1441971120,"2015-09-11 04:32:00"
"3304","20154620024644-66",2,"2015-09-07 18:51:00",1441677060,"C8",313980,1441991040,"2015-09-11 10:04:00"
"457","20150602050643-221",3,"2015-09-07 18:54:00",1441677240,"C4",62640,1441739880,"2015-09-08 12:18:00"
"3069","20152422012450-156",1,"2015-09-07 19:00:00",1441677600,"C0",175320,1441852920,"2015-09-09 19:42:00"
"2299","20153716123710-632",1,"2015-09-07 19:39:00",1441679940,"C3",275160,1441955100,"2015-09-11 00:05:00"
"5361","20154224124203-336",1,"2015-09-07 20:17:00",1441682220,"C8",176700,1441858920,"2015-09-09 21:22:00"
"3596","20150525050544-558",2,"2015-09-07 21:21:00",1441686060,"C5",142320,1441828380,"2015-09-09 12:53:00"
"5913","20153703033757-677",1,"2015-09-07 22:38:00",1441690680,"C4",52980,1441743660,"2015-09-08 13:21:00"
"2002","20153922113902-456",1,"2015-09-08 00:05:00",1441695900,"C7",203880,1441899780,"2015-09-10 08:43:00"
"4801","20153622113627-960",2,"2015-09-08 00:16:00",1441696560,"C8",285600,1441982160,"2015-09-11 07:36:00"
"1867","20154405084402-280",2,"2015-09-08 01:17:00",1441700220,"C2",77460,1441777680,"2015-09-08 22:48:00"
"3385","20153406023410-438",1,"2015-09-08 01:46:00",1441701960,"C0",63360,1441765320,"2015-09-08 19:22:00"
"1522","20150820090832-399",3,"2015-09-08 02:52:00",1441705920,"C5",537180,1442243100,"2015-09-14 08:05:00"
"3892","20152801042854-889",1,"2015-09-08 03:52:00",1441709520,"C4",279720,1441989240,"2015-09-11 09:34:00"
"5319","20153221023253-382",1,"2015-09-08 05:17:00",1441714620,"C4",507300,1442221920,"2015-09-14 02:12:00"
"6550","20153229013212-110",1,"2015-09-08 06:12:00",1441717920,"C5",418800,1442136720,"2015-09-13 02:32:00"
"5185","20154828034832-528",2,"2015-09-08 06:56:00",1441720560,"C2",513840,1442234400,"2015-09-14 05:40:00"
"3364","20150219120223-913",1,"2015-09-08 07:22:00",1441722120,"C4",548700,1442270820,"2015-09-14 15:47:00"
"3551","20154919024910-736",3,"2015-09-08 10:29:00",1441733340,"C8",342480,1442075820,"2015-09-12 09:37:00"
"821","20154904074940-639",1,"2015-09-08 10:40:00",1441734000,"C5",118620,1441852620,"2015-09-09 19:37:00"
"4462","20153805033854-367",3,"2015-09-08 10:49:00",1441734540,"C6",241860,1441976400,"2015-09-11 06:00:00"
"5865","20153621043606-60",3,"2015-09-08 10:54:00",1441734840,"C3",219240,1441954080,"2015-09-10 23:48:00"
"4315","20154102054122-35",1,"2015-09-08 12:20:00",1441740000,"C2",499140,1442239140,"2015-09-14 06:59:00"
"5816","20150510040554-767",1,"2015-09-08 12:21:00",1441740060,"C2",311520,1442051580,"2015-09-12 02:53:00"
"6484","20154804054850-394",1,"2015-09-08 12:58:00",1441742280,"C5",164100,1441906380,"2015-09-10 10:33:00"
"3680","20155830045808-582",1,"2015-09-08 13:28:00",1441744080,"C8",153000,1441897080,"2015-09-10 07:58:00"
"1484","20152127102149-247",2,"2015-09-08 13:57:00",1441745820,"C5",466020,1442211840,"2015-09-13 23:24:00"
"6220","20154119074133-741",2,"2015-09-08 14:05:00",1441746300,"C3",218880,1441965180,"2015-09-11 02:53:00"
"4167","20154104114100-134",2,"2015-09-08 15:17:00",1441750620,"C5",714420,1442465040,"2015-09-16 21:44:00"
"3900","20150328060314-923",1,"2015-09-08 16:15:00",1441754100,"C6",610920,1442365020,"2015-09-15 17:57:00"
"5986","20150701070722-706",1,"2015-09-08 16:37:00",1441755420,"C2",213000,1441968420,"2015-09-11 03:47:00"
"1408","20152606102611-230",2,"2015-09-08 18:02:00",1441760520,"C2",100080,1441860600,"2015-09-09 21:50:00"
"789","20150903020949-595",1,"2015-09-08 18:12:00",1441761120,"C2",148860,1441909980,"2015-09-10 11:33:00"
"2139","20150404010414-57",1,"2015-09-08 19:02:00",1441764120,"C3",183540,1441947660,"2015-09-10 22:01:00"
"3759","20152128042140-763",3,"2015-09-08 19:38:00",1441766280,"C4",137460,1441903740,"2015-09-10 09:49:00"
"2407","20155410055413-237",2,"2015-09-08 20:12:00",1441768320,"C6",418980,1442187300,"2015-09-13 16:35:00"
"3418","20155430065457-569",1,"2015-09-08 20:30:00",1441769400,"C5",103320,1441872720,"2015-09-10 01:12:00"
"859","20151528041551-821",1,"2015-09-08 22:19:00",1441775940,"C7",521520,1442297460,"2015-09-14 23:11:00"
"5932","20155430065423-661",3,"2015-09-08 22:27:00",1441776420,"C2",277860,1442054280,"2015-09-12 03:38:00"
"6366","20154001094026-804",3,"2015-09-08 23:08:00",1441778880,"C2",416460,1442195340,"2015-09-13 18:49:00"
"4856","20150001070006-104",1,"2015-09-08 23:12:00",1441779120,"C5",477360,1442256480,"2015-09-14 11:48:00"
"4963","20152104032137-992",3,"2015-09-08 23:57:00",1441781820,"C2",188280,1441970100,"2015-09-11 04:15:00"
"937","20155806065835-432",1,"2015-09-09 00:08:00",1441782480,"C7",117300,1441899780,"2015-09-10 08:43:00"
"3753","20151506071555-282",1,"2015-09-09 01:23:00",1441786980,"C2",119040,1441906020,"2015-09-10 10:27:00"
"5629","20151526081503-628",1,"2015-09-09 01:30:00",1441787400,"C2",1287900,1443075300,"2015-09-23 23:15:00"
"1736","20150605090619-525",2,"2015-09-09 02:46:00",1441791960,"C7",161400,1441953360,"2015-09-10 23:36:00"
"3720","20152830112817-503",2,"2015-09-09 04:27:00",1441798020,"C4",119820,1441917840,"2015-09-10 13:44:00"
"2409","20154404024444-783",1,"2015-09-09 05:56:00",1441803360,"C5",200160,1442003520,"2015-09-11 13:32:00"
"4611","20154519024544-322",2,"2015-09-09 07:09:00",1441807740,"C4",201780,1442009520,"2015-09-11 15:12:00"
"5098","20152125062113-255",1,"2015-09-09 07:19:00",1441808340,"C7",185640,1441993980,"2015-09-11 10:53:00"
"6282","20154105024125-706",2,"2015-09-09 07:20:00",1441808400,"C4",428220,1442236620,"2015-09-14 06:17:00"
"527","20152524042528-383",1,"2015-09-09 07:37:00",1441809420,"C6",168840,1441978260,"2015-09-11 06:31:00"
"6456","20155028065044-583",2,"2015-09-09 07:46:00",1441809960,"C2",130020,1441939980,"2015-09-10 19:53:00"
"6520","20150724010736-623",1,"2015-09-09 08:03:00",1441810980,"C2",170520,1441981500,"2015-09-11 07:25:00"
"5718","20150412090424-439",1,"2015-09-09 08:21:00",1441812060,"C2",727860,1442539920,"2015-09-17 18:32:00"
"3545","20153129093103-446",1,"2015-09-09 08:51:00",1441813860,"C3",474000,1442287860,"2015-09-14 20:31:00"
"3149","20155424115433-691",1,"2015-09-09 10:16:00",1441818960,"C5",688260,1442507220,"2015-09-17 09:27:00"
"5108","20154510114523-240",1,"2015-09-09 10:25:00",1441819500,"C4",369600,1442189100,"2015-09-13 17:05:00"
"2735","20154812034822-196",3,"2015-09-09 10:40:00",1441820400,"C3",342960,1442163360,"2015-09-13 09:56:00"
"3444","20155628075607-90",1,"2015-09-09 11:08:00",1441822080,"C0",349440,1442171520,"2015-09-13 12:12:00"
"5976","20150508040515-409",1,"2015-09-09 11:40:00",1441824000,"C6",70500,1441894500,"2015-09-10 07:15:00"
"5679","20153430063422-994",1,"2015-09-09 13:05:00",1441829100,"C3",126780,1441955880,"2015-09-11 00:18:00"
"5567","20155917095958-769",2,"2015-09-09 13:23:00",1441830180,"C6",779640,1442609820,"2015-09-18 13:57:00"
"6548","20154522074508-296",3,"2015-09-09 14:00:00",1441832400,"C5",525900,1442358300,"2015-09-15 16:05:00"
"5341","20153209083207-54",1,"2015-09-09 14:56:00",1441835760,"C5",385920,1442221680,"2015-09-14 02:08:00"
"351","20153131083117-488",1,"2015-09-09 15:01:00",1441836060,"C5",267000,1442103060,"2015-09-12 17:11:00"
"3679","20151908111910-929",1,"2015-09-09 15:09:00",1441836540,"C5",1389300,1443225840,"2015-09-25 17:04:00"
"3162","20155024015018-365",3,"2015-09-09 15:15:00",1441836900,"C8",277500,1442114400,"2015-09-12 20:20:00"
"4243","20152605082604-337",1,"2015-09-09 15:47:00",1441838820,"C5",124020,1441962840,"2015-09-11 02:14:00"
"4577","20151729071748-127",1,"2015-09-09 15:47:00",1441838820,"C8",731880,1442570700,"2015-09-18 03:05:00"
"2510","20155205045234-468",2,"2015-09-09 16:14:00",1441840440,"C5",171660,1442012100,"2015-09-11 15:55:00"
"3287","20150001050042-811",1,"2015-09-09 17:20:00",1441844400,"C7",346200,1442190600,"2015-09-13 17:30:00"
"1080","20153801033808-197",2,"2015-09-09 18:52:00",1441849920,"C2",351420,1442201340,"2015-09-13 20:29:00"
"5133","20151728051728-164",2,"2015-09-09 19:14:00",1441851240,"C5",347940,1442199180,"2015-09-13 19:53:00"
"4788","20153208023216-402",2,"2015-09-09 19:51:00",1441853460,"C2",105540,1441959000,"2015-09-11 01:10:00"
"2734","20152108122142-303",2,"2015-09-09 20:17:00",1441855020,"C5",1396680,1443251700,"2015-09-26 00:15:00"
"135","20152610052623-296",1,"2015-09-09 20:45:00",1441856700,"C7",754620,1442611320,"2015-09-18 14:22:00"
"1030","20151217101212-140",1,"2015-09-09 21:00:00",1441857600,"C5",588060,1442445660,"2015-09-16 16:21:00"
"3271","20153824013848-746",1,"2015-09-09 21:24:00",1441859040,"C8",201480,1442060520,"2015-09-12 05:22:00"
"6259","20153605103654-343",1,"2015-09-09 21:44:00",1441860240,"C8",192840,1442053080,"2015-09-12 03:18:00"
"3134","20151304011353-532",1,"2015-09-09 22:01:00",1441861260,"C4",463680,1442324940,"2015-09-15 06:49:00"
"5878","20150730090701-127",3,"2015-09-09 22:03:00",1441861380,"C5",455280,1442316660,"2015-09-15 04:31:00"
"5545","20151307011356-805",2,"2015-09-09 22:31:00",1441863060,"C0",103140,1441966200,"2015-09-11 03:10:00"
"3662","20155929085958-172",2,"2015-09-09 22:59:00",1441864740,"C2",125100,1441989840,"2015-09-11 09:44:00"
"5080","20155107095150-103",2,"2015-09-09 23:57:00",1441868220,"C0",74520,1441942740,"2015-09-10 20:39:00"
"5224","20154501024521-895",1,"2015-09-10 00:00:00",1441868400,"C4",103500,1441971900,"2015-09-11 04:45:00"
"1042","20150704020738-670",3,"2015-09-10 00:03:00",1441868580,"C5",233880,1442102460,"2015-09-12 17:01:00"
"5575","20154601104625-869",1,"2015-09-10 00:34:00",1441870440,"C7",105840,1441976280,"2015-09-11 05:58:00"
"3681","20150619070601-944",3,"2015-09-10 01:06:00",1441872360,"C6",569700,1442442060,"2015-09-16 15:21:00"
"3357","20154615054634-509",2,"2015-09-10 02:10:00",1441876200,"C2",273780,1442149980,"2015-09-13 06:13:00"
"5586","20153828023832-687",3,"2015-09-10 02:42:00",1441878120,"C8",540120,1442418240,"2015-09-16 08:44:00"
"3170","20155807055827-460",2,"2015-09-10 03:00:00",1441879200,"C3",411960,1442291160,"2015-09-14 21:26:00"
"6318","20154730074747-926",1,"2015-09-10 03:44:00",1441881840,"C3",311940,1442193780,"2015-09-13 18:23:00"
"1740","20155310035300-431",1,"2015-09-10 04:41:00",1441885260,"C6",886080,1442771340,"2015-09-20 10:49:00"
"4852","20152322032341-450",1,"2015-09-10 04:43:00",1441885380,"C5",535200,1442420580,"2015-09-16 09:23:00"
"4299","20150906120952-835",1,"2015-09-10 04:55:00",1441886100,"C5",428280,1442314380,"2015-09-15 03:53:00"
"1676","20152527092517-772",1,"2015-09-10 04:59:00",1441886340,"C3",170520,1442056860,"2015-09-12 04:21:00"
"5156","20153614123621-352",3,"2015-09-10 05:13:00",1441887180,"C4",329460,1442216640,"2015-09-14 00:44:00"
"5747","20150420070433-947",1,"2015-09-10 05:31:00",1441888260,"C4",602940,1442491200,"2015-09-17 05:00:00"
"3888","20155922065913-325",2,"2015-09-10 05:39:00",1441888740,"C5",204600,1442093340,"2015-09-12 14:29:00"
"5390","20155230075218-899",3,"2015-09-10 06:08:00",1441890480,"C5",134880,1442025360,"2015-09-11 19:36:00"
"3030","20151627111655-590",1,"2015-09-10 06:35:00",1441892100,"C7",553020,1442445120,"2015-09-16 16:12:00"
"4395","20153629023651-616",2,"2015-09-10 06:57:00",1441893420,"C5",144180,1442037600,"2015-09-11 23:00:00"
"735","20154903014909-323",3,"2015-09-10 07:43:00",1441896180,"C8",291420,1442187600,"2015-09-13 16:40:00"
"3824","20153929033958-663",1,"2015-09-10 07:43:00",1441896180,"C8",504120,1442400300,"2015-09-16 03:45:00"
"2505","20150908120943-943",1,"2015-09-10 07:55:00",1441896900,"C8",78780,1441975680,"2015-09-11 05:48:00"
"6145","20151225041253-640",2,"2015-09-10 08:18:00",1441898280,"C5",676980,1442575260,"2015-09-18 04:21:00"
"4281","20152419032457-473",2,"2015-09-10 09:09:00",1441901340,"C5",626100,1442527440,"2015-09-17 15:04:00"
"4907","20150228110224-816",1,"2015-09-10 09:22:00",1441902120,"C4",159600,1442061720,"2015-09-12 05:42:00"
"5654","20155429065420-360",1,"2015-09-10 09:24:00",1441902240,"C5",348600,1442250840,"2015-09-14 10:14:00"
"4959","20151029121032-170",1,"2015-09-10 10:14:00",1441905240,"C5",514920,1442420160,"2015-09-16 09:16:00"
"3670","20155819015821-968",1,"2015-09-10 11:58:00",1441911480,"C6",315600,1442227080,"2015-09-14 03:38:00"
"5834","20152231032211-936",3,"2015-09-10 12:04:00",1441911840,"C4",426060,1442337900,"2015-09-15 10:25:00"
"858","20151808121857-411",1,"2015-09-10 12:10:00",1441912200,"C5",1015140,1442927340,"2015-09-22 06:09:00"
"3338","20153228113210-234",1,"2015-09-10 12:12:00",1441912320,"C7",160800,1442073120,"2015-09-12 08:52:00"
"3117","20153004123036-930",1,"2015-09-10 12:14:00",1441912440,"C4",517440,1442429880,"2015-09-16 11:58:00"
"1936","20150524040536-313",1,"2015-09-10 12:33:00",1441913580,"C2",590640,1442504220,"2015-09-17 08:37:00"
"730","20154727044758-903",2,"2015-09-10 13:43:00",1441917780,"C2",149820,1442067600,"2015-09-12 07:20:00"
"5038","20153110103147-254",3,"2015-09-10 15:01:00",1441922460,"C6",449100,1442371560,"2015-09-15 19:46:00"
"364","20150127030133-376",1,"2015-09-10 15:06:00",1441922760,"C8",241980,1442164740,"2015-09-13 10:19:00"
"1270","20151217121243-265",1,"2015-09-10 15:12:00",1441923120,"C3",680400,1442603520,"2015-09-18 12:12:00"
"5725","20155230025241-974",3,"2015-09-10 18:58:00",1441936680,"C5",321720,1442258400,"2015-09-14 12:20:00"
"3307","20153430053418-339",3,"2015-09-10 19:34:00",1441938840,"C5",319200,1442258040,"2015-09-14 12:14:00"
"4892","20151204031221-340",1,"2015-09-10 19:42:00",1441939320,"C7",267300,1442206620,"2015-09-13 21:57:00"
"3696","20153816093827-264",1,"2015-09-10 19:53:00",1441939980,"C8",439380,1442379360,"2015-09-15 21:56:00"
"4419","20154825014843-884",2,"2015-09-10 19:56:00",1441940160,"C5",200640,1442140800,"2015-09-13 03:40:00"
"2220","20151201031214-85",1,"2015-09-10 20:24:00",1441941840,"C4",434340,1442376180,"2015-09-15 21:03:00"
"606","20152208052219-435",1,"2015-09-10 20:40:00",1441942800,"C4",92340,1442035140,"2015-09-11 22:19:00"
"1156","20151318021301-158",2,"2015-09-10 21:13:00",1441944780,"C2",670800,1442615580,"2015-09-18 15:33:00"
"2096","20150504020535-36",1,"2015-09-10 22:11:00",1441948260,"C3",273780,1442222040,"2015-09-14 02:14:00"
"992","20150921120902-568",2,"2015-09-10 22:58:00",1441951080,"C7",252420,1442203500,"2015-09-13 21:05:00"
"3912","20152208042243-251",3,"2015-09-10 23:08:00",1441951680,"C5",98580,1442050260,"2015-09-12 02:31:00"
"6290","20153809053851-563",1,"2015-09-10 23:16:00",1441952160,"C5",53340,1442005500,"2015-09-11 14:05:00"
"3959","20154904024927-977",1,"2015-09-10 23:37:00",1441953420,"C3",183360,1442136780,"2015-09-13 02:33:00"
"5662","20151108071113-261",2,"2015-09-11 00:07:00",1441955220,"C5",116880,1442072100,"2015-09-12 08:35:00"
"1349","20152130082153-677",1,"2015-09-11 00:09:00",1441955340,"C6",167880,1442123220,"2015-09-12 22:47:00"
"857","20151724021705-148",1,"2015-09-11 01:24:00",1441959840,"C8",968460,1442928300,"2015-09-22 06:25:00"
"5648","20154003054009-197",1,"2015-09-11 02:28:00",1441963680,"C5",749160,1442712840,"2015-09-19 18:34:00"
"4340","20150507120531-544",2,"2015-09-11 04:17:00",1441970220,"C4",158760,1442128980,"2015-09-13 00:23:00"
"4527","20150028050007-273",2,"2015-09-11 05:00:00",1441972800,"C2",429120,1442401920,"2015-09-16 04:12:00"
"954","20153701043709-900",1,"2015-09-11 05:17:00",1441973820,"C2",437700,1442411520,"2015-09-16 06:52:00"
"3024","20154803014805-523",1,"2015-09-11 05:33:00",1441974780,"C8",667980,1442642760,"2015-09-18 23:06:00"
"5261","20154622044617-838",2,"2015-09-11 07:31:00",1441981860,"C2",242100,1442223960,"2015-09-14 02:46:00"
"2527","20155403055431-688",1,"2015-09-11 08:00:00",1441983600,"C4",218520,1442202120,"2015-09-13 20:42:00"
"1211","20154514024558-986",3,"2015-09-11 08:33:00",1441985580,"C5",1198440,1443184020,"2015-09-25 05:27:00"
"1941","20153807073822-145",3,"2015-09-11 09:06:00",1441987560,"C2",175440,1442163000,"2015-09-13 09:50:00"
"382","20151507031539-411",3,"2015-09-11 09:15:00",1441988100,"C7",333600,1442321700,"2015-09-15 05:55:00"
"127","20150426120423-659",1,"2015-09-11 09:22:00",1441988520,"C5",686340,1442674860,"2015-09-19 08:01:00"
"490","20154715114704-310",1,"2015-09-11 09:25:00",1441988700,"C2",332040,1442320740,"2015-09-15 05:39:00"
"1614","20154529014510-493",2,"2015-09-11 10:06:00",1441991160,"C8",158580,1442149740,"2015-09-13 06:09:00"
"3925","20153515113516-627",3,"2015-09-11 10:20:00",1441992000,"C8",465660,1442457660,"2015-09-16 19:41:00"
"6070","20151531051542-946",1,"2015-09-11 10:25:00",1441992300,"C8",185160,1442177460,"2015-09-13 13:51:00"
"2145","20151510101536-354",2,"2015-09-11 10:58:00",1441994280,"C6",88980,1442083260,"2015-09-12 11:41:00"
"5411","20153711073708-752",1,"2015-09-11 11:40:00",1441996800,"C7",299220,1442296020,"2015-09-14 22:47:00"
"4876","20151326031321-981",2,"2015-09-11 12:50:00",1442001000,"C8",196260,1442197260,"2015-09-13 19:21:00"
"1051","20152505052550-320",3,"2015-09-11 14:01:00",1442005260,"C4",168720,1442173980,"2015-09-13 12:53:00"
"1585","20151915021949-470",1,"2015-09-11 14:17:00",1442006220,"C4",333240,1442339460,"2015-09-15 10:51:00"
"3336","20151502021555-920",2,"2015-09-11 14:45:00",1442007900,"C8",691560,1442699460,"2015-09-19 14:51:00"
"2365","20153103053109-344",3,"2015-09-11 15:08:00",1442009280,"C0",682620,1442691900,"2015-09-19 12:45:00"
"1290","20154404044452-704",2,"2015-09-11 15:13:00",1442009580,"C4",85620,1442095200,"2015-09-12 15:00:00"
"5708","20153308013340-678",2,"2015-09-11 15:54:00",1442012040,"C4",89220,1442101260,"2015-09-12 16:41:00"
"650","20150930080915-526",1,"2015-09-11 16:21:00",1442013660,"C4",355440,1442369100,"2015-09-15 19:05:00"
"4097","20155506045534-554",1,"2015-09-11 16:22:00",1442013720,"C5",1036140,1443049860,"2015-09-23 16:11:00"
"1267","20151030111021-959",1,"2015-09-11 16:40:00",1442014800,"C8",528300,1442543100,"2015-09-17 19:25:00"
"2265","20155822075801-949",1,"2015-09-11 16:47:00",1442015220,"C7",634020,1442649240,"2015-09-19 00:54:00"
"4311","20153411103429-694",1,"2015-09-11 18:22:00",1442020920,"C8",386640,1442407560,"2015-09-16 05:46:00"
"3269","20150608090629-720",2,"2015-09-11 19:54:00",1442026440,"C8",807840,1442834280,"2015-09-21 04:18:00"
"3066","20152123032134-92",2,"2015-09-11 20:11:00",1442027460,"C8",237000,1442264460,"2015-09-14 14:01:00"
"2897","20154508084534-828",1,"2015-09-11 20:36:00",1442028960,"C5",100620,1442129580,"2015-09-13 00:33:00"
"1215","20155006025053-216",2,"2015-09-11 20:58:00",1442030280,"C4",227040,1442257320,"2015-09-14 12:02:00"
"324","20150208060247-95",1,"2015-09-11 21:38:00",1442032680,"C5",105120,1442137800,"2015-09-13 02:50:00"
"1137","20151101081129-848",1,"2015-09-11 22:03:00",1442034180,"C0",783840,1442818020,"2015-09-20 23:47:00"
"5295","20153209113252-119",1,"2015-09-11 22:52:00",1442037120,"C4",361500,1442398620,"2015-09-16 03:17:00"
"4232","20152816112859-104",1,"2015-09-11 23:36:00",1442039760,"C3",945060,1442984820,"2015-09-22 22:07:00"
"6538","20152101122110-544",1,"2015-09-12 00:37:00",1442043420,"C4",113520,1442156940,"2015-09-13 08:09:00"
"2616","20154207064238-836",1,"2015-09-12 01:12:00",1442045520,"C5",137400,1442182920,"2015-09-13 15:22:00"
"3602","20152420122408-685",3,"2015-09-12 01:30:00",1442046600,"C5",278280,1442324880,"2015-09-15 06:48:00"
"2230","20152405042448-474",2,"2015-09-12 01:34:00",1442046840,"C2",55140,1442101980,"2015-09-12 16:53:00"
"144","20154305054350-339",1,"2015-09-12 02:15:00",1442049300,"C5",274560,1442323860,"2015-09-15 06:31:00"
"5675","20155305015326-67",1,"2015-09-12 02:23:00",1442049780,"C7",281700,1442331480,"2015-09-15 08:38:00"
"1378","20152531102541-22",1,"2015-09-12 02:31:00",1442050260,"C4",504180,1442554440,"2015-09-17 22:34:00"
"5653","20154926104933-124",1,"2015-09-12 02:39:00",1442050740,"C8",287880,1442338620,"2015-09-15 10:37:00"
"1510","20150710110737-521",1,"2015-09-12 04:53:00",1442058780,"C2",75180,1442133960,"2015-09-13 01:46:00"
"6534","20152928122912-286",2,"2015-09-12 05:01:00",1442059260,"C5",158640,1442217900,"2015-09-14 01:05:00"
"3618","20151017101005-541",1,"2015-09-12 05:06:00",1442059560,"C5",278520,1442338080,"2015-09-15 10:28:00"
"3947","20151710031722-962",1,"2015-09-12 05:21:00",1442060460,"C5",68520,1442128980,"2015-09-13 00:23:00"
"5103","20155605105623-939",1,"2015-09-12 05:23:00",1442060580,"C5",194940,1442255520,"2015-09-14 11:32:00"
"5547","20154830054857-116",3,"2015-09-12 06:57:00",1442066220,"C4",361380,1442427600,"2015-09-16 11:20:00"
"6022","20155107025120-910",2,"2015-09-12 07:01:00",1442066460,"C0",403800,1442470260,"2015-09-16 23:11:00"
"2038","20151901101926-562",1,"2015-09-12 07:14:00",1442067240,"C8",187860,1442255100,"2015-09-14 11:25:00"
"1426","20150428030425-959",2,"2015-09-12 07:20:00",1442067600,"C5",158520,1442226120,"2015-09-14 03:22:00"
"6450","20153011043031-930",1,"2015-09-12 08:23:00",1442071380,"C0",57180,1442128560,"2015-09-13 00:16:00"
"5498","20154311024355-911",1,"2015-09-12 09:01:00",1442073660,"C0",65880,1442139540,"2015-09-13 03:19:00"
"1772","20154308124319-670",1,"2015-09-12 10:17:00",1442078220,"C5",168420,1442246640,"2015-09-14 09:04:00"
"852","20150430020414-999",2,"2015-09-12 11:55:00",1442084100,"C4",371820,1442455920,"2015-09-16 19:12:00"
"4301","20151729091748-733",1,"2015-09-12 12:05:00",1442084700,"C6",649680,1442734380,"2015-09-20 00:33:00"
"4364","20150821110852-676",1,"2015-09-12 12:27:00",1442086020,"C0",272220,1442358240,"2015-09-15 16:04:00"
"2231","20153910033927-41",1,"2015-09-12 12:42:00",1442086920,"C5",946860,1443033780,"2015-09-23 11:43:00"
"2699","20155807055837-636",2,"2015-09-12 13:50:00",1442091000,"C2",52140,1442143140,"2015-09-13 04:19:00"
"5417","20151725071716-115",1,"2015-09-12 13:57:00",1442091420,"C6",197400,1442288820,"2015-09-14 20:47:00"
"6134","20150209060217-820",2,"2015-09-12 14:32:00",1442093520,"C5",144900,1442238420,"2015-09-14 06:47:00"
"4172","20151930121913-276",2,"2015-09-12 14:37:00",1442093820,"C2",1131480,1443225300,"2015-09-25 16:55:00"
"2471","20153211073233-705",1,"2015-09-12 14:42:00",1442094120,"C4",112200,1442206320,"2015-09-13 21:52:00"
"284","20150328090330-172",1,"2015-09-12 14:55:00",1442094900,"C3",164640,1442259540,"2015-09-14 12:39:00"
"2753","20154011054033-757",2,"2015-09-12 16:51:00",1442101860,"C6",83460,1442185320,"2015-09-13 16:02:00"
"398","20154511024505-828",1,"2015-09-12 18:29:00",1442107740,"C6",99840,1442207580,"2015-09-13 22:13:00"
"4563","20154208074227-295",2,"2015-09-12 18:56:00",1442109360,"C8",193020,1442302380,"2015-09-15 00:33:00"
"5376","20151907121926-813",2,"2015-09-12 19:37:00",1442111820,"C3",152760,1442264580,"2015-09-14 14:03:00"
"615","20153224093211-44",1,"2015-09-12 19:56:00",1442112960,"C2",1679040,1443792000,"2015-10-02 06:20:00"
"5366","20150306050305-235",2,"2015-09-12 20:33:00",1442115180,"C2",177000,1442292180,"2015-09-14 21:43:00"
"5218","20155206105202-711",1,"2015-09-12 20:49:00",1442116140,"C0",184740,1442300880,"2015-09-15 00:08:00"
"3452","20151405051442-519",3,"2015-09-12 21:12:00",1442117520,"C7",88440,1442205960,"2015-09-13 21:46:00"
"3965","20150707050739-597",2,"2015-09-12 22:34:00",1442122440,"C3",150540,1442272980,"2015-09-14 16:23:00"
"3505","20151824121846-361",2,"2015-09-12 22:58:00",1442123880,"C2",240000,1442363880,"2015-09-15 17:38:00"
"2329","20153823083813-827",1,"2015-09-12 23:18:00",1442125080,"C3",254400,1442379480,"2015-09-15 21:58:00"
"4026","20153124123117-215",2,"2015-09-12 23:39:00",1442126340,"C0",240240,1442366580,"2015-09-15 18:23:00"
"3185","20151926041922-655",1,"2015-09-13 00:11:00",1442128260,"C5",845940,1442974200,"2015-09-22 19:10:00"
"5646","20151910031909-576",1,"2015-09-13 01:22:00",1442132520,"C5",69660,1442202180,"2015-09-13 20:43:00"
"6011","20150904100901-193",1,"2015-09-13 01:29:00",1442132940,"C7",373200,1442506140,"2015-09-17 09:09:00"
"4631","20150408020442-543",1,"2015-09-13 01:32:00",1442133120,"C3",193440,1442326560,"2015-09-15 07:16:00"
"4969","20150514100544-988",2,"2015-09-13 01:38:00",1442133480,"C2",365940,1442499420,"2015-09-17 07:17:00"
"4028","20152924102954-975",1,"2015-09-13 01:47:00",1442134020,"C7",1071720,1443205740,"2015-09-25 11:29:00"
"3325","20151406051448-965",1,"2015-09-13 01:52:00",1442134320,"C7",274740,1442409060,"2015-09-16 06:11:00"
"3608","20153211053257-976",2,"2015-09-13 02:04:00",1442135040,"C4",58560,1442193600,"2015-09-13 18:20:00"
"518","20153607093625-365",1,"2015-09-13 02:26:00",1442136360,"C5",246300,1442382660,"2015-09-15 22:51:00"
"3231","20152908042900-407",1,"2015-09-13 02:51:00",1442137860,"C8",191460,1442329320,"2015-09-15 08:02:00"
"706","20153423063429-324",3,"2015-09-13 03:39:00",1442140740,"C2",257700,1442398440,"2015-09-16 03:14:00"
"5278","20152030082047-827",2,"2015-09-13 03:47:00",1442141220,"C4",170460,1442311680,"2015-09-15 03:08:00"
"5232","20154221124220-61",1,"2015-09-13 05:46:00",1442148360,"C3",245280,1442393640,"2015-09-16 01:54:00"
"653","20155407095443-656",2,"2015-09-13 07:52:00",1442155920,"C3",255540,1442411460,"2015-09-16 06:51:00"
"1423","20152310032333-876",2,"2015-09-13 08:08:00",1442156880,"C2",77700,1442234580,"2015-09-14 05:43:00"
"3797","20153809063840-685",3,"2015-09-13 08:14:00",1442157240,"C7",175680,1442332920,"2015-09-15 09:02:00"
"604","20152806082844-502",1,"2015-09-13 08:18:00",1442157480,"C8",120840,1442278320,"2015-09-14 17:52:00"
"3695","20154030024055-701",3,"2015-09-13 09:44:00",1442162640,"C6",148980,1442311620,"2015-09-15 03:07:00"
"3487","20155323025342-437",3,"2015-09-13 10:37:00",1442165820,"C5",224880,1442390700,"2015-09-16 01:05:00"
"4241","20152028072051-354",2,"2015-09-13 10:56:00",1442166960,"C8",697680,1442864640,"2015-09-21 12:44:00"
"5203","20152904062902-66",1,"2015-09-13 11:03:00",1442167380,"C8",397020,1442564400,"2015-09-18 01:20:00"
"5812","20155204055205-222",3,"2015-09-13 11:52:00",1442170320,"C6",429300,1442599620,"2015-09-18 11:07:00"
"6143","20153129063108-867",2,"2015-09-13 13:48:00",1442177280,"C2",1322220,1443499500,"2015-09-28 21:05:00"
"4923","20155931025933-274",1,"2015-09-13 14:08:00",1442178480,"C7",160020,1442338500,"2015-09-15 10:35:00"
"1842","20155703035752-285",1,"2015-09-13 14:21:00",1442179260,"C7",429120,1442608380,"2015-09-18 13:33:00"
"3046","20153406083425-63",3,"2015-09-13 15:06:00",1442181960,"C2",78540,1442260500,"2015-09-14 12:55:00"
"40","20155720055708-822",1,"2015-09-13 15:27:00",1442183220,"C8",412920,1442596140,"2015-09-18 10:09:00"
"1052","20153604073635-88",2,"2015-09-13 19:36:00",1442198160,"C4",102600,1442300760,"2015-09-15 00:06:00"
"2223","20155107125121-144",2,"2015-09-13 20:04:00",1442199840,"C3",544380,1442744220,"2015-09-20 03:17:00"
"1149","20155122055108-85",1,"2015-09-13 20:23:00",1442200980,"C2",238740,1442439720,"2015-09-16 14:42:00"
"6497","20152330122319-139",3,"2015-09-13 20:53:00",1442202780,"C6",206700,1442409480,"2015-09-16 06:18:00"
"401","20153001123033-350",1,"2015-09-13 21:10:00",1442203800,"C4",803100,1443006900,"2015-09-23 04:15:00"
"622","20155228105231-492",1,"2015-09-13 21:47:00",1442206020,"C2",203100,1442409120,"2015-09-16 06:12:00"
"4103","20151928121941-484",3,"2015-09-13 21:55:00",1442206500,"C5",708480,1442914980,"2015-09-22 02:43:00"
"5950","20150901040932-288",1,"2015-09-13 23:04:00",1442210640,"C8",534300,1442744940,"2015-09-20 03:29:00"
"5703","20153329043300-437",2,"2015-09-13 23:06:00",1442210760,"C4",439860,1442650620,"2015-09-19 01:17:00"
"2826","20155211075227-27",1,"2015-09-13 23:36:00",1442212560,"C0",114720,1442327280,"2015-09-15 07:28:00"
"2275","20150808010856-926",1,"2015-09-13 23:47:00",1442213220,"C3",156780,1442370000,"2015-09-15 19:20:00"
"1666","20155118075124-295",1,"2015-09-14 04:41:00",1442230860,"C8",464280,1442695140,"2015-09-19 13:39:00"
"1220","20152411022428-441",1,"2015-09-14 04:42:00",1442230920,"C4",112140,1442343060,"2015-09-15 11:51:00"
"4692","20154409084413-801",3,"2015-09-14 05:02:00",1442232120,"C8",209340,1442441460,"2015-09-16 15:11:00"
"3424","20151127101117-321",2,"2015-09-14 05:14:00",1442232840,"C4",512460,1442745300,"2015-09-20 03:35:00"
"2767","20155018105000-729",2,"2015-09-14 05:38:00",1442234280,"C4",289260,1442523540,"2015-09-17 13:59:00"
"6033","20151106071138-520",2,"2015-09-14 05:47:00",1442234820,"C0",343080,1442577900,"2015-09-18 05:05:00"
"2884","20151224041242-581",2,"2015-09-14 06:28:00",1442237280,"C2",222420,1442459700,"2015-09-16 20:15:00"
"3081","20154010044016-420",1,"2015-09-14 06:48:00",1442238480,"C8",155040,1442393520,"2015-09-16 01:52:00"
"2650","20153517023507-15",1,"2015-09-14 07:19:00",1442240340,"C2",1196520,1443436860,"2015-09-28 03:41:00"
"2355","20154704084736-736",3,"2015-09-14 07:26:00",1442240760,"C7",95460,1442336220,"2015-09-15 09:57:00"
"1195","20154120094127-321",3,"2015-09-14 10:13:00",1442250780,"C5",605040,1442855820,"2015-09-21 10:17:00"
"980","20154315114328-382",1,"2015-09-14 10:16:00",1442250960,"C2",369540,1442620500,"2015-09-18 16:55:00"
"2287","20151004081041-724",1,"2015-09-14 11:04:00",1442253840,"C5",437220,1442691060,"2015-09-19 12:31:00"
"6365","20152812042819-422",2,"2015-09-14 11:20:00",1442254800,"C5",77160,1442331960,"2015-09-15 08:46:00"
"4905","20150920070902-234",1,"2015-09-14 11:21:00",1442254860,"C6",808920,1443063780,"2015-09-23 20:03:00"
"4480","20150913060942-503",1,"2015-09-14 11:27:00",1442255220,"C6",105480,1442360700,"2015-09-15 16:45:00"
"1909","20154730114701-335",3,"2015-09-14 11:54:00",1442256840,"C6",1296420,1443553260,"2015-09-29 12:01:00"
"3555","20151809121805-29",1,"2015-09-14 11:59:00",1442257140,"C8",444180,1442701320,"2015-09-19 15:22:00"
"6524","20151311031311-115",1,"2015-09-14 12:01:00",1442257260,"C5",82560,1442339820,"2015-09-15 10:57:00"
"3239","20150408090432-622",1,"2015-09-14 12:58:00",1442260680,"C5",177480,1442438160,"2015-09-16 14:16:00"
"3000","20150929030929-812",1,"2015-09-14 13:07:00",1442261220,"C2",196440,1442457660,"2015-09-16 19:41:00"
"29","20152608012606-941",1,"2015-09-14 13:23:00",1442262180,"C5",172740,1442434920,"2015-09-16 13:22:00"
"168","20151109051100-693",3,"2015-09-14 13:29:00",1442262540,"C4",139560,1442402100,"2015-09-16 04:15:00"
"2152","20152211122236-998",2,"2015-09-14 14:37:00",1442266620,"C4",89100,1442355720,"2015-09-15 15:22:00"
"2288","20152914112948-207",1,"2015-09-14 15:05:00",1442268300,"C0",671220,1442939520,"2015-09-22 09:32:00"
"1961","20153430123444-403",1,"2015-09-14 15:54:00",1442271240,"C2",163500,1442434740,"2015-09-16 13:19:00"
"6003","20154909044956-518",3,"2015-09-14 17:21:00",1442276460,"C4",433920,1442710380,"2015-09-19 17:53:00"
"2832","20154701054735-930",2,"2015-09-14 19:02:00",1442282520,"C8",225540,1442508060,"2015-09-17 09:41:00"
"3506","20155609015650-953",2,"2015-09-14 19:02:00",1442282520,"C0",150120,1442432640,"2015-09-16 12:44:00"
"2350","20154823104821-280",3,"2015-09-14 20:24:00",1442287440,"C2",241920,1442529360,"2015-09-17 15:36:00"
"5930","20152007032057-494",3,"2015-09-14 20:32:00",1442287920,"C5",77940,1442365860,"2015-09-15 18:11:00"
"3360","20150105120114-572",3,"2015-09-14 20:50:00",1442289000,"C8",115620,1442404620,"2015-09-16 04:57:00"
"3928","20151611081603-412",2,"2015-09-15 01:13:00",1442304780,"C5",106740,1442411520,"2015-09-16 06:52:00"
"1501","20154102114141-894",3,"2015-09-15 01:44:00",1442306640,"C8",155340,1442461980,"2015-09-16 20:53:00"
"5744","20152513092548-480",1,"2015-09-15 01:49:00",1442306940,"C4",352980,1442659920,"2015-09-19 03:52:00"
"2943","20155507025528-30",2,"2015-09-15 02:35:00",1442309700,"C8",323400,1442633100,"2015-09-18 20:25:00"
"4467","20155208045228-597",3,"2015-09-15 02:54:00",1442310840,"C7",277260,1442588100,"2015-09-18 07:55:00"
"4391","20153612103624-436",2,"2015-09-15 03:30:00",1442313000,"C4",116820,1442429820,"2015-09-16 11:57:00"
"105","20154504024526-617",3,"2015-09-15 03:39:00",1442313540,"C8",455220,1442768760,"2015-09-20 10:06:00"
"6501","20154505034517-211",1,"2015-09-15 03:39:00",1442313540,"C8",410220,1442723760,"2015-09-19 21:36:00"
"6252","20153605023617-415",1,"2015-09-15 04:04:00",1442315040,"C5",103260,1442418300,"2015-09-16 08:45:00"
"5398","20152520022515-874",2,"2015-09-15 04:05:00",1442315100,"C5",315600,1442630700,"2015-09-18 19:45:00"
"3496","20150124040121-291",1,"2015-09-15 04:33:00",1442316780,"C5",232440,1442549220,"2015-09-17 21:07:00"
"6223","20153813093821-524",2,"2015-09-15 04:48:00",1442317680,"C3",77700,1442395380,"2015-09-16 02:23:00"
"6460","20152405092403-279",1,"2015-09-15 04:48:00",1442317680,"C0",282480,1442600160,"2015-09-18 11:16:00"
"5660","20155812115802-110",2,"2015-09-15 05:02:00",1442318520,"C5",117120,1442435640,"2015-09-16 13:34:00"
"3701","20152212012249-243",1,"2015-09-15 05:52:00",1442321520,"C3",116100,1442437620,"2015-09-16 14:07:00"
"138","20152131052130-113",1,"2015-09-15 05:56:00",1442321760,"C5",561900,1442883660,"2015-09-21 18:01:00"
"414","20150321080317-281",1,"2015-09-15 06:43:00",1442324580,"C4",269400,1442593980,"2015-09-18 09:33:00"
"6024","20152613102657-412",2,"2015-09-15 06:52:00",1442325120,"C8",79980,1442405100,"2015-09-16 05:05:00"
"3581","20155712125720-473",1,"2015-09-15 07:21:00",1442326860,"C0",699480,1443026340,"2015-09-23 09:39:00"
"2462","20155011115006-613",1,"2015-09-15 07:28:00",1442327280,"C2",329880,1442657160,"2015-09-19 03:06:00"
"5473","20155326035314-70",1,"2015-09-15 07:55:00",1442328900,"C3",242760,1442571660,"2015-09-18 03:21:00"
"101","20150613120634-302",1,"2015-09-15 08:26:00",1442330760,"C7",79800,1442410560,"2015-09-16 06:36:00"
"1162","20153113123129-802",1,"2015-09-15 09:43:00",1442335380,"C5",81360,1442416740,"2015-09-16 08:19:00"
"5265","20155424095403-620",1,"2015-09-15 10:34:00",1442338440,"C3",896700,1443235140,"2015-09-25 19:39:00"
"3437","20150607030612-158",1,"2015-09-15 11:03:00",1442340180,"C2",225540,1442565720,"2015-09-18 01:42:00"
"3935","20152712102746-890",1,"2015-09-15 11:19:00",1442341140,"C6",262320,1442603460,"2015-09-18 12:11:00"
"4819","20150612040643-903",1,"2015-09-15 11:51:00",1442343060,"C0",243900,1442586960,"2015-09-18 07:36:00"
"3946","20153412033456-768",1,"2015-09-15 13:01:00",1442347260,"C3",83340,1442430600,"2015-09-16 12:10:00"
"5951","20151411121401-100",1,"2015-09-15 14:00:00",1442350800,"C5",175980,1442526780,"2015-09-17 14:53:00"
"5252","20154310044355-435",1,"2015-09-15 14:53:00",1442353980,"C8",443400,1442797380,"2015-09-20 18:03:00"
"5047","20150105070153-470",1,"2015-09-15 15:48:00",1442357280,"C2",895620,1443252900,"2015-09-26 00:35:00"
"3319","20154808094807-64",2,"2015-09-15 16:11:00",1442358660,"C4",627780,1442986440,"2015-09-22 22:34:00"
"4330","20151931021927-541",3,"2015-09-15 16:54:00",1442361240,"C8",261060,1442622300,"2015-09-18 17:25:00"
"2848","20154912104945-323",3,"2015-09-15 16:55:00",1442361300,"C6",281160,1442642460,"2015-09-18 23:01:00"
"4424","20151324041323-86",1,"2015-09-15 16:57:00",1442361420,"C0",271920,1442633340,"2015-09-18 20:29:00"
"3017","20155307075336-227",2,"2015-09-15 17:29:00",1442363340,"C2",103680,1442467020,"2015-09-16 22:17:00"
"214","20150413020432-24",3,"2015-09-15 18:28:00",1442366880,"C7",94320,1442461200,"2015-09-16 20:40:00"
"6391","20155911015958-174",2,"2015-09-15 18:49:00",1442368140,"C5",181500,1442549640,"2015-09-17 21:14:00"
"4351","20154212104231-5",3,"2015-09-15 19:14:00",1442369640,"C3",705840,1443075480,"2015-09-23 23:18:00"
"6293","20152505102537-378",3,"2015-09-15 19:33:00",1442370780,"C0",448440,1442819220,"2015-09-21 00:07:00"
"3572","20154228044234-553",2,"2015-09-15 19:36:00",1442370960,"C5",782820,1443153780,"2015-09-24 21:03:00"
"4042","20155023105006-119",2,"2015-09-15 20:08:00",1442372880,"C2",673560,1443046440,"2015-09-23 15:14:00"
"4440","20154214064217-704",1,"2015-09-15 20:18:00",1442373480,"C7",1406880,1443780360,"2015-10-02 03:06:00"
"4576","20153311123312-935",2,"2015-09-15 20:23:00",1442373780,"C4",373800,1442747580,"2015-09-20 04:13:00"
"3584","20151622101630-477",1,"2015-09-15 20:31:00",1442374260,"C4",703500,1443077760,"2015-09-23 23:56:00"
"4690","20154612124610-968",2,"2015-09-15 21:44:00",1442378640,"C3",291480,1442670120,"2015-09-19 06:42:00"
"4669","20150313090335-839",2,"2015-09-15 21:47:00",1442378820,"C8",109320,1442488140,"2015-09-17 04:09:00"
"1986","20151812081835-734",2,"2015-09-15 22:05:00",1442379900,"C2",308820,1442688720,"2015-09-19 11:52:00"
"907","20153931113929-38",1,"2015-09-15 22:51:00",1442382660,"C0",445440,1442828100,"2015-09-21 02:35:00"
"3879","20151912061915-319",1,"2015-09-15 23:46:00",1442385960,"C5",107340,1442493300,"2015-09-17 05:35:00"
"5214","20155812045842-786",1,"2015-09-16 00:20:00",1442388000,"C8",142860,1442530860,"2015-09-17 16:01:00"
"1481","20152730052714-154",2,"2015-09-16 00:47:00",1442389620,"C4",176100,1442565720,"2015-09-18 01:42:00"
"3780","20153002053041-801",1,"2015-09-16 01:22:00",1442391720,"C3",143940,1442535660,"2015-09-17 17:21:00"
"3619","20152414102459-200",1,"2015-09-16 01:40:00",1442392800,"C5",70680,1442463480,"2015-09-16 21:18:00"
"2306","20150312030323-538",1,"2015-09-16 02:09:00",1442394540,"C4",149580,1442544120,"2015-09-17 19:42:00"
"4781","20152211072240-895",1,"2015-09-16 02:52:00",1442397120,"C5",207900,1442605020,"2015-09-18 12:37:00"
"5782","20152416102430-660",2,"2015-09-16 03:02:00",1442397720,"C8",378840,1442776560,"2015-09-20 12:16:00"
"4711","20154826044849-501",1,"2015-09-16 03:26:00",1442399160,"C8",883140,1443282300,"2015-09-26 08:45:00"
"2720","20152114022149-636",1,"2015-09-16 03:33:00",1442399580,"C2",66960,1442466540,"2015-09-16 22:09:00"
"441","20150113020105-915",1,"2015-09-16 05:13:00",1442405580,"C4",75840,1442481420,"2015-09-17 02:17:00"
"4612","20154519024544-322",2,"2015-09-16 05:28:00",1442406480,"C4",200940,1442607420,"2015-09-18 13:17:00"
"2646","20150916010937-480",1,"2015-09-16 05:39:00",1442407140,"C4",176760,1442583900,"2015-09-18 06:45:00"
"393","20153829123844-783",3,"2015-09-16 06:20:00",1442409600,"C8",601560,1443011160,"2015-09-23 05:26:00"
"5120","20155302025312-112",1,"2015-09-16 07:25:00",1442413500,"C3",168960,1442582460,"2015-09-18 06:21:00"
"1007","20150506060512-399",1,"2015-09-16 07:53:00",1442415180,"C8",435240,1442850420,"2015-09-21 08:47:00"
"4881","20153927083928-87",1,"2015-09-16 08:07:00",1442416020,"C4",550560,1442966580,"2015-09-22 17:03:00"
"6299","20152608042656-439",1,"2015-09-16 08:18:00",1442416680,"C2",94560,1442511240,"2015-09-17 10:34:00"
"4417","20152304062326-36",1,"2015-09-16 08:55:00",1442418900,"C3",465540,1442884440,"2015-09-21 18:14:00"
"809","20154027024014-523",1,"2015-09-16 09:51:00",1442422260,"C4",244380,1442666640,"2015-09-19 05:44:00"
"3248","20153331043359-711",1,"2015-09-16 10:25:00",1442424300,"C2",170040,1442594340,"2015-09-18 09:39:00"
"388","20151931031941-864",1,"2015-09-16 11:57:00",1442429820,"C8",685140,1443114960,"2015-09-24 10:16:00"
"4991","20151810051808-730",1,"2015-09-16 12:14:00",1442430840,"C5",62520,1442493360,"2015-09-17 05:36:00"
"6268","20153008093014-166",2,"2015-09-16 13:24:00",1442435040,"C5",352620,1442787660,"2015-09-20 15:21:00"
"883","20153423043438-15",3,"2015-09-16 14:26:00",1442438760,"C2",258240,1442697000,"2015-09-19 14:10:00"
"4505","20150812050828-793",3,"2015-09-16 17:16:00",1442448960,"C7",49440,1442498400,"2015-09-17 07:00:00"
"6008","20153016063017-510",3,"2015-09-16 18:30:00",1442453400,"C5",388800,1442842200,"2015-09-21 06:30:00"
"4762","20153804013829-884",2,"2015-09-16 18:42:00",1442454120,"C0",150720,1442604840,"2015-09-18 12:34:00"
"218","20152523062510-74",2,"2015-09-16 18:49:00",1442454540,"C5",264780,1442719320,"2015-09-19 20:22:00"
"1116","20152321032356-54",2,"2015-09-16 18:59:00",1442455140,"C3",1129680,1443584820,"2015-09-29 20:47:00"
"1064","20154412104452-262",1,"2015-09-16 19:19:00",1442456340,"C8",75300,1442531640,"2015-09-17 16:14:00"
"3910","20151913061938-878",1,"2015-09-16 19:28:00",1442456880,"C0",102180,1442559060,"2015-09-17 23:51:00"
"1829","20150723060758-760",1,"2015-09-16 20:42:00",1442461320,"C8",960900,1443422220,"2015-09-27 23:37:00"
"317","20152206042213-803",1,"2015-09-16 20:56:00",1442462160,"C8",440220,1442902380,"2015-09-21 23:13:00"
"1731","20151124081137-232",2,"2015-09-16 22:11:00",1442466660,"C2",254700,1442721360,"2015-09-19 20:56:00"
"5935","20154425114422-810",2,"2015-09-16 22:16:00",1442466960,"C3",242340,1442709300,"2015-09-19 17:35:00"
"3728","20154809034821-765",1,"2015-09-16 22:44:00",1442468640,"C5",314880,1442783520,"2015-09-20 14:12:00"
"5885","20155823085830-345",1,"2015-09-16 23:18:00",1442470680,"C0",303600,1442774280,"2015-09-20 11:38:00"
"3356","20154509104501-59",2,"2015-09-16 23:57:00",1442473020,"C0",416340,1442889360,"2015-09-21 19:36:00"
"4733","20155722095743-296",1,"2015-09-17 03:32:00",1442485920,"C8",444660,1442930580,"2015-09-22 07:03:00"
"509","20155304065306-536",1,"2015-09-17 03:41:00",1442486460,"C5",473760,1442960220,"2015-09-22 15:17:00"
"6316","20152113092153-515",2,"2015-09-17 03:51:00",1442487060,"C3",162900,1442649960,"2015-09-19 01:06:00"
"5518","20153425093430-367",2,"2015-09-17 06:01:00",1442494860,"C0",282060,1442776920,"2015-09-20 12:22:00"
"545","20150809030847-891",1,"2015-09-17 06:18:00",1442495880,"C2",94200,1442590080,"2015-09-18 08:28:00"
"5287","20151727081727-53",2,"2015-09-17 07:35:00",1442500500,"C7",258840,1442759340,"2015-09-20 07:29:00"
"2970","20151027121055-218",2,"2015-09-17 07:44:00",1442501040,"C3",256920,1442757960,"2015-09-20 07:06:00"
"2051","20151114071159-705",3,"2015-09-17 07:55:00",1442501700,"C5",130920,1442632620,"2015-09-18 20:17:00"
"3746","20150912100912-409",3,"2015-09-17 08:47:00",1442504820,"C8",213540,1442718360,"2015-09-19 20:06:00"
"2869","20153812113834-265",3,"2015-09-17 09:24:00",1442507040,"C5",211980,1442719020,"2015-09-19 20:17:00"
"494","20151818101826-629",3,"2015-09-17 09:27:00",1442507220,"C5",862980,1443370200,"2015-09-27 09:10:00"
"2064","20153221123200-816",1,"2015-09-17 10:17:00",1442510220,"C4",332100,1442842320,"2015-09-21 06:32:00"
"342","20154015034053-424",3,"2015-09-17 12:30:00",1442518200,"C8",80700,1442598900,"2015-09-18 10:55:00"
"1989","20153023063031-787",1,"2015-09-17 12:38:00",1442518680,"C4",607560,1443126240,"2015-09-24 13:24:00"
"4900","20155614125629-357",2,"2015-09-17 12:55:00",1442519700,"C2",259140,1442778840,"2015-09-20 12:54:00"
"274","20153615013648-281",3,"2015-09-17 14:44:00",1442526240,"C2",88440,1442614680,"2015-09-18 15:18:00"
"3232","20152128092124-904",3,"2015-09-17 15:21:00",1442528460,"C1",291600,1442820060,"2015-09-21 00:21:00"
"2550","20152512042530-460",1,"2015-09-17 15:53:00",1442530380,"C7",61440,1442591820,"2015-09-18 08:57:00"
"5528","20152815072807-909",1,"2015-09-17 16:24:00",1442532240,"C7",102480,1442634720,"2015-09-18 20:52:00"
"1124","20154201074239-177",1,"2015-09-17 16:42:00",1442533320,"C7",707400,1443240720,"2015-09-25 21:12:00"
"2019","20152308032332-748",2,"2015-09-17 17:53:00",1442537580,"C5",262200,1442799780,"2015-09-20 18:43:00"
"1188","20152913112927-997",3,"2015-09-17 19:11:00",1442542260,"C8",186660,1442728920,"2015-09-19 23:02:00"
"3620","20151705081753-773",3,"2015-09-17 19:23:00",1442542980,"C7",119640,1442662620,"2015-09-19 04:37:00"
"4060","20154415114438-543",2,"2015-09-17 20:02:00",1442545320,"C4",202680,1442748000,"2015-09-20 04:20:00"
"4707","20150322020344-232",2,"2015-09-17 20:03:00",1442545380,"C3",283500,1442828880,"2015-09-21 02:48:00"
"1038","20155615055609-330",1,"2015-09-17 20:06:00",1442545560,"C7",90300,1442635860,"2015-09-18 21:11:00"
"4784","20153213073258-209",1,"2015-09-17 20:21:00",1442546460,"C3",391740,1442938200,"2015-09-22 09:10:00"
"951","20151729051759-488",1,"2015-09-17 20:47:00",1442548020,"C8",330840,1442878860,"2015-09-21 16:41:00"
"5981","20154430084401-298",1,"2015-09-17 20:59:00",1442548740,"C4",533100,1443081840,"2015-09-24 01:04:00"
"5641","20152205052244-453",2,"2015-09-17 21:08:00",1442549280,"C8",525180,1443074460,"2015-09-23 23:01:00"
"3801","20154026094053-772",2,"2015-09-17 21:13:00",1442549580,"C7",215820,1442765400,"2015-09-20 09:10:00"
"2089","20152607062650-779",1,"2015-09-17 21:17:00",1442549820,"C3",305820,1442855640,"2015-09-21 10:14:00"
"5624","20154811054808-989",1,"2015-09-17 21:32:00",1442550720,"C0",66480,1442617200,"2015-09-18 16:00:00"
"6195","20155314095341-355",2,"2015-09-17 22:08:00",1442552880,"C4",303300,1442856180,"2015-09-21 10:23:00"
"1598","20154615114635-60",1,"2015-09-17 22:10:00",1442553000,"C2",361080,1442914080,"2015-09-22 02:28:00"
"3366","20153709093741-767",1,"2015-09-17 23:21:00",1442557260,"C2",92580,1442649840,"2015-09-19 01:04:00"
"2085","20151309121323-469",2,"2015-09-17 23:47:00",1442558820,"C7",366420,1442925240,"2015-09-22 05:34:00"
"1387","20152931072940-294",1,"2015-09-18 00:14:00",1442560440,"C8",305820,1442866260,"2015-09-21 13:11:00"
"2836","20153711033732-656",2,"2015-09-18 00:49:00",1442562540,"C5",68940,1442631480,"2015-09-18 19:58:00"
"5114","20155409055424-104",1,"2015-09-18 01:30:00",1442565000,"C4",485280,1443050280,"2015-09-23 16:18:00"
"34","20151211081210-391",2,"2015-09-18 03:20:00",1442571600,"C0",293640,1442865240,"2015-09-21 12:54:00"
"4938","20150631110616-558",3,"2015-09-18 03:22:00",1442571720,"C6",190920,1442762640,"2015-09-20 08:24:00"
"2529","20150630110633-414",1,"2015-09-18 03:30:00",1442572200,"C0",538080,1443110280,"2015-09-24 08:58:00"
"5400","20152429012447-906",1,"2015-09-18 03:55:00",1442573700,"C5",241980,1442815680,"2015-09-20 23:08:00"
"581","20150822040848-819",1,"2015-09-18 04:18:00",1442575080,"C5",709800,1443284880,"2015-09-26 09:28:00"
"4772","20154512084511-218",2,"2015-09-18 05:26:00",1442579160,"C4",454980,1443034140,"2015-09-23 11:49:00"
"787","20155815115806-862",3,"2015-09-18 05:50:00",1442580600,"C0",364440,1442945040,"2015-09-22 11:04:00"
"1924","20155130025118-645",3,"2015-09-18 05:56:00",1442580960,"C8",321900,1442902860,"2015-09-21 23:21:00"
"1517","20155313085338-538",3,"2015-09-18 06:07:00",1442581620,"C5",211020,1442792640,"2015-09-20 16:44:00"
"6021","20151614071616-110",3,"2015-09-18 06:10:00",1442581800,"C7",170820,1442752620,"2015-09-20 05:37:00"
"2631","20152724112733-858",1,"2015-09-18 06:31:00",1442583060,"C0",602580,1443185640,"2015-09-25 05:54:00"
"6207","20150305110318-934",2,"2015-09-18 06:57:00",1442584620,"C8",554220,1443138840,"2015-09-24 16:54:00"
"5805","20152123092103-610",1,"2015-09-18 07:17:00",1442585820,"C3",1119480,1443705300,"2015-10-01 06:15:00"
"5094","20150607030644-318",1,"2015-09-18 07:21:00",1442586060,"C3",1200300,1443786360,"2015-10-02 04:46:00"
"1617","20150515110551-961",1,"2015-09-18 08:50:00",1442591400,"C5",418500,1443009900,"2015-09-23 05:05:00"
"447","20155012065039-980",2,"2015-09-18 08:52:00",1442591520,"C8",262860,1442854380,"2015-09-21 09:53:00"
"115","20155213045249-101",1,"2015-09-18 08:57:00",1442591820,"C8",80700,1442672520,"2015-09-19 07:22:00"
"5686","20151730041740-897",2,"2015-09-18 09:12:00",1442592720,"C8",323220,1442915940,"2015-09-22 02:59:00"
"6380","20152111122136-527",3,"2015-09-18 09:54:00",1442595240,"C5",198660,1442793900,"2015-09-20 17:05:00"
"1796","20155328055322-628",1,"2015-09-18 11:37:00",1442601420,"C5",223980,1442825400,"2015-09-21 01:50:00"
"249","20153708023759-709",1,"2015-09-18 12:25:00",1442604300,"C8",428040,1443032340,"2015-09-23 11:19:00"
"37","20150924120946-229",1,"2015-09-18 12:49:00",1442605740,"C3",605100,1443210840,"2015-09-25 12:54:00"
"1773","20153116073142-631",2,"2015-09-18 12:53:00",1442605980,"C4",96060,1442702040,"2015-09-19 15:34:00"
"3611","20151228021221-216",1,"2015-09-18 13:24:00",1442607840,"C0",226440,1442834280,"2015-09-21 04:18:00"
"6167","20153304093314-219",1,"2015-09-18 13:39:00",1442608740,"C8",612180,1443220920,"2015-09-25 15:42:00"
"4476","20152117012105-319",3,"2015-09-18 13:43:00",1442608980,"C4",87720,1442696700,"2015-09-19 14:05:00"
"1600","20154912074929-675",3,"2015-09-18 14:19:00",1442611140,"C2",541800,1443152940,"2015-09-24 20:49:00"
"5969","20153802033804-576",1,"2015-09-18 14:38:00",1442612280,"C8",275760,1442888040,"2015-09-21 19:14:00"
"508","20154410124427-370",3,"2015-09-18 14:45:00",1442612700,"C4",99780,1442712480,"2015-09-19 18:28:00"
"5672","20153509063553-817",3,"2015-09-18 15:25:00",1442615100,"C8",697560,1443312660,"2015-09-26 17:11:00"
"2595","20150406120417-939",1,"2015-09-18 15:58:00",1442617080,"C4",150120,1442767200,"2015-09-20 09:40:00"
"6196","20151406061442-733",2,"2015-09-18 17:14:00",1442621640,"C3",538200,1443159840,"2015-09-24 22:44:00"
"3663","20153829013850-412",1,"2015-09-18 17:20:00",1442622000,"C3",870660,1443492660,"2015-09-28 19:11:00"
"3703","20151914041904-182",1,"2015-09-18 17:49:00",1442623740,"C2",175500,1442799240,"2015-09-20 18:34:00"
"2605","20152602042627-350",1,"2015-09-18 19:06:00",1442628360,"C2",696000,1443324360,"2015-09-26 20:26:00"
"4545","20155216015253-395",2,"2015-09-18 20:08:00",1442632080,"C4",97680,1442729760,"2015-09-19 23:16:00"
"2855","20150413080423-537",1,"2015-09-18 20:17:00",1442632620,"C4",475980,1443108600,"2015-09-24 08:30:00"
"1976","20150414070459-536",3,"2015-09-18 20:19:00",1442632740,"C5",131100,1442763840,"2015-09-20 08:44:00"
"6481","20150512110539-725",2,"2015-09-18 20:24:00",1442633040,"C4",551940,1443184980,"2015-09-25 05:43:00"
"2478","20155012055005-718",2,"2015-09-18 20:32:00",1442633520,"C8",264060,1442897580,"2015-09-21 21:53:00"
"4869","20154625064609-206",1,"2015-09-18 22:30:00",1442640600,"C5",304320,1442944920,"2015-09-22 11:02:00"
"3251","20151812081845-784",2,"2015-09-18 23:03:00",1442642580,"C5",190500,1442833080,"2015-09-21 03:58:00"
"415","20155126025133-294",1,"2015-09-19 00:27:00",1442647620,"C4",252720,1442900340,"2015-09-21 22:39:00"
"4183","20155303125323-651",1,"2015-09-19 00:28:00",1442647680,"C3",191100,1442838780,"2015-09-21 05:33:00"
"3546","20153710103741-345",1,"2015-09-19 00:45:00",1442648700,"C2",371040,1443019740,"2015-09-23 07:49:00"
"1057","20152120122138-42",1,"2015-09-19 02:37:00",1442655420,"C7",365280,1443020700,"2015-09-23 08:05:00"
"5190","20151829061839-838",1,"2015-09-19 02:48:00",1442656080,"C8",257400,1442913480,"2015-09-22 02:18:00"
"3930","20150313110328-797",2,"2015-09-19 03:57:00",1442660220,"C8",246420,1442906640,"2015-09-22 00:24:00"
"3575","20152107032156-241",1,"2015-09-19 05:48:00",1442666880,"C2",334140,1443001020,"2015-09-23 02:37:00"
"1575","20151504111546-565",1,"2015-09-19 06:10:00",1442668200,"C2",1277700,1443945900,"2015-10-04 01:05:00"
"1171","20152604072643-403",1,"2015-09-19 07:18:00",1442672280,"C4",647760,1443320040,"2015-09-26 19:14:00"
"5709","20154217024216-818",1,"2015-09-19 07:29:00",1442672940,"C3",146820,1442819760,"2015-09-21 00:16:00"
"5642","20155613105649-467",1,"2015-09-19 07:40:00",1442673600,"C4",253320,1442926920,"2015-09-22 06:02:00"
"4274","20152917082955-286",3,"2015-09-19 08:12:00",1442675520,"C0",171780,1442847300,"2015-09-21 07:55:00"
"96","20150713110726-288",1,"2015-09-19 08:55:00",1442678100,"C8",255240,1442933340,"2015-09-22 07:49:00"
"1360","20152913042937-614",1,"2015-09-19 10:16:00",1442682960,"C5",70860,1442753820,"2015-09-20 05:57:00"
"1468","20153312023328-539",2,"2015-09-19 10:35:00",1442684100,"C7",84360,1442768460,"2015-09-20 10:01:00"
"6521","20154415064447-909",1,"2015-09-19 10:36:00",1442684160,"C5",379740,1443063900,"2015-09-23 20:05:00"
"5687","20153007093004-81",3,"2015-09-19 11:24:00",1442687040,"C5",521820,1443208860,"2015-09-25 12:21:00"
"4058","20155612065603-160",2,"2015-09-19 11:29:00",1442687340,"C3",207060,1442894400,"2015-09-21 21:00:00"
"2717","20153611093610-113",2,"2015-09-19 12:56:00",1442692560,"C2",351600,1443044160,"2015-09-23 14:36:00"
"5945","20150813060851-608",2,"2015-09-19 14:08:00",1442696880,"C6",91200,1442788080,"2015-09-20 15:28:00"
"6189","20154529064528-757",3,"2015-09-19 14:20:00",1442697600,"C7",263100,1442960700,"2015-09-22 15:25:00"
"4966","20150008080048-814",2,"2015-09-19 14:24:00",1442697840,"C5",121680,1442819520,"2015-09-21 00:12:00"
"2553","20151310101330-91",1,"2015-09-19 15:43:00",1442702580,"C4",265800,1442968380,"2015-09-22 17:33:00"
"1114","20153317113300-397",1,"2015-09-19 15:50:00",1442703000,"C4",188220,1442891220,"2015-09-21 20:07:00"
"5914","20155309035345-751",2,"2015-09-19 16:05:00",1442703900,"C6",144120,1442848020,"2015-09-21 08:07:00"
"2074","20154309084354-984",1,"2015-09-19 16:19:00",1442704740,"C5",297120,1443001860,"2015-09-23 02:51:00"
"2639","20154930064934-59",2,"2015-09-19 16:51:00",1442706660,"C8",882060,1443588720,"2015-09-29 21:52:00"
"1739","20154510014516-824",1,"2015-09-19 17:05:00",1442707500,"C5",98700,1442806200,"2015-09-20 20:30:00"
"3525","20152310012347-406",2,"2015-09-19 18:03:00",1442710980,"C4",99300,1442810280,"2015-09-20 21:38:00"
"6437","20153612033615-297",1,"2015-09-19 18:08:00",1442711280,"C0",76740,1442788020,"2015-09-20 15:27:00"
"673","20155508075512-365",1,"2015-09-19 18:43:00",1442713380,"C2",458460,1443171840,"2015-09-25 02:04:00"
"436","20151401121438-732",3,"2015-09-19 20:26:00",1442719560,"C3",792360,1443511920,"2015-09-29 00:32:00"
"1556","20152424032429-194",2,"2015-09-19 21:03:00",1442721780,"C4",323820,1443045600,"2015-09-23 15:00:00"
"2138","20152606032633-640",1,"2015-09-19 22:52:00",1442728320,"C2",574980,1443303300,"2015-09-26 14:35:00"
"823","20155317085330-284",2,"2015-09-19 23:11:00",1442729460,"C8",112140,1442841600,"2015-09-21 06:20:00"
"3848","20150802060812-197",2,"2015-09-19 23:36:00",1442730960,"C4",526260,1443257220,"2015-09-26 01:47:00"
"2770","20150901120957-839",1,"2015-09-19 23:49:00",1442731740,"C3",610800,1443342540,"2015-09-27 01:29:00"
"3969","20152516042528-805",2,"2015-09-20 00:05:00",1442732700,"C5",423600,1443156300,"2015-09-24 21:45:00"
"3029","20152310122351-816",3,"2015-09-20 00:31:00",1442734260,"C5",102660,1442836920,"2015-09-21 05:02:00"
"555","20155518055520-844",3,"2015-09-20 00:57:00",1442735820,"C2",55860,1442791680,"2015-09-20 16:28:00"
"4277","20150024040008-576",3,"2015-09-20 01:02:00",1442736120,"C7",325560,1443061680,"2015-09-23 19:28:00"
"6463","20151716101753-304",1,"2015-09-20 01:11:00",1442736660,"C8",156420,1442893080,"2015-09-21 20:38:00"
"5205","20150010070052-300",2,"2015-09-20 02:36:00",1442741760,"C2",106020,1442847780,"2015-09-21 08:03:00"
"1531","20153106033136-478",1,"2015-09-20 03:47:00",1442746020,"C0",145920,1442891940,"2015-09-21 20:19:00"
"1339","20155316115321-402",3,"2015-09-20 04:27:00",1442748420,"C8",159420,1442907840,"2015-09-22 00:44:00"
"2303","20155905015919-324",1,"2015-09-20 04:55:00",1442750100,"C5",180480,1442930580,"2015-09-22 07:03:00"
"3054","20154612084611-217",3,"2015-09-20 05:04:00",1442750640,"C6",112980,1442863620,"2015-09-21 12:27:00"
"3828","20151821101831-698",1,"2015-09-20 06:48:00",1442756880,"C6",429900,1443186780,"2015-09-25 06:13:00"
"5529","20150413100443-728",3,"2015-09-20 07:02:00",1442757720,"C2",593880,1443351600,"2015-09-27 04:00:00"
"2282","20151713071733-979",1,"2015-09-20 07:21:00",1442758860,"C0",302520,1443061380,"2015-09-23 19:23:00"
"3783","20153707123722-164",1,"2015-09-20 07:29:00",1442759340,"C7",552360,1443311700,"2015-09-26 16:55:00"
"808","20151013101006-462",1,"2015-09-20 08:10:00",1442761800,"C0",74700,1442836500,"2015-09-21 04:55:00"
"5606","20151212011243-975",1,"2015-09-20 08:20:00",1442762400,"C4",96240,1442858640,"2015-09-21 11:04:00"
"3332","20151313041349-276",1,"2015-09-20 09:11:00",1442765460,"C6",579480,1443344940,"2015-09-27 02:09:00"
"4962","20150020090018-839",1,"2015-09-20 09:18:00",1442765880,"C6",446580,1443212460,"2015-09-25 13:21:00"
"2404","20155417095454-820",3,"2015-09-20 11:07:00",1442772420,"C0",263580,1443036000,"2015-09-23 12:20:00"
"4621","20152322072348-123",1,"2015-09-20 11:16:00",1442772960,"C8",359940,1443132900,"2015-09-24 15:15:00"
"1260","20155019025025-685",1,"2015-09-20 11:18:00",1442773080,"C4",73680,1442846760,"2015-09-21 07:46:00"
"6499","20151904021905-805",1,"2015-09-20 11:19:00",1442773140,"C7",1035600,1443808740,"2015-10-02 10:59:00"
"4126","20153402053419-365",1,"2015-09-20 11:37:00",1442774220,"C4",601740,1443375960,"2015-09-27 10:46:00"
"5868","20154212114258-729",1,"2015-09-20 11:37:00",1442774220,"C7",98700,1442872920,"2015-09-21 15:02:00"
"1238","20154105044140-645",1,"2015-09-20 12:17:00",1442776620,"C2",426720,1443203340,"2015-09-25 10:49:00"
"6004","20153911083955-135",1,"2015-09-20 12:27:00",1442777220,"C8",113040,1442890260,"2015-09-21 19:51:00"
"1317","20154411024426-868",2,"2015-09-20 12:56:00",1442778960,"C2",110160,1442889120,"2015-09-21 19:32:00"
"6453","20153925033936-464",2,"2015-09-20 12:59:00",1442779140,"C0",279600,1443058740,"2015-09-23 18:39:00"
"501","20151116071131-16",1,"2015-09-20 13:03:00",1442779380,"C2",183360,1442962740,"2015-09-22 15:59:00"
"4285","20152416092443-318",2,"2015-09-20 13:38:00",1442781480,"C4",180420,1442961900,"2015-09-22 15:45:00"
"2941","20153115023128-580",1,"2015-09-20 14:27:00",1442784420,"C8",61680,1442846100,"2015-09-21 07:35:00"
"4366","20154211074259-773",1,"2015-09-20 14:30:00",1442784600,"C6",133680,1442918280,"2015-09-22 03:38:00"
"5313","20154216084221-101",3,"2015-09-20 14:34:00",1442784840,"C2",380640,1443165480,"2015-09-25 00:18:00"
"4627","20150412010421-959",1,"2015-09-20 17:11:00",1442794260,"C4",100860,1442895120,"2015-09-21 21:12:00"
"2358","20151814071826-934",1,"2015-09-20 17:18:00",1442794680,"C5",79200,1442873880,"2015-09-21 15:18:00"
"874","20153808113851-534",2,"2015-09-20 17:30:00",1442795400,"C8",528960,1443324360,"2015-09-26 20:26:00"
"1454","20155310105320-51",2,"2015-09-20 18:54:00",1442800440,"C8",510180,1443310620,"2015-09-26 16:37:00"
"1207","20152612022619-830",1,"2015-09-20 19:36:00",1442802960,"C8",354900,1443157860,"2015-09-24 22:11:00"
"5722","20155012015018-20",2,"2015-09-20 20:00:00",1442804400,"C8",71340,1442875740,"2015-09-21 15:49:00"
"3918","20155530075533-622",2,"2015-09-20 21:10:00",1442808600,"C8",372420,1443181020,"2015-09-25 04:37:00"
"1624","20154309104322-867",2,"2015-09-20 22:38:00",1442813880,"C8",198660,1443012540,"2015-09-23 05:49:00"
"3097","20155810015814-86",3,"2015-09-20 22:58:00",1442815080,"C0",448200,1443263280,"2015-09-26 03:28:00"
"2283","20152711122705-744",2,"2015-09-20 23:01:00",1442815260,"C8",116520,1442931780,"2015-09-22 07:23:00"
"4929","20155707045739-291",1,"2015-09-20 23:06:00",1442815560,"C5",163620,1442979180,"2015-09-22 20:33:00"
"2041","20150609060600-167",1,"2015-09-20 23:10:00",1442815800,"C3",126480,1442942280,"2015-09-22 10:18:00"
"2091","20154114014105-799",1,"2015-09-21 00:32:00",1442820720,"C5",185820,1443006540,"2015-09-23 04:09:00"
"925","20154213094240-842",1,"2015-09-21 01:06:00",1442822760,"C5",94320,1442917080,"2015-09-22 03:18:00"
"6125","20153125013133-452",1,"2015-09-21 01:06:00",1442822760,"C8",457620,1443280380,"2015-09-26 08:13:00"
"4001","20150719050720-439",1,"2015-09-21 01:27:00",1442824020,"C5",58200,1442882220,"2015-09-21 17:37:00"
"5927","20152827102844-258",1,"2015-09-21 01:28:00",1442824080,"C8",425520,1443249600,"2015-09-25 23:40:00"
"4409","20154229064247-967",1,"2015-09-21 02:38:00",1442828280,"C2",986280,1443814560,"2015-10-02 12:36:00"
"98","20154027074029-955",1,"2015-09-21 02:44:00",1442828640,"C5",267780,1443096420,"2015-09-24 05:07:00"
"5921","20153727113719-945",3,"2015-09-21 02:57:00",1442829420,"C8",425760,1443255180,"2015-09-26 01:13:00"
"3395","20154903014907-481",2,"2015-09-21 03:33:00",1442831580,"C4",189780,1443021360,"2015-09-23 08:16:00"
"1011","20155615125621-835",1,"2015-09-21 04:09:00",1442833740,"C8",69540,1442903280,"2015-09-21 23:28:00"
"5020","20152618022623-126",1,"2015-09-21 05:16:00",1442837760,"C2",113100,1442950860,"2015-09-22 12:41:00"
"2122","20154810124843-713",3,"2015-09-21 05:48:00",1442839680,"C2",514800,1443354480,"2015-09-27 04:48:00"
"2516","20151813061817-670",2,"2015-09-21 05:48:00",1442839680,"C8",137880,1442977560,"2015-09-22 20:06:00"
"2645","20153831073821-785",1,"2015-09-21 05:50:00",1442839800,"C6",301320,1443141120,"2015-09-24 17:32:00"
"1236","20153914023919-152",1,"2015-09-21 05:54:00",1442840040,"C8",81900,1442921940,"2015-09-22 04:39:00"
"1850","20155815105829-773",1,"2015-09-21 06:14:00",1442841240,"C2",250680,1443091920,"2015-09-24 03:52:00"
"1008","20150020040021-389",2,"2015-09-21 06:43:00",1442842980,"C3",52980,1442895960,"2015-09-21 21:26:00"
"4552","20152609102611-783",1,"2015-09-21 06:58:00",1442843880,"C3",528960,1443372840,"2015-09-27 09:54:00"
"1734","20152515062540-976",2,"2015-09-21 07:27:00",1442845620,"C5",261060,1443106680,"2015-09-24 07:58:00"
"5499","20155205025245-653",3,"2015-09-21 07:43:00",1442846580,"C4",452220,1443298800,"2015-09-26 13:20:00"
"2499","20154223104254-46",1,"2015-09-21 07:50:00",1442847000,"C4",1247640,1444094640,"2015-10-05 18:24:00"
"3113","20150115010131-543",1,"2015-09-21 08:54:00",1442850840,"C2",71940,1442922780,"2015-09-22 04:53:00"
"4347","20153218103248-711",2,"2015-09-21 09:03:00",1442851380,"C4",253860,1443105240,"2015-09-24 07:34:00"
"3722","20155110075150-591",1,"2015-09-21 09:59:00",1442854740,"C6",454560,1443309300,"2015-09-26 16:15:00"
"4253","20151804051810-974",1,"2015-09-21 10:09:00",1442855340,"C5",481020,1443336360,"2015-09-26 23:46:00"
"292","20151118061145-872",2,"2015-09-21 12:32:00",1442863920,"C3",94020,1442957940,"2015-09-22 14:39:00"
"4279","20154220044203-784",1,"2015-09-21 12:38:00",1442864280,"C2",71760,1442936040,"2015-09-22 08:34:00"
"6102","20153829053832-818",2,"2015-09-21 13:06:00",1442865960,"C4",581160,1443447120,"2015-09-28 06:32:00"
"2737","20153206063215-204",1,"2015-09-21 13:40:00",1442868000,"C8",571440,1443439440,"2015-09-28 04:24:00"
"3966","20153207093226-553",1,"2015-09-21 16:10:00",1442877000,"C5",558840,1443435840,"2015-09-28 03:24:00"
"5821","20155427045428-734",1,"2015-09-21 16:55:00",1442879700,"C5",308580,1443188280,"2015-09-25 06:38:00"
"716","20153317113343-810",1,"2015-09-21 17:19:00",1442881140,"C4",366360,1443247500,"2015-09-25 23:05:00"
"215","20153022123027-88",2,"2015-09-21 17:21:00",1442881260,"C2",372780,1443254040,"2015-09-26 00:54:00"
"1200","20154713024750-774",1,"2015-09-21 17:41:00",1442882460,"C4",350820,1443233280,"2015-09-25 19:08:00"
"3429","20152119022156-795",1,"2015-09-21 18:48:00",1442886480,"C5",62940,1442949420,"2015-09-22 12:17:00"
"3420","20152518072549-657",3,"2015-09-21 20:05:00",1442891100,"C0",372900,1443264000,"2015-09-26 03:40:00"
"2703","20151911021956-775",1,"2015-09-21 20:43:00",1442893380,"C3",780480,1443673860,"2015-09-30 21:31:00"
"3582","20150918060923-118",1,"2015-09-21 21:41:00",1442896860,"C3",315120,1443211980,"2015-09-25 13:13:00"
"2825","20153413023435-625",1,"2015-09-21 22:37:00",1442900220,"C5",240060,1443140280,"2015-09-24 17:18:00"
"6474","20150821020810-335",3,"2015-09-21 23:50:00",1442904600,"C6",452220,1443356820,"2015-09-27 05:27:00"
"1680","20152724062710-421",1,"2015-09-22 00:27:00",1442906820,"C2",645300,1443552120,"2015-09-29 11:42:00"
"4828","20155516015509-611",2,"2015-09-22 00:35:00",1442907300,"C4",58800,1442966100,"2015-09-22 16:55:00"
"2422","20150920090938-107",1,"2015-09-22 00:37:00",1442907420,"C5",352560,1443259980,"2015-09-26 02:33:00"
"3749","20150314050311-620",2,"2015-09-22 01:25:00",1442910300,"C5",855960,1443766260,"2015-10-01 23:11:00"
"75","20150419080423-232",1,"2015-09-22 01:56:00",1442912160,"C2",118560,1443030720,"2015-09-23 10:52:00"
"3266","20153903123925-684",1,"2015-09-22 01:59:00",1442912340,"C0",535200,1443447540,"2015-09-28 06:39:00"
"2100","20154217124209-940",2,"2015-09-22 04:04:00",1442919840,"C7",200460,1443120300,"2015-09-24 11:45:00"
"2620","20154906114942-746",3,"2015-09-22 04:10:00",1442920200,"C7",150540,1443070740,"2015-09-23 21:59:00"
"4213","20154209104204-174",2,"2015-09-22 05:18:00",1442924280,"C5",157680,1443081960,"2015-09-24 01:06:00"
"429","20150613110621-217",1,"2015-09-22 05:38:00",1442925480,"C5",429540,1443355020,"2015-09-27 04:57:00"
"6403","20152406112431-687",1,"2015-09-22 06:48:00",1442929680,"C5",682920,1443612600,"2015-09-30 04:30:00"
"4618","20154419024438-705",1,"2015-09-22 07:14:00",1442931240,"C2",77400,1443008640,"2015-09-23 04:44:00"
"2222","20152713112722-565",2,"2015-09-22 07:45:00",1442933100,"C5",254760,1443187860,"2015-09-25 06:31:00"
"3875","20154115124102-576",3,"2015-09-22 08:41:00",1442936460,"C6",544800,1443481260,"2015-09-28 16:01:00"
"6464","20151006031044-506",1,"2015-09-22 08:46:00",1442936760,"C6",169920,1443106680,"2015-09-24 07:58:00"
"3006","20150622030637-276",1,"2015-09-22 09:00:00",1442937600,"C4",885480,1443823080,"2015-10-02 14:58:00"
"4511","20151713061726-223",1,"2015-09-22 09:35:00",1442939700,"C6",131580,1443071280,"2015-09-23 22:08:00"
"6340","20154719064707-283",2,"2015-09-22 10:09:00",1442941740,"C7",135660,1443077400,"2015-09-23 23:50:00"
"3383","20150922110914-684",2,"2015-09-22 10:49:00",1442944140,"C8",535440,1443479580,"2015-09-28 15:33:00"
"4890","20150931010941-247",1,"2015-09-22 11:04:00",1442945040,"C8",378660,1443323700,"2015-09-26 20:15:00"
"1579","20153606103657-307",1,"2015-09-22 11:22:00",1442946120,"C7",197880,1443144000,"2015-09-24 18:20:00"
"4667","20155318045300-137",3,"2015-09-22 11:49:00",1442947740,"C4",163680,1443111420,"2015-09-24 09:17:00"
"3836","20155910095936-211",1,"2015-09-22 12:08:00",1442948880,"C4",348180,1443297060,"2015-09-26 12:51:00"
"4209","20154517084514-625",2,"2015-09-22 12:33:00",1442950380,"C6",520680,1443471060,"2015-09-28 13:11:00"
"4529","20153128063145-895",2,"2015-09-22 12:43:00",1442950980,"C5",311760,1443262740,"2015-09-26 03:19:00"
"361","20155603105654-700",2,"2015-09-22 13:08:00",1442952480,"C6",274920,1443227400,"2015-09-25 17:30:00"
"4328","20155613065652-38",1,"2015-09-22 16:34:00",1442964840,"C2",116040,1443080880,"2015-09-24 00:48:00"
"4512","20152705082730-727",1,"2015-09-22 17:39:00",1442968740,"C8",214560,1443183300,"2015-09-25 05:15:00"
"4928","20152616072652-905",2,"2015-09-22 17:56:00",1442969760,"C5",185400,1443155160,"2015-09-24 21:26:00"
"1864","20152520062536-43",1,"2015-09-22 18:33:00",1442971980,"C2",216480,1443188460,"2015-09-25 06:41:00"
"5243","20154107074130-137",2,"2015-09-22 18:46:00",1442972760,"C8",802860,1443775620,"2015-10-02 01:47:00"
"4930","20154509114531-556",1,"2015-09-22 19:30:00",1442975400,"C5",383700,1443359100,"2015-09-27 06:05:00"
"4251","20150814050807-728",1,"2015-09-22 19:41:00",1442976060,"C4",233460,1443209520,"2015-09-25 12:32:00"
"5166","20152220102228-66",3,"2015-09-22 20:08:00",1442977680,"C5",103980,1443081660,"2015-09-24 01:01:00"
"2967","20154818114859-137",3,"2015-09-22 21:30:00",1442982600,"C2",190260,1443172860,"2015-09-25 02:21:00"
"5165","20153014083025-418",3,"2015-09-22 22:04:00",1442984640,"C7",105720,1443090360,"2015-09-24 03:26:00"
"4808","20154412014428-448",1,"2015-09-22 22:08:00",1442984880,"C2",447120,1443432000,"2015-09-28 02:20:00"
"3494","20152718102756-727",1,"2015-09-22 22:28:00",1442986080,"C7",438180,1443424260,"2015-09-28 00:11:00"
"3653","20150001090048-374",1,"2015-09-22 23:35:00",1442990100,"C8",373380,1443363480,"2015-09-27 07:18:00"
"3328","20151820091811-842",3,"2015-09-23 00:32:00",1442993520,"C3",113820,1443107340,"2015-09-24 08:09:00"
"4266","20155913095938-39",1,"2015-09-23 02:07:00",1442999220,"C5",439260,1443438480,"2015-09-28 04:08:00"
"4978","20152616112648-695",2,"2015-09-23 03:38:00",1443004680,"C6",96120,1443100800,"2015-09-24 06:20:00"
"3552","20152020042020-267",1,"2015-09-23 05:17:00",1443010620,"C4",73140,1443083760,"2015-09-24 01:36:00"
"6116","20151120081141-291",3,"2015-09-23 05:41:00",1443012060,"C8",125100,1443137160,"2015-09-24 16:26:00"
"2541","20153317093349-531",2,"2015-09-23 05:57:00",1443013020,"C4",252720,1443265740,"2015-09-26 04:09:00"
"1157","20153523113541-168",2,"2015-09-23 06:07:00",1443013620,"C3",332340,1443345960,"2015-09-27 02:26:00"
"2773","20154218124259-772",2,"2015-09-23 08:18:00",1443021480,"C8",208080,1443229560,"2015-09-25 18:06:00"
"3329","20154614094653-955",1,"2015-09-23 08:46:00",1443023160,"C8",387000,1443410160,"2015-09-27 20:16:00"
"4613","20154519024544-322",2,"2015-09-23 08:55:00",1443023700,"C4",202620,1443226320,"2015-09-25 17:12:00"
"3865","20151726111704-117",1,"2015-09-23 10:11:00",1443028260,"C5",805080,1443833340,"2015-10-02 17:49:00"
"503","20152618062642-81",2,"2015-09-23 12:30:00",1443036600,"C4",453840,1443490440,"2015-09-28 18:34:00"
"2488","20154227054208-498",1,"2015-09-23 12:47:00",1443037620,"C8",998700,1444036320,"2015-10-05 02:12:00"
"536","20153723093753-818",3,"2015-09-23 12:49:00",1443037740,"C0",336240,1443373980,"2015-09-27 10:13:00"
"3260","20152128122117-954",2,"2015-09-23 13:48:00",1443041280,"C5",321660,1443362940,"2015-09-27 07:09:00"
"5597","20152615012610-377",2,"2015-09-23 14:36:00",1443044160,"C0",347700,1443391860,"2015-09-27 15:11:00"
"3792","20152819112852-444",2,"2015-09-23 14:56:00",1443045360,"C5",714360,1443759720,"2015-10-01 21:22:00"
"3795","20154615034637-382",1,"2015-09-23 15:56:00",1443048960,"C8",138360,1443187320,"2015-09-25 06:22:00"
"3280","20150506080545-327",1,"2015-09-23 17:02:00",1443052920,"C4",597060,1443649980,"2015-09-30 14:53:00"
"2113","20154322044336-436",2,"2015-09-23 17:19:00",1443053940,"C7",395280,1443449220,"2015-09-28 07:07:00"
"607","20152225082250-866",2,"2015-09-23 18:06:00",1443056760,"C0",652380,1443709140,"2015-10-01 07:19:00"
"409","20153016083036-762",2,"2015-09-23 18:27:00",1443058020,"C3",213540,1443271560,"2015-09-26 05:46:00"
"946","20155417095405-70",3,"2015-09-23 18:39:00",1443058740,"C5",183300,1443242040,"2015-09-25 21:34:00"
"993","20153114113153-521",2,"2015-09-23 20:11:00",1443064260,"C4",101100,1443165360,"2015-09-25 00:16:00"
"439","20155405055439-901",1,"2015-09-23 20:30:00",1443065400,"C4",782280,1443847680,"2015-10-02 21:48:00"
"6508","20151117101107-46",2,"2015-09-23 20:59:00",1443067140,"C5",462240,1443529380,"2015-09-29 05:23:00"
"6369","20154703104737-748",3,"2015-09-23 21:13:00",1443067980,"C0",882780,1443950760,"2015-10-04 02:26:00"
"4691","20151521021511-720",2,"2015-09-23 21:54:00",1443070440,"C4",200340,1443270780,"2015-09-26 05:33:00"
"5210","20155301055312-754",2,"2015-09-23 21:59:00",1443070740,"C0",656280,1443727020,"2015-10-01 12:17:00"
"410","20155606045620-205",2,"2015-09-23 22:22:00",1443072120,"C8",744180,1443816300,"2015-10-02 13:05:00"
"5574","20155729115754-235",2,"2015-09-24 00:13:00",1443078780,"C5",275520,1443354300,"2015-09-27 04:45:00"
"419","20154511094545-173",1,"2015-09-24 00:33:00",1443079980,"C4",545040,1443625020,"2015-09-30 07:57:00"
"1706","20155129125114-867",1,"2015-09-24 01:00:00",1443081600,"C7",244860,1443326460,"2015-09-26 21:01:00"
"860","20152716082703-974",1,"2015-09-24 01:09:00",1443082140,"C3",221640,1443303780,"2015-09-26 14:43:00"
"3778","20151711061722-116",2,"2015-09-24 03:02:00",1443088920,"C5",370500,1443459420,"2015-09-28 09:57:00"
"2728","20153119123113-587",3,"2015-09-24 04:44:00",1443095040,"C8",440340,1443535380,"2015-09-29 07:03:00"
"2938","20153806113852-538",2,"2015-09-24 05:30:00",1443097800,"C5",191640,1443289440,"2015-09-26 10:44:00"
"6343","20151715111719-318",1,"2015-09-24 05:32:00",1443097920,"C5",252300,1443350220,"2015-09-27 03:37:00"
"1636","20151018091033-267",1,"2015-09-24 07:26:00",1443104760,"C4",256080,1443360840,"2015-09-27 06:34:00"
"4342","20151804081822-193",3,"2015-09-24 07:38:00",1443105480,"C8",862800,1443968280,"2015-10-04 07:18:00"
"2709","20151010011010-902",3,"2015-09-24 07:46:00",1443105960,"C6",198360,1443304320,"2015-09-26 14:52:00"
"6130","20155221115237-739",1,"2015-09-24 07:50:00",1443106200,"C7",122340,1443228540,"2015-09-25 17:49:00"
"2342","20152718042732-411",2,"2015-09-24 09:09:00",1443110940,"C3",164040,1443274980,"2015-09-26 06:43:00"
"2033","20154420054435-183",1,"2015-09-24 10:10:00",1443114600,"C3",159180,1443273780,"2015-09-26 06:23:00"
"5213","20153515113535-847",3,"2015-09-24 11:32:00",1443119520,"C2",111060,1443230580,"2015-09-25 18:23:00"
"4227","20150305100328-487",3,"2015-09-24 12:21:00",1443122460,"C6",721380,1443843840,"2015-10-02 20:44:00"
"4207","20153218053206-183",1,"2015-09-24 13:06:00",1443125160,"C0",251220,1443376380,"2015-09-27 10:53:00"
"2204","20154610094644-926",2,"2015-09-24 13:11:00",1443125460,"C8",244380,1443369840,"2015-09-27 09:04:00"
"6526","20150223050200-237",3,"2015-09-24 13:34:00",1443126840,"C2",344040,1443470880,"2015-09-28 13:08:00"
"5419","20155710035705-492",1,"2015-09-24 16:00:00",1443135600,"C5",403260,1443538860,"2015-09-29 08:01:00"
"2530","20155608095652-395",3,"2015-09-24 17:20:00",1443140400,"C5",469680,1443610080,"2015-09-30 03:48:00"
"5441","20150303040325-976",1,"2015-09-24 17:48:00",1443142080,"C3",260100,1443402180,"2015-09-27 18:03:00"
"5027","20155411105414-764",2,"2015-09-24 18:00:00",1443142800,"C3",382920,1443525720,"2015-09-29 04:22:00"
"2132","20151026091044-859",2,"2015-09-24 18:25:00",1443144300,"C7",362700,1443507000,"2015-09-28 23:10:00"
"3466","20155318115321-937",2,"2015-09-24 18:36:00",1443144960,"C2",542580,1443687540,"2015-10-01 01:19:00"
"1276","20154224024243-441",1,"2015-09-24 18:59:00",1443146340,"C4",767460,1443913800,"2015-10-03 16:10:00"
"2807","20150107050116-884",2,"2015-09-24 19:26:00",1443147960,"C7",593700,1443741660,"2015-10-01 16:21:00"
"3635","20151528071513-888",1,"2015-09-24 20:38:00",1443152280,"C8",340140,1443492420,"2015-09-28 19:07:00"
"5548","20154702074759-377",1,"2015-09-24 21:00:00",1443153600,"C7",278340,1443431940,"2015-09-28 02:19:00"
"2637","20150819010811-13",2,"2015-09-24 21:02:00",1443153720,"C5",153480,1443307200,"2015-09-26 15:40:00"
"5564","20153228093241-330",2,"2015-09-24 23:58:00",1443164280,"C7",340680,1443504960,"2015-09-28 22:36:00"
"2149","20150419120407-235",3,"2015-09-25 00:10:00",1443165000,"C6",79260,1443244260,"2015-09-25 22:11:00"
"4203","20150322090352-662",1,"2015-09-25 03:09:00",1443175740,"C0",79320,1443255060,"2015-09-26 01:11:00"
"6309","20154316094311-12",1,"2015-09-25 03:35:00",1443177300,"C4",94440,1443271740,"2015-09-26 05:49:00"
"5207","20154114064153-342",2,"2015-09-25 03:45:00",1443177900,"C2",117480,1443295380,"2015-09-26 12:23:00"
"4630","20155716015705-26",3,"2015-09-25 04:37:00",1443181020,"C5",372000,1443553020,"2015-09-29 11:57:00"
"2955","20150022080040-235",2,"2015-09-25 06:24:00",1443187440,"C3",84480,1443271920,"2015-09-26 05:52:00"
"4120","20152920072900-597",2,"2015-09-25 06:37:00",1443188220,"C2",214440,1443402660,"2015-09-27 18:11:00"
"5298","20153202063212-217",2,"2015-09-25 07:25:00",1443191100,"C7",284340,1443475440,"2015-09-28 14:24:00"
"6339","20153717033736-717",2,"2015-09-25 07:29:00",1443191340,"C8",94560,1443285900,"2015-09-26 09:45:00"
"2548","20152001012016-668",3,"2015-09-25 07:52:00",1443192720,"C5",591540,1443784260,"2015-10-02 04:11:00"
"3835","20151919011904-725",3,"2015-09-25 08:04:00",1443193440,"C8",99900,1443293340,"2015-09-26 11:49:00"
"5704","20150816050832-772",1,"2015-09-25 08:10:00",1443193800,"C2",745320,1443939120,"2015-10-03 23:12:00"
"746","20155723025744-648",2,"2015-09-25 09:27:00",1443198420,"C5",76500,1443274920,"2015-09-26 06:42:00"
"3628","20155319025303-151",2,"2015-09-25 09:47:00",1443199620,"C7",55560,1443255180,"2015-09-26 01:13:00"
"6121","20150822100824-378",2,"2015-09-25 11:04:00",1443204240,"C5",367620,1443571860,"2015-09-29 17:11:00"
"313","20153908033947-597",1,"2015-09-25 11:15:00",1443204900,"C6",1134960,1444339860,"2015-10-08 14:31:00"
"1033","20152824092833-430",3,"2015-09-25 12:38:00",1443209880,"C2",97800,1443307680,"2015-09-26 15:48:00"
"5874","20153909063916-316",3,"2015-09-25 13:09:00",1443211740,"C5",468600,1443680340,"2015-09-30 23:19:00"
"3273","20150320040327-383",2,"2015-09-25 14:21:00",1443216060,"C4",141960,1443358020,"2015-09-27 05:47:00"
"570","20150723120718-938",3,"2015-09-25 14:25:00",1443216300,"C4",181080,1443397380,"2015-09-27 16:43:00"
"383","20155210105230-671",1,"2015-09-25 14:28:00",1443216480,"C4",1329120,1444545600,"2015-10-10 23:40:00"
"1919","20151521051522-169",2,"2015-09-25 14:40:00",1443217200,"C8",67260,1443284460,"2015-09-26 09:21:00"
"707","20155905015950-850",1,"2015-09-25 15:11:00",1443219060,"C4",577440,1443796500,"2015-10-02 07:35:00"
"5591","20155819125825-141",1,"2015-09-25 15:30:00",1443220200,"C3",263760,1443483960,"2015-09-28 16:46:00"
"553","20150315110303-677",1,"2015-09-25 16:01:00",1443222060,"C5",440940,1443663000,"2015-09-30 18:30:00"
"5506","20150213050220-905",3,"2015-09-25 17:23:00",1443226980,"C5",346020,1443573000,"2015-09-29 17:30:00"
"3012","20154911044919-82",1,"2015-09-25 18:13:00",1443229980,"C4",173520,1443403500,"2015-09-27 18:25:00"
"365","20153227023219-8",2,"2015-09-25 18:42:00",1443231720,"C8",504120,1443735840,"2015-10-01 14:44:00"
"2771","20155120125158-102",1,"2015-09-25 19:31:00",1443234660,"C5",1050600,1444285260,"2015-10-07 23:21:00"
"1347","20152130122123-358",2,"2015-09-25 20:09:00",1443236940,"C7",252720,1443489660,"2015-09-28 18:21:00"
"1458","20152715082740-609",2,"2015-09-25 20:21:00",1443237660,"C3",453420,1443691080,"2015-10-01 02:18:00"
"5942","20151113061129-478",3,"2015-09-25 20:59:00",1443239940,"C4",1129860,1444369800,"2015-10-08 22:50:00"
"451","20151824101808-298",2,"2015-09-25 21:20:00",1443241200,"C2",126120,1443367320,"2015-09-27 08:22:00"
"2088","20154304074340-809",1,"2015-09-25 21:25:00",1443241500,"C6",310620,1443552120,"2015-09-29 11:42:00"
"2069","20151219101232-863",3,"2015-09-25 22:12:00",1443244320,"C0",187200,1443431520,"2015-09-28 02:12:00"
"1192","20151417021426-33",3,"2015-09-25 22:44:00",1443246240,"C2",240600,1443486840,"2015-09-28 17:34:00"
"4951","20153322063335-503",3,"2015-09-25 23:24:00",1443248640,"C4",106620,1443355260,"2015-09-27 05:01:00"
"1032","20150605090601-376",2,"2015-09-25 23:30:00",1443249000,"C8",889920,1444138920,"2015-10-06 06:42:00"
"5948","20150802090823-595",1,"2015-09-25 23:56:00",1443250560,"C4",255060,1443505620,"2015-09-28 22:47:00"
"961","20150114010135-879",1,"2015-09-26 00:27:00",1443252420,"C2",495780,1443748200,"2015-10-01 18:10:00"
"1876","20151617021606-104",1,"2015-09-26 00:48:00",1443253680,"C5",104160,1443357840,"2015-09-27 05:44:00"
"1002","20150815100834-958",1,"2015-09-26 03:14:00",1443262440,"C7",897480,1444159920,"2015-10-06 12:32:00"
"1167","20154020024025-608",3,"2015-09-26 04:01:00",1443265260,"C3",68580,1443333840,"2015-09-26 23:04:00"
"3199","20152229022224-672",1,"2015-09-26 04:48:00",1443268080,"C3",340680,1443608760,"2015-09-30 03:26:00"
"2201","20150904060937-392",1,"2015-09-26 05:57:00",1443272220,"C5",271440,1443543660,"2015-09-29 09:21:00"
"3358","20151426091431-80",2,"2015-09-26 06:00:00",1443272400,"C0",1133880,1444406280,"2015-10-09 08:58:00"
"847","20150518090550-442",3,"2015-09-26 08:01:00",1443279660,"C4",343680,1443623340,"2015-09-30 07:29:00"
"5762","20153520093506-281",2,"2015-09-26 09:17:00",1443284220,"C3",258660,1443542880,"2015-09-29 09:08:00"
"5334","20155320035314-794",3,"2015-09-26 09:19:00",1443284340,"C4",70680,1443355020,"2015-09-27 04:57:00"
"4556","20153424073437-874",2,"2015-09-26 09:50:00",1443286200,"C5",90480,1443376680,"2015-09-27 10:58:00"
"4289","20150517010521-33",3,"2015-09-26 10:42:00",1443289320,"C2",109860,1443399180,"2015-09-27 17:13:00"
"3639","20155220055213-805",2,"2015-09-26 11:38:00",1443292680,"C4",247980,1443540660,"2015-09-29 08:31:00"
"2593","20154619054642-211",2,"2015-09-26 14:16:00",1443302160,"C4",84600,1443386760,"2015-09-27 13:46:00"
"4050","20153701113748-789",1,"2015-09-26 14:25:00",1443302700,"C6",361680,1443664380,"2015-09-30 18:53:00"
"1334","20154414024455-447",1,"2015-09-26 15:29:00",1443306540,"C2",346500,1443653040,"2015-09-30 15:44:00"
"1316","20154610014621-394",2,"2015-09-26 16:38:00",1443310680,"C0",198960,1443509640,"2015-09-28 23:54:00"
"6447","20153306013342-878",3,"2015-09-26 18:10:00",1443316200,"C7",631860,1443948060,"2015-10-04 01:41:00"
"3478","20150912060916-518",1,"2015-09-26 19:21:00",1443320460,"C2",826740,1444147200,"2015-10-06 09:00:00"
"803","20151822031835-962",2,"2015-09-26 19:40:00",1443321600,"C5",180660,1443502260,"2015-09-28 21:51:00"
"3806","20154925074924-66",1,"2015-09-26 19:43:00",1443321780,"C7",783720,1444105500,"2015-10-05 21:25:00"
"3004","20154805074832-890",2,"2015-09-26 20:52:00",1443325920,"C8",265920,1443591840,"2015-09-29 22:44:00"
"3457","20150127010131-864",3,"2015-09-26 21:50:00",1443329400,"C4",374820,1443704220,"2015-10-01 05:57:00"
"5928","20153817093840-341",1,"2015-09-26 22:41:00",1443332460,"C7",389220,1443721680,"2015-10-01 10:48:00"
"4814","20151119111132-408",3,"2015-09-27 00:01:00",1443337260,"C5",325500,1443662760,"2015-09-30 18:26:00"
"5680","20155215095214-503",1,"2015-09-27 00:22:00",1443338520,"C4",334200,1443672720,"2015-09-30 21:12:00"
"4735","20154207114257-472",1,"2015-09-27 01:37:00",1443343020,"C4",624300,1443967320,"2015-10-04 07:02:00"
"3498","20151604091656-972",1,"2015-09-27 04:03:00",1443351780,"C5",1046460,1444398240,"2015-10-09 06:44:00"
"149","20150221090256-672",1,"2015-09-27 04:13:00",1443352380,"C8",71580,1443423960,"2015-09-28 00:06:00"
"462","20154913114917-875",1,"2015-09-27 04:37:00",1443353820,"C6",197280,1443551100,"2015-09-29 11:25:00"
"972","20154819014855-670",2,"2015-09-27 05:19:00",1443356340,"C4",94380,1443450720,"2015-09-28 07:32:00"
"6114","20153125073143-771",2,"2015-09-27 06:18:00",1443359880,"C3",168420,1443528300,"2015-09-29 05:05:00"
"3193","20154822054838-865",1,"2015-09-27 07:03:00",1443362580,"C8",78660,1443441240,"2015-09-28 04:54:00"
"417","20154211024216-107",3,"2015-09-27 07:54:00",1443365640,"C6",1119120,1444484760,"2015-10-10 06:46:00"
"936","20154108014126-563",1,"2015-09-27 08:53:00",1443369180,"C6",537840,1443907020,"2015-10-03 14:17:00"
"2533","20153117093131-820",1,"2015-09-27 08:55:00",1443369300,"C7",123120,1443492420,"2015-09-28 19:07:00"
"5852","20154817054816-243",3,"2015-09-27 09:12:00",1443370320,"C8",416520,1443786840,"2015-10-02 04:54:00"
"4573","20150419050423-187",1,"2015-09-27 09:16:00",1443370560,"C7",331560,1443702120,"2015-10-01 05:22:00"
"6416","20153319053331-895",1,"2015-09-27 09:43:00",1443372180,"C4",331500,1443703680,"2015-10-01 05:48:00"
"4770","20151625031626-950",2,"2015-09-27 11:40:00",1443379200,"C7",315360,1443694560,"2015-10-01 03:16:00"
"4254","20154525014533-946",1,"2015-09-27 12:36:00",1443382560,"C4",168660,1443551220,"2015-09-29 11:27:00"
"3374","20150117070118-157",1,"2015-09-27 12:46:00",1443383160,"C5",294900,1443678060,"2015-09-30 22:41:00"
"45","20154719104700-710",3,"2015-09-27 13:37:00",1443386220,"C7",100200,1443486420,"2015-09-28 17:27:00"
"753","20153128063125-623",1,"2015-09-27 13:51:00",1443387060,"C8",523680,1443910740,"2015-10-03 15:19:00"
"2691","20153931093915-91",1,"2015-09-27 14:31:00",1443389460,"C7",335760,1443725220,"2015-10-01 11:47:00"
"5436","20155719075702-802",1,"2015-09-27 14:37:00",1443389820,"C5",357600,1443747420,"2015-10-01 17:57:00"
"3431","20151225091237-930",1,"2015-09-27 15:18:00",1443392280,"C5",793080,1444185360,"2015-10-06 19:36:00"
"3282","20152123052127-127",2,"2015-09-27 16:45:00",1443397500,"C3",343440,1443740940,"2015-10-01 16:09:00"
"3278","20155425085454-29",1,"2015-09-27 16:50:00",1443397800,"C8",100680,1443498480,"2015-09-28 20:48:00"
"6236","20154825044833-35",3,"2015-09-27 16:50:00",1443397800,"C7",86460,1443484260,"2015-09-28 16:51:00"
"921","20152518012558-924",2,"2015-09-27 17:23:00",1443399780,"C4",791880,1444191660,"2015-10-06 21:21:00"
"3009","20155722115704-142",1,"2015-09-27 19:49:00",1443408540,"C4",65760,1443474300,"2015-09-28 14:05:00"
"1191","20152310082337-650",1,"2015-09-27 20:02:00",1443409320,"C8",215820,1443625140,"2015-09-30 07:59:00"
"3165","20150110030105-67",3,"2015-09-27 21:24:00",1443414240,"C7",595740,1444009980,"2015-10-04 18:53:00"
"2715","20151215011211-758",1,"2015-09-27 22:21:00",1443417660,"C5",152820,1443570480,"2015-09-29 16:48:00"
"1953","20154512044556-370",2,"2015-09-28 00:13:00",1443424380,"C5",165360,1443589740,"2015-09-29 22:09:00"
"1968","20153119113110-269",1,"2015-09-28 01:34:00",1443429240,"C5",247260,1443676500,"2015-09-30 22:15:00"
"182","20150417010430-97",1,"2015-09-28 03:49:00",1443437340,"C8",183420,1443620760,"2015-09-30 06:46:00"
"1604","20155024015031-756",3,"2015-09-28 04:06:00",1443438360,"C3",373620,1443811980,"2015-10-02 11:53:00"
"4356","20150625070608-126",1,"2015-09-28 04:50:00",1443441000,"C4",125520,1443566520,"2015-09-29 15:42:00"
"2206","20154220054254-247",3,"2015-09-28 05:50:00",1443444600,"C2",92640,1443537240,"2015-09-29 07:34:00"
"6245","20154922094908-595",1,"2015-09-28 05:58:00",1443445080,"C0",1060980,1444506060,"2015-10-10 12:41:00"
"6479","20150913060926-359",1,"2015-09-28 06:11:00",1443445860,"C8",185160,1443631020,"2015-09-30 09:37:00"
"2252","20151814091851-213",1,"2015-09-28 06:16:00",1443446160,"C8",599340,1444045500,"2015-10-05 04:45:00"
"2731","20150111090110-546",2,"2015-09-28 06:24:00",1443446640,"C4",973740,1444420380,"2015-10-09 12:53:00"
"2790","20154019064052-72",2,"2015-09-28 06:37:00",1443447420,"C0",111060,1443558480,"2015-09-29 13:28:00"
"6420","20151019021027-10",2,"2015-09-28 07:04:00",1443449040,"C7",376020,1443825060,"2015-10-02 15:31:00"
"5550","20150818100801-621",3,"2015-09-28 08:15:00",1443453300,"C8",122460,1443575760,"2015-09-29 18:16:00"
"1644","20152724022701-346",1,"2015-09-28 08:24:00",1443453840,"C5",107940,1443561780,"2015-09-29 14:23:00"
"6013","20154330024325-110",1,"2015-09-28 08:49:00",1443455340,"C6",414060,1443869400,"2015-10-03 03:50:00"
"2163","20155825105841-374",1,"2015-09-28 08:56:00",1443455760,"C8",125940,1443581700,"2015-09-29 19:55:00"
"5544","20155131115159-825",3,"2015-09-28 09:59:00",1443459540,"C5",344640,1443804180,"2015-10-02 09:43:00"
"2759","20150926060947-3",1,"2015-09-28 11:29:00",1443464940,"C0",192000,1443656940,"2015-09-30 16:49:00"
"1753","20155116095155-952",2,"2015-09-28 12:12:00",1443467520,"C3",348420,1443815940,"2015-10-02 12:59:00"
"5551","20151007041045-624",1,"2015-09-28 12:42:00",1443469320,"C2",225240,1443694560,"2015-10-01 03:16:00"
"2248","20155726045730-46",1,"2015-09-28 13:09:00",1443470940,"C4",79560,1443550500,"2015-09-29 11:15:00"
"5317","20153126123126-309",3,"2015-09-28 15:26:00",1443479160,"C2",183300,1443662460,"2015-09-30 18:21:00"
"675","20153422023401-747",1,"2015-09-28 16:00:00",1443481200,"C2",261780,1443742980,"2015-10-01 16:43:00"
"5490","20152822052837-707",2,"2015-09-28 17:37:00",1443487020,"C2",518940,1444005960,"2015-10-04 17:46:00"
"5947","20151829071820-420",2,"2015-09-28 18:06:00",1443488760,"C4",375840,1443864600,"2015-10-03 02:30:00"
"350","20155002095022-451",2,"2015-09-28 18:55:00",1443491700,"C8",455820,1443947520,"2015-10-04 01:32:00"
"4246","20150307010338-210",2,"2015-09-28 19:07:00",1443492420,"C0",262320,1443754740,"2015-10-01 19:59:00"
"1513","20154823124859-777",3,"2015-09-28 19:45:00",1443494700,"C5",152340,1443647040,"2015-09-30 14:04:00"
"1733","20152922082911-839",2,"2015-09-28 20:15:00",1443496500,"C3",560760,1444057260,"2015-10-05 08:01:00"
"1534","20150908120959-737",2,"2015-09-28 20:42:00",1443498120,"C0",586260,1444084380,"2015-10-05 15:33:00"
"2191","20154525094552-398",1,"2015-09-28 20:48:00",1443498480,"C3",99660,1443598140,"2015-09-30 00:29:00"
"5766","20151817041849-523",2,"2015-09-28 21:21:00",1443500460,"C5",322860,1443823320,"2015-10-02 15:02:00"
"3122","20152912062950-917",1,"2015-09-28 21:49:00",1443502140,"C5",179700,1443681840,"2015-09-30 23:44:00"
"4517","20150103070112-250",3,"2015-09-28 21:57:00",1443502620,"C4",276720,1443779340,"2015-10-02 02:49:00"
"1891","20155823065837-106",1,"2015-09-28 23:13:00",1443507180,"C8",98100,1443605280,"2015-09-30 02:28:00"
"1885","20150326120302-265",1,"2015-09-28 23:48:00",1443509280,"C5",71700,1443580980,"2015-09-29 19:43:00"
"3369","20155126045131-960",1,"2015-09-28 23:55:00",1443509700,"C5",99120,1443608820,"2015-09-30 03:27:00"
"2058","20153726083749-370",1,"2015-09-29 00:09:00",1443510540,"C7",114360,1443624900,"2015-09-30 07:55:00"
"2816","20155022025040-869",3,"2015-09-29 01:14:00",1443514440,"C6",92640,1443607080,"2015-09-30 02:58:00"
"481","20155115045123-3",1,"2015-09-29 01:21:00",1443514860,"C0",576900,1444091760,"2015-10-05 17:36:00"
"2487","20154811074853-707",3,"2015-09-29 01:24:00",1443515040,"C4",510720,1444025760,"2015-10-04 23:16:00"
"6211","20152013052027-811",2,"2015-09-29 02:38:00",1443519480,"C3",443160,1443962640,"2015-10-04 05:44:00"
"643","20153524043531-670",1,"2015-09-29 03:10:00",1443521400,"C8",76740,1443598140,"2015-09-30 00:29:00"
"3463","20150902060920-793",2,"2015-09-29 04:00:00",1443524400,"C7",714780,1444239180,"2015-10-07 10:33:00"
"2298","20153123093148-981",1,"2015-09-29 04:11:00",1443525060,"C8",99840,1443624900,"2015-09-30 07:55:00"
"2655","20152926122925-922",1,"2015-09-29 04:23:00",1443525780,"C8",115020,1443640800,"2015-09-30 12:20:00"
"3348","20154402034422-248",1,"2015-09-29 04:43:00",1443526980,"C8",710220,1444237200,"2015-10-07 10:00:00"
"3822","20154027054037-715",1,"2015-09-29 05:00:00",1443528000,"C5",63600,1443591600,"2015-09-29 22:40:00"
"2557","20150819030822-252",2,"2015-09-29 05:20:00",1443529200,"C8",414360,1443943560,"2015-10-04 00:26:00"
"1445","20151412081447-295",1,"2015-09-29 06:22:00",1443532920,"C5",517560,1444050480,"2015-10-05 06:08:00"
"2523","20151727021712-641",1,"2015-09-29 06:27:00",1443533220,"C5",72300,1443605520,"2015-09-30 02:32:00"
"1063","20154114094103-483",1,"2015-09-29 06:48:00",1443534480,"C4",183660,1443718140,"2015-10-01 09:49:00"
"2686","20153725113714-643",2,"2015-09-29 06:58:00",1443535080,"C5",109620,1443644700,"2015-09-30 13:25:00"
"1012","20151619111656-337",2,"2015-09-29 07:03:00",1443535380,"C3",121260,1443656640,"2015-09-30 16:44:00"
"843","20150728030708-412",1,"2015-09-29 07:39:00",1443537540,"C2",342240,1443879780,"2015-10-03 06:43:00"
"2851","20150421060449-866",2,"2015-09-29 08:26:00",1443540360,"C8",349860,1443890220,"2015-10-03 09:37:00"
"1212","20152927012946-631",2,"2015-09-29 10:09:00",1443546540,"C6",160800,1443707340,"2015-10-01 06:49:00"
"3880","20150409100421-849",2,"2015-09-29 12:34:00",1443555240,"C8",347400,1443902640,"2015-10-03 13:04:00"
"1070","20151028071020-362",1,"2015-09-29 13:10:00",1443557400,"C6",108000,1443665400,"2015-09-30 19:10:00"
"2889","20150230070206-829",1,"2015-09-29 13:24:00",1443558240,"C7",373560,1443931800,"2015-10-03 21:10:00"
"257","20154719114724-517",2,"2015-09-29 13:49:00",1443559740,"C5",435660,1443995400,"2015-10-04 14:50:00"
"3425","20152227062258-532",2,"2015-09-29 13:56:00",1443560160,"C2",100020,1443660180,"2015-09-30 17:43:00"
"2501","20154230094206-93",1,"2015-09-29 14:26:00",1443561960,"C5",372720,1443934680,"2015-10-03 21:58:00"
"870","20155420115417-321",1,"2015-09-29 15:22:00",1443565320,"C2",768360,1444333680,"2015-10-08 12:48:00"
"5380","20153325073343-313",1,"2015-09-29 15:31:00",1443565860,"C6",374280,1443940140,"2015-10-03 23:29:00"
"5537","20153828093806-862",2,"2015-09-29 17:24:00",1443572640,"C0",114360,1443687000,"2015-10-01 01:10:00"
"4830","20154125084143-150",3,"2015-09-29 18:05:00",1443575100,"C8",189720,1443764820,"2015-10-01 22:47:00"
"1118","20152224022226-330",1,"2015-09-29 18:11:00",1443575460,"C0",445740,1444021200,"2015-10-04 22:00:00"
"6237","20150925030923-872",2,"2015-09-29 18:49:00",1443577740,"C0",179400,1443757140,"2015-10-01 20:39:00"
"534","20154419114439-303",1,"2015-09-29 18:56:00",1443578160,"C5",111240,1443689400,"2015-10-01 01:50:00"
"2838","20150021050036-788",3,"2015-09-29 19:00:00",1443578400,"C6",87300,1443665700,"2015-09-30 19:15:00"
"4381","20154725014705-617",2,"2015-09-29 19:21:00",1443579660,"C8",182820,1443762480,"2015-10-01 22:08:00"
"3438","20151624061651-753",1,"2015-09-29 20:04:00",1443582240,"C2",451440,1444033680,"2015-10-05 01:28:00"
"6271","20151825051820-653",3,"2015-09-29 20:30:00",1443583800,"C4",44640,1443628440,"2015-09-30 08:54:00"
"862","20150018080022-664",1,"2015-09-29 20:54:00",1443585240,"C7",110760,1443696000,"2015-10-01 03:40:00"
"2614","20152611022615-260",1,"2015-09-29 21:26:00",1443587160,"C4",608400,1444195560,"2015-10-06 22:26:00"
"271","20151425091439-648",2,"2015-09-29 22:47:00",1443592020,"C6",394380,1443986400,"2015-10-04 12:20:00"
"5975","20155511125500-140",1,"2015-09-29 23:11:00",1443593460,"C2",868620,1444462080,"2015-10-10 00:28:00"
"3105","20152519102554-161",2,"2015-09-30 00:49:00",1443599340,"C4",114480,1443713820,"2015-10-01 08:37:00"
"6535","20151302071301-31",3,"2015-09-30 00:55:00",1443599700,"C4",342360,1443942060,"2015-10-04 00:01:00"
"3033","20152919062956-312",2,"2015-09-30 01:14:00",1443600840,"C2",310500,1443911340,"2015-10-03 15:29:00"
"280","20154826064823-183",1,"2015-09-30 02:49:00",1443606540,"C4",812580,1444419120,"2015-10-09 12:32:00"
"3811","20152027052026-10",3,"2015-09-30 03:08:00",1443607680,"C8",104040,1443711720,"2015-10-01 08:02:00"
"5643","20154027114042-147",1,"2015-09-30 03:22:00",1443608520,"C3",114660,1443723180,"2015-10-01 11:13:00"
"3274","20151623041644-600",1,"2015-09-30 07:29:00",1443623340,"C6",573180,1444196520,"2015-10-06 22:42:00"
"5085","20155711025756-499",3,"2015-09-30 07:53:00",1443624780,"C0",230880,1443855660,"2015-10-03 00:01:00"
"5099","20152420032414-663",1,"2015-09-30 08:12:00",1443625920,"C7",93120,1443719040,"2015-10-01 10:04:00"
"5659","20155916085912-350",3,"2015-09-30 08:27:00",1443626820,"C5",820560,1444447380,"2015-10-09 20:23:00"
"4178","20150605090648-40",1,"2015-09-30 08:59:00",1443628740,"C2",691140,1444319880,"2015-10-08 08:58:00"
"4614","20154519024544-322",2,"2015-09-30 09:18:00",1443629880,"C4",202740,1443832620,"2015-10-02 17:37:00"
"2229","20155227055231-464",3,"2015-09-30 12:04:00",1443639840,"C6",238320,1443878160,"2015-10-03 06:16:00"
"1955","20152820102827-437",3,"2015-09-30 12:20:00",1443640800,"C6",108840,1443749640,"2015-10-01 18:34:00"
"5248","20150327030331-456",1,"2015-09-30 12:54:00",1443642840,"C4",83820,1443726660,"2015-10-01 12:11:00"
"4960","20151026061007-244",1,"2015-09-30 14:34:00",1443648840,"C6",375840,1444024680,"2015-10-04 22:58:00"
"6288","20155724045747-509",2,"2015-09-30 14:42:00",1443649320,"C8",102060,1443751380,"2015-10-01 19:03:00"
"2413","20151625041658-913",2,"2015-09-30 14:51:00",1443649860,"C6",426900,1444076760,"2015-10-05 13:26:00"
"2667","20150729110716-839",1,"2015-09-30 15:15:00",1443651300,"C0",101280,1443752580,"2015-10-01 19:23:00"
"1514","20152115122135-105",3,"2015-09-30 15:18:00",1443651480,"C7",186660,1443838140,"2015-10-02 19:09:00"
"1951","20153624113634-748",2,"2015-09-30 16:39:00",1443656340,"C0",178860,1443835200,"2015-10-02 18:20:00"
"5877","20151919061903-547",1,"2015-09-30 16:59:00",1443657540,"C4",123600,1443781140,"2015-10-02 03:19:00"
"3055","20150816110851-751",2,"2015-09-30 17:32:00",1443659520,"C6",154080,1443813600,"2015-10-02 12:20:00"
"4250","20155015115025-738",3,"2015-09-30 17:42:00",1443660120,"C7",188160,1443848280,"2015-10-02 21:58:00"
"3871","20151011051048-783",1,"2015-09-30 18:22:00",1443662520,"C7",182880,1443845400,"2015-10-02 21:10:00"
"251","20155512045556-420",3,"2015-09-30 18:23:00",1443662580,"C2",529860,1444192440,"2015-10-06 21:34:00"
"5111","20151923031917-617",1,"2015-09-30 19:43:00",1443667380,"C2",620640,1444288020,"2015-10-08 00:07:00"
"1000","20152529062500-596",2,"2015-09-30 21:31:00",1443673860,"C6",140760,1443814620,"2015-10-02 12:37:00"
"5823","20153910063931-835",2,"2015-10-01 01:27:00",1443688020,"C5",224460,1443912480,"2015-10-03 15:48:00"
"1817","20151823021836-870",3,"2015-10-01 01:58:00",1443689880,"C7",92400,1443782280,"2015-10-02 03:38:00"
"2654","20153027033021-889",2,"2015-10-01 02:09:00",1443690540,"C5",99180,1443789720,"2015-10-02 05:42:00"
"3032","20152523012506-74",1,"2015-10-01 03:33:00",1443695580,"C3",81960,1443777540,"2015-10-02 02:19:00"
"2540","20153329123327-162",1,"2015-10-01 04:11:00",1443697860,"C5",71340,1443769200,"2015-10-02 00:00:00"
"331","20154717034744-602",3,"2015-10-01 04:27:00",1443698820,"C6",146100,1443844920,"2015-10-02 21:02:00"
"5577","20151925041908-320",3,"2015-10-01 04:43:00",1443699780,"C8",450720,1444150500,"2015-10-06 09:55:00"
"3446","20154928014949-969",1,"2015-10-01 06:25:00",1443705900,"C8",116280,1443822180,"2015-10-02 14:43:00"
"2032","20154515054556-394",2,"2015-10-01 06:28:00",1443706080,"C5",956940,1444663020,"2015-10-12 08:17:00"
"3513","20150314060301-241",3,"2015-10-01 07:57:00",1443711420,"C5",737820,1444449240,"2015-10-09 20:54:00"
"4883","20152925062903-447",1,"2015-10-01 07:59:00",1443711540,"C2",261900,1443973440,"2015-10-04 08:44:00"
"2068","20153023073030-973",1,"2015-10-01 08:28:00",1443713280,"C8",99240,1443812520,"2015-10-02 12:02:00"
"2316","20154212084212-789",1,"2015-10-01 08:44:00",1443714240,"C5",617160,1444331400,"2015-10-08 12:10:00"
"5291","20150427050456-122",1,"2015-10-01 09:58:00",1443718680,"C8",45720,1443764400,"2015-10-01 22:40:00"
"5053","20151024091033-928",2,"2015-10-01 10:27:00",1443720420,"C5",87060,1443807480,"2015-10-02 10:38:00"
"4699","20155310085325-400",2,"2015-10-01 11:41:00",1443724860,"C7",260640,1443985500,"2015-10-04 12:05:00"
"6233","20155823045848-67",2,"2015-10-01 11:48:00",1443725280,"C8",134520,1443859800,"2015-10-03 01:10:00"
"6418","20155626055623-547",1,"2015-10-01 12:35:00",1443728100,"C3",412740,1444140840,"2015-10-06 07:14:00"
"5869","20153901053918-352",1,"2015-10-01 12:43:00",1443728580,"C2",321780,1444050360,"2015-10-05 06:06:00"
"2839","20155429055432-113",1,"2015-10-01 12:49:00",1443728940,"C4",154500,1443883440,"2015-10-03 07:44:00"
"3866","20151225051248-279",2,"2015-10-01 13:14:00",1443730440,"C4",252060,1443982500,"2015-10-04 11:15:00"
"3622","20153115083129-294",2,"2015-10-01 13:37:00",1443731820,"C2",466920,1444198740,"2015-10-06 23:19:00"
"6066","20155203015220-852",3,"2015-10-01 13:52:00",1443732720,"C3",345600,1444078320,"2015-10-05 13:52:00"
"1645","20151423061421-949",2,"2015-10-01 14:14:00",1443734040,"C5",360000,1444094040,"2015-10-05 18:14:00"
"2668","20155328085310-805",2,"2015-10-01 15:03:00",1443736980,"C6",281400,1444018380,"2015-10-04 21:13:00"
"4482","20153613083644-306",1,"2015-10-01 15:40:00",1443739200,"C4",197580,1443936780,"2015-10-03 22:33:00"
"5955","20150329030356-86",1,"2015-10-01 16:17:00",1443741420,"C4",177240,1443918660,"2015-10-03 17:31:00"
"5284","20152012122057-909",3,"2015-10-01 16:49:00",1443743340,"C2",236820,1443980160,"2015-10-04 10:36:00"
"4909","20150411050432-27",1,"2015-10-01 17:24:00",1443745440,"C8",345840,1444091280,"2015-10-05 17:28:00"
"267","20155711115749-167",1,"2015-10-01 19:01:00",1443751260,"C6",888780,1444640040,"2015-10-12 01:54:00"
"1457","20153710073725-591",2,"2015-10-01 19:59:00",1443754740,"C8",265560,1444020300,"2015-10-04 21:45:00"
"6224","20152504102537-658",2,"2015-10-01 20:46:00",1443757560,"C7",338580,1444096140,"2015-10-05 18:49:00"
"3895","20152328102355-953",1,"2015-10-01 20:49:00",1443757740,"C6",296760,1444054500,"2015-10-05 07:15:00"
"2411","20155024105051-288",3,"2015-10-01 20:53:00",1443757980,"C4",213660,1443971640,"2015-10-04 08:14:00"
"739","20150229120212-565",1,"2015-10-01 21:15:00",1443759300,"C3",205980,1443965280,"2015-10-04 06:28:00"
"4619","20150828050833-517",1,"2015-10-01 21:35:00",1443760500,"C5",91740,1443852240,"2015-10-02 23:04:00"
"5123","20150930110949-443",1,"2015-10-01 22:21:00",1443763260,"C0",350640,1444113900,"2015-10-05 23:45:00"
"1744","20150419110400-987",2,"2015-10-01 23:22:00",1443766920,"C8",154440,1443921360,"2015-10-03 18:16:00"
"4555","20151727121757-443",1,"2015-10-01 23:33:00",1443767580,"C5",193080,1443960660,"2015-10-04 05:11:00"
"3174","20152027062057-241",2,"2015-10-02 00:08:00",1443769680,"C5",204840,1443974520,"2015-10-04 09:02:00"
"3459","20151521021503-834",1,"2015-10-02 03:07:00",1443780420,"C5",455160,1444235580,"2015-10-07 09:33:00"
"3148","20153923093923-432",3,"2015-10-02 04:21:00",1443784860,"C8",108360,1443893220,"2015-10-03 10:27:00"
"4829","20155330055334-238",3,"2015-10-02 04:25:00",1443785100,"C4",350340,1444135440,"2015-10-06 05:44:00"
"3247","20155304085320-560",1,"2015-10-02 05:30:00",1443789000,"C3",343860,1444132860,"2015-10-06 05:01:00"
"1969","20155923115946-322",2,"2015-10-02 06:21:00",1443792060,"C0",378660,1444170720,"2015-10-06 15:32:00"
"1875","20150117100126-822",2,"2015-10-02 06:33:00",1443792780,"C8",641760,1444434540,"2015-10-09 16:49:00"
"130","20154928114954-255",1,"2015-10-02 06:37:00",1443793020,"C5",375660,1444168680,"2015-10-06 14:58:00"
"3659","20153517113533-488",2,"2015-10-02 06:55:00",1443794100,"C8",255840,1444049940,"2015-10-05 05:59:00"
"146","20152224062251-834",2,"2015-10-02 07:10:00",1443795000,"C4",86760,1443881760,"2015-10-03 07:16:00"
"6469","20152721082747-925",1,"2015-10-02 07:46:00",1443797160,"C5",135420,1443932580,"2015-10-03 21:23:00"
"1448","20150811080802-300",3,"2015-10-02 08:08:00",1443798480,"C2",259200,1444057680,"2015-10-05 08:08:00"
"6493","20153425023446-675",1,"2015-10-02 08:58:00",1443801480,"C5",83520,1443885000,"2015-10-03 08:10:00"
"5151","20155925115933-802",2,"2015-10-02 10:47:00",1443808020,"C0",200160,1444008180,"2015-10-04 18:23:00"
"5990","20154324014310-391",1,"2015-10-02 11:25:00",1443810300,"C4",97560,1443907860,"2015-10-03 14:31:00"
"2372","20154927084908-110",2,"2015-10-02 12:57:00",1443815820,"C4",446880,1444262700,"2015-10-07 17:05:00"
"2917","20151428061409-269",1,"2015-10-02 13:04:00",1443816240,"C7",185100,1444001340,"2015-10-04 16:29:00"
"4267","20150218020235-744",2,"2015-10-02 14:30:00",1443821400,"C8",173040,1443994440,"2015-10-04 14:34:00"
"4282","20154815114839-956",1,"2015-10-02 14:36:00",1443821760,"C6",184860,1444006620,"2015-10-04 17:57:00"
"4911","20154323124336-960",3,"2015-10-02 15:03:00",1443823380,"C8",1228560,1445051940,"2015-10-16 20:19:00"
"4543","20155726125730-585",1,"2015-10-02 16:49:00",1443829740,"C5",66540,1443896280,"2015-10-03 11:18:00"
"6160","20154626064612-785",1,"2015-10-02 17:10:00",1443831000,"C4",739080,1444570080,"2015-10-11 06:28:00"
"1594","20150722010749-2",1,"2015-10-02 17:25:00",1443831900,"C0",439740,1444271640,"2015-10-07 19:34:00"
"1997","20154817014854-170",2,"2015-10-02 19:48:00",1443840480,"C7",146400,1443986880,"2015-10-04 12:28:00"
"1381","20151623111631-719",1,"2015-10-02 20:04:00",1443841440,"C5",101160,1443942600,"2015-10-04 00:10:00"
"3331","20151628071608-385",3,"2015-10-02 20:04:00",1443841440,"C5",195840,1444037280,"2015-10-05 02:28:00"
"484","20155017105034-330",2,"2015-10-02 22:58:00",1443851880,"C4",167460,1444019340,"2015-10-04 21:29:00"
"1870","20155122115118-223",1,"2015-10-03 01:03:00",1443859380,"C4",113940,1443973320,"2015-10-04 08:42:00"
"3846","20155922085938-836",1,"2015-10-03 02:00:00",1443862800,"C2",132180,1443994980,"2015-10-04 14:43:00"
"886","20152013102004-55",1,"2015-10-03 02:04:00",1443863040,"C4",849120,1444712160,"2015-10-12 21:56:00"
"3861","20150326040316-459",1,"2015-10-03 03:42:00",1443868920,"C2",186780,1444055700,"2015-10-05 07:35:00"
"5883","20151925101910-391",2,"2015-10-03 04:07:00",1443870420,"C6",111480,1443981900,"2015-10-04 11:05:00"
"1154","20151204111220-934",2,"2015-10-03 04:09:00",1443870540,"C7",275580,1444146120,"2015-10-06 08:42:00"
"4688","20150223100216-408",2,"2015-10-03 04:26:00",1443871560,"C4",105480,1443977040,"2015-10-04 09:44:00"
"5138","20155611055631-743",2,"2015-10-03 04:26:00",1443871560,"C0",264600,1444136160,"2015-10-06 05:56:00"
"1085","20151526091530-569",1,"2015-10-03 04:39:00",1443872340,"C5",196080,1444068420,"2015-10-05 11:07:00"
"2251","20153622093633-893",2,"2015-10-03 05:04:00",1443873840,"C4",451560,1444325400,"2015-10-08 10:30:00"
"4656","20152723022703-590",1,"2015-10-03 05:39:00",1443875940,"C1",1097640,1444973580,"2015-10-15 22:33:00"
"5904","20150326110322-354",2,"2015-10-03 08:57:00",1443887820,"C6",99540,1443987360,"2015-10-04 12:36:00"
"820","20152826012855-73",3,"2015-10-03 09:43:00",1443890580,"C0",197100,1444087680,"2015-10-05 16:28:00"
"181","20155204055234-952",3,"2015-10-03 10:27:00",1443893220,"C8",1567140,1445460360,"2015-10-21 13:46:00"
"6301","20151103031107-509",1,"2015-10-03 10:31:00",1443893460,"C2",656700,1444550160,"2015-10-11 00:56:00"
"6045","20150215070210-159",1,"2015-10-03 11:15:00",1443896100,"C7",224340,1444120440,"2015-10-06 01:34:00"
"23","20151829011833-716",1,"2015-10-03 11:18:00",1443896280,"C1",949200,1444845480,"2015-10-14 10:58:00"
"4521","20153712113749-782",1,"2015-10-03 11:30:00",1443897000,"C5",259140,1444156140,"2015-10-06 11:29:00"
"2453","20153524023526-802",3,"2015-10-03 11:44:00",1443897840,"C2",109620,1444007460,"2015-10-04 18:11:00"
"953","20155431125412-835",3,"2015-10-03 11:53:00",1443898380,"C0",789420,1444687800,"2015-10-12 15:10:00"
"4298","20154824124832-402",2,"2015-10-03 12:45:00",1443901500,"C2",111060,1444012560,"2015-10-04 19:36:00"
"4249","20151502121513-669",1,"2015-10-03 13:27:00",1443904020,"C6",893520,1444797540,"2015-10-13 21:39:00"
"6457","20150229070254-204",1,"2015-10-03 13:28:00",1443904080,"C4",368760,1444272840,"2015-10-07 19:54:00"
"760","20151619091608-327",2,"2015-10-03 14:52:00",1443909120,"C5",175680,1444084800,"2015-10-05 15:40:00"
"2733","20154421054430-525",1,"2015-10-03 16:30:00",1443915000,"C2",147480,1444062480,"2015-10-05 09:28:00"
"4111","20153201013211-268",3,"2015-10-03 16:36:00",1443915360,"C2",681780,1444597140,"2015-10-11 13:59:00"
"2808","20152819022855-141",1,"2015-10-03 17:01:00",1443916860,"C7",1018620,1444935480,"2015-10-15 11:58:00"
"2048","20150028030051-590",3,"2015-10-03 17:15:00",1443917700,"C5",445500,1444363200,"2015-10-08 21:00:00"
"1539","20151812031807-51",1,"2015-10-03 17:18:00",1443917880,"C5",607200,1444525080,"2015-10-10 17:58:00"
"5549","20150206070250-791",1,"2015-10-03 17:20:00",1443918000,"C6",394980,1444312980,"2015-10-08 07:03:00"
"6273","20154025084030-323",2,"2015-10-03 17:40:00",1443919200,"C5",361800,1444281000,"2015-10-07 22:10:00"
"3533","20151121121131-715",3,"2015-10-03 19:29:00",1443925740,"C4",354360,1444280100,"2015-10-07 21:55:00"
"6367","20154829024816-982",2,"2015-10-03 19:45:00",1443926700,"C2",363420,1444290120,"2015-10-08 00:42:00"
"4536","20152717052750-615",3,"2015-10-03 20:17:00",1443928620,"C7",696300,1444624920,"2015-10-11 21:42:00"
"687","20155030125002-922",3,"2015-10-03 21:05:00",1443931500,"C2",96300,1444027800,"2015-10-04 23:50:00"
"3092","20154524034503-939",3,"2015-10-03 21:05:00",1443931500,"C0",99600,1444031100,"2015-10-05 00:45:00"
"4758","20150430090433-512",2,"2015-10-03 21:52:00",1443934320,"C2",707760,1444642080,"2015-10-12 02:28:00"
"5191","20153321073305-157",2,"2015-10-03 22:09:00",1443935340,"C8",544680,1444480020,"2015-10-10 05:27:00"
"1235","20153220073240-457",2,"2015-10-03 22:29:00",1443936540,"C2",392340,1444328880,"2015-10-08 11:28:00"
"4510","20152621062629-429",2,"2015-10-03 22:41:00",1443937260,"C5",539100,1444476360,"2015-10-10 04:26:00"
"3384","20154316024349-453",2,"2015-10-03 22:58:00",1443938280,"C2",596700,1444534980,"2015-10-10 20:43:00"
"1194","20155928015947-290",2,"2015-10-03 23:26:00",1443939960,"C3",155340,1444095300,"2015-10-05 18:35:00"
"6162","20153721073748-885",1,"2015-10-03 23:47:00",1443941220,"C8",219000,1444160220,"2015-10-06 12:37:00"
"1420","20155929045919-954",2,"2015-10-04 00:08:00",1443942480,"C3",1016580,1444959060,"2015-10-15 18:31:00"
"1789","20151314011311-1",3,"2015-10-04 00:33:00",1443943980,"C2",545100,1444489080,"2015-10-10 07:58:00"
"4775","20152501062522-694",2,"2015-10-04 00:45:00",1443944700,"C4",119400,1444064100,"2015-10-05 09:55:00"
"6146","20153925063909-84",3,"2015-10-04 00:45:00",1443944700,"C2",378180,1444322880,"2015-10-08 09:48:00"
"1148","20152620092652-624",2,"2015-10-04 02:33:00",1443951180,"C4",169260,1444120440,"2015-10-06 01:34:00"
"4043","20153730063725-217",1,"2015-10-04 03:14:00",1443953640,"C7",430260,1444383900,"2015-10-09 02:45:00"
"4740","20152524122527-579",1,"2015-10-04 03:18:00",1443953880,"C4",118740,1444072620,"2015-10-05 12:17:00"
"4101","20152006062007-464",2,"2015-10-04 03:32:00",1443954720,"C6",301140,1444255860,"2015-10-07 15:11:00"
"2769","20153902113957-47",3,"2015-10-04 03:47:00",1443955620,"C5",72240,1444027860,"2015-10-04 23:51:00"
"4500","20151904071915-758",2,"2015-10-04 04:19:00",1443957540,"C7",286800,1444244340,"2015-10-07 11:59:00"
"385","20155826025824-717",2,"2015-10-04 07:08:00",1443967680,"C5",331500,1444299180,"2015-10-08 03:13:00"
"3982","20152927082906-285",1,"2015-10-04 08:36:00",1443972960,"C8",86460,1444059420,"2015-10-05 08:37:00"
"5802","20151729051737-48",1,"2015-10-04 08:59:00",1443974340,"C5",134040,1444108380,"2015-10-05 22:13:00"
"2361","20150429100402-347",1,"2015-10-04 10:40:00",1443980400,"C5",217080,1444197480,"2015-10-06 22:58:00"
"117","20152631082611-613",2,"2015-10-04 11:11:00",1443982260,"C7",803700,1444785960,"2015-10-13 18:26:00"
"5842","20153430033444-725",2,"2015-10-04 11:58:00",1443985080,"C4",166320,1444151400,"2015-10-06 10:10:00"
"5049","20151128111144-648",2,"2015-10-04 12:26:00",1443986760,"C7",74700,1444061460,"2015-10-05 09:11:00"
"6322","20154623014627-670",2,"2015-10-04 12:50:00",1443988200,"C5",517920,1444506120,"2015-10-10 12:42:00"
"591","20152325042329-787",1,"2015-10-04 13:29:00",1443990540,"C3",255720,1444246260,"2015-10-07 12:31:00"
"1452","20155525115508-896",2,"2015-10-04 14:19:00",1443993540,"C3",112320,1444105860,"2015-10-05 21:31:00"
"5858","20150026120010-942",2,"2015-10-04 14:42:00",1443994920,"C0",350460,1444345380,"2015-10-08 16:03:00"
"6334","20153912103945-821",2,"2015-10-04 14:44:00",1443995040,"C8",383100,1444378140,"2015-10-09 01:09:00"
"996","20155526065554-981",1,"2015-10-04 15:11:00",1443996660,"C2",360480,1444357140,"2015-10-08 19:19:00"
"2325","20150627110636-691",2,"2015-10-04 15:38:00",1443998280,"C5",412440,1444410720,"2015-10-09 10:12:00"
"4749","20151526081527-704",2,"2015-10-04 16:27:00",1444001220,"C2",102960,1444104180,"2015-10-05 21:03:00"
"63","20154018024040-960",1,"2015-10-04 17:10:00",1444003800,"C5",581400,1444585200,"2015-10-11 10:40:00"
"5919","20151914101910-853",2,"2015-10-04 18:27:00",1444008420,"C7",251040,1444259460,"2015-10-07 16:11:00"
"905","20153030073006-385",2,"2015-10-04 18:30:00",1444008600,"C8",192600,1444201200,"2015-10-07 00:00:00"
"3899","20150328070359-611",1,"2015-10-04 19:44:00",1444013040,"C3",80580,1444093620,"2015-10-05 18:07:00"
"3340","20155229035205-191",2,"2015-10-04 20:00:00",1444014000,"C0",223440,1444237440,"2015-10-07 10:04:00"
"612","20154824034835-889",2,"2015-10-04 20:13:00",1444014780,"C8",175980,1444190760,"2015-10-06 21:06:00"
"5058","20152028092031-391",2,"2015-10-04 20:18:00",1444015080,"C3",278940,1444294020,"2015-10-08 01:47:00"
"4537","20152610092600-874",1,"2015-10-04 20:23:00",1444015380,"C7",301860,1444317240,"2015-10-08 08:14:00"
"2121","20155419015446-344",1,"2015-10-04 21:06:00",1444017960,"C5",165240,1444183200,"2015-10-06 19:00:00"
"3129","20153613033606-451",2,"2015-10-04 21:18:00",1444018680,"C0",611640,1444630320,"2015-10-11 23:12:00"
"4045","20151929021932-254",1,"2015-10-04 22:34:00",1444023240,"C8",92340,1444115580,"2015-10-06 00:13:00"
"2221","20152130032113-173",2,"2015-10-04 22:50:00",1444024200,"C4",372540,1444396740,"2015-10-09 06:19:00"
"3976","20150824070825-886",3,"2015-10-04 23:44:00",1444027440,"C0",307920,1444335360,"2015-10-08 13:16:00"
"5666","20151118101124-666",3,"2015-10-05 00:03:00",1444028580,"C5",179040,1444207620,"2015-10-07 01:47:00"
"5532","20151912111905-652",1,"2015-10-05 02:15:00",1444036500,"C5",977280,1445013780,"2015-10-16 09:43:00"
"5835","20151107021135-737",3,"2015-10-05 04:09:00",1444043340,"C5",340440,1444383780,"2015-10-09 02:43:00"
"1742","20153329043333-913",1,"2015-10-05 04:39:00",1444045140,"C6",79260,1444124400,"2015-10-06 02:40:00"
"4628","20153305023343-499",2,"2015-10-05 04:42:00",1444045320,"C5",365220,1444410540,"2015-10-09 10:09:00"
"998","20152226092250-865",1,"2015-10-05 06:56:00",1444053360,"C4",384420,1444437780,"2015-10-09 17:43:00"
"3654","20150530120541-89",1,"2015-10-05 07:29:00",1444055340,"C2",207720,1444263060,"2015-10-07 17:11:00"
"3743","20155826055856-580",1,"2015-10-05 08:46:00",1444059960,"C6",762660,1444822620,"2015-10-14 04:37:00"
"1105","20151229111259-568",1,"2015-10-05 09:24:00",1444062240,"C2",170640,1444232880,"2015-10-07 08:48:00"
"6139","20153425083416-909",1,"2015-10-05 09:31:00",1444062660,"C3",289140,1444351800,"2015-10-08 17:50:00"
"3561","20152328112352-194",1,"2015-10-05 12:33:00",1444073580,"C2",87000,1444160580,"2015-10-06 12:43:00"
"4291","20154925034909-164",2,"2015-10-05 12:59:00",1444075140,"C8",170760,1444245900,"2015-10-07 12:25:00"
"5681","20151826041854-598",1,"2015-10-05 13:09:00",1444075740,"C2",255420,1444331160,"2015-10-08 12:06:00"
"2289","20155128015133-316",1,"2015-10-05 14:15:00",1444079700,"C6",410580,1444490280,"2015-10-10 08:18:00"
"1483","20150009040035-292",1,"2015-10-05 14:48:00",1444081680,"C3",280260,1444361940,"2015-10-08 20:39:00"
"5699","20151821011808-722",1,"2015-10-05 15:06:00",1444082760,"C0",608040,1444690800,"2015-10-12 16:00:00"
"4509","20150818060847-607",1,"2015-10-05 15:13:00",1444083180,"C3",214500,1444297680,"2015-10-08 02:48:00"
"895","20152317102301-124",3,"2015-10-05 16:05:00",1444086300,"C3",990360,1445076660,"2015-10-17 03:11:00"
"1117","20154821124817-368",1,"2015-10-05 17:54:00",1444092840,"C7",434040,1444526880,"2015-10-10 18:28:00"
"5566","20155225085241-468",2,"2015-10-05 18:04:00",1444093440,"C4",128160,1444221600,"2015-10-07 05:40:00"
"4416","20153824093852-393",1,"2015-10-05 18:26:00",1444094760,"C2",122760,1444217520,"2015-10-07 04:32:00"
"3087","20155231105239-338",2,"2015-10-05 18:28:00",1444094880,"C6",508560,1444603440,"2015-10-11 15:44:00"
"1962","20152529072547-796",2,"2015-10-05 21:34:00",1444106040,"C3",189780,1444295820,"2015-10-08 02:17:00"
"1400","20151729021748-498",2,"2015-10-05 21:47:00",1444106820,"C7",60600,1444167420,"2015-10-06 14:37:00"
"4755","20155310125342-214",2,"2015-10-05 23:08:00",1444111680,"C8",439380,1444551060,"2015-10-11 01:11:00"
"3606","20150108060137-927",2,"2015-10-05 23:36:00",1444113360,"C4",342300,1444455660,"2015-10-09 22:41:00"
"5652","20152028112022-449",1,"2015-10-06 00:14:00",1444115640,"C5",325620,1444441260,"2015-10-09 18:41:00"
"5423","20155326075351-224",3,"2015-10-06 00:59:00",1444118340,"C7",119880,1444238220,"2015-10-07 10:17:00"
"2405","20152925012926-304",2,"2015-10-06 01:43:00",1444120980,"C4",454020,1444575000,"2015-10-11 07:50:00"
"1606","20153024013035-807",3,"2015-10-06 01:48:00",1444121280,"C7",408120,1444529400,"2015-10-10 19:10:00"
"3303","20152215092206-481",1,"2015-10-06 03:54:00",1444128840,"C0",893940,1445022780,"2015-10-16 12:13:00"
"3264","20154812074833-507",2,"2015-10-06 04:20:00",1444130400,"C5",257640,1444388040,"2015-10-09 03:54:00"
"303","20153231063236-320",3,"2015-10-06 05:12:00",1444133520,"C4",388200,1444521720,"2015-10-10 17:02:00"
"5459","20155029085047-891",3,"2015-10-06 05:12:00",1444133520,"C7",467160,1444600680,"2015-10-11 14:58:00"
"3576","20150625040628-192",1,"2015-10-06 05:16:00",1444133760,"C8",182280,1444316040,"2015-10-08 07:54:00"
"6374","20150414050436-933",1,"2015-10-06 05:28:00",1444134480,"C5",232380,1444366860,"2015-10-08 22:01:00"
"2887","20155228015220-418",2,"2015-10-06 06:40:00",1444138800,"C4",332640,1444471440,"2015-10-10 03:04:00"
"6112","20152230022253-963",1,"2015-10-06 06:44:00",1444139040,"C8",245460,1444384500,"2015-10-09 02:55:00"
"1122","20155127035102-451",2,"2015-10-06 07:24:00",1444141440,"C2",106740,1444248180,"2015-10-07 13:03:00"
"5145","20151628111650-794",2,"2015-10-06 08:04:00",1444143840,"C4",419760,1444563600,"2015-10-11 04:40:00"
"1322","20154529104539-756",1,"2015-10-06 09:33:00",1444149180,"C7",66720,1444215900,"2015-10-07 04:05:00"
"4349","20154911094955-742",1,"2015-10-06 09:48:00",1444150080,"C4",1073820,1445223900,"2015-10-18 20:05:00"
"745","20154303064359-839",1,"2015-10-06 10:04:00",1444151040,"C5",954420,1445105460,"2015-10-17 11:11:00"
"1956","20150327050342-760",1,"2015-10-06 10:12:00",1444151520,"C4",250980,1444402500,"2015-10-09 07:55:00"
"6272","20153707073715-128",2,"2015-10-06 10:17:00",1444151820,"C3",984000,1445135820,"2015-10-17 19:37:00"
"6278","20155026015014-82",1,"2015-10-06 11:21:00",1444155660,"C7",504780,1444660440,"2015-10-12 07:34:00"
"3279","20150326110308-543",1,"2015-10-06 11:27:00",1444156020,"C4",108180,1444264200,"2015-10-07 17:30:00"
"950","20152627032636-64",3,"2015-10-06 11:34:00",1444156440,"C2",430260,1444586700,"2015-10-11 11:05:00"
"989","20150108060104-840",1,"2015-10-06 12:58:00",1444161480,"C5",814740,1444976220,"2015-10-15 23:17:00"
"246","20150230110247-212",3,"2015-10-06 14:00:00",1444165200,"C3",264540,1444429740,"2015-10-09 15:29:00"
"1506","20153217013250-235",1,"2015-10-06 16:58:00",1444175880,"C3",236280,1444412160,"2015-10-09 10:36:00"
"6131","20155420055422-20",1,"2015-10-06 17:26:00",1444177560,"C5",690360,1444867920,"2015-10-14 17:12:00"
"3850","20150726120703-149",2,"2015-10-06 18:01:00",1444179660,"C2",295080,1444474740,"2015-10-10 03:59:00"
"1863","20153412033403-441",1,"2015-10-06 19:02:00",1444183320,"C2",930360,1445113680,"2015-10-17 13:28:00"
"4986","20150826030836-996",1,"2015-10-06 19:40:00",1444185600,"C4",110040,1444295640,"2015-10-08 02:14:00"
"2617","20150016070037-632",3,"2015-10-06 19:41:00",1444185660,"C7",253380,1444439040,"2015-10-09 18:04:00"
"4896","20155525025528-862",2,"2015-10-06 22:37:00",1444196220,"C5",326040,1444522260,"2015-10-10 17:11:00"
"4002","20154725064714-647",2,"2015-10-07 00:07:00",1444201620,"C0",461400,1444663020,"2015-10-12 08:17:00"
"4287","20151913061921-545",2,"2015-10-07 01:10:00",1444205400,"C4",293580,1444498980,"2015-10-10 10:43:00"
"6032","20155930055927-156",2,"2015-10-07 02:44:00",1444211040,"C4",183300,1444394340,"2015-10-09 05:39:00"
"5710","20150805040827-754",3,"2015-10-07 03:36:00",1444214160,"C2",339960,1444554120,"2015-10-11 02:02:00"
"4643","20150029020040-164",1,"2015-10-07 03:48:00",1444214880,"C7",72720,1444287600,"2015-10-08 00:00:00"
"4354","20154427014449-383",2,"2015-10-07 05:05:00",1444219500,"C5",277620,1444497120,"2015-10-10 10:12:00"
"66","20152508082517-666",1,"2015-10-07 05:24:00",1444220640,"C5",739020,1444959660,"2015-10-15 18:41:00"
"1912","20151719031705-396",1,"2015-10-07 05:53:00",1444222380,"C5",507120,1444729500,"2015-10-13 02:45:00"
"4895","20154827014803-602",3,"2015-10-07 05:54:00",1444222440,"C5",278520,1444500960,"2015-10-10 11:16:00"
"53","20150429080444-356",3,"2015-10-07 06:26:00",1444224360,"C4",342660,1444567020,"2015-10-11 05:37:00"
"3570","20155426015439-228",3,"2015-10-07 07:57:00",1444229820,"C7",515340,1444745160,"2015-10-13 07:06:00"
"807","20153515033550-824",1,"2015-10-07 08:15:00",1444230900,"C5",234300,1444465200,"2015-10-10 01:20:00"
"4615","20154519024544-322",2,"2015-10-07 08:49:00",1444232940,"C4",202560,1444435500,"2015-10-09 17:05:00"
"3095","20154719084741-65",3,"2015-10-07 08:53:00",1444233180,"C5",518520,1444751700,"2015-10-13 08:55:00"
"3448","20152930122926-301",3,"2015-10-07 10:26:00",1444238760,"C4",199140,1444437900,"2015-10-09 17:45:00"
"1897","20153914123920-944",1,"2015-10-07 12:07:00",1444244820,"C3",248160,1444492980,"2015-10-10 09:03:00"
"5581","20152923092919-201",1,"2015-10-07 13:23:00",1444249380,"C7",731160,1444980540,"2015-10-16 00:29:00"
"4662","20155120055142-403",1,"2015-10-07 13:58:00",1444251480,"C4",590460,1444841940,"2015-10-14 09:59:00"
"1918","20151529051508-917",1,"2015-10-07 14:09:00",1444252140,"C4",680040,1444932180,"2015-10-15 11:03:00"
"1929","20152729052719-451",1,"2015-10-07 14:23:00",1444252980,"C4",419820,1444672800,"2015-10-12 11:00:00"
"743","20150729080703-389",1,"2015-10-07 14:25:00",1444253100,"C5",356940,1444610040,"2015-10-11 17:34:00"
"3043","20153230023251-365",1,"2015-10-07 19:47:00",1444272420,"C7",89100,1444361520,"2015-10-08 20:32:00"
"4925","20151617021605-748",1,"2015-10-07 19:58:00",1444273080,"C5",874260,1445147340,"2015-10-17 22:49:00"
"2683","20152606012640-366",1,"2015-10-07 21:02:00",1444276920,"C4",338220,1444615140,"2015-10-11 18:59:00"
"2492","20150825120831-381",1,"2015-10-07 22:05:00",1444280700,"C0",357540,1444638240,"2015-10-12 01:24:00"
"3766","20151810061830-545",1,"2015-10-08 00:03:00",1444287780,"C5",798900,1445086680,"2015-10-17 05:58:00"
"4052","20153928053902-838",1,"2015-10-08 01:47:00",1444294020,"C5",770460,1445064480,"2015-10-16 23:48:00"
"5501","20152320082354-550",3,"2015-10-08 01:59:00",1444294740,"C5",510720,1444805460,"2015-10-13 23:51:00"
"4987","20155921075955-560",1,"2015-10-08 02:29:00",1444296540,"C4",207000,1444503540,"2015-10-10 11:59:00"
"2892","20152720032733-633",1,"2015-10-08 04:31:00",1444303860,"C5",189480,1444493340,"2015-10-10 09:09:00"
"2987","20152327072324-277",2,"2015-10-08 05:31:00",1444307460,"C4",117960,1444425420,"2015-10-09 14:17:00"
"2629","20150420080400-256",3,"2015-10-08 05:34:00",1444307640,"C8",309240,1444616880,"2015-10-11 19:28:00"
"1567","20150228100235-385",2,"2015-10-08 11:18:00",1444328280,"C0",434280,1444762560,"2015-10-13 11:56:00"
"2574","20150506040523-403",1,"2015-10-08 11:19:00",1444328340,"C4",392520,1444720860,"2015-10-13 00:21:00"
"1446","20152620062633-528",1,"2015-10-08 13:20:00",1444335600,"C7",225720,1444561320,"2015-10-11 04:02:00"
"1519","20150027100028-509",1,"2015-10-08 14:19:00",1444339140,"C3",520620,1444859760,"2015-10-14 14:56:00"
"4187","20152824022826-397",3,"2015-10-08 18:08:00",1444352880,"C5",611400,1444964280,"2015-10-15 19:58:00"
"5040","20154129044136-415",1,"2015-10-08 22:23:00",1444368180,"C8",399060,1444767240,"2015-10-13 13:14:00"
"3904","20155820055809-845",1,"2015-10-09 00:28:00",1444375680,"C4",526200,1444901880,"2015-10-15 02:38:00"
"5887","20151026061040-488",1,"2015-10-09 00:48:00",1444376880,"C5",551940,1444928820,"2015-10-15 10:07:00"
"4205","20150628060613-79",1,"2015-10-09 00:58:00",1444377480,"C0",515760,1444893240,"2015-10-15 00:14:00"
"6105","20151020021029-947",1,"2015-10-09 01:14:00",1444378440,"C2",199380,1444577820,"2015-10-11 08:37:00"
"636","20155221125213-371",1,"2015-10-09 02:20:00",1444382400,"C4",189660,1444572060,"2015-10-11 07:01:00"
"3305","20154916014936-45",2,"2015-10-09 03:07:00",1444385220,"C3",974340,1445359560,"2015-10-20 09:46:00"
"6308","20154617094613-518",2,"2015-10-09 03:16:00",1444385760,"C3",268200,1444653960,"2015-10-12 05:46:00"
"4815","20153426113440-126",3,"2015-10-09 03:29:00",1444386540,"C5",156300,1444542840,"2015-10-10 22:54:00"
"3949","20153429063446-548",2,"2015-10-09 03:49:00",1444387740,"C8",170820,1444558560,"2015-10-11 03:16:00"
"797","20154728124707-118",1,"2015-10-09 06:09:00",1444396140,"C7",463260,1444859400,"2015-10-14 14:50:00"
"2445","20153605033626-803",2,"2015-10-09 09:12:00",1444407120,"C2",971520,1445378640,"2015-10-20 15:04:00"
"6281","20154929104953-761",1,"2015-10-09 09:53:00",1444409580,"C2",107580,1444517160,"2015-10-10 15:46:00"
"5428","20153714053753-627",3,"2015-10-09 10:25:00",1444411500,"C5",266760,1444678260,"2015-10-12 12:31:00"
"2862","20151808071821-441",3,"2015-10-09 10:26:00",1444411560,"C5",384240,1444795800,"2015-10-13 21:10:00"
"974","20151422101430-872",1,"2015-10-09 10:38:00",1444412280,"C2",518580,1444930860,"2015-10-15 10:41:00"
"6010","20153425113451-606",2,"2015-10-09 11:27:00",1444415220,"C3",172740,1444587960,"2015-10-11 11:26:00"
"1605","20151814061817-293",1,"2015-10-09 12:09:00",1444417740,"C2",311580,1444729320,"2015-10-13 02:42:00"
"1361","20154219084210-14",3,"2015-10-09 13:06:00",1444421160,"C2",249120,1444670280,"2015-10-12 10:18:00"
"4523","20155727045729-105",2,"2015-10-09 15:14:00",1444428840,"C8",529860,1444958700,"2015-10-15 18:25:00"
"3475","20150829080813-483",2,"2015-10-09 15:35:00",1444430100,"C8",127260,1444557360,"2015-10-11 02:56:00"
"1288","20152121052117-267",2,"2015-10-09 17:03:00",1444435380,"C5",777060,1445212440,"2015-10-18 16:54:00"
"4676","20150601040632-151",2,"2015-10-09 17:16:00",1444436160,"C8",657480,1445093640,"2015-10-17 07:54:00"
"3511","20153723123726-448",2,"2015-10-09 17:31:00",1444437060,"C0",700020,1445137080,"2015-10-17 19:58:00"
"5705","20151929031948-686",2,"2015-10-09 17:59:00",1444438740,"C8",710400,1445149140,"2015-10-17 23:19:00"
"1417","20150513120548-43",3,"2015-10-09 18:19:00",1444439940,"C5",324120,1444764060,"2015-10-13 12:21:00"
"1028","20150528090539-210",1,"2015-10-09 23:20:00",1444458000,"C8",200340,1444658340,"2015-10-12 06:59:00"
"3209","20154525044559-95",1,"2015-10-10 03:45:00",1444473900,"C4",416400,1444890300,"2015-10-14 23:25:00"
"1415","20150713100753-416",1,"2015-10-10 05:03:00",1444478580,"C2",289320,1444767900,"2015-10-13 13:25:00"
"3334","20150025100041-260",3,"2015-10-10 05:30:00",1444480200,"C0",426600,1444906800,"2015-10-15 04:00:00"
"4591","20155606085604-918",1,"2015-10-10 05:36:00",1444480560,"C3",365700,1444846260,"2015-10-14 11:11:00"
"262","20151530031532-48",1,"2015-10-10 07:03:00",1444485780,"C3",278160,1444763940,"2015-10-13 12:19:00"
"4122","20154024084056-354",2,"2015-10-10 09:12:00",1444493520,"C5",173040,1444666560,"2015-10-12 09:16:00"
"1226","20152231092234-568",1,"2015-10-10 09:31:00",1444494660,"C5",876420,1445371080,"2015-10-20 12:58:00"
"5599","20151026051047-171",1,"2015-10-10 11:13:00",1444500780,"C5",396060,1444896840,"2015-10-15 01:14:00"
"4112","20150630080609-634",1,"2015-10-10 11:58:00",1444503480,"C2",444540,1444948020,"2015-10-15 15:27:00"
"4633","20151523091527-511",1,"2015-10-10 12:05:00",1444503900,"C8",295800,1444799700,"2015-10-13 22:15:00"
"4939","20151522061542-891",2,"2015-10-10 14:39:00",1444513140,"C0",528480,1445041620,"2015-10-16 17:27:00"
"99","20153915033947-108",1,"2015-10-10 16:09:00",1444518540,"C8",968040,1445486580,"2015-10-21 21:03:00"
"4460","20150822080830-143",3,"2015-10-10 17:12:00",1444522320,"C4",793920,1445316240,"2015-10-19 21:44:00"
"4518","20154616084623-195",1,"2015-10-10 17:58:00",1444525080,"C2",263340,1444788420,"2015-10-13 19:07:00"
"3843","20150818120801-625",2,"2015-10-10 18:14:00",1444526040,"C4",274680,1444800720,"2015-10-13 22:32:00"
"5388","20152419102424-497",1,"2015-10-10 20:07:00",1444532820,"C8",1399740,1445932560,"2015-10-27 00:56:00"
"443","20151529051506-307",2,"2015-10-10 20:39:00",1444534740,"C6",160440,1444695180,"2015-10-12 17:13:00"
"6197","20152229052214-773",3,"2015-10-10 20:45:00",1444535100,"C8",520140,1445055240,"2015-10-16 21:14:00"
"5402","20153710013742-178",3,"2015-10-10 23:45:00",1444545900,"C4",328560,1444874460,"2015-10-14 19:01:00"
"5373","20150323090352-23",2,"2015-10-11 00:07:00",1444547220,"C5",190380,1444737600,"2015-10-13 05:00:00"
"1599","20155123085147-286",1,"2015-10-11 00:14:00",1444547640,"C4",217740,1444765380,"2015-10-13 12:43:00"
"5937","20150002080017-383",1,"2015-10-11 00:32:00",1444548720,"C2",93840,1444642560,"2015-10-12 02:36:00"
"5189","20151129121122-794",1,"2015-10-11 03:06:00",1444557960,"C8",200820,1444758780,"2015-10-13 10:53:00"
"2219","20153717013727-315",1,"2015-10-11 05:37:00",1444567020,"C3",255600,1444822620,"2015-10-14 04:37:00"
"2784","20154423044409-968",2,"2015-10-11 06:44:00",1444571040,"C2",189900,1444760940,"2015-10-13 11:29:00"
"4875","20150230100237-163",1,"2015-10-11 07:38:00",1444574280,"C3",470880,1445045160,"2015-10-16 18:26:00"
"3349","20155306085328-467",1,"2015-10-11 08:48:00",1444578480,"C8",604740,1445183220,"2015-10-18 08:47:00"
"6012","20150205110228-447",2,"2015-10-11 12:21:00",1444591260,"C5",445020,1445036280,"2015-10-16 15:58:00"
"145","20150826010800-879",1,"2015-10-11 14:39:00",1444599540,"C4",951180,1445550720,"2015-10-22 14:52:00"
"6466","20154606024636-543",1,"2015-10-11 14:56:00",1444600560,"C8",86520,1444687080,"2015-10-12 14:58:00"
"3932","20151822111847-102",3,"2015-10-11 15:46:00",1444603560,"C4",619440,1445223000,"2015-10-18 19:50:00"
"5288","20154804124824-880",1,"2015-10-11 16:18:00",1444605480,"C6",534900,1445140380,"2015-10-17 20:53:00"
"1145","20150221010241-26",3,"2015-10-11 16:43:00",1444606980,"C5",631380,1445238360,"2015-10-19 00:06:00"
"2495","20152325092328-229",1,"2015-10-11 20:47:00",1444621620,"C5",474480,1445096100,"2015-10-17 08:35:00"
"2264","20152629042632-481",1,"2015-10-11 21:44:00",1444625040,"C6",622380,1445247420,"2015-10-19 02:37:00"
"3093","20153404113443-239",1,"2015-10-11 22:46:00",1444628760,"C6",80640,1444709400,"2015-10-12 21:10:00"
"4119","20152616062617-515",1,"2015-10-11 22:53:00",1444629180,"C5",699660,1445328840,"2015-10-20 01:14:00"
"59","20154314084327-265",2,"2015-10-11 23:15:00",1444630500,"C0",298140,1444928640,"2015-10-15 10:04:00"
"3224","20153113033133-51",1,"2015-10-11 23:15:00",1444630500,"C5",1223520,1445854020,"2015-10-26 03:07:00"
"3128","20150017040038-392",1,"2015-10-12 01:45:00",1444639500,"C8",421740,1445061240,"2015-10-16 22:54:00"
"3723","20150406120449-237",1,"2015-10-12 01:48:00",1444639680,"C2",718980,1445358660,"2015-10-20 09:31:00"
"4843","20153029123049-92",2,"2015-10-12 04:04:00",1444647840,"C0",156120,1444803960,"2015-10-13 23:26:00"
"3259","20151118041143-934",2,"2015-10-12 04:27:00",1444649220,"C5",923520,1445572740,"2015-10-22 20:59:00"
"2390","20153714093734-926",2,"2015-10-12 04:56:00",1444650960,"C8",725820,1445376780,"2015-10-20 14:33:00"
"582","20155815115859-161",3,"2015-10-12 05:02:00",1444651320,"C3",288480,1444939800,"2015-10-15 13:10:00"
"2747","20155325095328-933",2,"2015-10-12 06:01:00",1444654860,"C5",181860,1444836720,"2015-10-14 08:32:00"
"3352","20153521033534-609",3,"2015-10-12 07:03:00",1444658580,"C2",222960,1444881540,"2015-10-14 20:59:00"
"2835","20153109123110-337",2,"2015-10-12 08:23:00",1444663380,"C2",244320,1444907700,"2015-10-15 04:15:00"
"682","20150122060138-185",3,"2015-10-12 10:03:00",1444669380,"C5",871260,1445540640,"2015-10-22 12:04:00"
"5829","20153628113615-827",2,"2015-10-12 10:36:00",1444671360,"C8",603000,1445274360,"2015-10-19 10:06:00"
"1179","20154030094027-816",1,"2015-10-12 13:42:00",1444682520,"C7",525660,1445208180,"2015-10-18 15:43:00"
"6325","20150827060827-565",1,"2015-10-12 14:05:00",1444683900,"C2",571860,1445255760,"2015-10-19 04:56:00"
"4765","20153728063706-624",2,"2015-10-12 15:59:00",1444690740,"C5",1313160,1446003900,"2015-10-27 20:45:00"
"1404","20151716021749-651",2,"2015-10-12 16:11:00",1444691460,"C3",704520,1445395980,"2015-10-20 19:53:00"
"2585","20151229041207-285",2,"2015-10-12 16:38:00",1444693080,"C7",160680,1444853760,"2015-10-14 13:16:00"
"1939","20153726053749-107",1,"2015-10-12 17:45:00",1444697100,"C5",691440,1445388540,"2015-10-20 17:49:00"
"3482","20151520061516-982",2,"2015-10-12 18:24:00",1444699440,"C7",216060,1444915500,"2015-10-15 06:25:00"
"3180","20151128121126-103",3,"2015-10-12 21:59:00",1444712340,"C5",177840,1444890180,"2015-10-14 23:23:00"
"5281","20153724063727-843",2,"2015-10-13 00:53:00",1444722780,"C6",202620,1444925400,"2015-10-15 09:10:00"
"6436","20155701025733-561",1,"2015-10-13 02:01:00",1444726860,"C3",447780,1445174640,"2015-10-18 06:24:00"
"81","20150419090434-489",1,"2015-10-13 03:48:00",1444733280,"C5",293520,1445026800,"2015-10-16 13:20:00"
"5018","20155617075624-163",1,"2015-10-13 07:06:00",1444745160,"C8",448680,1445193840,"2015-10-18 11:44:00"
"2313","20151229121216-715",1,"2015-10-13 07:30:00",1444746600,"C8",596340,1445342940,"2015-10-20 05:09:00"
"2213","20150322080331-384",1,"2015-10-13 07:35:00",1444746900,"C5",258960,1445005860,"2015-10-16 07:31:00"
"5231","20152528012515-626",3,"2015-10-13 15:09:00",1444774140,"C4",162780,1444936920,"2015-10-15 12:22:00"
"6504","20155927105908-127",2,"2015-10-13 15:17:00",1444774620,"C4",465960,1445240580,"2015-10-19 00:43:00"
"2566","20153922083923-991",3,"2015-10-13 15:39:00",1444775940,"C4",262800,1445038740,"2015-10-16 16:39:00"
"4415","20152223052251-513",2,"2015-10-13 15:52:00",1444776720,"C2",574200,1445350920,"2015-10-20 07:22:00"
"4465","20152803072816-844",2,"2015-10-13 17:44:00",1444783440,"C0",436620,1445220060,"2015-10-18 19:01:00"
"1310","20151030061038-897",2,"2015-10-13 17:52:00",1444783920,"C3",388440,1445172360,"2015-10-18 05:46:00"
"42","20151712061733-488",1,"2015-10-13 18:27:00",1444786020,"C6",130200,1444916220,"2015-10-15 06:37:00"
"2716","20150908020926-913",2,"2015-10-13 21:05:00",1444795500,"C2",715920,1445511420,"2015-10-22 03:57:00"
"2912","20150730040705-133",2,"2015-10-13 21:19:00",1444796340,"C5",142740,1444939080,"2015-10-15 12:58:00"
"5043","20152909092941-524",1,"2015-10-13 22:19:00",1444799940,"C0",195900,1444995840,"2015-10-16 04:44:00"
"444","20151119091154-119",3,"2015-10-13 23:36:00",1444804560,"C0",1068900,1445873460,"2015-10-26 08:31:00"
"1762","20152102052154-22",3,"2015-10-14 00:40:00",1444808400,"C2",509820,1445318220,"2015-10-19 22:17:00"
"5571","20154427034432-511",3,"2015-10-14 00:50:00",1444809000,"C6",235860,1445044860,"2015-10-16 18:21:00"
"2311","20151328011351-370",1,"2015-10-14 01:09:00",1444810140,"C5",191280,1445001420,"2015-10-16 06:17:00"
"1126","20155823095855-582",1,"2015-10-14 01:44:00",1444812240,"C8",892380,1445704620,"2015-10-24 09:37:00"
"4616","20154519024544-322",2,"2015-10-14 04:23:00",1444821780,"C4",200400,1445022180,"2015-10-16 12:03:00"
"4240","20154711074751-689",2,"2015-10-14 08:35:00",1444836900,"C5",356760,1445193660,"2015-10-18 11:41:00"
"2351","20155022025025-894",2,"2015-10-14 11:22:00",1444846920,"C4",269760,1445116680,"2015-10-17 14:18:00"
"6061","20153510103519-730",2,"2015-10-14 12:11:00",1444849860,"C5",367920,1445217780,"2015-10-18 18:23:00"
"6140","20154027024025-199",1,"2015-10-14 13:36:00",1444854960,"C2",183120,1445038080,"2015-10-16 16:28:00"
"4463","20155126015101-584",2,"2015-10-14 15:01:00",1444860060,"C4",779700,1445639760,"2015-10-23 15:36:00"
"4569","20151712061745-29",3,"2015-10-14 16:20:00",1444864800,"C7",311220,1445176020,"2015-10-18 06:47:00"
"2576","20154917054928-183",3,"2015-10-14 16:51:00",1444866660,"C8",332760,1445199420,"2015-10-18 13:17:00"
"2308","20152702072702-121",1,"2015-10-14 18:25:00",1444872300,"C8",538140,1445410440,"2015-10-20 23:54:00"
"289","20152727122724-538",1,"2015-10-14 18:33:00",1444872780,"C5",496920,1445369700,"2015-10-20 12:35:00"
"1663","20151526061504-680",3,"2015-10-14 18:57:00",1444874220,"C0",800460,1445674680,"2015-10-24 01:18:00"
"751","20150426100413-9",2,"2015-10-14 18:58:00",1444874280,"C5",793620,1445667900,"2015-10-23 23:25:00"
"5845","20152608092613-41",1,"2015-10-14 23:56:00",1444892160,"C8",451800,1445343960,"2015-10-20 05:26:00"
"1547","20151108081116-912",2,"2015-10-14 23:58:00",1444892280,"C5",452460,1445344740,"2015-10-20 05:39:00"
"2185","20153123073146-272",1,"2015-10-15 02:53:00",1444902780,"C5",269160,1445171940,"2015-10-18 05:39:00"
"1685","20153030113019-64",1,"2015-10-15 05:36:00",1444912560,"C4",637380,1445549940,"2015-10-22 14:39:00"
"4010","20152218072255-716",1,"2015-10-15 05:40:00",1444912800,"C2",775560,1445688360,"2015-10-24 05:06:00"
"4514","20153607113603-801",3,"2015-10-15 07:52:00",1444920720,"C5",408720,1445329440,"2015-10-20 01:24:00"
"4434","20154124124106-525",2,"2015-10-15 09:46:00",1444927560,"C3",257700,1445185260,"2015-10-18 09:21:00"
"1054","20155002115040-685",1,"2015-10-15 15:27:00",1444948020,"C2",1136220,1446084240,"2015-10-28 19:04:00"
"1992","20154830034853-516",3,"2015-10-15 16:12:00",1444950720,"C2",831780,1445782500,"2015-10-25 07:15:00"
"1416","20150231010233-845",1,"2015-10-15 16:58:00",1444953480,"C7",940080,1445893560,"2015-10-26 14:06:00"
"1325","20151803011812-57",2,"2015-10-15 18:22:00",1444958520,"C6",455880,1445414400,"2015-10-21 01:00:00"
"854","20154023044028-20",1,"2015-10-15 20:11:00",1444965060,"C0",655980,1445621040,"2015-10-23 10:24:00"
"2318","20152723032741-851",1,"2015-10-15 22:00:00",1444971600,"C8",657540,1445629140,"2015-10-23 12:39:00"
"1651","20155526085516-0",2,"2015-10-15 22:22:00",1444972920,"C4",563340,1445536260,"2015-10-22 10:51:00"
"2693","20150018100013-569",1,"2015-10-16 03:35:00",1444991700,"C2",342300,1445334000,"2015-10-20 02:40:00"
"5090","20155026105032-380",1,"2015-10-16 04:37:00",1444995420,"C5",243660,1445239080,"2015-10-19 00:18:00"
"2429","20155514055529-108",1,"2015-10-16 07:11:00",1445004660,"C7",772080,1445776740,"2015-10-25 05:39:00"
"5764","20152827022817-16",1,"2015-10-16 08:19:00",1445008740,"C8",613980,1445622720,"2015-10-23 10:52:00"
"945","20155705095723-561",1,"2015-10-16 13:32:00",1445027520,"C4",507900,1445535420,"2015-10-22 10:37:00"
"282","20153916083923-377",1,"2015-10-16 15:50:00",1445035800,"C2",373980,1445409780,"2015-10-20 23:43:00"
"3745","20153220113237-70",2,"2015-10-16 16:38:00",1445038680,"C5",1647720,1446686400,"2015-11-04 17:20:00"
"2066","20154728014746-613",1,"2015-10-16 18:27:00",1445045220,"C4",196500,1445241720,"2015-10-19 01:02:00"
"3318","20150822100826-928",1,"2015-10-16 18:59:00",1445047140,"C5",300780,1445347920,"2015-10-20 06:32:00"
"3675","20153126033132-596",1,"2015-10-16 22:36:00",1445060160,"C8",250500,1445310660,"2015-10-19 20:11:00"
"3629","20154809044835-78",1,"2015-10-16 23:43:00",1445064180,"C5",1225500,1446289680,"2015-10-31 04:08:00"
"1304","20153625063605-688",1,"2015-10-17 01:48:00",1445071680,"C2",570240,1445641920,"2015-10-23 16:12:00"
"3605","20153927063907-823",3,"2015-10-17 01:51:00",1445071860,"C5",213840,1445285700,"2015-10-19 13:15:00"
"3633","20151707111715-550",2,"2015-10-17 02:10:00",1445073000,"C0",118740,1445191740,"2015-10-18 11:09:00"
"3809","20150119090129-183",1,"2015-10-17 05:07:00",1445083620,"C4",1202580,1446286200,"2015-10-31 03:10:00"
"3008","20155110085148-525",2,"2015-10-17 05:09:00",1445083740,"C6",530580,1445614320,"2015-10-23 08:32:00"
"2452","20151902091944-855",3,"2015-10-17 05:35:00",1445085300,"C4",819120,1445904420,"2015-10-26 17:07:00"
"35","20151521051524-864",1,"2015-10-17 09:08:00",1445098080,"C2",316740,1445414820,"2015-10-21 01:07:00"
"3646","20154821024838-295",2,"2015-10-17 10:32:00",1445103120,"C7",318720,1445421840,"2015-10-21 03:04:00"
"1328","20152129052143-619",3,"2015-10-17 14:03:00",1445115780,"C3",771660,1445887440,"2015-10-26 12:24:00"
"603","20155806065852-717",3,"2015-10-17 15:14:00",1445120040,"C5",446520,1445566560,"2015-10-22 19:16:00"
"3804","20152911042945-827",3,"2015-10-17 16:02:00",1445122920,"C3",826740,1445949660,"2015-10-27 05:41:00"
"3436","20155015015017-670",2,"2015-10-18 01:17:00",1445156220,"C3",400860,1445557080,"2015-10-22 16:38:00"
"2240","20151917051906-622",3,"2015-10-18 02:07:00",1445159220,"C2",327960,1445487180,"2015-10-21 21:13:00"
"3229","20155415055448-117",1,"2015-10-18 04:09:00",1445166540,"C0",69900,1445236440,"2015-10-18 23:34:00"
"5259","20152816102821-282",1,"2015-10-18 05:26:00",1445171160,"C7",1157640,1446328800,"2015-10-31 15:00:00"
"128","20154104064113-956",2,"2015-10-18 14:32:00",1445203920,"C8",1312380,1446516300,"2015-11-02 18:05:00"
"2878","20153824023857-53",3,"2015-10-18 17:17:00",1445213820,"C5",680220,1445894040,"2015-10-26 14:14:00"
"3788","20152815012824-971",1,"2015-10-18 18:24:00",1445217840,"C4",792480,1446010320,"2015-10-27 22:32:00"
"4973","20154319074317-573",3,"2015-10-18 20:38:00",1445225880,"C8",510420,1445736300,"2015-10-24 18:25:00"
"1827","20155827025824-481",1,"2015-10-18 22:54:00",1445234040,"C2",263280,1445497320,"2015-10-22 00:02:00"
"5256","20153329083354-580",1,"2015-10-18 23:45:00",1445237100,"C0",212040,1445449140,"2015-10-21 10:39:00"
"1839","20152130042105-824",1,"2015-10-19 03:09:00",1445249340,"C2",534060,1445783400,"2015-10-25 07:30:00"
"3705","20155223065200-218",2,"2015-10-19 03:56:00",1445252160,"C5",614280,1445866440,"2015-10-26 06:34:00"
"2203","20153829013813-529",2,"2015-10-19 04:16:00",1445253360,"C2",242040,1445495400,"2015-10-21 23:30:00"
"6390","20150522100502-509",3,"2015-10-19 04:20:00",1445253600,"C7",330300,1445583900,"2015-10-23 00:05:00"
"5088","20155821065833-503",3,"2015-10-19 05:54:00",1445259240,"C5",301920,1445561160,"2015-10-22 17:46:00"
"6335","20152006072036-68",3,"2015-10-19 06:47:00",1445262420,"C8",530460,1445792880,"2015-10-25 10:08:00"
"4131","20153112033150-305",2,"2015-10-19 09:03:00",1445270580,"C2",453360,1445723940,"2015-10-24 14:59:00"
"5856","20155703045756-537",1,"2015-10-19 10:49:00",1445276940,"C2",828840,1446105780,"2015-10-29 01:03:00"
"3958","20154026104009-242",2,"2015-10-19 12:48:00",1445284080,"C3",584160,1445868240,"2015-10-26 07:04:00"
"2014","20151327101317-796",2,"2015-10-19 14:06:00",1445288760,"C4",273540,1445562300,"2015-10-22 18:05:00"
"6107","20152512052534-249",2,"2015-10-19 15:09:00",1445292540,"C0",398580,1445691120,"2015-10-24 05:52:00"
"4640","20153224043258-562",2,"2015-10-19 15:12:00",1445292720,"C3",604200,1445896920,"2015-10-26 15:02:00"
"5211","20152725052758-524",2,"2015-10-19 17:30:00",1445301000,"C5",691260,1445992260,"2015-10-27 17:31:00"
"114","20155723035703-81",1,"2015-10-19 17:41:00",1445301660,"C0",951180,1446252840,"2015-10-30 17:54:00"
"3717","20155326015327-562",2,"2015-10-19 19:53:00",1445309580,"C4",251100,1445560680,"2015-10-22 17:38:00"
"4908","20153119013102-317",1,"2015-10-20 04:51:00",1445341860,"C2",760800,1446102660,"2015-10-29 00:11:00"
"1938","20150322060343-331",1,"2015-10-20 06:24:00",1445347440,"C5",345780,1445693220,"2015-10-24 06:27:00"
"54","20150215060225-774",1,"2015-10-20 13:01:00",1445371260,"C7",818220,1446189480,"2015-10-30 00:18:00"
"6392","20155501015527-544",2,"2015-10-20 16:19:00",1445383140,"C5",530280,1445913420,"2015-10-26 19:37:00"
"3293","20155411025401-133",3,"2015-10-20 19:58:00",1445396280,"C0",758280,1446154560,"2015-10-29 14:36:00"
"3775","20155024105003-765",2,"2015-10-20 22:25:00",1445405100,"C5",709500,1446114600,"2015-10-29 03:30:00"
"587","20151328101312-818",2,"2015-10-20 23:54:00",1445410440,"C5",278580,1445689020,"2015-10-24 05:17:00"
"714","20152610012616-238",1,"2015-10-21 01:58:00",1445417880,"C4",437640,1445855520,"2015-10-26 03:32:00"
"579","20151726101752-323",2,"2015-10-21 02:17:00",1445419020,"C3",936000,1446355020,"2015-10-31 22:17:00"
"4617","20154519024544-322",2,"2015-10-21 07:22:00",1445437320,"C4",201900,1445639220,"2015-10-23 15:27:00"
"1984","20152414122415-656",2,"2015-10-21 08:37:00",1445441820,"C4",454740,1445896560,"2015-10-26 14:56:00"
"6208","20155124095132-430",1,"2015-10-21 08:46:00",1445442360,"C4",332700,1445775060,"2015-10-25 05:11:00"
"5998","20152801072801-74",1,"2015-10-21 10:09:00",1445447340,"C4",1383780,1446831120,"2015-11-06 09:32:00"
"6547","20152119112147-519",1,"2015-10-21 10:57:00",1445450220,"C5",345420,1445795640,"2015-10-25 10:54:00"
"4284","20151028061026-297",3,"2015-10-21 12:28:00",1445455680,"C6",1227780,1446683460,"2015-11-04 16:31:00"
"4564","20152928102926-60",1,"2015-10-21 14:29:00",1445462940,"C2",250200,1445713140,"2015-10-24 11:59:00"
"5024","20150030070026-128",1,"2015-10-21 15:31:00",1445466660,"C8",263580,1445730240,"2015-10-24 16:44:00"
"6532","20150829050830-287",3,"2015-10-21 17:43:00",1445474580,"C8",916260,1446390840,"2015-11-01 07:14:00"
"6077","20153421053409-684",1,"2015-10-21 23:04:00",1445493840,"C1",435300,1445929140,"2015-10-26 23:59:00"
"2648","20150518080515-636",3,"2015-10-22 00:29:00",1445498940,"C5",363780,1445862720,"2015-10-26 05:32:00"
"2531","20153330083330-845",3,"2015-10-22 01:28:00",1445502480,"C4",267900,1445770380,"2015-10-25 03:53:00"
"6248","20150419080453-269",2,"2015-10-22 01:40:00",1445503200,"C0",78720,1445581920,"2015-10-22 23:32:00"
"3119","20154801084801-486",2,"2015-10-22 03:36:00",1445510160,"C4",883260,1446393420,"2015-11-01 07:57:00"
"3509","20154524124536-93",2,"2015-10-22 04:12:00",1445512320,"C7",265380,1445777700,"2015-10-25 05:55:00"
"2394","20150430100459-528",2,"2015-10-22 05:40:00",1445517600,"C8",269280,1445786880,"2015-10-25 08:28:00"
"977","20152628112645-216",2,"2015-10-22 05:58:00",1445518680,"C4",256740,1445775420,"2015-10-25 05:17:00"
"513","20154125074157-46",3,"2015-10-22 06:01:00",1445518860,"C8",1001040,1446519900,"2015-11-02 19:05:00"
"403","20155705085705-756",2,"2015-10-22 08:57:00",1445529420,"C2",507600,1446037020,"2015-10-28 05:57:00"
"2812","20154402044412-377",1,"2015-10-22 11:29:00",1445538540,"C7",477900,1446016440,"2015-10-28 00:14:00"
"1432","20155602075606-537",1,"2015-10-22 15:12:00",1445551920,"C7",620880,1446172800,"2015-10-29 19:40:00"
"5888","20150009060037-852",1,"2015-10-22 17:13:00",1445559180,"C7",919140,1446478320,"2015-11-02 07:32:00"
"5220","20155706065753-746",1,"2015-10-22 20:50:00",1445572200,"C0",957540,1446529740,"2015-11-02 21:49:00"
"2591","20155419125408-510",1,"2015-10-23 01:18:00",1445588280,"C7",796320,1446384600,"2015-11-01 05:30:00"
"1489","20150019040039-358",1,"2015-10-23 01:20:00",1445588400,"C6",695400,1446283800,"2015-10-31 02:30:00"
"3152","20155221125229-19",3,"2015-10-23 01:34:00",1445589240,"C6",454020,1446043260,"2015-10-28 07:41:00"
"4305","20150615070645-876",2,"2015-10-23 01:42:00",1445589720,"C7",362640,1445952360,"2015-10-27 06:26:00"
"2692","20152025062036-525",1,"2015-10-23 02:52:00",1445593920,"C5",635640,1446229560,"2015-10-30 11:26:00"
"3037","20151117051123-614",1,"2015-10-23 16:29:00",1445642940,"C2",1209240,1446852180,"2015-11-06 15:23:00"
"3526","20154916064951-160",1,"2015-10-23 21:56:00",1445662560,"C5",464460,1446127020,"2015-10-29 06:57:00"
"2682","20154117064148-969",1,"2015-10-23 22:28:00",1445664480,"C2",452460,1446116940,"2015-10-29 04:09:00"
"3166","20151703081723-858",2,"2015-10-24 00:04:00",1445670240,"C7",625260,1446295500,"2015-10-31 05:45:00"
"3800","20153326083315-407",2,"2015-10-24 07:37:00",1445697420,"C4",345120,1446042540,"2015-10-28 07:29:00"
"6035","20151019081015-655",1,"2015-10-24 08:18:00",1445699880,"C3",378060,1446077940,"2015-10-28 17:19:00"
"3387","20153713053720-934",3,"2015-10-24 08:52:00",1445701920,"C5",1637100,1447339020,"2015-11-12 06:37:00"
"1705","20153820063840-304",2,"2015-10-24 13:59:00",1445720340,"C2",988020,1446708360,"2015-11-04 23:26:00"
"1803","20153819053827-500",3,"2015-10-24 17:08:00",1445731680,"C6",1396500,1447128180,"2015-11-09 20:03:00"
"1896","20150411120416-183",1,"2015-10-24 22:01:00",1445749260,"C8",535860,1446285120,"2015-10-31 02:52:00"
"3211","20151905111924-469",2,"2015-10-24 23:13:00",1445753580,"C3",610920,1446364500,"2015-11-01 00:55:00"
"4968","20153307023355-407",1,"2015-10-24 23:35:00",1445754900,"C4",584760,1446339660,"2015-10-31 18:01:00"
"2964","20154328044302-517",2,"2015-10-25 01:52:00",1445763120,"C7",848460,1446611580,"2015-11-03 20:33:00"
"6287","20151825061809-937",1,"2015-10-25 14:18:00",1445807880,"C5",374400,1446182280,"2015-10-29 22:18:00"
"3120","20151926031950-628",1,"2015-10-25 15:14:00",1445811240,"C8",501060,1446312300,"2015-10-31 10:25:00"
"349","20151131081108-573",1,"2015-10-25 16:51:00",1445817060,"C8",956640,1446773700,"2015-11-05 17:35:00"
"5194","20151927071926-369",3,"2015-10-25 18:10:00",1445821800,"C7",351180,1446172980,"2015-10-29 19:43:00"
"6009","20154721064725-145",1,"2015-10-25 18:11:00",1445821860,"C3",992880,1446814740,"2015-11-06 04:59:00"
"2695","20152004112056-852",1,"2015-10-25 20:23:00",1445829780,"C4",634140,1446463920,"2015-11-02 03:32:00"
"2606","20154712024716-747",2,"2015-10-25 22:39:00",1445837940,"C5",1137540,1446975480,"2015-11-08 01:38:00"
"5063","20150829080825-567",2,"2015-10-25 23:20:00",1445840400,"C3",622440,1446462840,"2015-11-02 03:14:00"
"4195","20154719114738-807",2,"2015-10-26 03:41:00",1445856060,"C3",452520,1446308580,"2015-10-31 09:23:00"
"2841","20151412031428-824",3,"2015-10-26 07:34:00",1445870040,"C2",1304400,1447174440,"2015-11-10 08:54:00"
"703","20152407072413-469",3,"2015-10-26 07:45:00",1445870700,"C4",604980,1446475680,"2015-11-02 06:48:00"
"4269","20153319103344-890",1,"2015-10-26 11:21:00",1445883660,"C2",75960,1445959620,"2015-10-27 08:27:00"
"5447","20154917034903-850",1,"2015-10-26 13:49:00",1445892540,"C5",420300,1446312840,"2015-10-31 10:34:00"
"4140","20152326012317-940",1,"2015-10-26 14:35:00",1445895300,"C8",1136160,1447031460,"2015-11-08 17:11:00"
"3455","20151505021556-896",1,"2015-10-26 17:49:00",1445906940,"C2",631320,1446538260,"2015-11-03 00:11:00"
"6378","20153424023413-34",3,"2015-10-26 22:00:00",1445922000,"C2",199560,1446121560,"2015-10-29 05:26:00"
"4194","20151301091306-345",2,"2015-10-27 02:20:00",1445937600,"C8",687660,1446625260,"2015-11-04 00:21:00"
"1538","20152527072503-929",1,"2015-10-27 03:31:00",1445941860,"C7",368280,1446310140,"2015-10-31 09:49:00"
"4859","20153624043623-472",2,"2015-10-27 06:03:00",1445950980,"C4",221220,1446172200,"2015-10-29 19:30:00"
"2466","20150022110023-715",2,"2015-10-27 06:32:00",1445952720,"C5",1194960,1447147680,"2015-11-10 01:28:00"
"3391","20152215082220-506",2,"2015-10-27 11:03:00",1445968980,"C4",519780,1446488760,"2015-11-02 10:26:00"
"1164","20150201030237-485",1,"2015-10-27 17:57:00",1445993820,"C5",692700,1446686520,"2015-11-04 17:22:00"
"2115","20152515012543-659",1,"2015-10-27 19:47:00",1446000420,"C2",1825860,1447826280,"2015-11-17 21:58:00"
"5587","20154723074706-99",1,"2015-10-28 01:31:00",1446021060,"C3",709980,1446731040,"2015-11-05 05:44:00"
"3729","20151818111845-978",2,"2015-10-28 02:10:00",1446023400,"C4",201360,1446224760,"2015-10-30 10:06:00"
"2095","20150805070853-118",3,"2015-10-28 05:40:00",1446036000,"C4",906540,1446942540,"2015-11-07 16:29:00"
"777","20151329111354-725",1,"2015-10-28 07:24:00",1446042240,"C2",355980,1446398220,"2015-11-01 09:17:00"
"6557","20152823032832-378",2,"2015-10-28 17:28:00",1446078480,"C0",54900,1446133380,"2015-10-29 08:43:00"
"1777","20152918022901-486",1,"2015-10-28 20:59:00",1446091140,"C4",443700,1446534840,"2015-11-02 23:14:00"
"3451","20153125013101-836",2,"2015-10-28 21:01:00",1446091260,"C7",617400,1446708660,"2015-11-04 23:31:00"
"815","20155917095957-221",2,"2015-10-28 23:39:00",1446100740,"C8",718320,1446819060,"2015-11-06 06:11:00"
"2719","20153720123722-777",2,"2015-10-29 00:21:00",1446103260,"C0",750480,1446853740,"2015-11-06 15:49:00"
"3609","20151704091740-106",2,"2015-10-29 00:53:00",1446105180,"C4",590220,1446695400,"2015-11-04 19:50:00"
"511","20155123115132-660",2,"2015-10-29 02:01:00",1446109260,"C8",1537500,1447646760,"2015-11-15 20:06:00"
"595","20152030022022-687",2,"2015-10-29 02:42:00",1446111720,"C4",351960,1446463680,"2015-11-02 03:28:00"
"4110","20151207101219-530",2,"2015-10-29 05:32:00",1446121920,"C5",559500,1446681420,"2015-11-04 15:57:00"
"5487","20152822092858-860",3,"2015-10-29 09:28:00",1446136080,"C7",86400,1446222480,"2015-10-30 09:28:00"
"5183","20151822031808-265",1,"2015-10-29 09:32:00",1446136320,"C8",453720,1446590040,"2015-11-03 14:34:00"
"2484","20150317060312-681",2,"2015-10-29 11:32:00",1446143520,"C7",521220,1446664740,"2015-11-04 11:19:00"
"6232","20150323050332-513",3,"2015-10-29 15:13:00",1446156780,"C3",443400,1446600180,"2015-11-03 17:23:00"
"5768","20152611072627-207",3,"2015-10-30 00:05:00",1446188700,"C4",1402380,1447591080,"2015-11-15 04:38:00"
"1059","20154324094311-697",2,"2015-10-30 10:51:00",1446227460,"C5",261240,1446488700,"2015-11-02 10:25:00"
"6405","20153815033847-524",3,"2015-10-30 11:54:00",1446231240,"C4",484320,1446715560,"2015-11-05 01:26:00"
"6519","20151308101333-914",2,"2015-10-30 17:39:00",1446251940,"C0",1028280,1447280220,"2015-11-11 14:17:00"
"1824","20154225024250-848",1,"2015-10-30 19:36:00",1446258960,"C6",506940,1446765900,"2015-11-05 15:25:00"
"3196","20153629053647-857",1,"2015-10-30 21:00:00",1446264000,"C6",448440,1446712440,"2015-11-05 00:34:00"
"2472","20150829070856-319",1,"2015-10-31 04:35:00",1446291300,"C7",306180,1446597480,"2015-11-03 16:38:00"
"4361","20152428112426-434",3,"2015-10-31 04:48:00",1446292080,"C5",78480,1446370560,"2015-11-01 01:36:00"
"1793","20154518094547-315",1,"2015-10-31 08:09:00",1446304140,"C0",463680,1446767820,"2015-11-05 15:57:00"
"605","20153026083032-587",1,"2015-10-31 09:08:00",1446307680,"C5",217140,1446524820,"2015-11-02 20:27:00"
"1851","20150818120815-803",1,"2015-10-31 09:50:00",1446310200,"C5",529560,1446839760,"2015-11-06 11:56:00"
"4134","20152130102130-760",2,"2015-10-31 12:54:00",1446321240,"C0",383940,1446705180,"2015-11-04 22:33:00"
"106","20153527083531-898",1,"2015-10-31 19:23:00",1446344580,"C2",372060,1446716640,"2015-11-05 01:44:00"
"3102","20151825091848-82",3,"2015-10-31 19:51:00",1446346260,"C3",185460,1446531720,"2015-11-02 22:22:00"
"5285","20151224101227-56",1,"2015-11-01 00:36:00",1446363360,"C6",987840,1447351200,"2015-11-12 10:00:00"
"1107","20152528092556-30",2,"2015-11-01 04:19:00",1446380340,"C4",110280,1446490620,"2015-11-02 10:57:00"
"515","20155821075857-972",2,"2015-11-01 07:52:00",1446393120,"C3",476820,1446869940,"2015-11-06 20:19:00"
"928","20155913015944-240",1,"2015-11-01 15:05:00",1446419100,"C0",605880,1447024980,"2015-11-08 15:23:00"
"5729","20153612043649-569",3,"2015-11-01 16:48:00",1446425280,"C3",875340,1447300620,"2015-11-11 19:57:00"
"5695","20154912084901-166",2,"2015-11-01 17:25:00",1446427500,"C7",622080,1447049580,"2015-11-08 22:13:00"
"5795","20151823041807-23",3,"2015-11-02 00:46:00",1446453960,"C0",101460,1446555420,"2015-11-03 04:57:00"
"768","20152328122311-696",1,"2015-11-02 02:15:00",1446459300,"C7",1495560,1447954860,"2015-11-19 09:41:00"
"1447","20152924032913-724",1,"2015-11-02 07:49:00",1446479340,"C3",1087800,1447567140,"2015-11-14 21:59:00"
"6244","20155627045658-136",2,"2015-11-02 08:37:00",1446482220,"C8",440580,1446922800,"2015-11-07 11:00:00"
"1873","20154623114627-225",1,"2015-11-02 09:16:00",1446484560,"C0",286200,1446770760,"2015-11-05 16:46:00"
"3612","20151713111750-937",1,"2015-11-02 13:21:00",1446499260,"C6",541380,1447040640,"2015-11-08 19:44:00"
"1505","20155127065120-711",3,"2015-11-02 15:03:00",1446505380,"C2",392940,1446898320,"2015-11-07 04:12:00"
"5025","20152722082711-239",3,"2015-11-02 15:21:00",1446506460,"C2",510120,1447016580,"2015-11-08 13:03:00"
"2780","20151404081429-288",1,"2015-11-03 02:02:00",1446544920,"C4",1315260,1447860180,"2015-11-18 07:23:00"
"811","20150815060824-848",1,"2015-11-03 04:40:00",1446554400,"C3",604560,1447158960,"2015-11-10 04:36:00"
"4554","20155926125956-991",3,"2015-11-03 08:20:00",1446567600,"C7",849780,1447417380,"2015-11-13 04:23:00"
"2705","20152230072211-448",3,"2015-11-03 11:41:00",1446579660,"C4",805020,1447384680,"2015-11-12 19:18:00"
"5901","20150227100257-879",2,"2015-11-04 00:57:00",1446627420,"C2",847500,1447474920,"2015-11-13 20:22:00"
"1881","20151516041514-25",2,"2015-11-04 10:21:00",1446661260,"C6",270660,1446931920,"2015-11-07 13:32:00"
"3108","20152217112251-421",3,"2015-11-05 06:46:00",1446734760,"C4",527580,1447262340,"2015-11-11 09:19:00"
"302","20153230113243-759",1,"2015-11-05 07:36:00",1446737760,"C8",253920,1446991680,"2015-11-08 06:08:00"
"4804","20151620061659-448",3,"2015-11-05 08:36:00",1446741360,"C3",174300,1446915660,"2015-11-07 09:01:00"
"826","20152229012216-958",2,"2015-11-05 09:10:00",1446743400,"C6",530880,1447274280,"2015-11-11 12:38:00"
"6262","20152126012150-343",3,"2015-11-05 10:21:00",1446747660,"C3",431100,1447178760,"2015-11-10 10:06:00"
"1398","20154428114434-818",2,"2015-11-05 12:52:00",1446756720,"C2",411360,1447168080,"2015-11-10 07:08:00"
"5407","20153023123036-30",3,"2015-11-05 22:10:00",1446790200,"C5",804000,1447594200,"2015-11-15 05:30:00"
"4012","20155817085826-736",1,"2015-11-05 23:02:00",1446793320,"C0",535980,1447329300,"2015-11-12 03:55:00"
"1959","20155121015151-176",1,"2015-11-06 03:33:00",1446809580,"C5",1313640,1448123220,"2015-11-21 08:27:00"
"1227","20153825123835-385",1,"2015-11-06 04:09:00",1446811740,"C8",897180,1447708920,"2015-11-16 13:22:00"
"4714","20151312011312-740",1,"2015-11-06 06:19:00",1446819540,"C2",1441080,1448260620,"2015-11-22 22:37:00"
"2063","20153209073227-920",1,"2015-11-06 12:54:00",1446843240,"C7",719160,1447562400,"2015-11-14 20:40:00"
"1613","20153124013107-263",1,"2015-11-06 13:43:00",1446846180,"C5",375840,1447222020,"2015-11-10 22:07:00"
"5496","20153031083006-993",1,"2015-11-06 19:48:00",1446868080,"C3",187560,1447055640,"2015-11-08 23:54:00"
"3683","20151622081618-495",1,"2015-11-06 19:56:00",1446868560,"C8",1322400,1448190960,"2015-11-22 03:16:00"
"64","20153424013401-207",1,"2015-11-07 02:32:00",1446892320,"C8",586740,1447479060,"2015-11-13 21:31:00"
"6044","20152520042545-155",3,"2015-11-07 05:14:00",1446902040,"C7",587220,1447489260,"2015-11-14 00:21:00"
"4004","20150110060107-684",1,"2015-11-07 16:45:00",1446943500,"C3",631680,1447575180,"2015-11-15 00:13:00"
"1947","20150927090926-427",3,"2015-11-07 17:24:00",1446945840,"C8",715140,1447660980,"2015-11-16 00:03:00"
"6006","20154902034953-35",3,"2015-11-07 18:38:00",1446950280,"C2",1199220,1448149500,"2015-11-21 15:45:00"
"1022","20151909051914-299",1,"2015-11-07 20:04:00",1446955440,"C7",865500,1447820940,"2015-11-17 20:29:00"
"5665","20152902112948-976",2,"2015-11-08 06:29:00",1446992940,"C5",166800,1447159740,"2015-11-10 04:49:00"
"2923","20154727064700-998",3,"2015-11-08 10:08:00",1447006080,"C2",1214820,1448220900,"2015-11-22 11:35:00"
"6183","20151518011531-224",1,"2015-11-08 12:23:00",1447014180,"C0",1220460,1448234640,"2015-11-22 15:24:00"
"927","20150826020806-485",2,"2015-11-08 13:08:00",1447016880,"C5",140400,1447157280,"2015-11-10 04:08:00"
"6295","20154127034153-72",1,"2015-11-09 05:51:00",1447077060,"C2",526200,1447603260,"2015-11-15 08:01:00"
"3782","20153223033200-444",3,"2015-11-09 07:44:00",1447083840,"C5",180540,1447264380,"2015-11-11 09:53:00"
"4149","20150122100139-218",1,"2015-11-09 09:25:00",1447089900,"C5",518580,1447608480,"2015-11-15 09:28:00"
"4503","20153319093327-65",2,"2015-11-09 10:01:00",1447092060,"C5",551460,1447643520,"2015-11-15 19:12:00"
"1529","20150606090649-896",1,"2015-11-09 10:54:00",1447095240,"C0",692460,1447787700,"2015-11-17 11:15:00"
"1841","20150509110550-759",1,"2015-11-09 11:28:00",1447097280,"C2",383340,1447480620,"2015-11-13 21:57:00"
"2169","20153118113152-842",2,"2015-11-09 12:31:00",1447101060,"C5",897300,1447998360,"2015-11-19 21:46:00"
"5091","20151131021149-695",3,"2015-11-09 15:05:00",1447110300,"C5",261480,1447371780,"2015-11-12 15:43:00"
"5746","20155921125901-834",1,"2015-11-09 16:11:00",1447114260,"C4",606960,1447721220,"2015-11-16 16:47:00"
"352","20153923083952-869",1,"2015-11-09 21:31:00",1447133460,"C4",513840,1447647300,"2015-11-15 20:15:00"
"126","20152231122207-586",1,"2015-11-10 12:43:00",1447188180,"C4",289620,1447477800,"2015-11-13 21:10:00"
"3059","20150004120029-367",2,"2015-11-10 12:44:00",1447188240,"C2",724380,1447912620,"2015-11-18 21:57:00"
"2756","20155114055130-358",1,"2015-11-10 16:09:00",1447200540,"C0",1468440,1448668980,"2015-11-27 16:03:00"
"3441","20153127083119-859",1,"2015-11-10 22:46:00",1447224360,"C8",771300,1447995660,"2015-11-19 21:01:00"
"3485","20153728033704-530",2,"2015-11-11 02:45:00",1447238700,"C4",145860,1447384560,"2015-11-12 19:16:00"
"244","20150806110838-706",1,"2015-11-11 03:33:00",1447241580,"C8",1135740,1448377320,"2015-11-24 07:02:00"
"1913","20155328095345-887",1,"2015-11-11 13:48:00",1447278480,"C8",763860,1448042340,"2015-11-20 09:59:00"
"3996","20153730083758-789",2,"2015-11-12 00:39:00",1447317540,"C0",527160,1447844700,"2015-11-18 03:05:00"
"3449","20153328033312-600",3,"2015-11-13 01:36:00",1447407360,"C5",943740,1448351100,"2015-11-23 23:45:00"
"3392","20155523065557-761",2,"2015-11-13 14:59:00",1447455540,"C2",554880,1448010420,"2015-11-20 01:07:00"
"3190","20150928020950-296",1,"2015-11-13 19:57:00",1447473420,"C5",499860,1447973280,"2015-11-19 14:48:00"
"5649","20153618053610-340",1,"2015-11-13 22:31:00",1447482660,"C7",1459500,1448942160,"2015-11-30 19:56:00"
"5730","20150825040833-548",2,"2015-11-14 02:20:00",1447496400,"C4",534240,1448030640,"2015-11-20 06:44:00"
"1366","20153519093544-845",1,"2015-11-14 02:27:00",1447496820,"C6",936840,1448433660,"2015-11-24 22:41:00"
"4313","20151114111101-450",1,"2015-11-15 13:25:00",1447622700,"C7",766920,1448389620,"2015-11-24 10:27:00"
"572","20151826011805-225",2,"2015-11-15 14:18:00",1447625880,"C8",865440,1448491320,"2015-11-25 14:42:00"
"176","20155426035428-177",2,"2015-11-16 09:15:00",1447694100,"C7",626580,1448320680,"2015-11-23 15:18:00"
"5952","20151431051408-107",1,"2015-11-16 21:10:00",1447737000,"C5",833820,1448570820,"2015-11-26 12:47:00"
"4624","20150420010418-650",1,"2015-11-17 13:48:00",1447796880,"C3",961980,1448758860,"2015-11-28 17:01:00"
"3823","20154216034256-486",2,"2015-11-17 15:22:00",1447802520,"C2",765600,1448568120,"2015-11-26 12:02:00"
"2809","20152211042208-883",1,"2015-11-18 04:41:00",1447850460,"C4",833820,1448684280,"2015-11-27 20:18:00"
"6023","20155706095759-642",1,"2015-11-18 05:05:00",1447851900,"C5",899040,1448750940,"2015-11-28 14:49:00"
"1847","20152513062528-584",1,"2015-11-18 05:17:00",1447852620,"C3",712740,1448565360,"2015-11-26 11:16:00"
"5876","20153113023123-668",2,"2015-11-18 10:03:00",1447869780,"C2",711240,1448581020,"2015-11-26 15:37:00"
"505","20150027080052-161",3,"2015-11-18 13:10:00",1447881000,"C8",903000,1448784000,"2015-11-29 00:00:00"
"3907","20153528073554-422",1,"2015-11-18 13:23:00",1447881780,"C4",553860,1448435640,"2015-11-24 23:14:00"
"621","20153925023956-683",2,"2015-11-18 15:34:00",1447889640,"C2",667500,1448557140,"2015-11-26 08:59:00"
"1582","20151426021455-333",1,"2015-11-18 16:41:00",1447893660,"C7",510180,1448403840,"2015-11-24 14:24:00"
"3591","20154903114941-837",1,"2015-11-19 07:14:00",1447946040,"C6",273180,1448219220,"2015-11-22 11:07:00"
"2684","20153226043220-886",1,"2015-11-19 09:31:00",1447954260,"C8",663420,1448617680,"2015-11-27 01:48:00"
"2871","20151814051808-820",3,"2015-11-19 14:17:00",1447971420,"C8",1196220,1449167640,"2015-12-03 10:34:00"
"264","20151201121236-41",1,"2015-11-19 16:08:00",1447978080,"C3",1190220,1449168300,"2015-12-03 10:45:00"
"1005","20155223045209-786",2,"2015-11-19 16:16:00",1447978560,"C2",615780,1448594340,"2015-11-26 19:19:00"
"5732","20155705025759-63",1,"2015-11-20 10:33:00",1448044380,"C6",2417160,1450461540,"2015-12-18 09:59:00"
"5354","20150327030347-941",1,"2015-11-20 21:15:00",1448082900,"C5",586440,1448669340,"2015-11-27 16:09:00"
"2909","20153622103648-402",3,"2015-11-21 18:56:00",1448160960,"C8",1043520,1449204480,"2015-12-03 20:48:00"
"343","20155819065837-382",2,"2015-11-22 10:05:00",1448215500,"C5",792060,1449007560,"2015-12-01 14:06:00"
"1495","20152023042040-26",2,"2015-11-23 00:05:00",1448265900,"C3",1127700,1449393600,"2015-12-06 01:20:00"
"4519","20151427031411-974",2,"2015-11-23 22:22:00",1448346120,"C2",619260,1448965380,"2015-12-01 02:23:00"
"4070","20151125121147-666",1,"2015-11-24 05:56:00",1448373360,"C7",871500,1449244860,"2015-12-04 08:01:00"
"5841","20152418062434-209",1,"2015-11-24 09:48:00",1448387280,"C2",725580,1449112860,"2015-12-02 19:21:00"
"4124","20151127051117-574",1,"2015-11-24 12:53:00",1448398380,"C6",1279620,1449678000,"2015-12-09 08:20:00"
"6267","20155430015455-513",3,"2015-11-25 08:30:00",1448469000,"C5",937620,1449406620,"2015-12-06 04:57:00"
"4426","20150516050501-365",2,"2015-11-25 14:41:00",1448491260,"C4",863280,1449354540,"2015-12-05 14:29:00"
"2497","20152227062255-337",2,"2015-11-26 00:10:00",1448525400,"C3",645660,1449171060,"2015-12-03 11:31:00"
"2099","20152207062244-430",2,"2015-11-26 09:47:00",1448560020,"C8",867180,1449427200,"2015-12-06 10:40:00"
"957","20154529034521-219",1,"2015-11-29 21:41:00",1448862060,"C4",661920,1449523980,"2015-12-07 13:33:00"
"3898","20151613061634-340",2,"2015-11-30 00:46:00",1448873160,"C8",289800,1449162960,"2015-12-03 09:16:00"
"5254","20151617081652-70",1,"2015-11-30 12:20:00",1448914800,"C4",1471080,1450385880,"2015-12-17 12:58:00"
"1828","20150712070713-541",2,"2015-11-30 21:56:00",1448949360,"C7",983220,1449932580,"2015-12-12 07:03:00"
"3396","20150930030938-661",3,"2015-12-01 01:52:00",1448963520,"C0",758940,1449722460,"2015-12-09 20:41:00"
"532","20155528055554-549",2,"2015-12-01 08:47:00",1448988420,"C2",687540,1449675960,"2015-12-09 07:46:00"
"1077","20153120063140-521",1,"2015-12-02 21:46:00",1449121560,"C7",539100,1449660660,"2015-12-09 03:31:00"
"94","20150614110632-795",3,"2015-12-03 06:06:00",1449151560,"C8",324720,1449476280,"2015-12-07 00:18:00"
"2065","20154023084052-167",1,"2015-12-04 09:20:00",1449249600,"C8",190560,1449440160,"2015-12-06 14:16:00"
"1557","20154525114509-293",1,"2015-12-04 19:41:00",1449286860,"C2",760020,1450046880,"2015-12-13 14:48:00"
"3624","20153309103304-690",1,"2015-12-04 21:51:00",1449294660,"C8",1450440,1450745100,"2015-12-21 16:45:00"
"2802","20152329072302-894",1,"2015-12-05 01:43:00",1449308580,"C8",1207200,1450515780,"2015-12-19 01:03:00"
"564","20154826034855-575",1,"2015-12-05 06:00:00",1449324000,"C2",752040,1450076040,"2015-12-13 22:54:00"
"3376","20153829013810-820",1,"2015-12-05 07:44:00",1449330240,"C8",1207080,1450537320,"2015-12-19 07:02:00"
"4590","20153428083457-4",1,"2015-12-06 03:40:00",1449402000,"C8",1232280,1450634280,"2015-12-20 09:58:00"
"4964","20155617035648-789",1,"2015-12-06 05:45:00",1449409500,"C2",612420,1450021920,"2015-12-13 07:52:00"
"3530","20154119024105-829",2,"2015-12-06 11:47:00",1449431220,"C6",1122060,1450553280,"2015-12-19 11:28:00"
"2977","20152829012800-488",3,"2015-12-08 09:16:00",1449594960,"C4",754560,1450349520,"2015-12-17 02:52:00"
"4872","20151525031532-107",1,"2015-12-08 09:21:00",1449595260,"C7",1293480,1450888740,"2015-12-23 08:39:00"
"2643","20152710122745-528",1,"2015-12-08 21:52:00",1449640320,"C3",1486500,1451126820,"2015-12-26 02:47:00"
"1554","20154904064902-300",1,"2015-12-10 16:19:00",1449793140,"C8",110520,1449903660,"2015-12-11 23:01:00"
"5042","20150916030932-958",1,"2015-12-11 11:16:00",1449861360,"C5",1825260,1451686620,"2016-01-01 14:17:00"
"427","20152629012651-157",3,"2015-12-11 11:28:00",1449862080,"C7",1283160,1451145240,"2015-12-26 07:54:00"
"6314","20155826055855-744",2,"2015-12-12 13:14:00",1449954840,"C8",948480,1450903320,"2015-12-23 12:42:00"
"708","20154326044353-158",3,"2015-12-12 15:29:00",1449962940,"C0",950280,1450913220,"2015-12-23 15:27:00"
"4759","20150414060406-461",2,"2015-12-13 03:52:00",1450007520,"C2",1306260,1451313780,"2015-12-28 06:43:00"
"5610","20154629064615-476",1,"2015-12-15 03:48:00",1450180080,"C3",195960,1450376040,"2015-12-17 10:14:00"
"5799","20151509081503-433",3,"2015-12-18 00:33:00",1450427580,"C8",374940,1450802520,"2015-12-22 08:42:00"
"4235","20155822105810-579",2,"2015-12-18 20:46:00",1450500360,"C6",944460,1451444820,"2015-12-29 19:07:00"
"4201","20154125074116-47",1,"2015-12-18 21:05:00",1450501500,"C5",913680,1451415180,"2015-12-29 10:53:00"
"3863","20153917053945-907",1,"2015-12-20 08:27:00",1450628820,"C2",75360,1450704180,"2015-12-21 05:23:00"
"1982","20152218122219-545",2,"2015-12-21 10:09:00",1450721340,"C4",251220,1450972560,"2015-12-24 07:56:00"
"2421","20150613010619-88",3,"2015-12-22 13:09:00",1450818540,"C5",864540,1451683080,"2016-01-01 13:18:00"
"3123","20152404012417-940",1,"2015-12-24 01:03:00",1450947780,"C2",1364220,1452312000,"2016-01-08 20:00:00"
"1901","20153628063656-228",3,"2015-12-25 08:06:00",1451059560,"C4",864600,1451924160,"2016-01-04 08:16:00"
"4809","20153310103325-597",3,"2015-12-26 20:13:00",1451189580,"C3",1708800,1452898380,"2016-01-15 14:53:00"
"4090","20150319090350-88",1,"2015-12-29 00:41:00",1451378460,"C2",1242840,1452621300,"2016-01-12 09:55:00"
"24","20151408071436-141",1,"2015-12-29 01:50:00",1451382600,"C2",1207620,1452590220,"2016-01-12 01:17:00"
"1927","20151828111836-799",1,"2015-12-30 12:40:00",1451508000,"C4",88860,1451596860,"2015-12-31 13:21:00"
"6156","20151622071609-320",1,"2016-01-06 12:35:00",1452112500,"C5",1694220,1453806720,"2016-01-26 03:12:00"
"6347","20160506090520-274",2,"2016-01-08 17:59:00",1452304740,"C0",102420,1452407160,"2016-01-09 22:26:00"
"2582","20151821081800-795",1,"2016-01-11 06:22:00",1452522120,"C3",1209180,1453731300,"2016-01-25 06:15:00"
"2172","20154430034428-915",1,"2016-01-11 21:45:00",1452577500,"C2",2040180,1454617680,"2016-02-04 12:28:00"
"1309","20151415031434-50",1,"2016-01-21 02:17:00",1453371420,"C4",1573740,1454945160,"2016-02-08 07:26:00"
"1001","20163708103702-555",2,"2016-01-21 09:35:00",1453397700,"C5",559740,1453957440,"2016-01-27 21:04:00"
"2748","20165519125545-196",2,"2016-01-25 20:49:00",1453783740,"C2",78120,1453861860,"2016-01-26 18:31:00"
"2353","20151815091854-333",1,"2016-02-01 04:02:00",1454328120,"C5",1499280,1455827400,"2016-02-18 12:30:00"
"5765","20161915061905-937",2,"2016-02-02 15:05:00",1454454300,"C4",226680,1454680980,"2016-02-05 06:03:00"
"1193","20162716112747-330",1,"2016-02-03 05:35:00",1454506500,"C5",191760,1454698260,"2016-02-05 10:51:00"
"4037","20162209102238-93",2,"2016-02-13 20:28:00",1455424080,"C4",127320,1455551400,"2016-02-15 07:50:00"
"2155","20154828034832-761",2,"2016-02-17 20:56:00",1455771360,"C5",1536360,1457307720,"2016-03-06 15:42:00"
"4958","20154625114655-96",1,"2016-02-23 04:34:00",1456230840,"C8",2625840,1458856680,"2016-03-24 14:58:00"
"4223","20154604064624-746",1,"2016-02-24 20:23:00",1456374180,"C3",2525460,1458899640,"2016-03-25 02:54:00"
"5579","20164124024135-223",3,"2016-02-25 17:01:00",1456448460,"C4",94800,1456543260,"2016-02-26 19:21:00"
"3421","20160020030000-577",2,"2016-02-26 04:36:00",1456490160,"C5",160320,1456650480,"2016-02-28 01:08:00"
"2831","20165222105209-198",1,"2016-02-27 16:57:00",1456621020,"C8",90780,1456711800,"2016-02-28 18:10:00"
"5386","20164124024115-14",1,"2016-03-03 00:41:00",1456994460,"C5",414900,1457409360,"2016-03-07 19:56:00"
"3808","20164701124736-81",1,"2016-03-04 02:05:00",1457085900,"C4",73560,1457159460,"2016-03-04 22:31:00"
"838","20155723045734-820",1,"2016-03-05 13:57:00",1457215020,"C4",1301280,1458516300,"2016-03-20 16:25:00"
"47","20162904122951-717",1,"2016-03-09 05:37:00",1457530620,"C0",203640,1457734260,"2016-03-11 14:11:00"
"6489","20161412121444-732",1,"2016-03-13 09:12:00",1457885520,"C0",71880,1457957400,"2016-03-14 05:10:00"
"191","20160411030412-40",1,"2016-03-14 19:18:00",1458008280,"C4",1388220,1459396500,"2016-03-30 20:55:00"
"6123","20161503081526-237",1,"2016-03-15 12:35:00",1458070500,"C2",131100,1458201600,"2016-03-17 01:00:00"
"48","20162904122951-717",1,"2016-03-16 06:09:00",1458133740,"C0",202920,1458336660,"2016-03-18 14:31:00"
"2090","20164504064540-547",1,"2016-03-19 10:19:00",1458407940,"C8",652620,1459060560,"2016-03-26 23:36:00"
"2256","20163007043005-603",3,"2016-03-19 20:30:00",1458444600,"C3",1047600,1459492200,"2016-03-31 23:30:00"
"2496","20165117045137-283",1,"2016-03-21 02:21:00",1458552060,"C5",146700,1458698760,"2016-03-22 19:06:00"
"49","20162904122951-717",1,"2016-03-23 06:02:00",1458738120,"C0",204780,1458942900,"2016-03-25 14:55:00"
"780","20165624125612-641",2,"2016-03-26 20:55:00",1459050900,"C6",201540,1459252440,"2016-03-29 04:54:00"
"3268","20163125083158-7",2,"2016-03-27 15:37:00",1459118220,"C5",99180,1459217400,"2016-03-28 19:10:00"
"50","20162904122951-717",1,"2016-03-30 05:13:00",1459339980,"C0",202980,1459542960,"2016-04-01 13:36:00"
"51","20162904122951-717",1,"2016-04-06 05:18:00",1459945080,"C0",202740,1460147820,"2016-04-08 13:37:00"
"4849","20161605081629-930",1,"2016-04-09 05:00:00",1460203200,"C7",166920,1460370120,"2016-04-11 03:22:00"
"920","20165206045258-573",1,"2016-04-10 05:04:00",1460289840,"C8",151560,1460441400,"2016-04-11 23:10:00"
"4912","20165701055728-629",1,"2016-04-10 17:25:00",1460334300,"C4",96960,1460431260,"2016-04-11 20:21:00"
"5072","20162810052858-571",2,"2016-04-12 08:44:00",1460475840,"C5",70680,1460546520,"2016-04-13 04:22:00"
"52","20162904122951-717",1,"2016-04-13 05:49:00",1460551740,"C0",203700,1460755440,"2016-04-15 14:24:00"
"1673","20165904095931-786",2,"2016-04-13 14:07:00",1460581620,"C5",99060,1460680680,"2016-04-14 17:38:00"
"1279","20163014013040-441",1,"2016-04-16 08:40:00",1460821200,"C4",77700,1460898900,"2016-04-17 06:15:00"
"1603","20164707014735-384",2,"2016-04-16 13:23:00",1460838180,"C2",258720,1461096900,"2016-04-19 13:15:00"
"4697","20161308031352-805",3,"2016-04-18 20:51:00",1461037860,"C7",442140,1461480000,"2016-04-23 23:40:00"
"4357","20163403093427-432",2,"2016-04-19 03:07:00",1461060420,"C4",453060,1461513480,"2016-04-24 08:58:00"
"2979","20162115092102-471",1,"2016-04-21 01:30:00",1461227400,"C4",163380,1461390780,"2016-04-22 22:53:00"
"4854","20164712064702-854",2,"2016-04-23 10:02:00",1461430920,"C8",192420,1461623340,"2016-04-25 15:29:00"
"3075","20164021074031-924",1,"2016-04-23 16:04:00",1461452640,"C8",101520,1461554160,"2016-04-24 20:16:00"
"4810","20161731021739-422",3,"2016-04-29 18:01:00",1461978060,"C5",314880,1462292940,"2016-05-03 09:29:00"
"6048","20165001065047-958",1,"2016-05-02 11:57:00",1462215420,"C4",104820,1462320240,"2016-05-03 17:04:00"
"2343","20161928071944-220",2,"2016-05-02 21:59:00",1462251540,"C7",199200,1462450740,"2016-05-05 05:19:00"
"2520","20161130121138-137",2,"2016-05-03 08:45:00",1462290300,"C7",123420,1462413720,"2016-05-04 19:02:00"
"647","20161227011258-480",1,"2016-05-03 19:51:00",1462330260,"C3",180780,1462511040,"2016-05-05 22:04:00"
"5327","20163301093354-99",2,"2016-05-04 07:33:00",1462372380,"C4",252000,1462624380,"2016-05-07 05:33:00"
"752","20162226032206-214",1,"2016-05-05 12:38:00",1462477080,"C4",109680,1462586760,"2016-05-06 19:06:00"
"4091","20160402010438-874",2,"2016-05-05 13:03:00",1462478580,"C6",259140,1462737720,"2016-05-08 13:02:00"
"4216","20161501071504-180",3,"2016-05-05 15:01:00",1462485660,"C3",186780,1462672440,"2016-05-07 18:54:00"
"689","20162302072339-398",1,"2016-05-05 15:35:00",1462487700,"C4",96240,1462583940,"2016-05-06 18:19:00"
"4015","20162616092636-320",1,"2016-05-07 08:20:00",1462634400,"C6",301740,1462936140,"2016-05-10 20:09:00"
"1350","20161405101442-940",2,"2016-05-07 11:56:00",1462647360,"C4",89460,1462736820,"2016-05-08 12:47:00"
"5073","20160003020009-483",1,"2016-05-07 22:32:00",1462685520,"C5",188160,1462873680,"2016-05-10 02:48:00"
"386","20163001013040-715",3,"2016-05-08 01:08:00",1462694880,"C7",80040,1462774920,"2016-05-08 23:22:00"
"2315","20162403012456-660",1,"2016-05-08 05:14:00",1462709640,"C0",201300,1462910940,"2016-05-10 13:09:00"
"87","20162113102146-554",1,"2016-05-08 15:09:00",1462745340,"C5",272160,1463017500,"2016-05-11 18:45:00"
"3985","20161207031252-328",2,"2016-05-08 16:36:00",1462750560,"C6",91440,1462842000,"2016-05-09 18:00:00"
"3217","20162204092243-393",2,"2016-05-08 17:12:00",1462752720,"C7",186900,1462939620,"2016-05-10 21:07:00"
"6302","20165202075235-678",1,"2016-05-08 18:00:00",1462755600,"C5",277440,1463033040,"2016-05-11 23:04:00"
"802","20162502012517-879",2,"2016-05-08 19:06:00",1462759560,"C7",76980,1462836540,"2016-05-09 16:29:00"
"4226","20162104032146-897",3,"2016-05-08 21:55:00",1462769700,"C3",184620,1462954320,"2016-05-11 01:12:00"
"541","20163403103449-145",3,"2016-05-09 02:36:00",1462786560,"C8",69960,1462856520,"2016-05-09 22:02:00"
"2958","20164806024852-900",1,"2016-05-09 04:12:00",1462792320,"C2",110520,1462902840,"2016-05-10 10:54:00"
"5535","20165807025851-835",3,"2016-05-09 04:52:00",1462794720,"C2",68220,1462862940,"2016-05-09 23:49:00"
"5360","20162305022327-418",3,"2016-05-09 09:53:00",1462812780,"C4",109800,1462922580,"2016-05-10 16:23:00"
"5525","20162807032803-741",2,"2016-05-09 11:29:00",1462818540,"C6",158460,1462977000,"2016-05-11 07:30:00"
"397","20163806093805-983",1,"2016-05-09 20:51:00",1462852260,"C0",299580,1463151840,"2016-05-13 08:04:00"
"691","20164407054454-328",3,"2016-05-09 22:47:00",1462859220,"C4",63660,1462922880,"2016-05-10 16:28:00"
"2360","20163702083732-163",1,"2016-05-10 03:39:00",1462876740,"C5",336660,1463213400,"2016-05-14 01:10:00"
"5113","20162308022340-411",3,"2016-05-10 06:34:00",1462887240,"C4",144660,1463031900,"2016-05-11 22:45:00"
"405","20162703112728-345",1,"2016-05-10 09:57:00",1462899420,"C4",199800,1463099220,"2016-05-12 17:27:00"
"2028","20162406112415-657",1,"2016-05-10 10:26:00",1462901160,"C6",342120,1463243280,"2016-05-14 09:28:00"
"3082","20165703075701-962",1,"2016-05-10 12:09:00",1462907340,"C4",88560,1462995900,"2016-05-11 12:45:00"
"478","20163904013912-769",2,"2016-05-10 18:12:00",1462929120,"C2",534780,1463463900,"2016-05-16 22:45:00"
"935","20162806092859-620",2,"2016-05-11 00:38:00",1462952280,"C8",80040,1463032320,"2016-05-11 22:52:00"
"4200","20160909040905-953",1,"2016-05-11 07:13:00",1462975980,"C8",70320,1463046300,"2016-05-12 02:45:00"
"1711","20164708074730-603",2,"2016-05-11 12:32:00",1462995120,"C4",92100,1463087220,"2016-05-12 14:07:00"
"5798","20163508033551-791",1,"2016-05-11 14:50:00",1463003400,"C4",85500,1463088900,"2016-05-12 14:35:00"
"877","20161706051756-373",2,"2016-05-11 20:33:00",1463023980,"C4",221880,1463245860,"2016-05-14 10:11:00"
"6363","20164006104039-266",3,"2016-05-12 02:00:00",1463043600,"C5",69600,1463113200,"2016-05-12 21:20:00"
"986","20160301010333-533",2,"2016-05-12 04:07:00",1463051220,"C4",114780,1463166000,"2016-05-13 12:00:00"
"598","20164508064519-442",1,"2016-05-12 05:33:00",1463056380,"C3",113760,1463170140,"2016-05-13 13:09:00"
"4723","20163309073335-602",2,"2016-05-12 08:44:00",1463067840,"C6",263460,1463331300,"2016-05-15 09:55:00"
"5379","20163108043103-996",3,"2016-05-12 09:55:00",1463072100,"C0",160920,1463233020,"2016-05-14 06:37:00"
"5002","20163607053650-333",1,"2016-05-12 16:15:00",1463094900,"C0",61020,1463155920,"2016-05-13 09:12:00"
"4652","20161001071044-510",1,"2016-05-12 23:42:00",1463121720,"C2",126240,1463247960,"2016-05-14 10:46:00"
"4423","20161205051258-519",3,"2016-05-13 09:00:00",1463155200,"C5",330840,1463486040,"2016-05-17 04:54:00"
"4458","20160311050309-656",2,"2016-05-13 10:15:00",1463159700,"C4",49440,1463209140,"2016-05-13 23:59:00"
"6471","20160709060739-448",1,"2016-05-13 12:33:00",1463167980,"C7",184380,1463352360,"2016-05-15 15:46:00"
"6238","20165712035713-404",3,"2016-05-14 01:25:00",1463214300,"C2",60240,1463274540,"2016-05-14 18:09:00"
"2150","20165005045015-818",1,"2016-05-14 03:32:00",1463221920,"C5",364860,1463586780,"2016-05-18 08:53:00"
"5005","20160306010354-831",2,"2016-05-14 06:35:00",1463232900,"C2",333960,1463566860,"2016-05-18 03:21:00"
"3388","20164212054245-135",1,"2016-05-14 12:58:00",1463255880,"C5",77880,1463333760,"2016-05-15 10:36:00"
"3761","20160311050306-89",1,"2016-05-14 14:43:00",1463262180,"C4",250800,1463512980,"2016-05-17 12:23:00"
"4173","20161508121511-970",2,"2016-05-14 17:03:00",1463270580,"C6",89280,1463359860,"2016-05-15 17:51:00"
"5985","20163207073234-8",2,"2016-05-14 19:17:00",1463278620,"C0",215700,1463494320,"2016-05-17 07:12:00"
"1027","20165710015727-667",2,"2016-05-14 20:31:00",1463283060,"C3",184620,1463467680,"2016-05-16 23:48:00"
"764","20165706065721-811",1,"2016-05-15 01:37:00",1463301420,"C2",94800,1463396220,"2016-05-16 03:57:00"
"4650","20161412101451-978",1,"2016-05-15 13:32:00",1463344320,"C0",271080,1463615400,"2016-05-18 16:50:00"
"4132","20160414060432-270",1,"2016-05-15 21:47:00",1463374020,"C2",142980,1463517000,"2016-05-17 13:30:00"
"4063","20161507081502-674",2,"2016-05-16 05:53:00",1463403180,"C4",384540,1463787720,"2016-05-20 16:42:00"
"5311","20163810043842-166",2,"2016-05-16 06:06:00",1463403960,"C7",68640,1463472600,"2016-05-17 01:10:00"
"4764","20161903071919-851",2,"2016-05-16 06:15:00",1463404500,"C2",1119360,1464523860,"2016-05-29 05:11:00"
"338","20161604061614-874",1,"2016-05-16 08:58:00",1463414280,"C5",348840,1463763120,"2016-05-20 09:52:00"
"3594","20162101102134-434",3,"2016-05-16 10:37:00",1463420220,"C0",185280,1463605500,"2016-05-18 14:05:00"
"6336","20165510115511-114",2,"2016-05-16 15:05:00",1463436300,"C4",264900,1463701200,"2016-05-19 16:40:00"
"4016","20163413023412-159",1,"2016-05-16 21:24:00",1463459040,"C7",141900,1463600940,"2016-05-18 12:49:00"
"358","20160604020620-396",1,"2016-05-17 01:50:00",1463475000,"C7",539520,1464014520,"2016-05-23 07:42:00"
"4807","20163909093927-432",1,"2016-05-17 07:41:00",1463496060,"C0",342060,1463838120,"2016-05-21 06:42:00"
"1274","20164607104629-486",1,"2016-05-17 08:03:00",1463497380,"C6",854220,1464351600,"2016-05-27 05:20:00"
"4980","20164713014745-616",1,"2016-05-17 13:39:00",1463517540,"C5",172560,1463690100,"2016-05-19 13:35:00"
"3559","20161211061224-16",1,"2016-05-17 15:56:00",1463525760,"C8",276720,1463802480,"2016-05-20 20:48:00"
"4779","20161213101216-677",1,"2016-05-17 17:54:00",1463532840,"C2",373320,1463906160,"2016-05-22 01:36:00"
"3026","20165112105109-897",2,"2016-05-17 20:27:00",1463542020,"C3",155520,1463697540,"2016-05-19 15:39:00"
"2702","20161615021657-872",3,"2016-05-18 03:04:00",1463565840,"C5",72960,1463638800,"2016-05-18 23:20:00"
"2867","20164308024330-236",3,"2016-05-18 09:15:00",1463588100,"C7",422160,1464010260,"2016-05-23 06:31:00"
"1601","20164314024337-465",1,"2016-05-18 10:33:00",1463592780,"C6",330600,1463923380,"2016-05-22 06:23:00"
"2539","20162809102817-777",1,"2016-05-18 13:07:00",1463602020,"C5",262380,1463864400,"2016-05-21 14:00:00"
"5322","20162612072638-753",1,"2016-05-18 16:44:00",1463615040,"C5",183960,1463799000,"2016-05-20 19:50:00"
"1848","20164624094605-617",2,"2016-05-18 18:26:00",1463621160,"C4",263100,1463884260,"2016-05-21 19:31:00"
"5557","20163314053345-713",3,"2016-05-18 19:33:00",1463625180,"C8",70560,1463695740,"2016-05-19 15:09:00"
"1268","20162317022350-38",1,"2016-05-18 23:53:00",1463640780,"C5",60300,1463701080,"2016-05-19 16:38:00"
"2013","20165704055721-696",1,"2016-05-19 00:42:00",1463643720,"C3",411300,1464055020,"2016-05-23 18:57:00"
"3876","20163707033759-413",1,"2016-05-19 00:58:00",1463644680,"C0",140580,1463785260,"2016-05-20 16:01:00"
"1884","20161611051626-58",2,"2016-05-19 01:48:00",1463647680,"C4",403440,1464051120,"2016-05-23 17:52:00"
"4231","20161805081816-21",1,"2016-05-19 03:38:00",1463654280,"C7",170400,1463824680,"2016-05-21 02:58:00"
"1140","20161214011208-135",1,"2016-05-19 04:44:00",1463658240,"C0",57360,1463715600,"2016-05-19 20:40:00"
"3550","20165408055453-259",3,"2016-05-19 09:12:00",1463674320,"C2",306360,1463980680,"2016-05-22 22:18:00"
"6518","20160317100339-729",1,"2016-05-19 09:41:00",1463676060,"C2",85740,1463761800,"2016-05-20 09:30:00"
"4746","20165813015832-479",2,"2016-05-19 15:38:00",1463697480,"C8",104880,1463802360,"2016-05-20 20:46:00"
"6529","20165911025927-470",1,"2016-05-19 16:26:00",1463700360,"C4",232140,1463932500,"2016-05-22 08:55:00"
"1794","20162316122341-349",1,"2016-05-19 16:56:00",1463702160,"C2",275580,1463977740,"2016-05-22 21:29:00"
"5356","20160412100403-624",1,"2016-05-19 17:29:00",1463704140,"C0",631500,1464335640,"2016-05-27 00:54:00"
"1461","20164516124536-165",1,"2016-05-19 20:36:00",1463715360,"C3",95820,1463811180,"2016-05-20 23:13:00"
"6555","20165313095326-823",1,"2016-05-19 20:37:00",1463715420,"C5",278520,1463993940,"2016-05-23 01:59:00"
"3909","20163909083952-107",3,"2016-05-19 20:59:00",1463716740,"C7",454200,1464170940,"2016-05-25 03:09:00"
"3252","20162014082012-197",1,"2016-05-19 22:13:00",1463721180,"C4",481980,1464203160,"2016-05-25 12:06:00"
"4275","20161106011142-596",2,"2016-05-20 10:57:00",1463767020,"C7",600780,1464367800,"2016-05-27 09:50:00"
"4334","20165710075759-354",1,"2016-05-20 14:41:00",1463780460,"C5",444120,1464224580,"2016-05-25 18:03:00"
"3768","20163922113927-867",3,"2016-05-20 18:32:00",1463794320,"C0",349140,1464143460,"2016-05-24 19:31:00"
"3311","20160219110233-416",1,"2016-05-20 19:08:00",1463796480,"C4",115560,1463912040,"2016-05-22 03:14:00"
"4011","20164201094203-125",1,"2016-05-21 00:46:00",1463816760,"C4",211980,1464028740,"2016-05-23 11:39:00"
"696","20161618071617-763",2,"2016-05-21 02:16:00",1463822160,"C0",120600,1463942760,"2016-05-22 11:46:00"
"1904","20160813020801-597",2,"2016-05-21 03:44:00",1463827440,"C6",108960,1463936400,"2016-05-22 10:00:00"
"2674","20160011040054-612",1,"2016-05-21 05:00:00",1463832000,"C5",412200,1464244200,"2016-05-25 23:30:00"
"3121","20162911092915-817",2,"2016-05-21 06:38:00",1463837880,"C4",284580,1464122460,"2016-05-24 13:41:00"
"6117","20161418061406-876",2,"2016-05-21 08:58:00",1463846280,"C3",269040,1464115320,"2016-05-24 11:42:00"
"2427","20161917061915-322",2,"2016-05-21 15:06:00",1463868360,"C3",377220,1464245580,"2016-05-25 23:53:00"
"781","20164810074837-368",2,"2016-05-21 16:53:00",1463874780,"C8",196620,1464071400,"2016-05-23 23:30:00"
"5509","20165305015329-885",1,"2016-05-21 20:25:00",1463887500,"C0",175740,1464063240,"2016-05-23 21:14:00"
"3051","20161818071801-292",1,"2016-05-22 01:15:00",1463904900,"C3",107940,1464012840,"2016-05-23 07:14:00"
"455","20160109120154-984",3,"2016-05-22 01:23:00",1463905380,"C0",542460,1464447840,"2016-05-28 08:04:00"
"4562","20165911075945-393",1,"2016-05-22 01:56:00",1463907360,"C4",132660,1464040020,"2016-05-23 14:47:00"
"6015","20165907125955-871",2,"2016-05-22 03:41:00",1463913660,"C5",420840,1464334500,"2016-05-27 00:35:00"
"2454","20163410053456-4",2,"2016-05-22 05:46:00",1463921160,"C4",331440,1464252600,"2016-05-26 01:50:00"
"2906","20162106052135-91",1,"2016-05-22 06:21:00",1463923260,"C5",447600,1464370860,"2016-05-27 10:41:00"
"1346","20161112031156-198",2,"2016-05-22 08:47:00",1463932020,"C0",280320,1464212340,"2016-05-25 14:39:00"
"6026","20165320125359-334",1,"2016-05-22 11:39:00",1463942340,"C6",168360,1464110700,"2016-05-24 10:25:00"
"4304","20162612082614-132",2,"2016-05-22 14:41:00",1463953260,"C8",177300,1464130560,"2016-05-24 15:56:00"
"4993","20160615090601-72",2,"2016-05-22 19:43:00",1463971380,"C8",91860,1464063240,"2016-05-23 21:14:00"
"6059","20162203102237-41",1,"2016-05-22 22:46:00",1463982360,"C5",210780,1464193140,"2016-05-25 09:19:00"
"6476","20162921042944-446",3,"2016-05-22 23:17:00",1463984220,"C3",55440,1464039660,"2016-05-23 14:41:00"
"1878","20165319125305-907",1,"2016-05-23 01:35:00",1463992500,"C7",152460,1464144960,"2016-05-24 19:56:00"
"1100","20165814095833-724",2,"2016-05-23 05:01:00",1464004860,"C0",253260,1464258120,"2016-05-26 03:22:00"
"5480","20160711110708-553",2,"2016-05-23 05:35:00",1464006900,"C0",508440,1464515340,"2016-05-29 02:49:00"
"2886","20160418080421-476",2,"2016-05-23 07:01:00",1464012060,"C2",428220,1464440280,"2016-05-28 05:58:00"
"2610","20160102010124-415",3,"2016-05-23 14:11:00",1464037860,"C7",259800,1464297660,"2016-05-26 14:21:00"
"3648","20165920055941-216",1,"2016-05-23 22:14:00",1464066840,"C0",274500,1464341340,"2016-05-27 02:29:00"
"2465","20161414041441-290",3,"2016-05-24 01:22:00",1464078120,"C0",405240,1464483360,"2016-05-28 17:56:00"
"6551","20164319034355-175",2,"2016-05-24 01:43:00",1464079380,"C5",190800,1464270180,"2016-05-26 06:43:00"
"5175","20162706102701-37",3,"2016-05-24 03:45:00",1464086700,"C4",510360,1464597060,"2016-05-30 01:31:00"
"2258","20162409062454-857",2,"2016-05-24 03:49:00",1464086940,"C7",554100,1464641040,"2016-05-30 13:44:00"
"4477","20162323112359-854",1,"2016-05-24 10:16:00",1464110160,"C0",82380,1464192540,"2016-05-25 09:09:00"
"1121","20160508120500-362",1,"2016-05-24 23:00:00",1464156000,"C8",284340,1464440340,"2016-05-28 05:59:00"
"5182","20163217053256-155",1,"2016-05-25 02:14:00",1464167640,"C0",318060,1464485700,"2016-05-28 18:35:00"
"4684","20164222054243-411",3,"2016-05-25 02:54:00",1464170040,"C4",68640,1464238680,"2016-05-25 21:58:00"
"3512","20163223093205-573",1,"2016-05-25 05:06:00",1464177960,"C4",78420,1464256380,"2016-05-26 02:53:00"
"2257","20161507051513-138",2,"2016-05-25 06:18:00",1464182280,"C4",216540,1464398820,"2016-05-27 18:27:00"
"6115","20162621032632-655",1,"2016-05-25 07:20:00",1464186000,"C0",105480,1464291480,"2016-05-26 12:38:00"
"1182","20163419063429-101",3,"2016-05-25 10:14:00",1464196440,"C8",106320,1464302760,"2016-05-26 15:46:00"
"1023","20165116035154-472",1,"2016-05-25 12:55:00",1464206100,"C0",95880,1464301980,"2016-05-26 15:33:00"
"2432","20160715040757-420",2,"2016-05-25 15:32:00",1464215520,"C8",172380,1464387900,"2016-05-27 15:25:00"
"6051","20164618094655-835",1,"2016-05-25 15:46:00",1464216360,"C2",78300,1464294660,"2016-05-26 13:31:00"
"600","20165119025134-664",1,"2016-05-25 20:18:00",1464232680,"C3",76860,1464309540,"2016-05-26 17:39:00"
"1653","20165213105244-282",3,"2016-05-25 20:30:00",1464233400,"C7",535740,1464769140,"2016-06-01 01:19:00"
"4170","20165716115733-899",1,"2016-05-26 07:46:00",1464273960,"C6",848940,1465122900,"2016-06-05 03:35:00"
"6455","20164724114712-44",2,"2016-05-26 17:49:00",1464310140,"C5",97260,1464407400,"2016-05-27 20:50:00"
"1403","20161612071621-912",1,"2016-05-26 18:28:00",1464312480,"C7",178560,1464491040,"2016-05-28 20:04:00"
"2503","20161929031920-756",1,"2016-05-26 19:43:00",1464316980,"C2",335520,1464652500,"2016-05-30 16:55:00"
"5351","20162824122829-498",1,"2016-05-26 23:26:00",1464330360,"C2",106140,1464436500,"2016-05-28 04:55:00"
"655","20165723055733-60",1,"2016-05-27 00:03:00",1464332580,"C4",140580,1464473160,"2016-05-28 15:06:00"
"3558","20161421031451-792",1,"2016-05-27 06:46:00",1464356760,"C5",243960,1464600720,"2016-05-30 02:32:00"
"6427","20164912044955-331",1,"2016-05-27 14:59:00",1464386340,"C7",184200,1464570540,"2016-05-29 18:09:00"
"1222","20162222042259-769",1,"2016-05-27 16:00:00",1464390000,"C4",430680,1464820680,"2016-06-01 15:38:00"
"1738","20161625021649-105",2,"2016-05-27 16:40:00",1464392400,"C5",90720,1464483120,"2016-05-28 17:52:00"
"5405","20163015053019-83",2,"2016-05-28 01:18:00",1464423480,"C5",532440,1464955920,"2016-06-03 05:12:00"
"4857","20160521040514-90",1,"2016-05-28 04:02:00",1464433320,"C0",187140,1464620460,"2016-05-30 08:01:00"
"6136","20165824065853-160",1,"2016-05-28 04:14:00",1464434040,"C4",167880,1464601920,"2016-05-30 02:52:00"
"2853","20162925012937-610",2,"2016-05-28 16:06:00",1464476760,"C4",268620,1464745380,"2016-05-31 18:43:00"
"3507","20161318071302-141",2,"2016-05-29 01:10:00",1464509400,"C5",309540,1464818940,"2016-06-01 15:09:00"
"624","20162114082157-230",1,"2016-05-29 02:47:00",1464515220,"C2",182280,1464697500,"2016-05-31 05:25:00"
"6142","20162027042012-940",1,"2016-05-29 08:27:00",1464535620,"C1",144420,1464680040,"2016-05-31 00:34:00"
"4994","20165927105911-596",1,"2016-05-29 08:47:00",1464536820,"C8",82440,1464619260,"2016-05-30 07:41:00"
"2572","20161226101220-113",1,"2016-05-29 15:24:00",1464560640,"C5",92640,1464653280,"2016-05-30 17:08:00"
"2584","20164715104741-924",1,"2016-05-29 16:12:00",1464563520,"C8",245820,1464809340,"2016-06-01 12:29:00"
"2044","20163414033416-878",3,"2016-05-29 18:24:00",1464571440,"C2",186600,1464758040,"2016-05-31 22:14:00"
"56","20164026084027-353",2,"2016-05-29 18:49:00",1464572940,"C4",98580,1464671520,"2016-05-30 22:12:00"
"827","20162515022503-709",1,"2016-05-30 01:30:00",1464597000,"C8",249900,1464846900,"2016-06-01 22:55:00"
"375","20165429105417-811",3,"2016-05-30 10:39:00",1464629940,"C4",85500,1464715440,"2016-05-31 10:24:00"
"152","20164926124930-922",1,"2016-05-30 13:54:00",1464641640,"C3",349500,1464991140,"2016-06-03 14:59:00"
"3849","20164220094251-139",1,"2016-05-30 14:00:00",1464642000,"C4",293160,1464935160,"2016-06-02 23:26:00"
"390","20163402063435-850",1,"2016-05-30 14:51:00",1464645060,"C7",349860,1464994920,"2016-06-03 16:02:00"
"3031","20162425062418-198",1,"2016-05-30 14:54:00",1464645240,"C8",231300,1464876540,"2016-06-02 07:09:00"
"514","20164115024151-5",1,"2016-05-30 17:59:00",1464656340,"C7",186840,1464843180,"2016-06-01 21:53:00"
"4181","20161121021106-144",1,"2016-05-30 20:05:00",1464663900,"C2",266280,1464930180,"2016-06-02 22:03:00"
"4022","20160728090757-429",1,"2016-05-31 01:39:00",1464683940,"C2",116160,1464800100,"2016-06-01 09:55:00"
"2111","20160809090856-701",1,"2016-05-31 02:10:00",1464685800,"C4",267960,1464953760,"2016-06-03 04:36:00"
"3763","20164726074710-213",2,"2016-05-31 04:37:00",1464694620,"C8",210300,1464904920,"2016-06-02 15:02:00"
"5871","20163724093730-240",3,"2016-05-31 04:43:00",1464694980,"C4",83880,1464778860,"2016-06-01 04:01:00"
"845","20155517055510-758",2,"2016-05-31 06:05:00",1464699900,"C2",2751900,1467451800,"2016-07-02 02:30:00"
"4261","20160624070637-743",2,"2016-05-31 08:16:00",1464707760,"C7",87000,1464794760,"2016-06-01 08:26:00"
"2536","20160124090148-920",1,"2016-05-31 11:57:00",1464721020,"C5",307680,1465028700,"2016-06-04 01:25:00"
"4153","20165529085512-11",1,"2016-05-31 14:56:00",1464731760,"C0",194460,1464926220,"2016-06-02 20:57:00"
"4324","20160326030315-917",2,"2016-05-31 16:21:00",1464736860,"C5",145560,1464882420,"2016-06-02 08:47:00"
"2630","20162421092429-563",1,"2016-05-31 16:37:00",1464737820,"C5",127140,1464864960,"2016-06-02 03:56:00"
"2618","20161623011642-809",1,"2016-05-31 21:31:00",1464755460,"C8",144180,1464899640,"2016-06-02 13:34:00"
"2098","20162629082608-704",1,"2016-06-01 00:10:00",1464765000,"C5",114720,1464879720,"2016-06-02 08:02:00"
"4642","20160017030016-746",2,"2016-06-01 01:39:00",1464770340,"C4",415980,1465186320,"2016-06-05 21:12:00"
"6005","20163314053328-67",3,"2016-06-01 01:51:00",1464771060,"C2",499560,1465270620,"2016-06-06 20:37:00"
"4421","20160529040522-408",1,"2016-06-01 02:15:00",1464772500,"C2",104700,1464877200,"2016-06-02 07:20:00"
"3638","20162125082144-48",3,"2016-06-01 07:31:00",1464791460,"C7",300900,1465092360,"2016-06-04 19:06:00"
"5825","20164622114647-721",3,"2016-06-01 07:43:00",1464792180,"C4",283140,1465075320,"2016-06-04 14:22:00"
"4645","20160419080431-102",1,"2016-06-01 09:16:00",1464797760,"C4",375840,1465173600,"2016-06-05 17:40:00"
"1113","20164216084251-215",1,"2016-06-01 16:58:00",1464825480,"C8",706080,1465531560,"2016-06-09 21:06:00"
"3980","20164128104138-234",1,"2016-06-01 17:53:00",1464828780,"C4",185760,1465014540,"2016-06-03 21:29:00"
"2107","20161613031621-889",1,"2016-06-01 18:21:00",1464830460,"C4",236100,1465066560,"2016-06-04 11:56:00"
"630","20164115054120-679",1,"2016-06-02 00:59:00",1464854340,"C6",249180,1465103520,"2016-06-04 22:12:00"
"474","20165815125818-188",1,"2016-06-02 01:46:00",1464857160,"C3",189360,1465046520,"2016-06-04 06:22:00"
"4792","20162511082549-862",2,"2016-06-02 06:37:00",1464874620,"C7",210480,1465085100,"2016-06-04 17:05:00"
"1745","20161918041903-606",1,"2016-06-02 08:39:00",1464881940,"C5",181200,1465063140,"2016-06-04 10:59:00"
"3047","20162015042050-853",1,"2016-06-02 12:40:00",1464896400,"C7",771000,1465667400,"2016-06-11 10:50:00"
"956","20162217032244-108",2,"2016-06-02 19:14:00",1464920040,"C5",174540,1465094580,"2016-06-04 19:43:00"
"3073","20161006051036-393",2,"2016-06-02 22:44:00",1464932640,"C7",336120,1465268760,"2016-06-06 20:06:00"
"3673","20162104082115-909",1,"2016-06-03 01:32:00",1464942720,"C8",366780,1465309500,"2016-06-07 07:25:00"
"3187","20162027072034-172",2,"2016-06-03 15:12:00",1464991920,"C4",79140,1465071060,"2016-06-04 13:11:00"
"5128","20164718044740-123",1,"2016-06-03 17:59:00",1465001940,"C2",173340,1465175280,"2016-06-05 18:08:00"
"3903","20165024055011-688",3,"2016-06-03 22:48:00",1465019280,"C5",440940,1465460220,"2016-06-09 01:17:00"
"4393","20164028114031-155",1,"2016-06-03 23:40:00",1465022400,"C3",70200,1465092600,"2016-06-04 19:10:00"
"5626","20163922093934-985",1,"2016-06-04 00:04:00",1465023840,"C8",217740,1465241580,"2016-06-06 12:33:00"
"681","20161410101407-777",3,"2016-06-04 00:38:00",1465025880,"C5",265680,1465291560,"2016-06-07 02:26:00"
"5116","20162119092147-990",2,"2016-06-04 15:15:00",1465078500,"C2",467880,1465546380,"2016-06-10 01:13:00"
"6171","20161927041946-363",3,"2016-06-04 17:24:00",1465086240,"C7",99300,1465185540,"2016-06-05 20:59:00"
"832","20161912121924-319",1,"2016-06-04 20:19:00",1465096740,"C7",288000,1465384740,"2016-06-08 04:19:00"
"5637","20163630103646-440",3,"2016-06-05 00:25:00",1465111500,"C5",68820,1465180320,"2016-06-05 19:32:00"
"6307","20164028104033-812",3,"2016-06-05 00:26:00",1465111560,"C5",93480,1465205040,"2016-06-06 02:24:00"
"6470","20161711061704-241",1,"2016-06-05 07:21:00",1465136460,"C6",270480,1465406940,"2016-06-08 10:29:00"
"2604","20161010091000-835",3,"2016-06-05 10:40:00",1465148400,"C7",250200,1465398600,"2016-06-08 08:10:00"
"1647","20162706052712-821",2,"2016-06-05 19:51:00",1465181460,"C5",325080,1465506540,"2016-06-09 14:09:00"
"6082","20162828032836-807",2,"2016-06-05 23:37:00",1465195020,"C0",240180,1465435200,"2016-06-08 18:20:00"
"2567","20161222121219-49",1,"2016-06-06 03:56:00",1465210560,"C5",158280,1465368840,"2016-06-07 23:54:00"
"1066","20163125113148-504",2,"2016-06-06 07:06:00",1465221960,"C8",204180,1465426140,"2016-06-08 15:49:00"
"6326","20161905071929-794",2,"2016-06-06 09:33:00",1465230780,"C2",1148520,1466379300,"2016-06-19 16:35:00"
"6386","20162627082628-314",1,"2016-06-06 17:06:00",1465257960,"C4",111900,1465369860,"2016-06-08 00:11:00"
"930","20165001065044-854",2,"2016-06-07 09:42:00",1465317720,"C7",458160,1465775880,"2016-06-12 16:58:00"
"754","20162325052301-988",2,"2016-06-09 03:46:00",1465469160,"C2",178140,1465647300,"2016-06-11 05:15:00"
"5519","20162125032104-263",2,"2016-06-09 04:12:00",1465470720,"C5",418620,1465889340,"2016-06-14 00:29:00"
"648","20163020083029-640",1,"2016-06-09 04:45:00",1465472700,"C7",190500,1465663200,"2016-06-11 09:40:00"
"5946","20160920120951-598",1,"2016-06-09 12:35:00",1465500900,"C7",247080,1465747980,"2016-06-12 09:13:00"
"5530","20164020014058-615",2,"2016-06-10 09:21:00",1465575660,"C2",256980,1465832640,"2016-06-13 08:44:00"
"1799","20161319081321-100",3,"2016-06-10 22:57:00",1465624620,"C4",279120,1465903740,"2016-06-14 04:29:00"
"1229","20164826104846-825",1,"2016-06-12 04:36:00",1465731360,"C7",206640,1465938000,"2016-06-14 14:00:00"
"1709","20161326101328-758",1,"2016-06-12 05:25:00",1465734300,"C4",181440,1465915740,"2016-06-14 07:49:00"
"3535","20161224031222-354",1,"2016-06-12 10:14:00",1465751640,"C8",231960,1465983600,"2016-06-15 02:40:00"
"6415","20164728074737-670",1,"2016-06-13 08:54:00",1465833240,"C2",198060,1466031300,"2016-06-15 15:55:00"
"55","20160902060942-509",2,"2016-06-13 19:27:00",1465871220,"C6",612780,1466484000,"2016-06-20 21:40:00"
"2656","20162214052214-931",2,"2016-06-14 17:17:00",1465949820,"C8",535620,1466485440,"2016-06-20 22:04:00"
"3296","20162701122721-624",3,"2016-06-14 21:18:00",1465964280,"C7",425940,1466390220,"2016-06-19 19:37:00"
"5903","20164923044905-91",3,"2016-06-15 06:09:00",1465996140,"C0",243600,1466239740,"2016-06-18 01:49:00"
"4211","20161103061131-806",1,"2016-06-15 14:09:00",1466024940,"C5",534840,1466559780,"2016-06-21 18:43:00"
"596","20160424070451-587",1,"2016-06-16 02:04:00",1466067840,"C8",393840,1466461680,"2016-06-20 15:28:00"
"3160","20161907081910-516",1,"2016-06-16 07:34:00",1466087640,"C7",383700,1466471340,"2016-06-20 18:09:00"
"1818","20160618010659-729",2,"2016-06-17 02:06:00",1466154360,"C8",510480,1466664840,"2016-06-22 23:54:00"
"1570","20163527043543-724",1,"2016-06-17 06:27:00",1466170020,"C3",222240,1466392260,"2016-06-19 20:11:00"
"3136","20165709095721-17",1,"2016-06-17 18:12:00",1466212320,"C5",1133100,1467345420,"2016-06-30 20:57:00"
"592","20161228061242-834",1,"2016-06-17 22:20:00",1466227200,"C3",223260,1466450460,"2016-06-20 12:21:00"
"5494","20164927034958-905",1,"2016-06-18 05:49:00",1466254140,"C8",266400,1466520540,"2016-06-21 07:49:00"
"3517","20163116093107-139",1,"2016-06-19 17:32:00",1466382720,"C5",423780,1466806500,"2016-06-24 15:15:00"
"3104","20164717114725-131",2,"2016-06-21 08:17:00",1466522220,"C4",430200,1466952420,"2016-06-26 07:47:00"
"485","20162310042305-75",1,"2016-06-21 10:32:00",1466530320,"C7",400860,1466931180,"2016-06-26 01:53:00"
"1963","20165117075149-247",1,"2016-06-22 04:27:00",1466594820,"C3",1032720,1467627540,"2016-07-04 03:19:00"
"476","20162701092754-587",1,"2016-06-26 13:39:00",1466973540,"C8",693360,1467666900,"2016-07-04 14:15:00"
"2670","20164006084004-327",2,"2016-06-27 05:12:00",1467029520,"C4",560040,1467589560,"2016-07-03 16:46:00"
"6528","20164622054644-414",2,"2016-06-27 15:49:00",1467067740,"C0",443340,1467511080,"2016-07-02 18:58:00"
"6177","20162224012201-227",1,"2016-06-27 19:31:00",1467081060,"C4",422820,1467503880,"2016-07-02 16:58:00"
"1359","20163118113139-316",1,"2016-06-28 11:36:00",1467138960,"C2",506100,1467645060,"2016-07-04 08:11:00"
"5192","20160418080457-245",1,"2016-06-29 15:25:00",1467239100,"C2",522180,1467761280,"2016-07-05 16:28:00"
"762","20160723050724-51",2,"2016-07-02 17:07:00",1467504420,"C2",864000,1468368420,"2016-07-12 17:07:00"
"6428","20161515101514-592",1,"2016-07-02 19:45:00",1467513900,"C2",278760,1467792660,"2016-07-06 01:11:00"
"914","20164101114139-473",3,"2016-07-05 11:45:00",1467744300,"C3",802320,1468546620,"2016-07-14 18:37:00"
"1115","20165105115138-773",1,"2016-07-06 23:24:00",1467872640,"C7",599820,1468472460,"2016-07-13 22:01:00"
"5253","20162506102549-845",1,"2016-07-08 09:22:00",1467994920,"C5",777060,1468771980,"2016-07-17 09:13:00"
"1950","20164108104158-541",2,"2016-07-10 03:29:00",1468146540,"C6",677160,1468823700,"2016-07-17 23:35:00"
"2696","20164808054840-252",1,"2016-07-10 09:31:00",1468168260,"C3",773340,1468941600,"2016-07-19 08:20:00"
"1389","20165621125656-604",1,"2016-07-10 19:16:00",1468203360,"C5",620400,1468823760,"2016-07-17 23:36:00"
"4208","20161523061558-393",1,"2016-07-12 22:54:00",1468389240,"C7",486660,1468875900,"2016-07-18 14:05:00"
"4584","20163108093145-941",1,"2016-07-14 07:07:00",1468505220,"C7",642240,1469147460,"2016-07-21 17:31:00"
"5734","20155705025759-63",1,"2016-07-20 22:34:00",1469079240,"C3",2090460,1471169700,"2016-08-14 03:15:00"
"1893","20164322074326-978",1,"2016-07-25 02:37:00",1469439420,"C3",787320,1470226740,"2016-08-03 05:19:00"
"5733","20155705025759-63",1,"2016-07-28 03:27:00",1469701620,"C2",2410680,1472112300,"2016-08-25 01:05:00"
"6511","20162213012243-861",1,"2016-07-31 18:48:00",1470016080,"C5",977880,1470993960,"2016-08-12 02:26:00"
"5306","20162823012818-280",2,"2016-08-04 13:28:00",1470342480,"C7",700800,1471043280,"2016-08-12 16:08:00"
"2662","20165407095430-165",1,"2016-08-21 14:02:00",1471813320,"C4",1146660,1472959980,"2016-09-03 20:33:00"
"5735","20155705025759-63",1,"2016-09-19 21:37:00",1474346220,"C5",2040240,1476386460,"2016-10-13 12:21:00"
"5743","20155705025759-63",1,"2018-07-18 06:15:00",1531919700,"C2",1490580,1533410280,"2018-08-04 12:18:00"
"5736","20155705025759-63",1,"2018-10-14 16:19:00",1539559140,"C0",2789940,1542349080,"2018-11-15 22:18:00"
"5737","20155705025759-63",1,"2019-02-14 11:57:00",1550174220,"C2",2915820,1553090040,"2019-03-20 06:54:00"
"5738","20155705025759-63",1,"2019-06-22 05:04:00",1561205040,"C6",2605380,1563810420,"2019-07-22 08:47:00"
"5741","20155705025759-63",1,"2020-06-26 10:31:00",1593192660,"C0",2575020,1595767680,"2020-07-26 05:48:00"
"5739","20155705025759-63",1,"2020-12-17 06:49:00",1608216540,"C3",3011640,1611228180,"2021-01-21 03:23:00"
"5742","20155705025759-63",1,"2021-03-02 05:57:00",1614693420,"C4",2830500,1617523920,"2021-04-04 01:12:00"
"5740","20155705025759-63",1,"2021-03-12 14:57:00",1615589820,"C4",3034140,1618623960,"2021-04-16 18:46:00"
