,car.id,car.type,startDatetime,startTimestamp,gate.name,duration,endTimestamp,endDatetime
5740,20155705025759-63,1,3/12/2021 14:57,1615589820,C4,3034140,1618623960,4/16/2021 18:46
5742,20155705025759-63,1,3/2/2021 5:57,1614693420,C4,2830500,1617523920,4/4/2021 1:12
5739,20155705025759-63,1,12/17/2020 6:49,1608216540,C3,3011640,1611228180,1/21/2021 3:23
5741,20155705025759-63,1,6/26/2020 10:31,1593192660,C0,2575020,1595767680,7/26/2020 5:48
5738,20155705025759-63,1,6/22/2019 5:04,1561205040,C6,2605380,1563810420,7/22/2019 8:47
5737,20155705025759-63,1,2/14/2019 11:57,1550174220,C2,2915820,1553090040,3/20/2019 6:54
5736,20155705025759-63,1,10/14/2018 16:19,1539559140,C0,2789940,1542349080,11/15/2018 22:18
5743,20155705025759-63,1,7/18/2018 6:15,1531919700,C2,1490580,1533410280,8/4/2018 12:18
5735,20155705025759-63,1,9/19/2016 21:37,1474346220,C5,2040240,1476386460,10/13/2016 12:21
2662,20165407095430-165,1,8/21/2016 14:02,1471813320,C4,1146660,1472959980,9/3/2016 20:33
5733,20155705025759-63,1,7/28/2016 3:27,1469701620,C2,2410680,1472112300,8/25/2016 1:05
5734,20155705025759-63,1,7/20/2016 22:34,1469079240,C3,2090460,1471169700,8/14/2016 3:15
5306,20162823012818-280,2,8/4/2016 13:28,1470342480,C7,700800,1471043280,8/12/2016 16:08
6511,20162213012243-861,1,7/31/2016 18:48,1470016080,C5,977880,1470993960,8/12/2016 2:26
1893,20164322074326-978,1,7/25/2016 2:37,1469439420,C3,787320,1470226740,8/3/2016 5:19
4584,20163108093145-941,1,7/14/2016 7:07,1468505220,C7,642240,1469147460,7/21/2016 17:31
2696,20164808054840-252,1,7/10/2016 9:31,1468168260,C3,773340,1468941600,7/19/2016 8:20
4208,20161523061558-393,1,7/12/2016 22:54,1468389240,C7,486660,1468875900,7/18/2016 14:05
1389,20165621125656-604,1,7/10/2016 19:16,1468203360,C5,620400,1468823760,7/17/2016 23:36
1950,20164108104158-541,2,7/10/2016 3:29,1468146540,C6,677160,1468823700,7/17/2016 23:35
5253,20162506102549-845,1,7/8/2016 9:22,1467994920,C5,777060,1468771980,7/17/2016 9:13
914,20164101114139-473,3,7/5/2016 11:45,1467744300,C3,802320,1468546620,7/14/2016 18:37
1115,20165105115138-773,1,7/6/2016 23:24,1467872640,C7,599820,1468472460,7/13/2016 22:01
762,20160723050724-51,2,7/2/2016 17:07,1467504420,C2,864000,1468368420,7/12/2016 17:07
6428,20161515101514-592,1,7/2/2016 19:45,1467513900,C2,278760,1467792660,7/6/2016 1:11
5192,20160418080457-245,1,6/29/2016 15:25,1467239100,C2,522180,1467761280,7/5/2016 16:28
476,20162701092754-587,1,6/26/2016 13:39,1466973540,C8,693360,1467666900,7/4/2016 14:15
1359,20163118113139-316,1,6/28/2016 11:36,1467138960,C2,506100,1467645060,7/4/2016 8:11
1963,20165117075149-247,1,6/22/2016 4:27,1466594820,C3,1032720,1467627540,7/4/2016 3:19
2670,20164006084004-327,2,6/27/2016 5:12,1467029520,C4,560040,1467589560,7/3/2016 16:46
6528,20164622054644-414,2,6/27/2016 15:49,1467067740,C0,443340,1467511080,7/2/2016 18:58
6177,20162224012201-227,1,6/27/2016 19:31,1467081060,C4,422820,1467503880,7/2/2016 16:58
845,20155517055510-758,2,5/31/2016 6:05,1464699900,C2,2751900,1467451800,7/2/2016 2:30
3136,20165709095721-17,1,6/17/2016 18:12,1466212320,C5,1133100,1467345420,6/30/2016 20:57
3104,20164717114725-131,2,6/21/2016 8:17,1466522220,C4,430200,1466952420,6/26/2016 7:47
485,20162310042305-75,1,6/21/2016 10:32,1466530320,C7,400860,1466931180,6/26/2016 1:53
3517,20163116093107-139,1,6/19/2016 17:32,1466382720,C5,423780,1466806500,6/24/2016 15:15
1818,20160618010659-729,2,6/17/2016 2:06,1466154360,C8,510480,1466664840,6/22/2016 23:54
4211,20161103061131-806,1,6/15/2016 14:09,1466024940,C5,534840,1466559780,6/21/2016 18:43
5494,20164927034958-905,1,6/18/2016 5:49,1466254140,C8,266400,1466520540,6/21/2016 7:49
2656,20162214052214-931,2,6/14/2016 17:17,1465949820,C8,535620,1466485440,6/20/2016 22:04
55,20160902060942-509,2,6/13/2016 19:27,1465871220,C6,612780,1466484000,6/20/2016 21:40
3160,20161907081910-516,1,6/16/2016 7:34,1466087640,C7,383700,1466471340,6/20/2016 18:09
596,20160424070451-587,1,6/16/2016 2:04,1466067840,C8,393840,1466461680,6/20/2016 15:28
592,20161228061242-834,1,6/17/2016 22:20,1466227200,C3,223260,1466450460,6/20/2016 12:21
1570,20163527043543-724,1,6/17/2016 6:27,1466170020,C3,222240,1466392260,6/19/2016 20:11
3296,20162701122721-624,3,6/14/2016 21:18,1465964280,C7,425940,1466390220,6/19/2016 19:37
6326,20161905071929-794,2,6/6/2016 9:33,1465230780,C2,1148520,1466379300,6/19/2016 16:35
5903,20164923044905-91,3,6/15/2016 6:09,1465996140,C0,243600,1466239740,6/18/2016 1:49
6415,20164728074737-670,1,6/13/2016 8:54,1465833240,C2,198060,1466031300,6/15/2016 15:55
3535,20161224031222-354,1,6/12/2016 10:14,1465751640,C8,231960,1465983600,6/15/2016 2:40
1229,20164826104846-825,1,6/12/2016 4:36,1465731360,C7,206640,1465938000,6/14/2016 14:00
1709,20161326101328-758,1,6/12/2016 5:25,1465734300,C4,181440,1465915740,6/14/2016 7:49
1799,20161319081321-100,3,6/10/2016 22:57,1465624620,C4,279120,1465903740,6/14/2016 4:29
5519,20162125032104-263,2,6/9/2016 4:12,1465470720,C5,418620,1465889340,6/14/2016 0:29
5530,20164020014058-615,2,6/10/2016 9:21,1465575660,C2,256980,1465832640,6/13/2016 8:44
930,20165001065044-854,2,6/7/2016 9:42,1465317720,C7,458160,1465775880,6/12/2016 16:58
5946,20160920120951-598,1,6/9/2016 12:35,1465500900,C7,247080,1465747980,6/12/2016 9:13
3047,20162015042050-853,1,6/2/2016 12:40,1464896400,C7,771000,1465667400,6/11/2016 10:50
648,20163020083029-640,1,6/9/2016 4:45,1465472700,C7,190500,1465663200,6/11/2016 9:40
754,20162325052301-988,2,6/9/2016 3:46,1465469160,C2,178140,1465647300,6/11/2016 5:15
5116,20162119092147-990,2,6/4/2016 15:15,1465078500,C2,467880,1465546380,6/10/2016 1:13
1113,20164216084251-215,1,6/1/2016 16:58,1464825480,C8,706080,1465531560,6/9/2016 21:06
1647,20162706052712-821,2,6/5/2016 19:51,1465181460,C5,325080,1465506540,6/9/2016 14:09
3903,20165024055011-688,3,6/3/2016 22:48,1465019280,C5,440940,1465460220,6/9/2016 1:17
6082,20162828032836-807,2,6/5/2016 23:37,1465195020,C0,240180,1465435200,6/8/2016 18:20
1066,20163125113148-504,2,6/6/2016 7:06,1465221960,C8,204180,1465426140,6/8/2016 15:49
6470,20161711061704-241,1,6/5/2016 7:21,1465136460,C6,270480,1465406940,6/8/2016 10:29
2604,20161010091000-835,3,6/5/2016 10:40,1465148400,C7,250200,1465398600,6/8/2016 8:10
832,20161912121924-319,1,6/4/2016 20:19,1465096740,C7,288000,1465384740,6/8/2016 4:19
6386,20162627082628-314,1,6/6/2016 17:06,1465257960,C4,111900,1465369860,6/8/2016 0:11
2567,20161222121219-49,1,6/6/2016 3:56,1465210560,C5,158280,1465368840,6/7/2016 23:54
3673,20162104082115-909,1,6/3/2016 1:32,1464942720,C8,366780,1465309500,6/7/2016 7:25
681,20161410101407-777,3,6/4/2016 0:38,1465025880,C5,265680,1465291560,6/7/2016 2:26
6005,20163314053328-67,3,6/1/2016 1:51,1464771060,C2,499560,1465270620,6/6/2016 20:37
3073,20161006051036-393,2,6/2/2016 22:44,1464932640,C7,336120,1465268760,6/6/2016 20:06
5626,20163922093934-985,1,6/4/2016 0:04,1465023840,C8,217740,1465241580,6/6/2016 12:33
6307,20164028104033-812,3,6/5/2016 0:26,1465111560,C5,93480,1465205040,6/6/2016 2:24
4642,20160017030016-746,2,6/1/2016 1:39,1464770340,C4,415980,1465186320,6/5/2016 21:12
6171,20161927041946-363,3,6/4/2016 17:24,1465086240,C7,99300,1465185540,6/5/2016 20:59
5637,20163630103646-440,3,6/5/2016 0:25,1465111500,C5,68820,1465180320,6/5/2016 19:32
5128,20164718044740-123,1,6/3/2016 17:59,1465001940,C2,173340,1465175280,6/5/2016 18:08
4645,20160419080431-102,1,6/1/2016 9:16,1464797760,C4,375840,1465173600,6/5/2016 17:40
4170,20165716115733-899,1,5/26/2016 7:46,1464273960,C6,848940,1465122900,6/5/2016 3:35
630,20164115054120-679,1,6/2/2016 0:59,1464854340,C6,249180,1465103520,6/4/2016 22:12
956,20162217032244-108,2,6/2/2016 19:14,1464920040,C5,174540,1465094580,6/4/2016 19:43
4393,20164028114031-155,1,6/3/2016 23:40,1465022400,C3,70200,1465092600,6/4/2016 19:10
3638,20162125082144-48,3,6/1/2016 7:31,1464791460,C7,300900,1465092360,6/4/2016 19:06
4792,20162511082549-862,2,6/2/2016 6:37,1464874620,C7,210480,1465085100,6/4/2016 17:05
5825,20164622114647-721,3,6/1/2016 7:43,1464792180,C4,283140,1465075320,6/4/2016 14:22
3187,20162027072034-172,2,6/3/2016 15:12,1464991920,C4,79140,1465071060,6/4/2016 13:11
2107,20161613031621-889,1,6/1/2016 18:21,1464830460,C4,236100,1465066560,6/4/2016 11:56
1745,20161918041903-606,1,6/2/2016 8:39,1464881940,C5,181200,1465063140,6/4/2016 10:59
474,20165815125818-188,1,6/2/2016 1:46,1464857160,C3,189360,1465046520,6/4/2016 6:22
2536,20160124090148-920,1,5/31/2016 11:57,1464721020,C5,307680,1465028700,6/4/2016 1:25
3980,20164128104138-234,1,6/1/2016 17:53,1464828780,C4,185760,1465014540,6/3/2016 21:29
390,20163402063435-850,1,5/30/2016 14:51,1464645060,C7,349860,1464994920,6/3/2016 16:02
152,20164926124930-922,1,5/30/2016 13:54,1464641640,C3,349500,1464991140,6/3/2016 14:59
5405,20163015053019-83,2,5/28/2016 1:18,1464423480,C5,532440,1464955920,6/3/2016 5:12
2111,20160809090856-701,1,5/31/2016 2:10,1464685800,C4,267960,1464953760,6/3/2016 4:36
3849,20164220094251-139,1,5/30/2016 14:00,1464642000,C4,293160,1464935160,6/2/2016 23:26
4181,20161121021106-144,1,5/30/2016 20:05,1464663900,C2,266280,1464930180,6/2/2016 22:03
4153,20165529085512-11,1,5/31/2016 14:56,1464731760,C0,194460,1464926220,6/2/2016 20:57
3763,20164726074710-213,2,5/31/2016 4:37,1464694620,C8,210300,1464904920,6/2/2016 15:02
2618,20161623011642-809,1,5/31/2016 21:31,1464755460,C8,144180,1464899640,6/2/2016 13:34
4324,20160326030315-917,2,5/31/2016 16:21,1464736860,C5,145560,1464882420,6/2/2016 8:47
2098,20162629082608-704,1,6/1/2016 0:10,1464765000,C5,114720,1464879720,6/2/2016 8:02
4421,20160529040522-408,1,6/1/2016 2:15,1464772500,C2,104700,1464877200,6/2/2016 7:20
3031,20162425062418-198,1,5/30/2016 14:54,1464645240,C8,231300,1464876540,6/2/2016 7:09
2630,20162421092429-563,1,5/31/2016 16:37,1464737820,C5,127140,1464864960,6/2/2016 3:56
827,20162515022503-709,1,5/30/2016 1:30,1464597000,C8,249900,1464846900,6/1/2016 22:55
514,20164115024151-5,1,5/30/2016 17:59,1464656340,C7,186840,1464843180,6/1/2016 21:53
1222,20162222042259-769,1,5/27/2016 16:00,1464390000,C4,430680,1464820680,6/1/2016 15:38
3507,20161318071302-141,2,5/29/2016 1:10,1464509400,C5,309540,1464818940,6/1/2016 15:09
2584,20164715104741-924,1,5/29/2016 16:12,1464563520,C8,245820,1464809340,6/1/2016 12:29
4022,20160728090757-429,1,5/31/2016 1:39,1464683940,C2,116160,1464800100,6/1/2016 9:55
4261,20160624070637-743,2,5/31/2016 8:16,1464707760,C7,87000,1464794760,6/1/2016 8:26
5871,20163724093730-240,3,5/31/2016 4:43,1464694980,C4,83880,1464778860,6/1/2016 4:01
1653,20165213105244-282,3,5/25/2016 20:30,1464233400,C7,535740,1464769140,6/1/2016 1:19
2044,20163414033416-878,3,5/29/2016 18:24,1464571440,C2,186600,1464758040,5/31/2016 22:14
2853,20162925012937-610,2,5/28/2016 16:06,1464476760,C4,268620,1464745380,5/31/2016 18:43
375,20165429105417-811,3,5/30/2016 10:39,1464629940,C4,85500,1464715440,5/31/2016 10:24
624,20162114082157-230,1,5/29/2016 2:47,1464515220,C2,182280,1464697500,5/31/2016 5:25
6142,20162027042012-940,1,5/29/2016 8:27,1464535620,C1,144420,1464680040,5/31/2016 0:34
56,20164026084027-353,2,5/29/2016 18:49,1464572940,C4,98580,1464671520,5/30/2016 22:12
2572,20161226101220-113,1,5/29/2016 15:24,1464560640,C5,92640,1464653280,5/30/2016 17:08
2503,20161929031920-756,1,5/26/2016 19:43,1464316980,C2,335520,1464652500,5/30/2016 16:55
2258,20162409062454-857,2,5/24/2016 3:49,1464086940,C7,554100,1464641040,5/30/2016 13:44
4857,20160521040514-90,1,5/28/2016 4:02,1464433320,C0,187140,1464620460,5/30/2016 8:01
4994,20165927105911-596,1,5/29/2016 8:47,1464536820,C8,82440,1464619260,5/30/2016 7:41
6136,20165824065853-160,1,5/28/2016 4:14,1464434040,C4,167880,1464601920,5/30/2016 2:52
3558,20161421031451-792,1,5/27/2016 6:46,1464356760,C5,243960,1464600720,5/30/2016 2:32
5175,20162706102701-37,3,5/24/2016 3:45,1464086700,C4,510360,1464597060,5/30/2016 1:31
6427,20164912044955-331,1,5/27/2016 14:59,1464386340,C7,184200,1464570540,5/29/2016 18:09
4764,20161903071919-851,2,5/16/2016 6:15,1463404500,C2,1119360,1464523860,5/29/2016 5:11
5480,20160711110708-553,2,5/23/2016 5:35,1464006900,C0,508440,1464515340,5/29/2016 2:49
1403,20161612071621-912,1,5/26/2016 18:28,1464312480,C7,178560,1464491040,5/28/2016 20:04
5182,20163217053256-155,1,5/25/2016 2:14,1464167640,C0,318060,1464485700,5/28/2016 18:35
2465,20161414041441-290,3,5/24/2016 1:22,1464078120,C0,405240,1464483360,5/28/2016 17:56
1738,20161625021649-105,2,5/27/2016 16:40,1464392400,C5,90720,1464483120,5/28/2016 17:52
655,20165723055733-60,1,5/27/2016 0:03,1464332580,C4,140580,1464473160,5/28/2016 15:06
455,20160109120154-984,3,5/22/2016 1:23,1463905380,C0,542460,1464447840,5/28/2016 8:04
1121,20160508120500-362,1,5/24/2016 23:00,1464156000,C8,284340,1464440340,5/28/2016 5:59
2886,20160418080421-476,2,5/23/2016 7:01,1464012060,C2,428220,1464440280,5/28/2016 5:58
5351,20162824122829-498,1,5/26/2016 23:26,1464330360,C2,106140,1464436500,5/28/2016 4:55
6455,20164724114712-44,2,5/26/2016 17:49,1464310140,C5,97260,1464407400,5/27/2016 20:50
2257,20161507051513-138,2,5/25/2016 6:18,1464182280,C4,216540,1464398820,5/27/2016 18:27
2432,20160715040757-420,2,5/25/2016 15:32,1464215520,C8,172380,1464387900,5/27/2016 15:25
2906,20162106052135-91,1,5/22/2016 6:21,1463923260,C5,447600,1464370860,5/27/2016 10:41
4275,20161106011142-596,2,5/20/2016 10:57,1463767020,C7,600780,1464367800,5/27/2016 9:50
1274,20164607104629-486,1,5/17/2016 8:03,1463497380,C6,854220,1464351600,5/27/2016 5:20
3648,20165920055941-216,1,5/23/2016 22:14,1464066840,C0,274500,1464341340,5/27/2016 2:29
5356,20160412100403-624,1,5/19/2016 17:29,1463704140,C0,631500,1464335640,5/27/2016 0:54
6015,20165907125955-871,2,5/22/2016 3:41,1463913660,C5,420840,1464334500,5/27/2016 0:35
600,20165119025134-664,1,5/25/2016 20:18,1464232680,C3,76860,1464309540,5/26/2016 17:39
1182,20163419063429-101,3,5/25/2016 10:14,1464196440,C8,106320,1464302760,5/26/2016 15:46
1023,20165116035154-472,1,5/25/2016 12:55,1464206100,C0,95880,1464301980,5/26/2016 15:33
2610,20160102010124-415,3,5/23/2016 14:11,1464037860,C7,259800,1464297660,5/26/2016 14:21
6051,20164618094655-835,1,5/25/2016 15:46,1464216360,C2,78300,1464294660,5/26/2016 13:31
6115,20162621032632-655,1,5/25/2016 7:20,1464186000,C0,105480,1464291480,5/26/2016 12:38
6551,20164319034355-175,2,5/24/2016 1:43,1464079380,C5,190800,1464270180,5/26/2016 6:43
1100,20165814095833-724,2,5/23/2016 5:01,1464004860,C0,253260,1464258120,5/26/2016 3:22
3512,20163223093205-573,1,5/25/2016 5:06,1464177960,C4,78420,1464256380,5/26/2016 2:53
2454,20163410053456-4,2,5/22/2016 5:46,1463921160,C4,331440,1464252600,5/26/2016 1:50
2427,20161917061915-322,2,5/21/2016 15:06,1463868360,C3,377220,1464245580,5/25/2016 23:53
2674,20160011040054-612,1,5/21/2016 5:00,1463832000,C5,412200,1464244200,5/25/2016 23:30
4684,20164222054243-411,3,5/25/2016 2:54,1464170040,C4,68640,1464238680,5/25/2016 21:58
4334,20165710075759-354,1,5/20/2016 14:41,1463780460,C5,444120,1464224580,5/25/2016 18:03
1346,20161112031156-198,2,5/22/2016 8:47,1463932020,C0,280320,1464212340,5/25/2016 14:39
3252,20162014082012-197,1,5/19/2016 22:13,1463721180,C4,481980,1464203160,5/25/2016 12:06
6059,20162203102237-41,1,5/22/2016 22:46,1463982360,C5,210780,1464193140,5/25/2016 9:19
4477,20162323112359-854,1,5/24/2016 10:16,1464110160,C0,82380,1464192540,5/25/2016 9:09
3909,20163909083952-107,3,5/19/2016 20:59,1463716740,C7,454200,1464170940,5/25/2016 3:09
1878,20165319125305-907,1,5/23/2016 1:35,1463992500,C7,152460,1464144960,5/24/2016 19:56
3768,20163922113927-867,3,5/20/2016 18:32,1463794320,C0,349140,1464143460,5/24/2016 19:31
4304,20162612082614-132,2,5/22/2016 14:41,1463953260,C8,177300,1464130560,5/24/2016 15:56
3121,20162911092915-817,2,5/21/2016 6:38,1463837880,C4,284580,1464122460,5/24/2016 13:41
6117,20161418061406-876,2,5/21/2016 8:58,1463846280,C3,269040,1464115320,5/24/2016 11:42
6026,20165320125359-334,1,5/22/2016 11:39,1463942340,C6,168360,1464110700,5/24/2016 10:25
781,20164810074837-368,2,5/21/2016 16:53,1463874780,C8,196620,1464071400,5/23/2016 23:30
5509,20165305015329-885,1,5/21/2016 20:25,1463887500,C0,175740,1464063240,5/23/2016 21:14
4993,20160615090601-72,2,5/22/2016 19:43,1463971380,C8,91860,1464063240,5/23/2016 21:14
2013,20165704055721-696,1,5/19/2016 0:42,1463643720,C3,411300,1464055020,5/23/2016 18:57
1884,20161611051626-58,2,5/19/2016 1:48,1463647680,C4,403440,1464051120,5/23/2016 17:52
4562,20165911075945-393,1,5/22/2016 1:56,1463907360,C4,132660,1464040020,5/23/2016 14:47
6476,20162921042944-446,3,5/22/2016 23:17,1463984220,C3,55440,1464039660,5/23/2016 14:41
4011,20164201094203-125,1,5/21/2016 0:46,1463816760,C4,211980,1464028740,5/23/2016 11:39
358,20160604020620-396,1,5/17/2016 1:50,1463475000,C7,539520,1464014520,5/23/2016 7:42
3051,20161818071801-292,1,5/22/2016 1:15,1463904900,C3,107940,1464012840,5/23/2016 7:14
2867,20164308024330-236,3,5/18/2016 9:15,1463588100,C7,422160,1464010260,5/23/2016 6:31
6555,20165313095326-823,1,5/19/2016 20:37,1463715420,C5,278520,1463993940,5/23/2016 1:59
3550,20165408055453-259,3,5/19/2016 9:12,1463674320,C2,306360,1463980680,5/22/2016 22:18
1794,20162316122341-349,1,5/19/2016 16:56,1463702160,C2,275580,1463977740,5/22/2016 21:29
696,20161618071617-763,2,5/21/2016 2:16,1463822160,C0,120600,1463942760,5/22/2016 11:46
1904,20160813020801-597,2,5/21/2016 3:44,1463827440,C6,108960,1463936400,5/22/2016 10:00
6529,20165911025927-470,1,5/19/2016 16:26,1463700360,C4,232140,1463932500,5/22/2016 8:55
1601,20164314024337-465,1,5/18/2016 10:33,1463592780,C6,330600,1463923380,5/22/2016 6:23
3311,20160219110233-416,1,5/20/2016 19:08,1463796480,C4,115560,1463912040,5/22/2016 3:14
4779,20161213101216-677,1,5/17/2016 17:54,1463532840,C2,373320,1463906160,5/22/2016 1:36
1848,20164624094605-617,2,5/18/2016 18:26,1463621160,C4,263100,1463884260,5/21/2016 19:31
2539,20162809102817-777,1,5/18/2016 13:07,1463602020,C5,262380,1463864400,5/21/2016 14:00
4807,20163909093927-432,1,5/17/2016 7:41,1463496060,C0,342060,1463838120,5/21/2016 6:42
4231,20161805081816-21,1,5/19/2016 3:38,1463654280,C7,170400,1463824680,5/21/2016 2:58
1461,20164516124536-165,1,5/19/2016 20:36,1463715360,C3,95820,1463811180,5/20/2016 23:13
3559,20161211061224-16,1,5/17/2016 15:56,1463525760,C8,276720,1463802480,5/20/2016 20:48
4746,20165813015832-479,2,5/19/2016 15:38,1463697480,C8,104880,1463802360,5/20/2016 20:46
5322,20162612072638-753,1,5/18/2016 16:44,1463615040,C5,183960,1463799000,5/20/2016 19:50
4063,20161507081502-674,2,5/16/2016 5:53,1463403180,C4,384540,1463787720,5/20/2016 16:42
3876,20163707033759-413,1,5/19/2016 0:58,1463644680,C0,140580,1463785260,5/20/2016 16:01
338,20161604061614-874,1,5/16/2016 8:58,1463414280,C5,348840,1463763120,5/20/2016 9:52
6518,20160317100339-729,1,5/19/2016 9:41,1463676060,C2,85740,1463761800,5/20/2016 9:30
1140,20161214011208-135,1,5/19/2016 4:44,1463658240,C0,57360,1463715600,5/19/2016 20:40
6336,20165510115511-114,2,5/16/2016 15:05,1463436300,C4,264900,1463701200,5/19/2016 16:40
1268,20162317022350-38,1,5/18/2016 23:53,1463640780,C5,60300,1463701080,5/19/2016 16:38
3026,20165112105109-897,2,5/17/2016 20:27,1463542020,C3,155520,1463697540,5/19/2016 15:39
5557,20163314053345-713,3,5/18/2016 19:33,1463625180,C8,70560,1463695740,5/19/2016 15:09
4980,20164713014745-616,1,5/17/2016 13:39,1463517540,C5,172560,1463690100,5/19/2016 13:35
2702,20161615021657-872,3,5/18/2016 3:04,1463565840,C5,72960,1463638800,5/18/2016 23:20
4650,20161412101451-978,1,5/15/2016 13:32,1463344320,C0,271080,1463615400,5/18/2016 16:50
3594,20162101102134-434,3,5/16/2016 10:37,1463420220,C0,185280,1463605500,5/18/2016 14:05
4016,20163413023412-159,1,5/16/2016 21:24,1463459040,C7,141900,1463600940,5/18/2016 12:49
2150,20165005045015-818,1,5/14/2016 3:32,1463221920,C5,364860,1463586780,5/18/2016 8:53
5005,20160306010354-831,2,5/14/2016 6:35,1463232900,C2,333960,1463566860,5/18/2016 3:21
4132,20160414060432-270,1,5/15/2016 21:47,1463374020,C2,142980,1463517000,5/17/2016 13:30
3761,20160311050306-89,1,5/14/2016 14:43,1463262180,C4,250800,1463512980,5/17/2016 12:23
5985,20163207073234-8,2,5/14/2016 19:17,1463278620,C0,215700,1463494320,5/17/2016 7:12
4423,20161205051258-519,3,5/13/2016 9:00,1463155200,C5,330840,1463486040,5/17/2016 4:54
5311,20163810043842-166,2,5/16/2016 6:06,1463403960,C7,68640,1463472600,5/17/2016 1:10
1027,20165710015727-667,2,5/14/2016 20:31,1463283060,C3,184620,1463467680,5/16/2016 23:48
478,20163904013912-769,2,5/10/2016 18:12,1462929120,C2,534780,1463463900,5/16/2016 22:45
764,20165706065721-811,1,5/15/2016 1:37,1463301420,C2,94800,1463396220,5/16/2016 3:57
4173,20161508121511-970,2,5/14/2016 17:03,1463270580,C6,89280,1463359860,5/15/2016 17:51
6471,20160709060739-448,1,5/13/2016 12:33,1463167980,C7,184380,1463352360,5/15/2016 15:46
3388,20164212054245-135,1,5/14/2016 12:58,1463255880,C5,77880,1463333760,5/15/2016 10:36
4723,20163309073335-602,2,5/12/2016 8:44,1463067840,C6,263460,1463331300,5/15/2016 9:55
6238,20165712035713-404,3,5/14/2016 1:25,1463214300,C2,60240,1463274540,5/14/2016 18:09
4652,20161001071044-510,1,5/12/2016 23:42,1463121720,C2,126240,1463247960,5/14/2016 10:46
877,20161706051756-373,2,5/11/2016 20:33,1463023980,C4,221880,1463245860,5/14/2016 10:11
2028,20162406112415-657,1,5/10/2016 10:26,1462901160,C6,342120,1463243280,5/14/2016 9:28
5379,20163108043103-996,3,5/12/2016 9:55,1463072100,C0,160920,1463233020,5/14/2016 6:37
2360,20163702083732-163,1,5/10/2016 3:39,1462876740,C5,336660,1463213400,5/14/2016 1:10
4458,20160311050309-656,2,5/13/2016 10:15,1463159700,C4,49440,1463209140,5/13/2016 23:59
598,20164508064519-442,1,5/12/2016 5:33,1463056380,C3,113760,1463170140,5/13/2016 13:09
986,20160301010333-533,2,5/12/2016 4:07,1463051220,C4,114780,1463166000,5/13/2016 12:00
5002,20163607053650-333,1,5/12/2016 16:15,1463094900,C0,61020,1463155920,5/13/2016 9:12
397,20163806093805-983,1,5/9/2016 20:51,1462852260,C0,299580,1463151840,5/13/2016 8:04
6363,20164006104039-266,3,5/12/2016 2:00,1463043600,C5,69600,1463113200,5/12/2016 21:20
405,20162703112728-345,1,5/10/2016 9:57,1462899420,C4,199800,1463099220,5/12/2016 17:27
5798,20163508033551-791,1,5/11/2016 14:50,1463003400,C4,85500,1463088900,5/12/2016 14:35
1711,20164708074730-603,2,5/11/2016 12:32,1462995120,C4,92100,1463087220,5/12/2016 14:07
4200,20160909040905-953,1,5/11/2016 7:13,1462975980,C8,70320,1463046300,5/12/2016 2:45
6302,20165202075235-678,1,5/8/2016 18:00,1462755600,C5,277440,1463033040,5/11/2016 23:04
935,20162806092859-620,2,5/11/2016 0:38,1462952280,C8,80040,1463032320,5/11/2016 22:52
5113,20162308022340-411,3,5/10/2016 6:34,1462887240,C4,144660,1463031900,5/11/2016 22:45
87,20162113102146-554,1,5/8/2016 15:09,1462745340,C5,272160,1463017500,5/11/2016 18:45
3082,20165703075701-962,1,5/10/2016 12:09,1462907340,C4,88560,1462995900,5/11/2016 12:45
5525,20162807032803-741,2,5/9/2016 11:29,1462818540,C6,158460,1462977000,5/11/2016 7:30
4226,20162104032146-897,3,5/8/2016 21:55,1462769700,C3,184620,1462954320,5/11/2016 1:12
3217,20162204092243-393,2,5/8/2016 17:12,1462752720,C7,186900,1462939620,5/10/2016 21:07
4015,20162616092636-320,1,5/7/2016 8:20,1462634400,C6,301740,1462936140,5/10/2016 20:09
691,20164407054454-328,3,5/9/2016 22:47,1462859220,C4,63660,1462922880,5/10/2016 16:28
5360,20162305022327-418,3,5/9/2016 9:53,1462812780,C4,109800,1462922580,5/10/2016 16:23
2315,20162403012456-660,1,5/8/2016 5:14,1462709640,C0,201300,1462910940,5/10/2016 13:09
2958,20164806024852-900,1,5/9/2016 4:12,1462792320,C2,110520,1462902840,5/10/2016 10:54
5073,20160003020009-483,1,5/7/2016 22:32,1462685520,C5,188160,1462873680,5/10/2016 2:48
5535,20165807025851-835,3,5/9/2016 4:52,1462794720,C2,68220,1462862940,5/9/2016 23:49
541,20163403103449-145,3,5/9/2016 2:36,1462786560,C8,69960,1462856520,5/9/2016 22:02
3985,20161207031252-328,2,5/8/2016 16:36,1462750560,C6,91440,1462842000,5/9/2016 18:00
802,20162502012517-879,2,5/8/2016 19:06,1462759560,C7,76980,1462836540,5/9/2016 16:29
386,20163001013040-715,3,5/8/2016 1:08,1462694880,C7,80040,1462774920,5/8/2016 23:22
4091,20160402010438-874,2,5/5/2016 13:03,1462478580,C6,259140,1462737720,5/8/2016 13:02
1350,20161405101442-940,2,5/7/2016 11:56,1462647360,C4,89460,1462736820,5/8/2016 12:47
4216,20161501071504-180,3,5/5/2016 15:01,1462485660,C3,186780,1462672440,5/7/2016 18:54
5327,20163301093354-99,2,5/4/2016 7:33,1462372380,C4,252000,1462624380,5/7/2016 5:33
752,20162226032206-214,1,5/5/2016 12:38,1462477080,C4,109680,1462586760,5/6/2016 19:06
689,20162302072339-398,1,5/5/2016 15:35,1462487700,C4,96240,1462583940,5/6/2016 18:19
647,20161227011258-480,1,5/3/2016 19:51,1462330260,C3,180780,1462511040,5/5/2016 22:04
2343,20161928071944-220,2,5/2/2016 21:59,1462251540,C7,199200,1462450740,5/5/2016 5:19
2520,20161130121138-137,2,5/3/2016 8:45,1462290300,C7,123420,1462413720,5/4/2016 19:02
6048,20165001065047-958,1,5/2/2016 11:57,1462215420,C4,104820,1462320240,5/3/2016 17:04
4810,20161731021739-422,3,4/29/2016 18:01,1461978060,C5,314880,1462292940,5/3/2016 9:29
4854,20164712064702-854,2,4/23/2016 10:02,1461430920,C8,192420,1461623340,4/25/2016 15:29
3075,20164021074031-924,1,4/23/2016 16:04,1461452640,C8,101520,1461554160,4/24/2016 20:16
4357,20163403093427-432,2,4/19/2016 3:07,1461060420,C4,453060,1461513480,4/24/2016 8:58
4697,20161308031352-805,3,4/18/2016 20:51,1461037860,C7,442140,1461480000,4/23/2016 23:40
2979,20162115092102-471,1,4/21/2016 1:30,1461227400,C4,163380,1461390780,4/22/2016 22:53
1603,20164707014735-384,2,4/16/2016 13:23,1460838180,C2,258720,1461096900,4/19/2016 13:15
1279,20163014013040-441,1,4/16/2016 8:40,1460821200,C4,77700,1460898900,4/17/2016 6:15
52,20162904122951-717,1,4/13/2016 5:49,1460551740,C0,203700,1460755440,4/15/2016 14:24
1673,20165904095931-786,2,4/13/2016 14:07,1460581620,C5,99060,1460680680,4/14/2016 17:38
5072,20162810052858-571,2,4/12/2016 8:44,1460475840,C5,70680,1460546520,4/13/2016 4:22
920,20165206045258-573,1,4/10/2016 5:04,1460289840,C8,151560,1460441400,4/11/2016 23:10
4912,20165701055728-629,1,4/10/2016 17:25,1460334300,C4,96960,1460431260,4/11/2016 20:21
4849,20161605081629-930,1,4/9/2016 5:00,1460203200,C7,166920,1460370120,4/11/2016 3:22
51,20162904122951-717,1,4/6/2016 5:18,1459945080,C0,202740,1460147820,4/8/2016 13:37
50,20162904122951-717,1,3/30/2016 5:13,1459339980,C0,202980,1459542960,4/1/2016 13:36
2256,20163007043005-603,3,3/19/2016 20:30,1458444600,C3,1047600,1459492200,3/31/2016 23:30
191,20160411030412-40,1,3/14/2016 19:18,1458008280,C4,1388220,1459396500,3/30/2016 20:55
780,20165624125612-641,2,3/26/2016 20:55,1459050900,C6,201540,1459252440,3/29/2016 4:54
3268,20163125083158-7,2,3/27/2016 15:37,1459118220,C5,99180,1459217400,3/28/2016 19:10
2090,20164504064540-547,1,3/19/2016 10:19,1458407940,C8,652620,1459060560,3/26/2016 23:36
49,20162904122951-717,1,3/23/2016 6:02,1458738120,C0,204780,1458942900,3/25/2016 14:55
4223,20154604064624-746,1,2/24/2016 20:23,1456374180,C3,2525460,1458899640,3/25/2016 2:54
4958,20154625114655-96,1,2/23/2016 4:34,1456230840,C8,2625840,1458856680,3/24/2016 14:58
2496,20165117045137-283,1,3/21/2016 2:21,1458552060,C5,146700,1458698760,3/22/2016 19:06
838,20155723045734-820,1,3/5/2016 13:57,1457215020,C4,1301280,1458516300,3/20/2016 16:25
48,20162904122951-717,1,3/16/2016 6:09,1458133740,C0,202920,1458336660,3/18/2016 14:31
6123,20161503081526-237,1,3/15/2016 12:35,1458070500,C2,131100,1458201600,3/17/2016 1:00
6489,20161412121444-732,1,3/13/2016 9:12,1457885520,C0,71880,1457957400,3/14/2016 5:10
47,20162904122951-717,1,3/9/2016 5:37,1457530620,C0,203640,1457734260,3/11/2016 14:11
5386,20164124024115-14,1,3/3/2016 0:41,1456994460,C5,414900,1457409360,3/7/2016 19:56
2155,20154828034832-761,2,2/17/2016 20:56,1455771360,C5,1536360,1457307720,3/6/2016 15:42
3808,20164701124736-81,1,3/4/2016 2:05,1457085900,C4,73560,1457159460,3/4/2016 22:31
2831,20165222105209-198,1,2/27/2016 16:57,1456621020,C8,90780,1456711800,2/28/2016 18:10
3421,20160020030000-577,2,2/26/2016 4:36,1456490160,C5,160320,1456650480,2/28/2016 1:08
5579,20164124024135-223,3,2/25/2016 17:01,1456448460,C4,94800,1456543260,2/26/2016 19:21
2353,20151815091854-333,1,2/1/2016 4:02,1454328120,C5,1499280,1455827400,2/18/2016 12:30
4037,20162209102238-93,2,2/13/2016 20:28,1455424080,C4,127320,1455551400,2/15/2016 7:50
1309,20151415031434-50,1,1/21/2016 2:17,1453371420,C4,1573740,1454945160,2/8/2016 7:26
1193,20162716112747-330,1,2/3/2016 5:35,1454506500,C5,191760,1454698260,2/5/2016 10:51
5765,20161915061905-937,2,2/2/2016 15:05,1454454300,C4,226680,1454680980,2/5/2016 6:03
2172,20154430034428-915,1,1/11/2016 21:45,1452577500,C2,2040180,1454617680,2/4/2016 12:28
1001,20163708103702-555,2,1/21/2016 9:35,1453397700,C5,559740,1453957440,1/27/2016 21:04
2748,20165519125545-196,2,1/25/2016 20:49,1453783740,C2,78120,1453861860,1/26/2016 18:31
6156,20151622071609-320,1,1/6/2016 12:35,1452112500,C5,1694220,1453806720,1/26/2016 3:12
2582,20151821081800-795,1,1/11/2016 6:22,1452522120,C3,1209180,1453731300,1/25/2016 6:15
4809,20153310103325-597,3,12/26/2015 20:13,1451189580,C3,1708800,1452898380,1/15/2016 14:53
4090,20150319090350-88,1,12/29/2015 0:41,1451378460,C2,1242840,1452621300,1/12/2016 9:55
24,20151408071436-141,1,12/29/2015 1:50,1451382600,C2,1207620,1452590220,1/12/2016 1:17
6347,20160506090520-274,2,1/8/2016 17:59,1452304740,C0,102420,1452407160,1/9/2016 22:26
3123,20152404012417-940,1,12/24/2015 1:03,1450947780,C2,1364220,1452312000,1/8/2016 20:00
1901,20153628063656-228,3,12/25/2015 8:06,1451059560,C4,864600,1451924160,1/4/2016 8:16
5042,20150916030932-958,1,12/11/2015 11:16,1449861360,C5,1825260,1451686620,1/1/2016 14:17
2421,20150613010619-88,3,12/22/2015 13:09,1450818540,C5,864540,1451683080,1/1/2016 13:18
1927,20151828111836-799,1,12/30/2015 12:40,1451508000,C4,88860,1451596860,12/31/2015 13:21
4235,20155822105810-579,2,12/18/2015 20:46,1450500360,C6,944460,1451444820,12/29/2015 19:07
4201,20154125074116-47,1,12/18/2015 21:05,1450501500,C5,913680,1451415180,12/29/2015 10:53
4759,20150414060406-461,2,12/13/2015 3:52,1450007520,C2,1306260,1451313780,12/28/2015 6:43
427,20152629012651-157,3,12/11/2015 11:28,1449862080,C7,1283160,1451145240,12/26/2015 7:54
2643,20152710122745-528,1,12/8/2015 21:52,1449640320,C3,1486500,1451126820,12/26/2015 2:47
1982,20152218122219-545,2,12/21/2015 10:09,1450721340,C4,251220,1450972560,12/24/2015 7:56
708,20154326044353-158,3,12/12/2015 15:29,1449962940,C0,950280,1450913220,12/23/2015 15:27
6314,20155826055855-744,2,12/12/2015 13:14,1449954840,C8,948480,1450903320,12/23/2015 12:42
4872,20151525031532-107,1,12/8/2015 9:21,1449595260,C7,1293480,1450888740,12/23/2015 8:39
5799,20151509081503-433,3,12/18/2015 0:33,1450427580,C8,374940,1450802520,12/22/2015 8:42
3624,20153309103304-690,1,12/4/2015 21:51,1449294660,C8,1450440,1450745100,12/21/2015 16:45
3863,20153917053945-907,1,12/20/2015 8:27,1450628820,C2,75360,1450704180,12/21/2015 5:23
4590,20153428083457-4,1,12/6/2015 3:40,1449402000,C8,1232280,1450634280,12/20/2015 9:58
3530,20154119024105-829,2,12/6/2015 11:47,1449431220,C6,1122060,1450553280,12/19/2015 11:28
3376,20153829013810-820,1,12/5/2015 7:44,1449330240,C8,1207080,1450537320,12/19/2015 7:02
2802,20152329072302-894,1,12/5/2015 1:43,1449308580,C8,1207200,1450515780,12/19/2015 1:03
5732,20155705025759-63,1,11/20/2015 10:33,1448044380,C6,2417160,1450461540,12/18/2015 9:59
5254,20151617081652-70,1,11/30/2015 12:20,1448914800,C4,1471080,1450385880,12/17/2015 12:58
5610,20154629064615-476,1,12/15/2015 3:48,1450180080,C3,195960,1450376040,12/17/2015 10:14
2977,20152829012800-488,3,12/8/2015 9:16,1449594960,C4,754560,1450349520,12/17/2015 2:52
564,20154826034855-575,1,12/5/2015 6:00,1449324000,C2,752040,1450076040,12/13/2015 22:54
1557,20154525114509-293,1,12/4/2015 19:41,1449286860,C2,760020,1450046880,12/13/2015 14:48
4964,20155617035648-789,1,12/6/2015 5:45,1449409500,C2,612420,1450021920,12/13/2015 7:52
1828,20150712070713-541,2,11/30/2015 21:56,1448949360,C7,983220,1449932580,12/12/2015 7:03
1554,20154904064902-300,1,12/10/2015 16:19,1449793140,C8,110520,1449903660,12/11/2015 23:01
3396,20150930030938-661,3,12/1/2015 1:52,1448963520,C0,758940,1449722460,12/9/2015 20:41
4124,20151127051117-574,1,11/24/2015 12:53,1448398380,C6,1279620,1449678000,12/9/2015 8:20
532,20155528055554-549,2,12/1/2015 8:47,1448988420,C2,687540,1449675960,12/9/2015 7:46
1077,20153120063140-521,1,12/2/2015 21:46,1449121560,C7,539100,1449660660,12/9/2015 3:31
957,20154529034521-219,1,11/29/2015 21:41,1448862060,C4,661920,1449523980,12/7/2015 13:33
94,20150614110632-795,3,12/3/2015 6:06,1449151560,C8,324720,1449476280,12/7/2015 0:18
2065,20154023084052-167,1,12/4/2015 9:20,1449249600,C8,190560,1449440160,12/6/2015 14:16
2099,20152207062244-430,2,11/26/2015 9:47,1448560020,C8,867180,1449427200,12/6/2015 10:40
6267,20155430015455-513,3,11/25/2015 8:30,1448469000,C5,937620,1449406620,12/6/2015 4:57
1495,20152023042040-26,2,11/23/2015 0:05,1448265900,C3,1127700,1449393600,12/6/2015 1:20
4426,20150516050501-365,2,11/25/2015 14:41,1448491260,C4,863280,1449354540,12/5/2015 14:29
4070,20151125121147-666,1,11/24/2015 5:56,1448373360,C7,871500,1449244860,12/4/2015 8:01
2909,20153622103648-402,3,11/21/2015 18:56,1448160960,C8,1043520,1449204480,12/3/2015 20:48
2497,20152227062255-337,2,11/26/2015 0:10,1448525400,C3,645660,1449171060,12/3/2015 11:31
264,20151201121236-41,1,11/19/2015 16:08,1447978080,C3,1190220,1449168300,12/3/2015 10:45
2871,20151814051808-820,3,11/19/2015 14:17,1447971420,C8,1196220,1449167640,12/3/2015 10:34
3898,20151613061634-340,2,11/30/2015 0:46,1448873160,C8,289800,1449162960,12/3/2015 9:16
5841,20152418062434-209,1,11/24/2015 9:48,1448387280,C2,725580,1449112860,12/2/2015 19:21
343,20155819065837-382,2,11/22/2015 10:05,1448215500,C5,792060,1449007560,12/1/2015 14:06
4519,20151427031411-974,2,11/23/2015 22:22,1448346120,C2,619260,1448965380,12/1/2015 2:23
5649,20153618053610-340,1,11/13/2015 22:31,1447482660,C7,1459500,1448942160,11/30/2015 19:56
505,20150027080052-161,3,11/18/2015 13:10,1447881000,C8,903000,1448784000,11/29/2015 0:00
4624,20150420010418-650,1,11/17/2015 13:48,1447796880,C3,961980,1448758860,11/28/2015 17:01
6023,20155706095759-642,1,11/18/2015 5:05,1447851900,C5,899040,1448750940,11/28/2015 14:49
2809,20152211042208-883,1,11/18/2015 4:41,1447850460,C4,833820,1448684280,11/27/2015 20:18
5354,20150327030347-941,1,11/20/2015 21:15,1448082900,C5,586440,1448669340,11/27/2015 16:09
2756,20155114055130-358,1,11/10/2015 16:09,1447200540,C0,1468440,1448668980,11/27/2015 16:03
2684,20153226043220-886,1,11/19/2015 9:31,1447954260,C8,663420,1448617680,11/27/2015 1:48
1005,20155223045209-786,2,11/19/2015 16:16,1447978560,C2,615780,1448594340,11/26/2015 19:19
5876,20153113023123-668,2,11/18/2015 10:03,1447869780,C2,711240,1448581020,11/26/2015 15:37
5952,20151431051408-107,1,11/16/2015 21:10,1447737000,C5,833820,1448570820,11/26/2015 12:47
3823,20154216034256-486,2,11/17/2015 15:22,1447802520,C2,765600,1448568120,11/26/2015 12:02
1847,20152513062528-584,1,11/18/2015 5:17,1447852620,C3,712740,1448565360,11/26/2015 11:16
621,20153925023956-683,2,11/18/2015 15:34,1447889640,C2,667500,1448557140,11/26/2015 8:59
572,20151826011805-225,2,11/15/2015 14:18,1447625880,C8,865440,1448491320,11/25/2015 14:42
3907,20153528073554-422,1,11/18/2015 13:23,1447881780,C4,553860,1448435640,11/24/2015 23:14
1366,20153519093544-845,1,11/14/2015 2:27,1447496820,C6,936840,1448433660,11/24/2015 22:41
1582,20151426021455-333,1,11/18/2015 16:41,1447893660,C7,510180,1448403840,11/24/2015 14:24
4313,20151114111101-450,1,11/15/2015 13:25,1447622700,C7,766920,1448389620,11/24/2015 10:27
244,20150806110838-706,1,11/11/2015 3:33,1447241580,C8,1135740,1448377320,11/24/2015 7:02
3449,20153328033312-600,3,11/13/2015 1:36,1447407360,C5,943740,1448351100,11/23/2015 23:45
176,20155426035428-177,2,11/16/2015 9:15,1447694100,C7,626580,1448320680,11/23/2015 15:18
4714,20151312011312-740,1,11/6/2015 6:19,1446819540,C2,1441080,1448260620,11/22/2015 22:37
6183,20151518011531-224,1,11/8/2015 12:23,1447014180,C0,1220460,1448234640,11/22/2015 15:24
2923,20154727064700-998,3,11/8/2015 10:08,1447006080,C2,1214820,1448220900,11/22/2015 11:35
3591,20154903114941-837,1,11/19/2015 7:14,1447946040,C6,273180,1448219220,11/22/2015 11:07
3683,20151622081618-495,1,11/6/2015 19:56,1446868560,C8,1322400,1448190960,11/22/2015 3:16
6006,20154902034953-35,3,11/7/2015 18:38,1446950280,C2,1199220,1448149500,11/21/2015 15:45
1959,20155121015151-176,1,11/6/2015 3:33,1446809580,C5,1313640,1448123220,11/21/2015 8:27
1913,20155328095345-887,1,11/11/2015 13:48,1447278480,C8,763860,1448042340,11/20/2015 9:59
5730,20150825040833-548,2,11/14/2015 2:20,1447496400,C4,534240,1448030640,11/20/2015 6:44
3392,20155523065557-761,2,11/13/2015 14:59,1447455540,C2,554880,1448010420,11/20/2015 1:07
2169,20153118113152-842,2,11/9/2015 12:31,1447101060,C5,897300,1447998360,11/19/2015 21:46
3441,20153127083119-859,1,11/10/2015 22:46,1447224360,C8,771300,1447995660,11/19/2015 21:01
3190,20150928020950-296,1,11/13/2015 19:57,1447473420,C5,499860,1447973280,11/19/2015 14:48
768,20152328122311-696,1,11/2/2015 2:15,1446459300,C7,1495560,1447954860,11/19/2015 9:41
3059,20150004120029-367,2,11/10/2015 12:44,1447188240,C2,724380,1447912620,11/18/2015 21:57
2780,20151404081429-288,1,11/3/2015 2:02,1446544920,C4,1315260,1447860180,11/18/2015 7:23
3996,20153730083758-789,2,11/12/2015 0:39,1447317540,C0,527160,1447844700,11/18/2015 3:05
2115,20152515012543-659,1,10/27/2015 19:47,1446000420,C2,1825860,1447826280,11/17/2015 21:58
1022,20151909051914-299,1,11/7/2015 20:04,1446955440,C7,865500,1447820940,11/17/2015 20:29
1529,20150606090649-896,1,11/9/2015 10:54,1447095240,C0,692460,1447787700,11/17/2015 11:15
5746,20155921125901-834,1,11/9/2015 16:11,1447114260,C4,606960,1447721220,11/16/2015 16:47
1227,20153825123835-385,1,11/6/2015 4:09,1446811740,C8,897180,1447708920,11/16/2015 13:22
1947,20150927090926-427,3,11/7/2015 17:24,1446945840,C8,715140,1447660980,11/16/2015 0:03
352,20153923083952-869,1,11/9/2015 21:31,1447133460,C4,513840,1447647300,11/15/2015 20:15
511,20155123115132-660,2,10/29/2015 2:01,1446109260,C8,1537500,1447646760,11/15/2015 20:06
4503,20153319093327-65,2,11/9/2015 10:01,1447092060,C5,551460,1447643520,11/15/2015 19:12
4149,20150122100139-218,1,11/9/2015 9:25,1447089900,C5,518580,1447608480,11/15/2015 9:28
6295,20154127034153-72,1,11/9/2015 5:51,1447077060,C2,526200,1447603260,11/15/2015 8:01
5407,20153023123036-30,3,11/5/2015 22:10,1446790200,C5,804000,1447594200,11/15/2015 5:30
5768,20152611072627-207,3,10/30/2015 0:05,1446188700,C4,1402380,1447591080,11/15/2015 4:38
4004,20150110060107-684,1,11/7/2015 16:45,1446943500,C3,631680,1447575180,11/15/2015 0:13
1447,20152924032913-724,1,11/2/2015 7:49,1446479340,C3,1087800,1447567140,11/14/2015 21:59
2063,20153209073227-920,1,11/6/2015 12:54,1446843240,C7,719160,1447562400,11/14/2015 20:40
6044,20152520042545-155,3,11/7/2015 5:14,1446902040,C7,587220,1447489260,11/14/2015 0:21
1841,20150509110550-759,1,11/9/2015 11:28,1447097280,C2,383340,1447480620,11/13/2015 21:57
64,20153424013401-207,1,11/7/2015 2:32,1446892320,C8,586740,1447479060,11/13/2015 21:31
126,20152231122207-586,1,11/10/2015 12:43,1447188180,C4,289620,1447477800,11/13/2015 21:10
5901,20150227100257-879,2,11/4/2015 0:57,1446627420,C2,847500,1447474920,11/13/2015 20:22
4554,20155926125956-991,3,11/3/2015 8:20,1446567600,C7,849780,1447417380,11/13/2015 4:23
2705,20152230072211-448,3,11/3/2015 11:41,1446579660,C4,805020,1447384680,11/12/2015 19:18
3485,20153728033704-530,2,11/11/2015 2:45,1447238700,C4,145860,1447384560,11/12/2015 19:16
5091,20151131021149-695,3,11/9/2015 15:05,1447110300,C5,261480,1447371780,11/12/2015 15:43
5285,20151224101227-56,1,11/1/2015 0:36,1446363360,C6,987840,1447351200,11/12/2015 10:00
3387,20153713053720-934,3,10/24/2015 8:52,1445701920,C5,1637100,1447339020,11/12/2015 6:37
4012,20155817085826-736,1,11/5/2015 23:02,1446793320,C0,535980,1447329300,11/12/2015 3:55
5729,20153612043649-569,3,11/1/2015 16:48,1446425280,C3,875340,1447300620,11/11/2015 19:57
6519,20151308101333-914,2,10/30/2015 17:39,1446251940,C0,1028280,1447280220,11/11/2015 14:17
826,20152229012216-958,2,11/5/2015 9:10,1446743400,C6,530880,1447274280,11/11/2015 12:38
3782,20153223033200-444,3,11/9/2015 7:44,1447083840,C5,180540,1447264380,11/11/2015 9:53
3108,20152217112251-421,3,11/5/2015 6:46,1446734760,C4,527580,1447262340,11/11/2015 9:19
1613,20153124013107-263,1,11/6/2015 13:43,1446846180,C5,375840,1447222020,11/10/2015 22:07
6262,20152126012150-343,3,11/5/2015 10:21,1446747660,C3,431100,1447178760,11/10/2015 10:06
2841,20151412031428-824,3,10/26/2015 7:34,1445870040,C2,1304400,1447174440,11/10/2015 8:54
1398,20154428114434-818,2,11/5/2015 12:52,1446756720,C2,411360,1447168080,11/10/2015 7:08
5665,20152902112948-976,2,11/8/2015 6:29,1446992940,C5,166800,1447159740,11/10/2015 4:49
811,20150815060824-848,1,11/3/2015 4:40,1446554400,C3,604560,1447158960,11/10/2015 4:36
927,20150826020806-485,2,11/8/2015 13:08,1447016880,C5,140400,1447157280,11/10/2015 4:08
2466,20150022110023-715,2,10/27/2015 6:32,1445952720,C5,1194960,1447147680,11/10/2015 1:28
1803,20153819053827-500,3,10/24/2015 17:08,1445731680,C6,1396500,1447128180,11/9/2015 20:03
5496,20153031083006-993,1,11/6/2015 19:48,1446868080,C3,187560,1447055640,11/8/2015 23:54
5695,20154912084901-166,2,11/1/2015 17:25,1446427500,C7,622080,1447049580,11/8/2015 22:13
3612,20151713111750-937,1,11/2/2015 13:21,1446499260,C6,541380,1447040640,11/8/2015 19:44
4140,20152326012317-940,1,10/26/2015 14:35,1445895300,C8,1136160,1447031460,11/8/2015 17:11
928,20155913015944-240,1,11/1/2015 15:05,1446419100,C0,605880,1447024980,11/8/2015 15:23
5025,20152722082711-239,3,11/2/2015 15:21,1446506460,C2,510120,1447016580,11/8/2015 13:03
302,20153230113243-759,1,11/5/2015 7:36,1446737760,C8,253920,1446991680,11/8/2015 6:08
2606,20154712024716-747,2,10/25/2015 22:39,1445837940,C5,1137540,1446975480,11/8/2015 1:38
2095,20150805070853-118,3,10/28/2015 5:40,1446036000,C4,906540,1446942540,11/7/2015 16:29
1881,20151516041514-25,2,11/4/2015 10:21,1446661260,C6,270660,1446931920,11/7/2015 13:32
6244,20155627045658-136,2,11/2/2015 8:37,1446482220,C8,440580,1446922800,11/7/2015 11:00
4804,20151620061659-448,3,11/5/2015 8:36,1446741360,C3,174300,1446915660,11/7/2015 9:01
1505,20155127065120-711,3,11/2/2015 15:03,1446505380,C2,392940,1446898320,11/7/2015 4:12
515,20155821075857-972,2,11/1/2015 7:52,1446393120,C3,476820,1446869940,11/6/2015 20:19
2719,20153720123722-777,2,10/29/2015 0:21,1446103260,C0,750480,1446853740,11/6/2015 15:49
3037,20151117051123-614,1,10/23/2015 16:29,1445642940,C2,1209240,1446852180,11/6/2015 15:23
1851,20150818120815-803,1,10/31/2015 9:50,1446310200,C5,529560,1446839760,11/6/2015 11:56
5998,20152801072801-74,1,10/21/2015 10:09,1445447340,C4,1383780,1446831120,11/6/2015 9:32
815,20155917095957-221,2,10/28/2015 23:39,1446100740,C8,718320,1446819060,11/6/2015 6:11
6009,20154721064725-145,1,10/25/2015 18:11,1445821860,C3,992880,1446814740,11/6/2015 4:59
349,20151131081108-573,1,10/25/2015 16:51,1445817060,C8,956640,1446773700,11/5/2015 17:35
1873,20154623114627-225,1,11/2/2015 9:16,1446484560,C0,286200,1446770760,11/5/2015 16:46
1793,20154518094547-315,1,10/31/2015 8:09,1446304140,C0,463680,1446767820,11/5/2015 15:57
1824,20154225024250-848,1,10/30/2015 19:36,1446258960,C6,506940,1446765900,11/5/2015 15:25
5587,20154723074706-99,1,10/28/2015 1:31,1446021060,C3,709980,1446731040,11/5/2015 5:44
106,20153527083531-898,1,10/31/2015 19:23,1446344580,C2,372060,1446716640,11/5/2015 1:44
6405,20153815033847-524,3,10/30/2015 11:54,1446231240,C4,484320,1446715560,11/5/2015 1:26
3196,20153629053647-857,1,10/30/2015 21:00,1446264000,C6,448440,1446712440,11/5/2015 0:34
3451,20153125013101-836,2,10/28/2015 21:01,1446091260,C7,617400,1446708660,11/4/2015 23:31
1705,20153820063840-304,2,10/24/2015 13:59,1445720340,C2,988020,1446708360,11/4/2015 23:26
4134,20152130102130-760,2,10/31/2015 12:54,1446321240,C0,383940,1446705180,11/4/2015 22:33
3609,20151704091740-106,2,10/29/2015 0:53,1446105180,C4,590220,1446695400,11/4/2015 19:50
1164,20150201030237-485,1,10/27/2015 17:57,1445993820,C5,692700,1446686520,11/4/2015 17:22
3745,20153220113237-70,2,10/16/2015 16:38,1445038680,C5,1647720,1446686400,11/4/2015 17:20
4284,20151028061026-297,3,10/21/2015 12:28,1445455680,C6,1227780,1446683460,11/4/2015 16:31
4110,20151207101219-530,2,10/29/2015 5:32,1446121920,C5,559500,1446681420,11/4/2015 15:57
2484,20150317060312-681,2,10/29/2015 11:32,1446143520,C7,521220,1446664740,11/4/2015 11:19
4194,20151301091306-345,2,10/27/2015 2:20,1445937600,C8,687660,1446625260,11/4/2015 0:21
2964,20154328044302-517,2,10/25/2015 1:52,1445763120,C7,848460,1446611580,11/3/2015 20:33
6232,20150323050332-513,3,10/29/2015 15:13,1446156780,C3,443400,1446600180,11/3/2015 17:23
2472,20150829070856-319,1,10/31/2015 4:35,1446291300,C7,306180,1446597480,11/3/2015 16:38
5183,20151822031808-265,1,10/29/2015 9:32,1446136320,C8,453720,1446590040,11/3/2015 14:34
5795,20151823041807-23,3,11/2/2015 0:46,1446453960,C0,101460,1446555420,11/3/2015 4:57
3455,20151505021556-896,1,10/26/2015 17:49,1445906940,C2,631320,1446538260,11/3/2015 0:11
1777,20152918022901-486,1,10/28/2015 20:59,1446091140,C4,443700,1446534840,11/2/2015 23:14
3102,20151825091848-82,3,10/31/2015 19:51,1446346260,C3,185460,1446531720,11/2/2015 22:22
5220,20155706065753-746,1,10/22/2015 20:50,1445572200,C0,957540,1446529740,11/2/2015 21:49
605,20153026083032-587,1,10/31/2015 9:08,1446307680,C5,217140,1446524820,11/2/2015 20:27
513,20154125074157-46,3,10/22/2015 6:01,1445518860,C8,1001040,1446519900,11/2/2015 19:05
128,20154104064113-956,2,10/18/2015 14:32,1445203920,C8,1312380,1446516300,11/2/2015 18:05
1107,20152528092556-30,2,11/1/2015 4:19,1446380340,C4,110280,1446490620,11/2/2015 10:57
3391,20152215082220-506,2,10/27/2015 11:03,1445968980,C4,519780,1446488760,11/2/2015 10:26
1059,20154324094311-697,2,10/30/2015 10:51,1446227460,C5,261240,1446488700,11/2/2015 10:25
5888,20150009060037-852,1,10/22/2015 17:13,1445559180,C7,919140,1446478320,11/2/2015 7:32
703,20152407072413-469,3,10/26/2015 7:45,1445870700,C4,604980,1446475680,11/2/2015 6:48
2695,20152004112056-852,1,10/25/2015 20:23,1445829780,C4,634140,1446463920,11/2/2015 3:32
595,20152030022022-687,2,10/29/2015 2:42,1446111720,C4,351960,1446463680,11/2/2015 3:28
5063,20150829080825-567,2,10/25/2015 23:20,1445840400,C3,622440,1446462840,11/2/2015 3:14
777,20151329111354-725,1,10/28/2015 7:24,1446042240,C2,355980,1446398220,11/1/2015 9:17
3119,20154801084801-486,2,10/22/2015 3:36,1445510160,C4,883260,1446393420,11/1/2015 7:57
6532,20150829050830-287,3,10/21/2015 17:43,1445474580,C8,916260,1446390840,11/1/2015 7:14
2591,20155419125408-510,1,10/23/2015 1:18,1445588280,C7,796320,1446384600,11/1/2015 5:30
4361,20152428112426-434,3,10/31/2015 4:48,1446292080,C5,78480,1446370560,11/1/2015 1:36
3211,20151905111924-469,2,10/24/2015 23:13,1445753580,C3,610920,1446364500,11/1/2015 0:55
579,20151726101752-323,2,10/21/2015 2:17,1445419020,C3,936000,1446355020,10/31/2015 22:17
4968,20153307023355-407,1,10/24/2015 23:35,1445754900,C4,584760,1446339660,10/31/2015 18:01
5259,20152816102821-282,1,10/18/2015 5:26,1445171160,C7,1157640,1446328800,10/31/2015 15:00
5447,20154917034903-850,1,10/26/2015 13:49,1445892540,C5,420300,1446312840,10/31/2015 10:34
3120,20151926031950-628,1,10/25/2015 15:14,1445811240,C8,501060,1446312300,10/31/2015 10:25
1538,20152527072503-929,1,10/27/2015 3:31,1445941860,C7,368280,1446310140,10/31/2015 9:49
4195,20154719114738-807,2,10/26/2015 3:41,1445856060,C3,452520,1446308580,10/31/2015 9:23
3166,20151703081723-858,2,10/24/2015 0:04,1445670240,C7,625260,1446295500,10/31/2015 5:45
3629,20154809044835-78,1,10/16/2015 23:43,1445064180,C5,1225500,1446289680,10/31/2015 4:08
3809,20150119090129-183,1,10/17/2015 5:07,1445083620,C4,1202580,1446286200,10/31/2015 3:10
1896,20150411120416-183,1,10/24/2015 22:01,1445749260,C8,535860,1446285120,10/31/2015 2:52
1489,20150019040039-358,1,10/23/2015 1:20,1445588400,C6,695400,1446283800,10/31/2015 2:30
114,20155723035703-81,1,10/19/2015 17:41,1445301660,C0,951180,1446252840,10/30/2015 17:54
2692,20152025062036-525,1,10/23/2015 2:52,1445593920,C5,635640,1446229560,10/30/2015 11:26
3729,20151818111845-978,2,10/28/2015 2:10,1446023400,C4,201360,1446224760,10/30/2015 10:06
5487,20152822092858-860,3,10/29/2015 9:28,1446136080,C7,86400,1446222480,10/30/2015 9:28
54,20150215060225-774,1,10/20/2015 13:01,1445371260,C7,818220,1446189480,10/30/2015 0:18
6287,20151825061809-937,1,10/25/2015 14:18,1445807880,C5,374400,1446182280,10/29/2015 22:18
5194,20151927071926-369,3,10/25/2015 18:10,1445821800,C7,351180,1446172980,10/29/2015 19:43
1432,20155602075606-537,1,10/22/2015 15:12,1445551920,C7,620880,1446172800,10/29/2015 19:40
4859,20153624043623-472,2,10/27/2015 6:03,1445950980,C4,221220,1446172200,10/29/2015 19:30
3293,20155411025401-133,3,10/20/2015 19:58,1445396280,C0,758280,1446154560,10/29/2015 14:36
6557,20152823032832-378,2,10/28/2015 17:28,1446078480,C0,54900,1446133380,10/29/2015 8:43
3526,20154916064951-160,1,10/23/2015 21:56,1445662560,C5,464460,1446127020,10/29/2015 6:57
6378,20153424023413-34,3,10/26/2015 22:00,1445922000,C2,199560,1446121560,10/29/2015 5:26
2682,20154117064148-969,1,10/23/2015 22:28,1445664480,C2,452460,1446116940,10/29/2015 4:09
3775,20155024105003-765,2,10/20/2015 22:25,1445405100,C5,709500,1446114600,10/29/2015 3:30
5856,20155703045756-537,1,10/19/2015 10:49,1445276940,C2,828840,1446105780,10/29/2015 1:03
4908,20153119013102-317,1,10/20/2015 4:51,1445341860,C2,760800,1446102660,10/29/2015 0:11
1054,20155002115040-685,1,10/15/2015 15:27,1444948020,C2,1136220,1446084240,10/28/2015 19:04
6035,20151019081015-655,1,10/24/2015 8:18,1445699880,C3,378060,1446077940,10/28/2015 17:19
3152,20155221125229-19,3,10/23/2015 1:34,1445589240,C6,454020,1446043260,10/28/2015 7:41
3800,20153326083315-407,2,10/24/2015 7:37,1445697420,C4,345120,1446042540,10/28/2015 7:29
403,20155705085705-756,2,10/22/2015 8:57,1445529420,C2,507600,1446037020,10/28/2015 5:57
2812,20154402044412-377,1,10/22/2015 11:29,1445538540,C7,477900,1446016440,10/28/2015 0:14
3788,20152815012824-971,1,10/18/2015 18:24,1445217840,C4,792480,1446010320,10/27/2015 22:32
4765,20153728063706-624,2,10/12/2015 15:59,1444690740,C5,1313160,1446003900,10/27/2015 20:45
5211,20152725052758-524,2,10/19/2015 17:30,1445301000,C5,691260,1445992260,10/27/2015 17:31
4269,20153319103344-890,1,10/26/2015 11:21,1445883660,C2,75960,1445959620,10/27/2015 8:27
4305,20150615070645-876,2,10/23/2015 1:42,1445589720,C7,362640,1445952360,10/27/2015 6:26
3804,20152911042945-827,3,10/17/2015 16:02,1445122920,C3,826740,1445949660,10/27/2015 5:41
5388,20152419102424-497,1,10/10/2015 20:07,1444532820,C8,1399740,1445932560,10/27/2015 0:56
6077,20153421053409-684,1,10/21/2015 23:04,1445493840,C1,435300,1445929140,10/26/2015 23:59
6392,20155501015527-544,2,10/20/2015 16:19,1445383140,C5,530280,1445913420,10/26/2015 19:37
2452,20151902091944-855,3,10/17/2015 5:35,1445085300,C4,819120,1445904420,10/26/2015 17:07
4640,20153224043258-562,2,10/19/2015 15:12,1445292720,C3,604200,1445896920,10/26/2015 15:02
1984,20152414122415-656,2,10/21/2015 8:37,1445441820,C4,454740,1445896560,10/26/2015 14:56
2878,20153824023857-53,3,10/18/2015 17:17,1445213820,C5,680220,1445894040,10/26/2015 14:14
1416,20150231010233-845,1,10/15/2015 16:58,1444953480,C7,940080,1445893560,10/26/2015 14:06
1328,20152129052143-619,3,10/17/2015 14:03,1445115780,C3,771660,1445887440,10/26/2015 12:24
444,20151119091154-119,3,10/13/2015 23:36,1444804560,C0,1068900,1445873460,10/26/2015 8:31
3958,20154026104009-242,2,10/19/2015 12:48,1445284080,C3,584160,1445868240,10/26/2015 7:04
3705,20155223065200-218,2,10/19/2015 3:56,1445252160,C5,614280,1445866440,10/26/2015 6:34
2648,20150518080515-636,3,10/22/2015 0:29,1445498940,C5,363780,1445862720,10/26/2015 5:32
714,20152610012616-238,1,10/21/2015 1:58,1445417880,C4,437640,1445855520,10/26/2015 3:32
3224,20153113033133-51,1,10/11/2015 23:15,1444630500,C5,1223520,1445854020,10/26/2015 3:07
6547,20152119112147-519,1,10/21/2015 10:57,1445450220,C5,345420,1445795640,10/25/2015 10:54
6335,20152006072036-68,3,10/19/2015 6:47,1445262420,C8,530460,1445792880,10/25/2015 10:08
2394,20150430100459-528,2,10/22/2015 5:40,1445517600,C8,269280,1445786880,10/25/2015 8:28
1839,20152130042105-824,1,10/19/2015 3:09,1445249340,C2,534060,1445783400,10/25/2015 7:30
1992,20154830034853-516,3,10/15/2015 16:12,1444950720,C2,831780,1445782500,10/25/2015 7:15
3509,20154524124536-93,2,10/22/2015 4:12,1445512320,C7,265380,1445777700,10/25/2015 5:55
2429,20155514055529-108,1,10/16/2015 7:11,1445004660,C7,772080,1445776740,10/25/2015 5:39
977,20152628112645-216,2,10/22/2015 5:58,1445518680,C4,256740,1445775420,10/25/2015 5:17
6208,20155124095132-430,1,10/21/2015 8:46,1445442360,C4,332700,1445775060,10/25/2015 5:11
2531,20153330083330-845,3,10/22/2015 1:28,1445502480,C4,267900,1445770380,10/25/2015 3:53
4973,20154319074317-573,3,10/18/2015 20:38,1445225880,C8,510420,1445736300,10/24/2015 18:25
5024,20150030070026-128,1,10/21/2015 15:31,1445466660,C8,263580,1445730240,10/24/2015 16:44
4131,20153112033150-305,2,10/19/2015 9:03,1445270580,C2,453360,1445723940,10/24/2015 14:59
4564,20152928102926-60,1,10/21/2015 14:29,1445462940,C2,250200,1445713140,10/24/2015 11:59
1126,20155823095855-582,1,10/14/2015 1:44,1444812240,C8,892380,1445704620,10/24/2015 9:37
1938,20150322060343-331,1,10/20/2015 6:24,1445347440,C5,345780,1445693220,10/24/2015 6:27
6107,20152512052534-249,2,10/19/2015 15:09,1445292540,C0,398580,1445691120,10/24/2015 5:52
587,20151328101312-818,2,10/20/2015 23:54,1445410440,C5,278580,1445689020,10/24/2015 5:17
4010,20152218072255-716,1,10/15/2015 5:40,1444912800,C2,775560,1445688360,10/24/2015 5:06
1663,20151526061504-680,3,10/14/2015 18:57,1444874220,C0,800460,1445674680,10/24/2015 1:18
751,20150426100413-9,2,10/14/2015 18:58,1444874280,C5,793620,1445667900,10/23/2015 23:25
1304,20153625063605-688,1,10/17/2015 1:48,1445071680,C2,570240,1445641920,10/23/2015 16:12
4463,20155126015101-584,2,10/14/2015 15:01,1444860060,C4,779700,1445639760,10/23/2015 15:36
4617,20154519024544-322,2,10/21/2015 7:22,1445437320,C4,201900,1445639220,10/23/2015 15:27
2318,20152723032741-851,1,10/15/2015 22:00,1444971600,C8,657540,1445629140,10/23/2015 12:39
5764,20152827022817-16,1,10/16/2015 8:19,1445008740,C8,613980,1445622720,10/23/2015 10:52
854,20154023044028-20,1,10/15/2015 20:11,1444965060,C0,655980,1445621040,10/23/2015 10:24
3008,20155110085148-525,2,10/17/2015 5:09,1445083740,C6,530580,1445614320,10/23/2015 8:32
6390,20150522100502-509,3,10/19/2015 4:20,1445253600,C7,330300,1445583900,10/23/2015 0:05
6248,20150419080453-269,2,10/22/2015 1:40,1445503200,C0,78720,1445581920,10/22/2015 23:32
3259,20151118041143-934,2,10/12/2015 4:27,1444649220,C5,923520,1445572740,10/22/2015 20:59
603,20155806065852-717,3,10/17/2015 15:14,1445120040,C5,446520,1445566560,10/22/2015 19:16
2014,20151327101317-796,2,10/19/2015 14:06,1445288760,C4,273540,1445562300,10/22/2015 18:05
5088,20155821065833-503,3,10/19/2015 5:54,1445259240,C5,301920,1445561160,10/22/2015 17:46
3717,20155326015327-562,2,10/19/2015 19:53,1445309580,C4,251100,1445560680,10/22/2015 17:38
3436,20155015015017-670,2,10/18/2015 1:17,1445156220,C3,400860,1445557080,10/22/2015 16:38
145,20150826010800-879,1,10/11/2015 14:39,1444599540,C4,951180,1445550720,10/22/2015 14:52
1685,20153030113019-64,1,10/15/2015 5:36,1444912560,C4,637380,1445549940,10/22/2015 14:39
682,20150122060138-185,3,10/12/2015 10:03,1444669380,C5,871260,1445540640,10/22/2015 12:04
1651,20155526085516-0,2,10/15/2015 22:22,1444972920,C4,563340,1445536260,10/22/2015 10:51
945,20155705095723-561,1,10/16/2015 13:32,1445027520,C4,507900,1445535420,10/22/2015 10:37
2716,20150908020926-913,2,10/13/2015 21:05,1444795500,C2,715920,1445511420,10/22/2015 3:57
1827,20155827025824-481,1,10/18/2015 22:54,1445234040,C2,263280,1445497320,10/22/2015 0:02
2203,20153829013813-529,2,10/19/2015 4:16,1445253360,C2,242040,1445495400,10/21/2015 23:30
2240,20151917051906-622,3,10/18/2015 2:07,1445159220,C2,327960,1445487180,10/21/2015 21:13
99,20153915033947-108,1,10/10/2015 16:09,1444518540,C8,968040,1445486580,10/21/2015 21:03
181,20155204055234-952,3,10/3/2015 10:27,1443893220,C8,1567140,1445460360,10/21/2015 13:46
5256,20153329083354-580,1,10/18/2015 23:45,1445237100,C0,212040,1445449140,10/21/2015 10:39
3646,20154821024838-295,2,10/17/2015 10:32,1445103120,C7,318720,1445421840,10/21/2015 3:04
35,20151521051524-864,1,10/17/2015 9:08,1445098080,C2,316740,1445414820,10/21/2015 1:07
1325,20151803011812-57,2,10/15/2015 18:22,1444958520,C6,455880,1445414400,10/21/2015 1:00
2308,20152702072702-121,1,10/14/2015 18:25,1444872300,C8,538140,1445410440,10/20/2015 23:54
282,20153916083923-377,1,10/16/2015 15:50,1445035800,C2,373980,1445409780,10/20/2015 23:43
1404,20151716021749-651,2,10/12/2015 16:11,1444691460,C3,704520,1445395980,10/20/2015 19:53
1939,20153726053749-107,1,10/12/2015 17:45,1444697100,C5,691440,1445388540,10/20/2015 17:49
2445,20153605033626-803,2,10/9/2015 9:12,1444407120,C2,971520,1445378640,10/20/2015 15:04
2390,20153714093734-926,2,10/12/2015 4:56,1444650960,C8,725820,1445376780,10/20/2015 14:33
1226,20152231092234-568,1,10/10/2015 9:31,1444494660,C5,876420,1445371080,10/20/2015 12:58
289,20152727122724-538,1,10/14/2015 18:33,1444872780,C5,496920,1445369700,10/20/2015 12:35
3305,20154916014936-45,2,10/9/2015 3:07,1444385220,C3,974340,1445359560,10/20/2015 9:46
3723,20150406120449-237,1,10/12/2015 1:48,1444639680,C2,718980,1445358660,10/20/2015 9:31
4415,20152223052251-513,2,10/13/2015 15:52,1444776720,C2,574200,1445350920,10/20/2015 7:22
3318,20150822100826-928,1,10/16/2015 18:59,1445047140,C5,300780,1445347920,10/20/2015 6:32
1547,20151108081116-912,2,10/14/2015 23:58,1444892280,C5,452460,1445344740,10/20/2015 5:39
5845,20152608092613-41,1,10/14/2015 23:56,1444892160,C8,451800,1445343960,10/20/2015 5:26
2313,20151229121216-715,1,10/13/2015 7:30,1444746600,C8,596340,1445342940,10/20/2015 5:09
2693,20150018100013-569,1,10/16/2015 3:35,1444991700,C2,342300,1445334000,10/20/2015 2:40
4514,20153607113603-801,3,10/15/2015 7:52,1444920720,C5,408720,1445329440,10/20/2015 1:24
4119,20152616062617-515,1,10/11/2015 22:53,1444629180,C5,699660,1445328840,10/20/2015 1:14
1762,20152102052154-22,3,10/14/2015 0:40,1444808400,C2,509820,1445318220,10/19/2015 22:17
4460,20150822080830-143,3,10/10/2015 17:12,1444522320,C4,793920,1445316240,10/19/2015 21:44
3675,20153126033132-596,1,10/16/2015 22:36,1445060160,C8,250500,1445310660,10/19/2015 20:11
3605,20153927063907-823,3,10/17/2015 1:51,1445071860,C5,213840,1445285700,10/19/2015 13:15
5829,20153628113615-827,2,10/12/2015 10:36,1444671360,C8,603000,1445274360,10/19/2015 10:06
6325,20150827060827-565,1,10/12/2015 14:05,1444683900,C2,571860,1445255760,10/19/2015 4:56
2264,20152629042632-481,1,10/11/2015 21:44,1444625040,C6,622380,1445247420,10/19/2015 2:37
2066,20154728014746-613,1,10/16/2015 18:27,1445045220,C4,196500,1445241720,10/19/2015 1:02
6504,20155927105908-127,2,10/13/2015 15:17,1444774620,C4,465960,1445240580,10/19/2015 0:43
5090,20155026105032-380,1,10/16/2015 4:37,1444995420,C5,243660,1445239080,10/19/2015 0:18
1145,20150221010241-26,3,10/11/2015 16:43,1444606980,C5,631380,1445238360,10/19/2015 0:06
3229,20155415055448-117,1,10/18/2015 4:09,1445166540,C0,69900,1445236440,10/18/2015 23:34
4349,20154911094955-742,1,10/6/2015 9:48,1444150080,C4,1073820,1445223900,10/18/2015 20:05
3932,20151822111847-102,3,10/11/2015 15:46,1444603560,C4,619440,1445223000,10/18/2015 19:50
4465,20152803072816-844,2,10/13/2015 17:44,1444783440,C0,436620,1445220060,10/18/2015 19:01
6061,20153510103519-730,2,10/14/2015 12:11,1444849860,C5,367920,1445217780,10/18/2015 18:23
1288,20152121052117-267,2,10/9/2015 17:03,1444435380,C5,777060,1445212440,10/18/2015 16:54
1179,20154030094027-816,1,10/12/2015 13:42,1444682520,C7,525660,1445208180,10/18/2015 15:43
2576,20154917054928-183,3,10/14/2015 16:51,1444866660,C8,332760,1445199420,10/18/2015 13:17
5018,20155617075624-163,1,10/13/2015 7:06,1444745160,C8,448680,1445193840,10/18/2015 11:44
4240,20154711074751-689,2,10/14/2015 8:35,1444836900,C5,356760,1445193660,10/18/2015 11:41
3633,20151707111715-550,2,10/17/2015 2:10,1445073000,C0,118740,1445191740,10/18/2015 11:09
4434,20154124124106-525,2,10/15/2015 9:46,1444927560,C3,257700,1445185260,10/18/2015 9:21
3349,20155306085328-467,1,10/11/2015 8:48,1444578480,C8,604740,1445183220,10/18/2015 8:47
4569,20151712061745-29,3,10/14/2015 16:20,1444864800,C7,311220,1445176020,10/18/2015 6:47
6436,20155701025733-561,1,10/13/2015 2:01,1444726860,C3,447780,1445174640,10/18/2015 6:24
1310,20151030061038-897,2,10/13/2015 17:52,1444783920,C3,388440,1445172360,10/18/2015 5:46
2185,20153123073146-272,1,10/15/2015 2:53,1444902780,C5,269160,1445171940,10/18/2015 5:39
5705,20151929031948-686,2,10/9/2015 17:59,1444438740,C8,710400,1445149140,10/17/2015 23:19
4925,20151617021605-748,1,10/7/2015 19:58,1444273080,C5,874260,1445147340,10/17/2015 22:49
5288,20154804124824-880,1,10/11/2015 16:18,1444605480,C6,534900,1445140380,10/17/2015 20:53
3511,20153723123726-448,2,10/9/2015 17:31,1444437060,C0,700020,1445137080,10/17/2015 19:58
6272,20153707073715-128,2,10/6/2015 10:17,1444151820,C3,984000,1445135820,10/17/2015 19:37
2351,20155022025025-894,2,10/14/2015 11:22,1444846920,C4,269760,1445116680,10/17/2015 14:18
1863,20153412033403-441,1,10/6/2015 19:02,1444183320,C2,930360,1445113680,10/17/2015 13:28
745,20154303064359-839,1,10/6/2015 10:04,1444151040,C5,954420,1445105460,10/17/2015 11:11
2495,20152325092328-229,1,10/11/2015 20:47,1444621620,C5,474480,1445096100,10/17/2015 8:35
4676,20150601040632-151,2,10/9/2015 17:16,1444436160,C8,657480,1445093640,10/17/2015 7:54
3766,20151810061830-545,1,10/8/2015 0:03,1444287780,C5,798900,1445086680,10/17/2015 5:58
895,20152317102301-124,3,10/5/2015 16:05,1444086300,C3,990360,1445076660,10/17/2015 3:11
4052,20153928053902-838,1,10/8/2015 1:47,1444294020,C5,770460,1445064480,10/16/2015 23:48
3128,20150017040038-392,1,10/12/2015 1:45,1444639500,C8,421740,1445061240,10/16/2015 22:54
6197,20152229052214-773,3,10/10/2015 20:45,1444535100,C8,520140,1445055240,10/16/2015 21:14
4911,20154323124336-960,3,10/2/2015 15:03,1443823380,C8,1228560,1445051940,10/16/2015 20:19
4875,20150230100237-163,1,10/11/2015 7:38,1444574280,C3,470880,1445045160,10/16/2015 18:26
5571,20154427034432-511,3,10/14/2015 0:50,1444809000,C6,235860,1445044860,10/16/2015 18:21
4939,20151522061542-891,2,10/10/2015 14:39,1444513140,C0,528480,1445041620,10/16/2015 17:27
2566,20153922083923-991,3,10/13/2015 15:39,1444775940,C4,262800,1445038740,10/16/2015 16:39
6140,20154027024025-199,1,10/14/2015 13:36,1444854960,C2,183120,1445038080,10/16/2015 16:28
6012,20150205110228-447,2,10/11/2015 12:21,1444591260,C5,445020,1445036280,10/16/2015 15:58
81,20150419090434-489,1,10/13/2015 3:48,1444733280,C5,293520,1445026800,10/16/2015 13:20
3303,20152215092206-481,1,10/6/2015 3:54,1444128840,C0,893940,1445022780,10/16/2015 12:13
4616,20154519024544-322,2,10/14/2015 4:23,1444821780,C4,200400,1445022180,10/16/2015 12:03
5532,20151912111905-652,1,10/5/2015 2:15,1444036500,C5,977280,1445013780,10/16/2015 9:43
2213,20150322080331-384,1,10/13/2015 7:35,1444746900,C5,258960,1445005860,10/16/2015 7:31
2311,20151328011351-370,1,10/14/2015 1:09,1444810140,C5,191280,1445001420,10/16/2015 6:17
5043,20152909092941-524,1,10/13/2015 22:19,1444799940,C0,195900,1444995840,10/16/2015 4:44
5581,20152923092919-201,1,10/7/2015 13:23,1444249380,C7,731160,1444980540,10/16/2015 0:29
989,20150108060104-840,1,10/6/2015 12:58,1444161480,C5,814740,1444976220,10/15/2015 23:17
4656,20152723022703-590,1,10/3/2015 5:39,1443875940,C1,1097640,1444973580,10/15/2015 22:33
4187,20152824022826-397,3,10/8/2015 18:08,1444352880,C5,611400,1444964280,10/15/2015 19:58
66,20152508082517-666,1,10/7/2015 5:24,1444220640,C5,739020,1444959660,10/15/2015 18:41
1420,20155929045919-954,2,10/4/2015 0:08,1443942480,C3,1016580,1444959060,10/15/2015 18:31
4523,20155727045729-105,2,10/9/2015 15:14,1444428840,C8,529860,1444958700,10/15/2015 18:25
4112,20150630080609-634,1,10/10/2015 11:58,1444503480,C2,444540,1444948020,10/15/2015 15:27
582,20155815115859-161,3,10/12/2015 5:02,1444651320,C3,288480,1444939800,10/15/2015 13:10
2912,20150730040705-133,2,10/13/2015 21:19,1444796340,C5,142740,1444939080,10/15/2015 12:58
5231,20152528012515-626,3,10/13/2015 15:09,1444774140,C4,162780,1444936920,10/15/2015 12:22
2808,20152819022855-141,1,10/3/2015 17:01,1443916860,C7,1018620,1444935480,10/15/2015 11:58
1918,20151529051508-917,1,10/7/2015 14:09,1444252140,C4,680040,1444932180,10/15/2015 11:03
974,20151422101430-872,1,10/9/2015 10:38,1444412280,C2,518580,1444930860,10/15/2015 10:41
5887,20151026061040-488,1,10/9/2015 0:48,1444376880,C5,551940,1444928820,10/15/2015 10:07
59,20154314084327-265,2,10/11/2015 23:15,1444630500,C0,298140,1444928640,10/15/2015 10:04
5281,20153724063727-843,2,10/13/2015 0:53,1444722780,C6,202620,1444925400,10/15/2015 9:10
42,20151712061733-488,1,10/13/2015 18:27,1444786020,C6,130200,1444916220,10/15/2015 6:37
3482,20151520061516-982,2,10/12/2015 18:24,1444699440,C7,216060,1444915500,10/15/2015 6:25
2835,20153109123110-337,2,10/12/2015 8:23,1444663380,C2,244320,1444907700,10/15/2015 4:15
3334,20150025100041-260,3,10/10/2015 5:30,1444480200,C0,426600,1444906800,10/15/2015 4:00
3904,20155820055809-845,1,10/9/2015 0:28,1444375680,C4,526200,1444901880,10/15/2015 2:38
5599,20151026051047-171,1,10/10/2015 11:13,1444500780,C5,396060,1444896840,10/15/2015 1:14
4205,20150628060613-79,1,10/9/2015 0:58,1444377480,C0,515760,1444893240,10/15/2015 0:14
3209,20154525044559-95,1,10/10/2015 3:45,1444473900,C4,416400,1444890300,10/14/2015 23:25
3180,20151128121126-103,3,10/12/2015 21:59,1444712340,C5,177840,1444890180,10/14/2015 23:23
3352,20153521033534-609,3,10/12/2015 7:03,1444658580,C2,222960,1444881540,10/14/2015 20:59
5402,20153710013742-178,3,10/10/2015 23:45,1444545900,C4,328560,1444874460,10/14/2015 19:01
6131,20155420055422-20,1,10/6/2015 17:26,1444177560,C5,690360,1444867920,10/14/2015 17:12
1519,20150027100028-509,1,10/8/2015 14:19,1444339140,C3,520620,1444859760,10/14/2015 14:56
797,20154728124707-118,1,10/9/2015 6:09,1444396140,C7,463260,1444859400,10/14/2015 14:50
2585,20151229041207-285,2,10/12/2015 16:38,1444693080,C7,160680,1444853760,10/14/2015 13:16
4591,20155606085604-918,1,10/10/2015 5:36,1444480560,C3,365700,1444846260,10/14/2015 11:11
23,20151829011833-716,1,10/3/2015 11:18,1443896280,C1,949200,1444845480,10/14/2015 10:58
4662,20155120055142-403,1,10/7/2015 13:58,1444251480,C4,590460,1444841940,10/14/2015 9:59
2747,20155325095328-933,2,10/12/2015 6:01,1444654860,C5,181860,1444836720,10/14/2015 8:32
3743,20155826055856-580,1,10/5/2015 8:46,1444059960,C6,762660,1444822620,10/14/2015 4:37
2219,20153717013727-315,1,10/11/2015 5:37,1444567020,C3,255600,1444822620,10/14/2015 4:37
5501,20152320082354-550,3,10/8/2015 1:59,1444294740,C5,510720,1444805460,10/13/2015 23:51
4843,20153029123049-92,2,10/12/2015 4:04,1444647840,C0,156120,1444803960,10/13/2015 23:26
3843,20150818120801-625,2,10/10/2015 18:14,1444526040,C4,274680,1444800720,10/13/2015 22:32
4633,20151523091527-511,1,10/10/2015 12:05,1444503900,C8,295800,1444799700,10/13/2015 22:15
4249,20151502121513-669,1,10/3/2015 13:27,1443904020,C6,893520,1444797540,10/13/2015 21:39
2862,20151808071821-441,3,10/9/2015 10:26,1444411560,C5,384240,1444795800,10/13/2015 21:10
4518,20154616084623-195,1,10/10/2015 17:58,1444525080,C2,263340,1444788420,10/13/2015 19:07
117,20152631082611-613,2,10/4/2015 11:11,1443982260,C7,803700,1444785960,10/13/2015 18:26
1415,20150713100753-416,1,10/10/2015 5:03,1444478580,C2,289320,1444767900,10/13/2015 13:25
5040,20154129044136-415,1,10/8/2015 22:23,1444368180,C8,399060,1444767240,10/13/2015 13:14
1599,20155123085147-286,1,10/11/2015 0:14,1444547640,C4,217740,1444765380,10/13/2015 12:43
1417,20150513120548-43,3,10/9/2015 18:19,1444439940,C5,324120,1444764060,10/13/2015 12:21
262,20151530031532-48,1,10/10/2015 7:03,1444485780,C3,278160,1444763940,10/13/2015 12:19
1567,20150228100235-385,2,10/8/2015 11:18,1444328280,C0,434280,1444762560,10/13/2015 11:56
2784,20154423044409-968,2,10/11/2015 6:44,1444571040,C2,189900,1444760940,10/13/2015 11:29
5189,20151129121122-794,1,10/11/2015 3:06,1444557960,C8,200820,1444758780,10/13/2015 10:53
3095,20154719084741-65,3,10/7/2015 8:53,1444233180,C5,518520,1444751700,10/13/2015 8:55
3570,20155426015439-228,3,10/7/2015 7:57,1444229820,C7,515340,1444745160,10/13/2015 7:06
5373,20150323090352-23,2,10/11/2015 0:07,1444547220,C5,190380,1444737600,10/13/2015 5:00
1912,20151719031705-396,1,10/7/2015 5:53,1444222380,C5,507120,1444729500,10/13/2015 2:45
1605,20151814061817-293,1,10/9/2015 12:09,1444417740,C2,311580,1444729320,10/13/2015 2:42
2574,20150506040523-403,1,10/8/2015 11:19,1444328340,C4,392520,1444720860,10/13/2015 0:21
886,20152013102004-55,1,10/3/2015 2:04,1443863040,C4,849120,1444712160,10/12/2015 21:56
3093,20153404113443-239,1,10/11/2015 22:46,1444628760,C6,80640,1444709400,10/12/2015 21:10
443,20151529051506-307,2,10/10/2015 20:39,1444534740,C6,160440,1444695180,10/12/2015 17:13
5699,20151821011808-722,1,10/5/2015 15:06,1444082760,C0,608040,1444690800,10/12/2015 16:00
953,20155431125412-835,3,10/3/2015 11:53,1443898380,C0,789420,1444687800,10/12/2015 15:10
6466,20154606024636-543,1,10/11/2015 14:56,1444600560,C8,86520,1444687080,10/12/2015 14:58
5428,20153714053753-627,3,10/9/2015 10:25,1444411500,C5,266760,1444678260,10/12/2015 12:31
1929,20152729052719-451,1,10/7/2015 14:23,1444252980,C4,419820,1444672800,10/12/2015 11:00
1361,20154219084210-14,3,10/9/2015 13:06,1444421160,C2,249120,1444670280,10/12/2015 10:18
4122,20154024084056-354,2,10/10/2015 9:12,1444493520,C5,173040,1444666560,10/12/2015 9:16
2032,20154515054556-394,2,10/1/2015 6:28,1443706080,C5,956940,1444663020,10/12/2015 8:17
4002,20154725064714-647,2,10/7/2015 0:07,1444201620,C0,461400,1444663020,10/12/2015 8:17
6278,20155026015014-82,1,10/6/2015 11:21,1444155660,C7,504780,1444660440,10/12/2015 7:34
1028,20150528090539-210,1,10/9/2015 23:20,1444458000,C8,200340,1444658340,10/12/2015 6:59
6308,20154617094613-518,2,10/9/2015 3:16,1444385760,C3,268200,1444653960,10/12/2015 5:46
5937,20150002080017-383,1,10/11/2015 0:32,1444548720,C2,93840,1444642560,10/12/2015 2:36
4758,20150430090433-512,2,10/3/2015 21:52,1443934320,C2,707760,1444642080,10/12/2015 2:28
267,20155711115749-167,1,10/1/2015 19:01,1443751260,C6,888780,1444640040,10/12/2015 1:54
2492,20150825120831-381,1,10/7/2015 22:05,1444280700,C0,357540,1444638240,10/12/2015 1:24
3129,20153613033606-451,2,10/4/2015 21:18,1444018680,C0,611640,1444630320,10/11/2015 23:12
4536,20152717052750-615,3,10/3/2015 20:17,1443928620,C7,696300,1444624920,10/11/2015 21:42
2629,20150420080400-256,3,10/8/2015 5:34,1444307640,C8,309240,1444616880,10/11/2015 19:28
2683,20152606012640-366,1,10/7/2015 21:02,1444276920,C4,338220,1444615140,10/11/2015 18:59
743,20150729080703-389,1,10/7/2015 14:25,1444253100,C5,356940,1444610040,10/11/2015 17:34
3087,20155231105239-338,2,10/5/2015 18:28,1444094880,C6,508560,1444603440,10/11/2015 15:44
5459,20155029085047-891,3,10/6/2015 5:12,1444133520,C7,467160,1444600680,10/11/2015 14:58
4111,20153201013211-268,3,10/3/2015 16:36,1443915360,C2,681780,1444597140,10/11/2015 13:59
6010,20153425113451-606,2,10/9/2015 11:27,1444415220,C3,172740,1444587960,10/11/2015 11:26
950,20152627032636-64,3,10/6/2015 11:34,1444156440,C2,430260,1444586700,10/11/2015 11:05
63,20154018024040-960,1,10/4/2015 17:10,1444003800,C5,581400,1444585200,10/11/2015 10:40
6105,20151020021029-947,1,10/9/2015 1:14,1444378440,C2,199380,1444577820,10/11/2015 8:37
2405,20152925012926-304,2,10/6/2015 1:43,1444120980,C4,454020,1444575000,10/11/2015 7:50
636,20155221125213-371,1,10/9/2015 2:20,1444382400,C4,189660,1444572060,10/11/2015 7:01
6160,20154626064612-785,1,10/2/2015 17:10,1443831000,C4,739080,1444570080,10/11/2015 6:28
53,20150429080444-356,3,10/7/2015 6:26,1444224360,C4,342660,1444567020,10/11/2015 5:37
5145,20151628111650-794,2,10/6/2015 8:04,1444143840,C4,419760,1444563600,10/11/2015 4:40
1446,20152620062633-528,1,10/8/2015 13:20,1444335600,C7,225720,1444561320,10/11/2015 4:02
3949,20153429063446-548,2,10/9/2015 3:49,1444387740,C8,170820,1444558560,10/11/2015 3:16
3475,20150829080813-483,2,10/9/2015 15:35,1444430100,C8,127260,1444557360,10/11/2015 2:56
5710,20150805040827-754,3,10/7/2015 3:36,1444214160,C2,339960,1444554120,10/11/2015 2:02
4755,20155310125342-214,2,10/5/2015 23:08,1444111680,C8,439380,1444551060,10/11/2015 1:11
6301,20151103031107-509,1,10/3/2015 10:31,1443893460,C2,656700,1444550160,10/11/2015 0:56
383,20155210105230-671,1,9/25/2015 14:28,1443216480,C4,1329120,1444545600,10/10/2015 23:40
4815,20153426113440-126,3,10/9/2015 3:29,1444386540,C5,156300,1444542840,10/10/2015 22:54
3384,20154316024349-453,2,10/3/2015 22:58,1443938280,C2,596700,1444534980,10/10/2015 20:43
1606,20153024013035-807,3,10/6/2015 1:48,1444121280,C7,408120,1444529400,10/10/2015 19:10
1117,20154821124817-368,1,10/5/2015 17:54,1444092840,C7,434040,1444526880,10/10/2015 18:28
1539,20151812031807-51,1,10/3/2015 17:18,1443917880,C5,607200,1444525080,10/10/2015 17:58
4896,20155525025528-862,2,10/6/2015 22:37,1444196220,C5,326040,1444522260,10/10/2015 17:11
303,20153231063236-320,3,10/6/2015 5:12,1444133520,C4,388200,1444521720,10/10/2015 17:02
6281,20154929104953-761,1,10/9/2015 9:53,1444409580,C2,107580,1444517160,10/10/2015 15:46
6322,20154623014627-670,2,10/4/2015 12:50,1443988200,C5,517920,1444506120,10/10/2015 12:42
6245,20154922094908-595,1,9/28/2015 5:58,1443445080,C0,1060980,1444506060,10/10/2015 12:41
4987,20155921075955-560,1,10/8/2015 2:29,1444296540,C4,207000,1444503540,10/10/2015 11:59
4895,20154827014803-602,3,10/7/2015 5:54,1444222440,C5,278520,1444500960,10/10/2015 11:16
4287,20151913061921-545,2,10/7/2015 1:10,1444205400,C4,293580,1444498980,10/10/2015 10:43
4354,20154427014449-383,2,10/7/2015 5:05,1444219500,C5,277620,1444497120,10/10/2015 10:12
2892,20152720032733-633,1,10/8/2015 4:31,1444303860,C5,189480,1444493340,10/10/2015 9:09
1897,20153914123920-944,1,10/7/2015 12:07,1444244820,C3,248160,1444492980,10/10/2015 9:03
2289,20155128015133-316,1,10/5/2015 14:15,1444079700,C6,410580,1444490280,10/10/2015 8:18
1789,20151314011311-1,3,10/4/2015 0:33,1443943980,C2,545100,1444489080,10/10/2015 7:58
417,20154211024216-107,3,9/27/2015 7:54,1443365640,C6,1119120,1444484760,10/10/2015 6:46
5191,20153321073305-157,2,10/3/2015 22:09,1443935340,C8,544680,1444480020,10/10/2015 5:27
4510,20152621062629-429,2,10/3/2015 22:41,1443937260,C5,539100,1444476360,10/10/2015 4:26
3850,20150726120703-149,2,10/6/2015 18:01,1444179660,C2,295080,1444474740,10/10/2015 3:59
2887,20155228015220-418,2,10/6/2015 6:40,1444138800,C4,332640,1444471440,10/10/2015 3:04
807,20153515033550-824,1,10/7/2015 8:15,1444230900,C5,234300,1444465200,10/10/2015 1:20
5975,20155511125500-140,1,9/29/2015 23:11,1443593460,C2,868620,1444462080,10/10/2015 0:28
3606,20150108060137-927,2,10/5/2015 23:36,1444113360,C4,342300,1444455660,10/9/2015 22:41
3513,20150314060301-241,3,10/1/2015 7:57,1443711420,C5,737820,1444449240,10/9/2015 20:54
5659,20155916085912-350,3,9/30/2015 8:27,1443626820,C5,820560,1444447380,10/9/2015 20:23
5652,20152028112022-449,1,10/6/2015 0:14,1444115640,C5,325620,1444441260,10/9/2015 18:41
2617,20150016070037-632,3,10/6/2015 19:41,1444185660,C7,253380,1444439040,10/9/2015 18:04
3448,20152930122926-301,3,10/7/2015 10:26,1444238760,C4,199140,1444437900,10/9/2015 17:45
998,20152226092250-865,1,10/5/2015 6:56,1444053360,C4,384420,1444437780,10/9/2015 17:43
4615,20154519024544-322,2,10/7/2015 8:49,1444232940,C4,202560,1444435500,10/9/2015 17:05
1875,20150117100126-822,2,10/2/2015 6:33,1443792780,C8,641760,1444434540,10/9/2015 16:49
246,20150230110247-212,3,10/6/2015 14:00,1444165200,C3,264540,1444429740,10/9/2015 15:29
2987,20152327072324-277,2,10/8/2015 5:31,1444307460,C4,117960,1444425420,10/9/2015 14:17
2731,20150111090110-546,2,9/28/2015 6:24,1443446640,C4,973740,1444420380,10/9/2015 12:53
280,20154826064823-183,1,9/30/2015 2:49,1443606540,C4,812580,1444419120,10/9/2015 12:32
1506,20153217013250-235,1,10/6/2015 16:58,1444175880,C3,236280,1444412160,10/9/2015 10:36
2325,20150627110636-691,2,10/4/2015 15:38,1443998280,C5,412440,1444410720,10/9/2015 10:12
4628,20153305023343-499,2,10/5/2015 4:42,1444045320,C5,365220,1444410540,10/9/2015 10:09
3358,20151426091431-80,2,9/26/2015 6:00,1443272400,C0,1133880,1444406280,10/9/2015 8:58
1956,20150327050342-760,1,10/6/2015 10:12,1444151520,C4,250980,1444402500,10/9/2015 7:55
3498,20151604091656-972,1,9/27/2015 4:03,1443351780,C5,1046460,1444398240,10/9/2015 6:44
2221,20152130032113-173,2,10/4/2015 22:50,1444024200,C4,372540,1444396740,10/9/2015 6:19
6032,20155930055927-156,2,10/7/2015 2:44,1444211040,C4,183300,1444394340,10/9/2015 5:39
3264,20154812074833-507,2,10/6/2015 4:20,1444130400,C5,257640,1444388040,10/9/2015 3:54
6112,20152230022253-963,1,10/6/2015 6:44,1444139040,C8,245460,1444384500,10/9/2015 2:55
4043,20153730063725-217,1,10/4/2015 3:14,1443953640,C7,430260,1444383900,10/9/2015 2:45
5835,20151107021135-737,3,10/5/2015 4:09,1444043340,C5,340440,1444383780,10/9/2015 2:43
6334,20153912103945-821,2,10/4/2015 14:44,1443995040,C8,383100,1444378140,10/9/2015 1:09
5942,20151113061129-478,3,9/25/2015 20:59,1443239940,C4,1129860,1444369800,10/8/2015 22:50
6374,20150414050436-933,1,10/6/2015 5:28,1444134480,C5,232380,1444366860,10/8/2015 22:01
2048,20150028030051-590,3,10/3/2015 17:15,1443917700,C5,445500,1444363200,10/8/2015 21:00
1483,20150009040035-292,1,10/5/2015 14:48,1444081680,C3,280260,1444361940,10/8/2015 20:39
3043,20153230023251-365,1,10/7/2015 19:47,1444272420,C7,89100,1444361520,10/8/2015 20:32
996,20155526065554-981,1,10/4/2015 15:11,1443996660,C2,360480,1444357140,10/8/2015 19:19
6139,20153425083416-909,1,10/5/2015 9:31,1444062660,C3,289140,1444351800,10/8/2015 17:50
5858,20150026120010-942,2,10/4/2015 14:42,1443994920,C0,350460,1444345380,10/8/2015 16:03
313,20153908033947-597,1,9/25/2015 11:15,1443204900,C6,1134960,1444339860,10/8/2015 14:31
3976,20150824070825-886,3,10/4/2015 23:44,1444027440,C0,307920,1444335360,10/8/2015 13:16
870,20155420115417-321,1,9/29/2015 15:22,1443565320,C2,768360,1444333680,10/8/2015 12:48
2316,20154212084212-789,1,10/1/2015 8:44,1443714240,C5,617160,1444331400,10/8/2015 12:10
5681,20151826041854-598,1,10/5/2015 13:09,1444075740,C2,255420,1444331160,10/8/2015 12:06
1235,20153220073240-457,2,10/3/2015 22:29,1443936540,C2,392340,1444328880,10/8/2015 11:28
2251,20153622093633-893,2,10/3/2015 5:04,1443873840,C4,451560,1444325400,10/8/2015 10:30
6146,20153925063909-84,3,10/4/2015 0:45,1443944700,C2,378180,1444322880,10/8/2015 9:48
4178,20150605090648-40,1,9/30/2015 8:59,1443628740,C2,691140,1444319880,10/8/2015 8:58
4537,20152610092600-874,1,10/4/2015 20:23,1444015380,C7,301860,1444317240,10/8/2015 8:14
3576,20150625040628-192,1,10/6/2015 5:16,1444133760,C8,182280,1444316040,10/8/2015 7:54
5549,20150206070250-791,1,10/3/2015 17:20,1443918000,C6,394980,1444312980,10/8/2015 7:03
385,20155826025824-717,2,10/4/2015 7:08,1443967680,C5,331500,1444299180,10/8/2015 3:13
4509,20150818060847-607,1,10/5/2015 15:13,1444083180,C3,214500,1444297680,10/8/2015 2:48
1962,20152529072547-796,2,10/5/2015 21:34,1444106040,C3,189780,1444295820,10/8/2015 2:17
4986,20150826030836-996,1,10/6/2015 19:40,1444185600,C4,110040,1444295640,10/8/2015 2:14
5058,20152028092031-391,2,10/4/2015 20:18,1444015080,C3,278940,1444294020,10/8/2015 1:47
6367,20154829024816-982,2,10/3/2015 19:45,1443926700,C2,363420,1444290120,10/8/2015 0:42
5111,20151923031917-617,1,9/30/2015 19:43,1443667380,C2,620640,1444288020,10/8/2015 0:07
4643,20150029020040-164,1,10/7/2015 3:48,1444214880,C7,72720,1444287600,10/8/2015 0:00
2771,20155120125158-102,1,9/25/2015 19:31,1443234660,C5,1050600,1444285260,10/7/2015 23:21
6273,20154025084030-323,2,10/3/2015 17:40,1443919200,C5,361800,1444281000,10/7/2015 22:10
3533,20151121121131-715,3,10/3/2015 19:29,1443925740,C4,354360,1444280100,10/7/2015 21:55
6457,20150229070254-204,1,10/3/2015 13:28,1443904080,C4,368760,1444272840,10/7/2015 19:54
1594,20150722010749-2,1,10/2/2015 17:25,1443831900,C0,439740,1444271640,10/7/2015 19:34
3279,20150326110308-543,1,10/6/2015 11:27,1444156020,C4,108180,1444264200,10/7/2015 17:30
3654,20150530120541-89,1,10/5/2015 7:29,1444055340,C2,207720,1444263060,10/7/2015 17:11
2372,20154927084908-110,2,10/2/2015 12:57,1443815820,C4,446880,1444262700,10/7/2015 17:05
5919,20151914101910-853,2,10/4/2015 18:27,1444008420,C7,251040,1444259460,10/7/2015 16:11
4101,20152006062007-464,2,10/4/2015 3:32,1443954720,C6,301140,1444255860,10/7/2015 15:11
1122,20155127035102-451,2,10/6/2015 7:24,1444141440,C2,106740,1444248180,10/7/2015 13:03
591,20152325042329-787,1,10/4/2015 13:29,1443990540,C3,255720,1444246260,10/7/2015 12:31
4291,20154925034909-164,2,10/5/2015 12:59,1444075140,C8,170760,1444245900,10/7/2015 12:25
4500,20151904071915-758,2,10/4/2015 4:19,1443957540,C7,286800,1444244340,10/7/2015 11:59
3463,20150902060920-793,2,9/29/2015 4:00,1443524400,C7,714780,1444239180,10/7/2015 10:33
5423,20155326075351-224,3,10/6/2015 0:59,1444118340,C7,119880,1444238220,10/7/2015 10:17
3340,20155229035205-191,2,10/4/2015 20:00,1444014000,C0,223440,1444237440,10/7/2015 10:04
3348,20154402034422-248,1,9/29/2015 4:43,1443526980,C8,710220,1444237200,10/7/2015 10:00
3459,20151521021503-834,1,10/2/2015 3:07,1443780420,C5,455160,1444235580,10/7/2015 9:33
1105,20151229111259-568,1,10/5/2015 9:24,1444062240,C2,170640,1444232880,10/7/2015 8:48
5566,20155225085241-468,2,10/5/2015 18:04,1444093440,C4,128160,1444221600,10/7/2015 5:40
4416,20153824093852-393,1,10/5/2015 18:26,1444094760,C2,122760,1444217520,10/7/2015 4:32
1322,20154529104539-756,1,10/6/2015 9:33,1444149180,C7,66720,1444215900,10/7/2015 4:05
5666,20151118101124-666,3,10/5/2015 0:03,1444028580,C5,179040,1444207620,10/7/2015 1:47
905,20153030073006-385,2,10/4/2015 18:30,1444008600,C8,192600,1444201200,10/7/2015 0:00
3622,20153115083129-294,2,10/1/2015 13:37,1443731820,C2,466920,1444198740,10/6/2015 23:19
2361,20150429100402-347,1,10/4/2015 10:40,1443980400,C5,217080,1444197480,10/6/2015 22:58
3274,20151623041644-600,1,9/30/2015 7:29,1443623340,C6,573180,1444196520,10/6/2015 22:42
2614,20152611022615-260,1,9/29/2015 21:26,1443587160,C4,608400,1444195560,10/6/2015 22:26
251,20155512045556-420,3,9/30/2015 18:23,1443662580,C2,529860,1444192440,10/6/2015 21:34
921,20152518012558-924,2,9/27/2015 17:23,1443399780,C4,791880,1444191660,10/6/2015 21:21
612,20154824034835-889,2,10/4/2015 20:13,1444014780,C8,175980,1444190760,10/6/2015 21:06
3431,20151225091237-930,1,9/27/2015 15:18,1443392280,C5,793080,1444185360,10/6/2015 19:36
2121,20155419015446-344,1,10/4/2015 21:06,1444017960,C5,165240,1444183200,10/6/2015 19:00
1969,20155923115946-322,2,10/2/2015 6:21,1443792060,C0,378660,1444170720,10/6/2015 15:32
130,20154928114954-255,1,10/2/2015 6:37,1443793020,C5,375660,1444168680,10/6/2015 14:58
1400,20151729021748-498,2,10/5/2015 21:47,1444106820,C7,60600,1444167420,10/6/2015 14:37
3561,20152328112352-194,1,10/5/2015 12:33,1444073580,C2,87000,1444160580,10/6/2015 12:43
6162,20153721073748-885,1,10/3/2015 23:47,1443941220,C8,219000,1444160220,10/6/2015 12:37
1002,20150815100834-958,1,9/26/2015 3:14,1443262440,C7,897480,1444159920,10/6/2015 12:32
4521,20153712113749-782,1,10/3/2015 11:30,1443897000,C5,259140,1444156140,10/6/2015 11:29
5842,20153430033444-725,2,10/4/2015 11:58,1443985080,C4,166320,1444151400,10/6/2015 10:10
5577,20151925041908-320,3,10/1/2015 4:43,1443699780,C8,450720,1444150500,10/6/2015 9:55
3478,20150912060916-518,1,9/26/2015 19:21,1443320460,C2,826740,1444147200,10/6/2015 9:00
1154,20151204111220-934,2,10/3/2015 4:09,1443870540,C7,275580,1444146120,10/6/2015 8:42
6418,20155626055623-547,1,10/1/2015 12:35,1443728100,C3,412740,1444140840,10/6/2015 7:14
1032,20150605090601-376,2,9/25/2015 23:30,1443249000,C8,889920,1444138920,10/6/2015 6:42
5138,20155611055631-743,2,10/3/2015 4:26,1443871560,C0,264600,1444136160,10/6/2015 5:56
4829,20155330055334-238,3,10/2/2015 4:25,1443785100,C4,350340,1444135440,10/6/2015 5:44
3247,20155304085320-560,1,10/2/2015 5:30,1443789000,C3,343860,1444132860,10/6/2015 5:01
1742,20153329043333-913,1,10/5/2015 4:39,1444045140,C6,79260,1444124400,10/6/2015 2:40
6045,20150215070210-159,1,10/3/2015 11:15,1443896100,C7,224340,1444120440,10/6/2015 1:34
1148,20152620092652-624,2,10/4/2015 2:33,1443951180,C4,169260,1444120440,10/6/2015 1:34
4045,20151929021932-254,1,10/4/2015 22:34,1444023240,C8,92340,1444115580,10/6/2015 0:13
5123,20150930110949-443,1,10/1/2015 22:21,1443763260,C0,350640,1444113900,10/5/2015 23:45
5802,20151729051737-48,1,10/4/2015 8:59,1443974340,C5,134040,1444108380,10/5/2015 22:13
1452,20155525115508-896,2,10/4/2015 14:19,1443993540,C3,112320,1444105860,10/5/2015 21:31
3806,20154925074924-66,1,9/26/2015 19:43,1443321780,C7,783720,1444105500,10/5/2015 21:25
4749,20151526081527-704,2,10/4/2015 16:27,1444001220,C2,102960,1444104180,10/5/2015 21:03
6224,20152504102537-658,2,10/1/2015 20:46,1443757560,C7,338580,1444096140,10/5/2015 18:49
1194,20155928015947-290,2,10/3/2015 23:26,1443939960,C3,155340,1444095300,10/5/2015 18:35
2499,20154223104254-46,1,9/21/2015 7:50,1442847000,C4,1247640,1444094640,10/5/2015 18:24
1645,20151423061421-949,2,10/1/2015 14:14,1443734040,C5,360000,1444094040,10/5/2015 18:14
3899,20150328070359-611,1,10/4/2015 19:44,1444013040,C3,80580,1444093620,10/5/2015 18:07
481,20155115045123-3,1,9/29/2015 1:21,1443514860,C0,576900,1444091760,10/5/2015 17:36
4909,20150411050432-27,1,10/1/2015 17:24,1443745440,C8,345840,1444091280,10/5/2015 17:28
820,20152826012855-73,3,10/3/2015 9:43,1443890580,C0,197100,1444087680,10/5/2015 16:28
760,20151619091608-327,2,10/3/2015 14:52,1443909120,C5,175680,1444084800,10/5/2015 15:40
1534,20150908120959-737,2,9/28/2015 20:42,1443498120,C0,586260,1444084380,10/5/2015 15:33
6066,20155203015220-852,3,10/1/2015 13:52,1443732720,C3,345600,1444078320,10/5/2015 13:52
2413,20151625041658-913,2,9/30/2015 14:51,1443649860,C6,426900,1444076760,10/5/2015 13:26
4740,20152524122527-579,1,10/4/2015 3:18,1443953880,C4,118740,1444072620,10/5/2015 12:17
1085,20151526091530-569,1,10/3/2015 4:39,1443872340,C5,196080,1444068420,10/5/2015 11:07
4775,20152501062522-694,2,10/4/2015 0:45,1443944700,C4,119400,1444064100,10/5/2015 9:55
2733,20154421054430-525,1,10/3/2015 16:30,1443915000,C2,147480,1444062480,10/5/2015 9:28
5049,20151128111144-648,2,10/4/2015 12:26,1443986760,C7,74700,1444061460,10/5/2015 9:11
3982,20152927082906-285,1,10/4/2015 8:36,1443972960,C8,86460,1444059420,10/5/2015 8:37
1448,20150811080802-300,3,10/2/2015 8:08,1443798480,C2,259200,1444057680,10/5/2015 8:08
1733,20152922082911-839,2,9/28/2015 20:15,1443496500,C3,560760,1444057260,10/5/2015 8:01
3861,20150326040316-459,1,10/3/2015 3:42,1443868920,C2,186780,1444055700,10/5/2015 7:35
3895,20152328102355-953,1,10/1/2015 20:49,1443757740,C6,296760,1444054500,10/5/2015 7:15
1445,20151412081447-295,1,9/29/2015 6:22,1443532920,C5,517560,1444050480,10/5/2015 6:08
5869,20153901053918-352,1,10/1/2015 12:43,1443728580,C2,321780,1444050360,10/5/2015 6:06
3659,20153517113533-488,2,10/2/2015 6:55,1443794100,C8,255840,1444049940,10/5/2015 5:59
2252,20151814091851-213,1,9/28/2015 6:16,1443446160,C8,599340,1444045500,10/5/2015 4:45
3331,20151628071608-385,3,10/2/2015 20:04,1443841440,C5,195840,1444037280,10/5/2015 2:28
2488,20154227054208-498,1,9/23/2015 12:47,1443037620,C8,998700,1444036320,10/5/2015 2:12
3438,20151624061651-753,1,9/29/2015 20:04,1443582240,C2,451440,1444033680,10/5/2015 1:28
3092,20154524034503-939,3,10/3/2015 21:05,1443931500,C0,99600,1444031100,10/5/2015 0:45
2769,20153902113957-47,3,10/4/2015 3:47,1443955620,C5,72240,1444027860,10/4/2015 23:51
687,20155030125002-922,3,10/3/2015 21:05,1443931500,C2,96300,1444027800,10/4/2015 23:50
2487,20154811074853-707,3,9/29/2015 1:24,1443515040,C4,510720,1444025760,10/4/2015 23:16
4960,20151026061007-244,1,9/30/2015 14:34,1443648840,C6,375840,1444024680,10/4/2015 22:58
1118,20152224022226-330,1,9/29/2015 18:11,1443575460,C0,445740,1444021200,10/4/2015 22:00
1457,20153710073725-591,2,10/1/2015 19:59,1443754740,C8,265560,1444020300,10/4/2015 21:45
484,20155017105034-330,2,10/2/2015 22:58,1443851880,C4,167460,1444019340,10/4/2015 21:29
2668,20155328085310-805,2,10/1/2015 15:03,1443736980,C6,281400,1444018380,10/4/2015 21:13
4298,20154824124832-402,2,10/3/2015 12:45,1443901500,C2,111060,1444012560,10/4/2015 19:36
3165,20150110030105-67,3,9/27/2015 21:24,1443414240,C7,595740,1444009980,10/4/2015 18:53
5151,20155925115933-802,2,10/2/2015 10:47,1443808020,C0,200160,1444008180,10/4/2015 18:23
2453,20153524023526-802,3,10/3/2015 11:44,1443897840,C2,109620,1444007460,10/4/2015 18:11
4282,20154815114839-956,1,10/2/2015 14:36,1443821760,C6,184860,1444006620,10/4/2015 17:57
5490,20152822052837-707,2,9/28/2015 17:37,1443487020,C2,518940,1444005960,10/4/2015 17:46
2917,20151428061409-269,1,10/2/2015 13:04,1443816240,C7,185100,1444001340,10/4/2015 16:29
257,20154719114724-517,2,9/29/2015 13:49,1443559740,C5,435660,1443995400,10/4/2015 14:50
3846,20155922085938-836,1,10/3/2015 2:00,1443862800,C2,132180,1443994980,10/4/2015 14:43
4267,20150218020235-744,2,10/2/2015 14:30,1443821400,C8,173040,1443994440,10/4/2015 14:34
5904,20150326110322-354,2,10/3/2015 8:57,1443887820,C6,99540,1443987360,10/4/2015 12:36
1997,20154817014854-170,2,10/2/2015 19:48,1443840480,C7,146400,1443986880,10/4/2015 12:28
271,20151425091439-648,2,9/29/2015 22:47,1443592020,C6,394380,1443986400,10/4/2015 12:20
4699,20155310085325-400,2,10/1/2015 11:41,1443724860,C7,260640,1443985500,10/4/2015 12:05
3866,20151225051248-279,2,10/1/2015 13:14,1443730440,C4,252060,1443982500,10/4/2015 11:15
5883,20151925101910-391,2,10/3/2015 4:07,1443870420,C6,111480,1443981900,10/4/2015 11:05
5284,20152012122057-909,3,10/1/2015 16:49,1443743340,C2,236820,1443980160,10/4/2015 10:36
4688,20150223100216-408,2,10/3/2015 4:26,1443871560,C4,105480,1443977040,10/4/2015 9:44
3174,20152027062057-241,2,10/2/2015 0:08,1443769680,C5,204840,1443974520,10/4/2015 9:02
4883,20152925062903-447,1,10/1/2015 7:59,1443711540,C2,261900,1443973440,10/4/2015 8:44
1870,20155122115118-223,1,10/3/2015 1:03,1443859380,C4,113940,1443973320,10/4/2015 8:42
2411,20155024105051-288,3,10/1/2015 20:53,1443757980,C4,213660,1443971640,10/4/2015 8:14
4342,20151804081822-193,3,9/24/2015 7:38,1443105480,C8,862800,1443968280,10/4/2015 7:18
4735,20154207114257-472,1,9/27/2015 1:37,1443343020,C4,624300,1443967320,10/4/2015 7:02
739,20150229120212-565,1,10/1/2015 21:15,1443759300,C3,205980,1443965280,10/4/2015 6:28
6211,20152013052027-811,2,9/29/2015 2:38,1443519480,C3,443160,1443962640,10/4/2015 5:44
4555,20151727121757-443,1,10/1/2015 23:33,1443767580,C5,193080,1443960660,10/4/2015 5:11
6369,20154703104737-748,3,9/23/2015 21:13,1443067980,C0,882780,1443950760,10/4/2015 2:26
6447,20153306013342-878,3,9/26/2015 18:10,1443316200,C7,631860,1443948060,10/4/2015 1:41
350,20155002095022-451,2,9/28/2015 18:55,1443491700,C8,455820,1443947520,10/4/2015 1:32
1575,20151504111546-565,1,9/19/2015 6:10,1442668200,C2,1277700,1443945900,10/4/2015 1:05
2557,20150819030822-252,2,9/29/2015 5:20,1443529200,C8,414360,1443943560,10/4/2015 0:26
1381,20151623111631-719,1,10/2/2015 20:04,1443841440,C5,101160,1443942600,10/4/2015 0:10
6535,20151302071301-31,3,9/30/2015 0:55,1443599700,C4,342360,1443942060,10/4/2015 0:01
5380,20153325073343-313,1,9/29/2015 15:31,1443565860,C6,374280,1443940140,10/3/2015 23:29
5704,20150816050832-772,1,9/25/2015 8:10,1443193800,C2,745320,1443939120,10/3/2015 23:12
4482,20153613083644-306,1,10/1/2015 15:40,1443739200,C4,197580,1443936780,10/3/2015 22:33
2501,20154230094206-93,1,9/29/2015 14:26,1443561960,C5,372720,1443934680,10/3/2015 21:58
6469,20152721082747-925,1,10/2/2015 7:46,1443797160,C5,135420,1443932580,10/3/2015 21:23
2889,20150230070206-829,1,9/29/2015 13:24,1443558240,C7,373560,1443931800,10/3/2015 21:10
1744,20150419110400-987,2,10/1/2015 23:22,1443766920,C8,154440,1443921360,10/3/2015 18:16
5955,20150329030356-86,1,10/1/2015 16:17,1443741420,C4,177240,1443918660,10/3/2015 17:31
1276,20154224024243-441,1,9/24/2015 18:59,1443146340,C4,767460,1443913800,10/3/2015 16:10
5823,20153910063931-835,2,10/1/2015 1:27,1443688020,C5,224460,1443912480,10/3/2015 15:48
3033,20152919062956-312,2,9/30/2015 1:14,1443600840,C2,310500,1443911340,10/3/2015 15:29
753,20153128063125-623,1,9/27/2015 13:51,1443387060,C8,523680,1443910740,10/3/2015 15:19
5990,20154324014310-391,1,10/2/2015 11:25,1443810300,C4,97560,1443907860,10/3/2015 14:31
936,20154108014126-563,1,9/27/2015 8:53,1443369180,C6,537840,1443907020,10/3/2015 14:17
3880,20150409100421-849,2,9/29/2015 12:34,1443555240,C8,347400,1443902640,10/3/2015 13:04
4543,20155726125730-585,1,10/2/2015 16:49,1443829740,C5,66540,1443896280,10/3/2015 11:18
3148,20153923093923-432,3,10/2/2015 4:21,1443784860,C8,108360,1443893220,10/3/2015 10:27
2851,20150421060449-866,2,9/29/2015 8:26,1443540360,C8,349860,1443890220,10/3/2015 9:37
6493,20153425023446-675,1,10/2/2015 8:58,1443801480,C5,83520,1443885000,10/3/2015 8:10
2839,20155429055432-113,1,10/1/2015 12:49,1443728940,C4,154500,1443883440,10/3/2015 7:44
146,20152224062251-834,2,10/2/2015 7:10,1443795000,C4,86760,1443881760,10/3/2015 7:16
843,20150728030708-412,1,9/29/2015 7:39,1443537540,C2,342240,1443879780,10/3/2015 6:43
2229,20155227055231-464,3,9/30/2015 12:04,1443639840,C6,238320,1443878160,10/3/2015 6:16
6013,20154330024325-110,1,9/28/2015 8:49,1443455340,C6,414060,1443869400,10/3/2015 3:50
5947,20151829071820-420,2,9/28/2015 18:06,1443488760,C4,375840,1443864600,10/3/2015 2:30
6233,20155823045848-67,2,10/1/2015 11:48,1443725280,C8,134520,1443859800,10/3/2015 1:10
5085,20155711025756-499,3,9/30/2015 7:53,1443624780,C0,230880,1443855660,10/3/2015 0:01
4619,20150828050833-517,1,10/1/2015 21:35,1443760500,C5,91740,1443852240,10/2/2015 23:04
4250,20155015115025-738,3,9/30/2015 17:42,1443660120,C7,188160,1443848280,10/2/2015 21:58
439,20155405055439-901,1,9/23/2015 20:30,1443065400,C4,782280,1443847680,10/2/2015 21:48
3871,20151011051048-783,1,9/30/2015 18:22,1443662520,C7,182880,1443845400,10/2/2015 21:10
331,20154717034744-602,3,10/1/2015 4:27,1443698820,C6,146100,1443844920,10/2/2015 21:02
4227,20150305100328-487,3,9/24/2015 12:21,1443122460,C6,721380,1443843840,10/2/2015 20:44
1514,20152115122135-105,3,9/30/2015 15:18,1443651480,C7,186660,1443838140,10/2/2015 19:09
1951,20153624113634-748,2,9/30/2015 16:39,1443656340,C0,178860,1443835200,10/2/2015 18:20
3865,20151726111704-117,1,9/23/2015 10:11,1443028260,C5,805080,1443833340,10/2/2015 17:49
4614,20154519024544-322,2,9/30/2015 9:18,1443629880,C4,202740,1443832620,10/2/2015 17:37
6420,20151019021027-10,2,9/28/2015 7:04,1443449040,C7,376020,1443825060,10/2/2015 15:31
5766,20151817041849-523,2,9/28/2015 21:21,1443500460,C5,322860,1443823320,10/2/2015 15:02
3006,20150622030637-276,1,9/22/2015 9:00,1442937600,C4,885480,1443823080,10/2/2015 14:58
3446,20154928014949-969,1,10/1/2015 6:25,1443705900,C8,116280,1443822180,10/2/2015 14:43
410,20155606045620-205,2,9/23/2015 22:22,1443072120,C8,744180,1443816300,10/2/2015 13:05
1753,20155116095155-952,2,9/28/2015 12:12,1443467520,C3,348420,1443815940,10/2/2015 12:59
1000,20152529062500-596,2,9/30/2015 21:31,1443673860,C6,140760,1443814620,10/2/2015 12:37
4409,20154229064247-967,1,9/21/2015 2:38,1442828280,C2,986280,1443814560,10/2/2015 12:36
3055,20150816110851-751,2,9/30/2015 17:32,1443659520,C6,154080,1443813600,10/2/2015 12:20
2068,20153023073030-973,1,10/1/2015 8:28,1443713280,C8,99240,1443812520,10/2/2015 12:02
1604,20155024015031-756,3,9/28/2015 4:06,1443438360,C3,373620,1443811980,10/2/2015 11:53
6499,20151904021905-805,1,9/20/2015 11:19,1442773140,C7,1035600,1443808740,10/2/2015 10:59
5053,20151024091033-928,2,10/1/2015 10:27,1443720420,C5,87060,1443807480,10/2/2015 10:38
5544,20155131115159-825,3,9/28/2015 9:59,1443459540,C5,344640,1443804180,10/2/2015 9:43
707,20155905015950-850,1,9/25/2015 15:11,1443219060,C4,577440,1443796500,10/2/2015 7:35
615,20153224093211-44,1,9/12/2015 19:56,1442112960,C2,1679040,1443792000,10/2/2015 6:20
2654,20153027033021-889,2,10/1/2015 2:09,1443690540,C5,99180,1443789720,10/2/2015 5:42
5852,20154817054816-243,3,9/27/2015 9:12,1443370320,C8,416520,1443786840,10/2/2015 4:54
5094,20150607030644-318,1,9/18/2015 7:21,1442586060,C3,1200300,1443786360,10/2/2015 4:46
2548,20152001012016-668,3,9/25/2015 7:52,1443192720,C5,591540,1443784260,10/2/2015 4:11
1817,20151823021836-870,3,10/1/2015 1:58,1443689880,C7,92400,1443782280,10/2/2015 3:38
5877,20151919061903-547,1,9/30/2015 16:59,1443657540,C4,123600,1443781140,10/2/2015 3:19
4440,20154214064217-704,1,9/15/2015 20:18,1442373480,C7,1406880,1443780360,10/2/2015 3:06
4517,20150103070112-250,3,9/28/2015 21:57,1443502620,C4,276720,1443779340,10/2/2015 2:49
3032,20152523012506-74,1,10/1/2015 3:33,1443695580,C3,81960,1443777540,10/2/2015 2:19
5243,20154107074130-137,2,9/22/2015 18:46,1442972760,C8,802860,1443775620,10/2/2015 1:47
2540,20153329123327-162,1,10/1/2015 4:11,1443697860,C5,71340,1443769200,10/2/2015 0:00
3749,20150314050311-620,2,9/22/2015 1:25,1442910300,C5,855960,1443766260,10/1/2015 23:11
4830,20154125084143-150,3,9/29/2015 18:05,1443575100,C8,189720,1443764820,10/1/2015 22:47
5291,20150427050456-122,1,10/1/2015 9:58,1443718680,C8,45720,1443764400,10/1/2015 22:40
4381,20154725014705-617,2,9/29/2015 19:21,1443579660,C8,182820,1443762480,10/1/2015 22:08
3792,20152819112852-444,2,9/23/2015 14:56,1443045360,C5,714360,1443759720,10/1/2015 21:22
6237,20150925030923-872,2,9/29/2015 18:49,1443577740,C0,179400,1443757140,10/1/2015 20:39
4246,20150307010338-210,2,9/28/2015 19:07,1443492420,C0,262320,1443754740,10/1/2015 19:59
2667,20150729110716-839,1,9/30/2015 15:15,1443651300,C0,101280,1443752580,10/1/2015 19:23
6288,20155724045747-509,2,9/30/2015 14:42,1443649320,C8,102060,1443751380,10/1/2015 19:03
1955,20152820102827-437,3,9/30/2015 12:20,1443640800,C6,108840,1443749640,10/1/2015 18:34
961,20150114010135-879,1,9/26/2015 0:27,1443252420,C2,495780,1443748200,10/1/2015 18:10
5436,20155719075702-802,1,9/27/2015 14:37,1443389820,C5,357600,1443747420,10/1/2015 17:57
675,20153422023401-747,1,9/28/2015 16:00,1443481200,C2,261780,1443742980,10/1/2015 16:43
2807,20150107050116-884,2,9/24/2015 19:26,1443147960,C7,593700,1443741660,10/1/2015 16:21
3282,20152123052127-127,2,9/27/2015 16:45,1443397500,C3,343440,1443740940,10/1/2015 16:09
365,20153227023219-8,2,9/25/2015 18:42,1443231720,C8,504120,1443735840,10/1/2015 14:44
5210,20155301055312-754,2,9/23/2015 21:59,1443070740,C0,656280,1443727020,10/1/2015 12:17
5248,20150327030331-456,1,9/30/2015 12:54,1443642840,C4,83820,1443726660,10/1/2015 12:11
2691,20153931093915-91,1,9/27/2015 14:31,1443389460,C7,335760,1443725220,10/1/2015 11:47
5643,20154027114042-147,1,9/30/2015 3:22,1443608520,C3,114660,1443723180,10/1/2015 11:13
5928,20153817093840-341,1,9/26/2015 22:41,1443332460,C7,389220,1443721680,10/1/2015 10:48
5099,20152420032414-663,1,9/30/2015 8:12,1443625920,C7,93120,1443719040,10/1/2015 10:04
1063,20154114094103-483,1,9/29/2015 6:48,1443534480,C4,183660,1443718140,10/1/2015 9:49
3105,20152519102554-161,2,9/30/2015 0:49,1443599340,C4,114480,1443713820,10/1/2015 8:37
3811,20152027052026-10,3,9/30/2015 3:08,1443607680,C8,104040,1443711720,10/1/2015 8:02
607,20152225082250-866,2,9/23/2015 18:06,1443056760,C0,652380,1443709140,10/1/2015 7:19
1212,20152927012946-631,2,9/29/2015 10:09,1443546540,C6,160800,1443707340,10/1/2015 6:49
5805,20152123092103-610,1,9/18/2015 7:17,1442585820,C3,1119480,1443705300,10/1/2015 6:15
3457,20150127010131-864,3,9/26/2015 21:50,1443329400,C4,374820,1443704220,10/1/2015 5:57
6416,20153319053331-895,1,9/27/2015 9:43,1443372180,C4,331500,1443703680,10/1/2015 5:48
4573,20150419050423-187,1,9/27/2015 9:16,1443370560,C7,331560,1443702120,10/1/2015 5:22
862,20150018080022-664,1,9/29/2015 20:54,1443585240,C7,110760,1443696000,10/1/2015 3:40
4770,20151625031626-950,2,9/27/2015 11:40,1443379200,C7,315360,1443694560,10/1/2015 3:16
5551,20151007041045-624,1,9/28/2015 12:42,1443469320,C2,225240,1443694560,10/1/2015 3:16
1458,20152715082740-609,2,9/25/2015 20:21,1443237660,C3,453420,1443691080,10/1/2015 2:18
534,20154419114439-303,1,9/29/2015 18:56,1443578160,C5,111240,1443689400,10/1/2015 1:50
3466,20155318115321-937,2,9/24/2015 18:36,1443144960,C2,542580,1443687540,10/1/2015 1:19
5537,20153828093806-862,2,9/29/2015 17:24,1443572640,C0,114360,1443687000,10/1/2015 1:10
3122,20152912062950-917,1,9/28/2015 21:49,1443502140,C5,179700,1443681840,9/30/2015 23:44
5874,20153909063916-316,3,9/25/2015 13:09,1443211740,C5,468600,1443680340,9/30/2015 23:19
3374,20150117070118-157,1,9/27/2015 12:46,1443383160,C5,294900,1443678060,9/30/2015 22:41
1968,20153119113110-269,1,9/28/2015 1:34,1443429240,C5,247260,1443676500,9/30/2015 22:15
2703,20151911021956-775,1,9/21/2015 20:43,1442893380,C3,780480,1443673860,9/30/2015 21:31
5680,20155215095214-503,1,9/27/2015 0:22,1443338520,C4,334200,1443672720,9/30/2015 21:12
2838,20150021050036-788,3,9/29/2015 19:00,1443578400,C6,87300,1443665700,9/30/2015 19:15
1070,20151028071020-362,1,9/29/2015 13:10,1443557400,C6,108000,1443665400,9/30/2015 19:10
4050,20153701113748-789,1,9/26/2015 14:25,1443302700,C6,361680,1443664380,9/30/2015 18:53
553,20150315110303-677,1,9/25/2015 16:01,1443222060,C5,440940,1443663000,9/30/2015 18:30
4814,20151119111132-408,3,9/27/2015 0:01,1443337260,C5,325500,1443662760,9/30/2015 18:26
5317,20153126123126-309,3,9/28/2015 15:26,1443479160,C2,183300,1443662460,9/30/2015 18:21
3425,20152227062258-532,2,9/29/2015 13:56,1443560160,C2,100020,1443660180,9/30/2015 17:43
2759,20150926060947-3,1,9/28/2015 11:29,1443464940,C0,192000,1443656940,9/30/2015 16:49
1012,20151619111656-337,2,9/29/2015 7:03,1443535380,C3,121260,1443656640,9/30/2015 16:44
1334,20154414024455-447,1,9/26/2015 15:29,1443306540,C2,346500,1443653040,9/30/2015 15:44
3280,20150506080545-327,1,9/23/2015 17:02,1443052920,C4,597060,1443649980,9/30/2015 14:53
1513,20154823124859-777,3,9/28/2015 19:45,1443494700,C5,152340,1443647040,9/30/2015 14:04
2686,20153725113714-643,2,9/29/2015 6:58,1443535080,C5,109620,1443644700,9/30/2015 13:25
2655,20152926122925-922,1,9/29/2015 4:23,1443525780,C8,115020,1443640800,9/30/2015 12:20
6479,20150913060926-359,1,9/28/2015 6:11,1443445860,C8,185160,1443631020,9/30/2015 9:37
6271,20151825051820-653,3,9/29/2015 20:30,1443583800,C4,44640,1443628440,9/30/2015 8:54
1191,20152310082337-650,1,9/27/2015 20:02,1443409320,C8,215820,1443625140,9/30/2015 7:59
419,20154511094545-173,1,9/24/2015 0:33,1443079980,C4,545040,1443625020,9/30/2015 7:57
2058,20153726083749-370,1,9/29/2015 0:09,1443510540,C7,114360,1443624900,9/30/2015 7:55
2298,20153123093148-981,1,9/29/2015 4:11,1443525060,C8,99840,1443624900,9/30/2015 7:55
847,20150518090550-442,3,9/26/2015 8:01,1443279660,C4,343680,1443623340,9/30/2015 7:29
182,20150417010430-97,1,9/28/2015 3:49,1443437340,C8,183420,1443620760,9/30/2015 6:46
6403,20152406112431-687,1,9/22/2015 6:48,1442929680,C5,682920,1443612600,9/30/2015 4:30
2530,20155608095652-395,3,9/24/2015 17:20,1443140400,C5,469680,1443610080,9/30/2015 3:48
3369,20155126045131-960,1,9/28/2015 23:55,1443509700,C5,99120,1443608820,9/30/2015 3:27
3199,20152229022224-672,1,9/26/2015 4:48,1443268080,C3,340680,1443608760,9/30/2015 3:26
2816,20155022025040-869,3,9/29/2015 1:14,1443514440,C6,92640,1443607080,9/30/2015 2:58
2523,20151727021712-641,1,9/29/2015 6:27,1443533220,C5,72300,1443605520,9/30/2015 2:32
1891,20155823065837-106,1,9/28/2015 23:13,1443507180,C8,98100,1443605280,9/30/2015 2:28
2191,20154525094552-398,1,9/28/2015 20:48,1443498480,C3,99660,1443598140,9/30/2015 0:29
643,20153524043531-670,1,9/29/2015 3:10,1443521400,C8,76740,1443598140,9/30/2015 0:29
3004,20154805074832-890,2,9/26/2015 20:52,1443325920,C8,265920,1443591840,9/29/2015 22:44
3822,20154027054037-715,1,9/29/2015 5:00,1443528000,C5,63600,1443591600,9/29/2015 22:40
1953,20154512044556-370,2,9/28/2015 0:13,1443424380,C5,165360,1443589740,9/29/2015 22:09
2639,20154930064934-59,2,9/19/2015 16:51,1442706660,C8,882060,1443588720,9/29/2015 21:52
1116,20152321032356-54,2,9/16/2015 18:59,1442455140,C3,1129680,1443584820,9/29/2015 20:47
2163,20155825105841-374,1,9/28/2015 8:56,1443455760,C8,125940,1443581700,9/29/2015 19:55
1885,20150326120302-265,1,9/28/2015 23:48,1443509280,C5,71700,1443580980,9/29/2015 19:43
5550,20150818100801-621,3,9/28/2015 8:15,1443453300,C8,122460,1443575760,9/29/2015 18:16
5506,20150213050220-905,3,9/25/2015 17:23,1443226980,C5,346020,1443573000,9/29/2015 17:30
6121,20150822100824-378,2,9/25/2015 11:04,1443204240,C5,367620,1443571860,9/29/2015 17:11
2715,20151215011211-758,1,9/27/2015 22:21,1443417660,C5,152820,1443570480,9/29/2015 16:48
4356,20150625070608-126,1,9/28/2015 4:50,1443441000,C4,125520,1443566520,9/29/2015 15:42
1644,20152724022701-346,1,9/28/2015 8:24,1443453840,C5,107940,1443561780,9/29/2015 14:23
2790,20154019064052-72,2,9/28/2015 6:37,1443447420,C0,111060,1443558480,9/29/2015 13:28
1909,20154730114701-335,3,9/14/2015 11:54,1442256840,C6,1296420,1443553260,9/29/2015 12:01
4630,20155716015705-26,3,9/25/2015 4:37,1443181020,C5,372000,1443553020,9/29/2015 11:57
1680,20152724062710-421,1,9/22/2015 0:27,1442906820,C2,645300,1443552120,9/29/2015 11:42
2088,20154304074340-809,1,9/25/2015 21:25,1443241500,C6,310620,1443552120,9/29/2015 11:42
4254,20154525014533-946,1,9/27/2015 12:36,1443382560,C4,168660,1443551220,9/29/2015 11:27
462,20154913114917-875,1,9/27/2015 4:37,1443353820,C6,197280,1443551100,9/29/2015 11:25
2248,20155726045730-46,1,9/28/2015 13:09,1443470940,C4,79560,1443550500,9/29/2015 11:15
2201,20150904060937-392,1,9/26/2015 5:57,1443272220,C5,271440,1443543660,9/29/2015 9:21
5762,20153520093506-281,2,9/26/2015 9:17,1443284220,C3,258660,1443542880,9/29/2015 9:08
3639,20155220055213-805,2,9/26/2015 11:38,1443292680,C4,247980,1443540660,9/29/2015 8:31
5419,20155710035705-492,1,9/24/2015 16:00,1443135600,C5,403260,1443538860,9/29/2015 8:01
2206,20154220054254-247,3,9/28/2015 5:50,1443444600,C2,92640,1443537240,9/29/2015 7:34
2728,20153119123113-587,3,9/24/2015 4:44,1443095040,C8,440340,1443535380,9/29/2015 7:03
6508,20151117101107-46,2,9/23/2015 20:59,1443067140,C5,462240,1443529380,9/29/2015 5:23
6114,20153125073143-771,2,9/27/2015 6:18,1443359880,C3,168420,1443528300,9/29/2015 5:05
5027,20155411105414-764,2,9/24/2015 18:00,1443142800,C3,382920,1443525720,9/29/2015 4:22
436,20151401121438-732,3,9/19/2015 20:26,1442719560,C3,792360,1443511920,9/29/2015 0:32
1316,20154610014621-394,2,9/26/2015 16:38,1443310680,C0,198960,1443509640,9/28/2015 23:54
2132,20151026091044-859,2,9/24/2015 18:25,1443144300,C7,362700,1443507000,9/28/2015 23:10
5948,20150802090823-595,1,9/25/2015 23:56,1443250560,C4,255060,1443505620,9/28/2015 22:47
5564,20153228093241-330,2,9/24/2015 23:58,1443164280,C7,340680,1443504960,9/28/2015 22:36
803,20151822031835-962,2,9/26/2015 19:40,1443321600,C5,180660,1443502260,9/28/2015 21:51
6143,20153129063108-867,2,9/13/2015 13:48,1442177280,C2,1322220,1443499500,9/28/2015 21:05
3278,20155425085454-29,1,9/27/2015 16:50,1443397800,C8,100680,1443498480,9/28/2015 20:48
3663,20153829013850-412,1,9/18/2015 17:20,1442622000,C3,870660,1443492660,9/28/2015 19:11
3635,20151528071513-888,1,9/24/2015 20:38,1443152280,C8,340140,1443492420,9/28/2015 19:07
2533,20153117093131-820,1,9/27/2015 8:55,1443369300,C7,123120,1443492420,9/28/2015 19:07
503,20152618062642-81,2,9/23/2015 12:30,1443036600,C4,453840,1443490440,9/28/2015 18:34
1347,20152130122123-358,2,9/25/2015 20:09,1443236940,C7,252720,1443489660,9/28/2015 18:21
1192,20151417021426-33,3,9/25/2015 22:44,1443246240,C2,240600,1443486840,9/28/2015 17:34
45,20154719104700-710,3,9/27/2015 13:37,1443386220,C7,100200,1443486420,9/28/2015 17:27
6236,20154825044833-35,3,9/27/2015 16:50,1443397800,C7,86460,1443484260,9/28/2015 16:51
5591,20155819125825-141,1,9/25/2015 15:30,1443220200,C3,263760,1443483960,9/28/2015 16:46
3875,20154115124102-576,3,9/22/2015 8:41,1442936460,C6,544800,1443481260,9/28/2015 16:01
3383,20150922110914-684,2,9/22/2015 10:49,1442944140,C8,535440,1443479580,9/28/2015 15:33
5298,20153202063212-217,2,9/25/2015 7:25,1443191100,C7,284340,1443475440,9/28/2015 14:24
3009,20155722115704-142,1,9/27/2015 19:49,1443408540,C4,65760,1443474300,9/28/2015 14:05
4209,20154517084514-625,2,9/22/2015 12:33,1442950380,C6,520680,1443471060,9/28/2015 13:11
6526,20150223050200-237,3,9/24/2015 13:34,1443126840,C2,344040,1443470880,9/28/2015 13:08
3778,20151711061722-116,2,9/24/2015 3:02,1443088920,C5,370500,1443459420,9/28/2015 9:57
972,20154819014855-670,2,9/27/2015 5:19,1443356340,C4,94380,1443450720,9/28/2015 7:32
2113,20154322044336-436,2,9/23/2015 17:19,1443053940,C7,395280,1443449220,9/28/2015 7:07
3266,20153903123925-684,1,9/22/2015 1:59,1442912340,C0,535200,1443447540,9/28/2015 6:39
6102,20153829053832-818,2,9/21/2015 13:06,1442865960,C4,581160,1443447120,9/28/2015 6:32
3193,20154822054838-865,1,9/27/2015 7:03,1443362580,C8,78660,1443441240,9/28/2015 4:54
2737,20153206063215-204,1,9/21/2015 13:40,1442868000,C8,571440,1443439440,9/28/2015 4:24
4266,20155913095938-39,1,9/23/2015 2:07,1442999220,C5,439260,1443438480,9/28/2015 4:08
2650,20153517023507-15,1,9/14/2015 7:19,1442240340,C2,1196520,1443436860,9/28/2015 3:41
3966,20153207093226-553,1,9/21/2015 16:10,1442877000,C5,558840,1443435840,9/28/2015 3:24
4808,20154412014428-448,1,9/22/2015 22:08,1442984880,C2,447120,1443432000,9/28/2015 2:20
5548,20154702074759-377,1,9/24/2015 21:00,1443153600,C7,278340,1443431940,9/28/2015 2:19
2069,20151219101232-863,3,9/25/2015 22:12,1443244320,C0,187200,1443431520,9/28/2015 2:12
3494,20152718102756-727,1,9/22/2015 22:28,1442986080,C7,438180,1443424260,9/28/2015 0:11
149,20150221090256-672,1,9/27/2015 4:13,1443352380,C8,71580,1443423960,9/28/2015 0:06
1829,20150723060758-760,1,9/16/2015 20:42,1442461320,C8,960900,1443422220,9/27/2015 23:37
3329,20154614094653-955,1,9/23/2015 8:46,1443023160,C8,387000,1443410160,9/27/2015 20:16
3012,20154911044919-82,1,9/25/2015 18:13,1443229980,C4,173520,1443403500,9/27/2015 18:25
4120,20152920072900-597,2,9/25/2015 6:37,1443188220,C2,214440,1443402660,9/27/2015 18:11
5441,20150303040325-976,1,9/24/2015 17:48,1443142080,C3,260100,1443402180,9/27/2015 18:03
4289,20150517010521-33,3,9/26/2015 10:42,1443289320,C2,109860,1443399180,9/27/2015 17:13
570,20150723120718-938,3,9/25/2015 14:25,1443216300,C4,181080,1443397380,9/27/2015 16:43
5597,20152615012610-377,2,9/23/2015 14:36,1443044160,C0,347700,1443391860,9/27/2015 15:11
2593,20154619054642-211,2,9/26/2015 14:16,1443302160,C4,84600,1443386760,9/27/2015 13:46
4556,20153424073437-874,2,9/26/2015 9:50,1443286200,C5,90480,1443376680,9/27/2015 10:58
4207,20153218053206-183,1,9/24/2015 13:06,1443125160,C0,251220,1443376380,9/27/2015 10:53
4126,20153402053419-365,1,9/20/2015 11:37,1442774220,C4,601740,1443375960,9/27/2015 10:46
536,20153723093753-818,3,9/23/2015 12:49,1443037740,C0,336240,1443373980,9/27/2015 10:13
4552,20152609102611-783,1,9/21/2015 6:58,1442843880,C3,528960,1443372840,9/27/2015 9:54
494,20151818101826-629,3,9/17/2015 9:27,1442507220,C5,862980,1443370200,9/27/2015 9:10
2204,20154610094644-926,2,9/24/2015 13:11,1443125460,C8,244380,1443369840,9/27/2015 9:04
451,20151824101808-298,2,9/25/2015 21:20,1443241200,C2,126120,1443367320,9/27/2015 8:22
3653,20150001090048-374,1,9/22/2015 23:35,1442990100,C8,373380,1443363480,9/27/2015 7:18
3260,20152128122117-954,2,9/23/2015 13:48,1443041280,C5,321660,1443362940,9/27/2015 7:09
1636,20151018091033-267,1,9/24/2015 7:26,1443104760,C4,256080,1443360840,9/27/2015 6:34
4930,20154509114531-556,1,9/22/2015 19:30,1442975400,C5,383700,1443359100,9/27/2015 6:05
3273,20150320040327-383,2,9/25/2015 14:21,1443216060,C4,141960,1443358020,9/27/2015 5:47
1876,20151617021606-104,1,9/26/2015 0:48,1443253680,C5,104160,1443357840,9/27/2015 5:44
6474,20150821020810-335,3,9/21/2015 23:50,1442904600,C6,452220,1443356820,9/27/2015 5:27
4951,20153322063335-503,3,9/25/2015 23:24,1443248640,C4,106620,1443355260,9/27/2015 5:01
429,20150613110621-217,1,9/22/2015 5:38,1442925480,C5,429540,1443355020,9/27/2015 4:57
5334,20155320035314-794,3,9/26/2015 9:19,1443284340,C4,70680,1443355020,9/27/2015 4:57
2122,20154810124843-713,3,9/21/2015 5:48,1442839680,C2,514800,1443354480,9/27/2015 4:48
5574,20155729115754-235,2,9/24/2015 0:13,1443078780,C5,275520,1443354300,9/27/2015 4:45
5529,20150413100443-728,3,9/20/2015 7:02,1442757720,C2,593880,1443351600,9/27/2015 4:00
6343,20151715111719-318,1,9/24/2015 5:32,1443097920,C5,252300,1443350220,9/27/2015 3:37
1157,20153523113541-168,2,9/23/2015 6:07,1443013620,C3,332340,1443345960,9/27/2015 2:26
3332,20151313041349-276,1,9/20/2015 9:11,1442765460,C6,579480,1443344940,9/27/2015 2:09
2770,20150901120957-839,1,9/19/2015 23:49,1442731740,C3,610800,1443342540,9/27/2015 1:29
4253,20151804051810-974,1,9/21/2015 10:09,1442855340,C5,481020,1443336360,9/26/2015 23:46
1167,20154020024025-608,3,9/26/2015 4:01,1443265260,C3,68580,1443333840,9/26/2015 23:04
1706,20155129125114-867,1,9/24/2015 1:00,1443081600,C7,244860,1443326460,9/26/2015 21:01
2605,20152602042627-350,1,9/18/2015 19:06,1442628360,C2,696000,1443324360,9/26/2015 20:26
874,20153808113851-534,2,9/20/2015 17:30,1442795400,C8,528960,1443324360,9/26/2015 20:26
4890,20150931010941-247,1,9/22/2015 11:04,1442945040,C8,378660,1443323700,9/26/2015 20:15
1171,20152604072643-403,1,9/19/2015 7:18,1442672280,C4,647760,1443320040,9/26/2015 19:14
5672,20153509063553-817,3,9/18/2015 15:25,1442615100,C8,697560,1443312660,9/26/2015 17:11
3783,20153707123722-164,1,9/20/2015 7:29,1442759340,C7,552360,1443311700,9/26/2015 16:55
1454,20155310105320-51,2,9/20/2015 18:54,1442800440,C8,510180,1443310620,9/26/2015 16:37
3722,20155110075150-591,1,9/21/2015 9:59,1442854740,C6,454560,1443309300,9/26/2015 16:15
1033,20152824092833-430,3,9/25/2015 12:38,1443209880,C2,97800,1443307680,9/26/2015 15:48
2637,20150819010811-13,2,9/24/2015 21:02,1443153720,C5,153480,1443307200,9/26/2015 15:40
2709,20151010011010-902,3,9/24/2015 7:46,1443105960,C6,198360,1443304320,9/26/2015 14:52
860,20152716082703-974,1,9/24/2015 1:09,1443082140,C3,221640,1443303780,9/26/2015 14:43
2138,20152606032633-640,1,9/19/2015 22:52,1442728320,C2,574980,1443303300,9/26/2015 14:35
5499,20155205025245-653,3,9/21/2015 7:43,1442846580,C4,452220,1443298800,9/26/2015 13:20
3836,20155910095936-211,1,9/22/2015 12:08,1442948880,C4,348180,1443297060,9/26/2015 12:51
5207,20154114064153-342,2,9/25/2015 3:45,1443177900,C2,117480,1443295380,9/26/2015 12:23
3835,20151919011904-725,3,9/25/2015 8:04,1443193440,C8,99900,1443293340,9/26/2015 11:49
2938,20153806113852-538,2,9/24/2015 5:30,1443097800,C5,191640,1443289440,9/26/2015 10:44
6339,20153717033736-717,2,9/25/2015 7:29,1443191340,C8,94560,1443285900,9/26/2015 9:45
581,20150822040848-819,1,9/18/2015 4:18,1442575080,C5,709800,1443284880,9/26/2015 9:28
1919,20151521051522-169,2,9/25/2015 14:40,1443217200,C8,67260,1443284460,9/26/2015 9:21
4711,20154826044849-501,1,9/16/2015 3:26,1442399160,C8,883140,1443282300,9/26/2015 8:45
6125,20153125013133-452,1,9/21/2015 1:06,1442822760,C8,457620,1443280380,9/26/2015 8:13
2342,20152718042732-411,2,9/24/2015 9:09,1443110940,C3,164040,1443274980,9/26/2015 6:43
746,20155723025744-648,2,9/25/2015 9:27,1443198420,C5,76500,1443274920,9/26/2015 6:42
2033,20154420054435-183,1,9/24/2015 10:10,1443114600,C3,159180,1443273780,9/26/2015 6:23
2955,20150022080040-235,2,9/25/2015 6:24,1443187440,C3,84480,1443271920,9/26/2015 5:52
6309,20154316094311-12,1,9/25/2015 3:35,1443177300,C4,94440,1443271740,9/26/2015 5:49
409,20153016083036-762,2,9/23/2015 18:27,1443058020,C3,213540,1443271560,9/26/2015 5:46
4691,20151521021511-720,2,9/23/2015 21:54,1443070440,C4,200340,1443270780,9/26/2015 5:33
2541,20153317093349-531,2,9/23/2015 5:57,1443013020,C4,252720,1443265740,9/26/2015 4:09
3420,20152518072549-657,3,9/21/2015 20:05,1442891100,C0,372900,1443264000,9/26/2015 3:40
3097,20155810015814-86,3,9/20/2015 22:58,1442815080,C0,448200,1443263280,9/26/2015 3:28
4529,20153128063145-895,2,9/22/2015 12:43,1442950980,C5,311760,1443262740,9/26/2015 3:19
2422,20150920090938-107,1,9/22/2015 0:37,1442907420,C5,352560,1443259980,9/26/2015 2:33
3848,20150802060812-197,2,9/19/2015 23:36,1442730960,C4,526260,1443257220,9/26/2015 1:47
5921,20153727113719-945,3,9/21/2015 2:57,1442829420,C8,425760,1443255180,9/26/2015 1:13
3628,20155319025303-151,2,9/25/2015 9:47,1443199620,C7,55560,1443255180,9/26/2015 1:13
4203,20150322090352-662,1,9/25/2015 3:09,1443175740,C0,79320,1443255060,9/26/2015 1:11
215,20153022123027-88,2,9/21/2015 17:21,1442881260,C2,372780,1443254040,9/26/2015 0:54
5047,20150105070153-470,1,9/15/2015 15:48,1442357280,C2,895620,1443252900,9/26/2015 0:35
2734,20152108122142-303,2,9/9/2015 20:17,1441855020,C5,1396680,1443251700,9/26/2015 0:15
5927,20152827102844-258,1,9/21/2015 1:28,1442824080,C8,425520,1443249600,9/25/2015 23:40
716,20153317113343-810,1,9/21/2015 17:19,1442881140,C4,366360,1443247500,9/25/2015 23:05
2149,20150419120407-235,3,9/25/2015 0:10,1443165000,C6,79260,1443244260,9/25/2015 22:11
946,20155417095405-70,3,9/23/2015 18:39,1443058740,C5,183300,1443242040,9/25/2015 21:34
1124,20154201074239-177,1,9/17/2015 16:42,1442533320,C7,707400,1443240720,9/25/2015 21:12
5265,20155424095403-620,1,9/15/2015 10:34,1442338440,C3,896700,1443235140,9/25/2015 19:39
1200,20154713024750-774,1,9/21/2015 17:41,1442882460,C4,350820,1443233280,9/25/2015 19:08
5213,20153515113535-847,3,9/24/2015 11:32,1443119520,C2,111060,1443230580,9/25/2015 18:23
2773,20154218124259-772,2,9/23/2015 8:18,1443021480,C8,208080,1443229560,9/25/2015 18:06
6130,20155221115237-739,1,9/24/2015 7:50,1443106200,C7,122340,1443228540,9/25/2015 17:49
361,20155603105654-700,2,9/22/2015 13:08,1442952480,C6,274920,1443227400,9/25/2015 17:30
4613,20154519024544-322,2,9/23/2015 8:55,1443023700,C4,202620,1443226320,9/25/2015 17:12
3679,20151908111910-929,1,9/9/2015 15:09,1441836540,C5,1389300,1443225840,9/25/2015 17:04
4172,20151930121913-276,2,9/12/2015 14:37,1442093820,C2,1131480,1443225300,9/25/2015 16:55
6167,20153304093314-219,1,9/18/2015 13:39,1442608740,C8,612180,1443220920,9/25/2015 15:42
4962,20150020090018-839,1,9/20/2015 9:18,1442765880,C6,446580,1443212460,9/25/2015 13:21
3582,20150918060923-118,1,9/21/2015 21:41,1442896860,C3,315120,1443211980,9/25/2015 13:13
37,20150924120946-229,1,9/18/2015 12:49,1442605740,C3,605100,1443210840,9/25/2015 12:54
4251,20150814050807-728,1,9/22/2015 19:41,1442976060,C4,233460,1443209520,9/25/2015 12:32
5687,20153007093004-81,3,9/19/2015 11:24,1442687040,C5,521820,1443208860,9/25/2015 12:21
4028,20152924102954-975,1,9/13/2015 1:47,1442134020,C7,1071720,1443205740,9/25/2015 11:29
1238,20154105044140-645,1,9/20/2015 12:17,1442776620,C2,426720,1443203340,9/25/2015 10:49
1864,20152520062536-43,1,9/22/2015 18:33,1442971980,C2,216480,1443188460,9/25/2015 6:41
5821,20155427045428-734,1,9/21/2015 16:55,1442879700,C5,308580,1443188280,9/25/2015 6:38
2222,20152713112722-565,2,9/22/2015 7:45,1442933100,C5,254760,1443187860,9/25/2015 6:31
3795,20154615034637-382,1,9/23/2015 15:56,1443048960,C8,138360,1443187320,9/25/2015 6:22
3828,20151821101831-698,1,9/20/2015 6:48,1442756880,C6,429900,1443186780,9/25/2015 6:13
2631,20152724112733-858,1,9/18/2015 6:31,1442583060,C0,602580,1443185640,9/25/2015 5:54
6481,20150512110539-725,2,9/18/2015 20:24,1442633040,C4,551940,1443184980,9/25/2015 5:43
1211,20154514024558-986,3,9/11/2015 8:33,1441985580,C5,1198440,1443184020,9/25/2015 5:27
4512,20152705082730-727,1,9/22/2015 17:39,1442968740,C8,214560,1443183300,9/25/2015 5:15
3918,20155530075533-622,2,9/20/2015 21:10,1442808600,C8,372420,1443181020,9/25/2015 4:37
2967,20154818114859-137,3,9/22/2015 21:30,1442982600,C2,190260,1443172860,9/25/2015 2:21
673,20155508075512-365,1,9/19/2015 18:43,1442713380,C2,458460,1443171840,9/25/2015 2:04
5313,20154216084221-101,3,9/20/2015 14:34,1442784840,C2,380640,1443165480,9/25/2015 0:18
993,20153114113153-521,2,9/23/2015 20:11,1443064260,C4,101100,1443165360,9/25/2015 0:16
6196,20151406061442-733,2,9/18/2015 17:14,1442621640,C3,538200,1443159840,9/24/2015 22:44
1207,20152612022619-830,1,9/20/2015 19:36,1442802960,C8,354900,1443157860,9/24/2015 22:11
3969,20152516042528-805,2,9/20/2015 0:05,1442732700,C5,423600,1443156300,9/24/2015 21:45
4928,20152616072652-905,2,9/22/2015 17:56,1442969760,C5,185400,1443155160,9/24/2015 21:26
3572,20154228044234-553,2,9/15/2015 19:36,1442370960,C5,782820,1443153780,9/24/2015 21:03
1600,20154912074929-675,3,9/18/2015 14:19,1442611140,C2,541800,1443152940,9/24/2015 20:49
1579,20153606103657-307,1,9/22/2015 11:22,1442946120,C7,197880,1443144000,9/24/2015 18:20
2645,20153831073821-785,1,9/21/2015 5:50,1442839800,C6,301320,1443141120,9/24/2015 17:32
2825,20153413023435-625,1,9/21/2015 22:37,1442900220,C5,240060,1443140280,9/24/2015 17:18
6207,20150305110318-934,2,9/18/2015 6:57,1442584620,C8,554220,1443138840,9/24/2015 16:54
6116,20151120081141-291,3,9/23/2015 5:41,1443012060,C8,125100,1443137160,9/24/2015 16:26
4621,20152322072348-123,1,9/20/2015 11:16,1442772960,C8,359940,1443132900,9/24/2015 15:15
1989,20153023063031-787,1,9/17/2015 12:38,1442518680,C4,607560,1443126240,9/24/2015 13:24
2100,20154217124209-940,2,9/22/2015 4:04,1442919840,C7,200460,1443120300,9/24/2015 11:45
388,20151931031941-864,1,9/16/2015 11:57,1442429820,C8,685140,1443114960,9/24/2015 10:16
4667,20155318045300-137,3,9/22/2015 11:49,1442947740,C4,163680,1443111420,9/24/2015 9:17
2529,20150630110633-414,1,9/18/2015 3:30,1442572200,C0,538080,1443110280,9/24/2015 8:58
2855,20150413080423-537,1,9/18/2015 20:17,1442632620,C4,475980,1443108600,9/24/2015 8:30
3328,20151820091811-842,3,9/23/2015 0:32,1442993520,C3,113820,1443107340,9/24/2015 8:09
1734,20152515062540-976,2,9/21/2015 7:27,1442845620,C5,261060,1443106680,9/24/2015 7:58
6464,20151006031044-506,1,9/22/2015 8:46,1442936760,C6,169920,1443106680,9/24/2015 7:58
4347,20153218103248-711,2,9/21/2015 9:03,1442851380,C4,253860,1443105240,9/24/2015 7:34
4978,20152616112648-695,2,9/23/2015 3:38,1443004680,C6,96120,1443100800,9/24/2015 6:20
98,20154027074029-955,1,9/21/2015 2:44,1442828640,C5,267780,1443096420,9/24/2015 5:07
1850,20155815105829-773,1,9/21/2015 6:14,1442841240,C2,250680,1443091920,9/24/2015 3:52
5165,20153014083025-418,3,9/22/2015 22:04,1442984640,C7,105720,1443090360,9/24/2015 3:26
3552,20152020042020-267,1,9/23/2015 5:17,1443010620,C4,73140,1443083760,9/24/2015 1:36
4213,20154209104204-174,2,9/22/2015 5:18,1442924280,C5,157680,1443081960,9/24/2015 1:06
5981,20154430084401-298,1,9/17/2015 20:59,1442548740,C4,533100,1443081840,9/24/2015 1:04
5166,20152220102228-66,3,9/22/2015 20:08,1442977680,C5,103980,1443081660,9/24/2015 1:01
4328,20155613065652-38,1,9/22/2015 16:34,1442964840,C2,116040,1443080880,9/24/2015 0:48
3584,20151622101630-477,1,9/15/2015 20:31,1442374260,C4,703500,1443077760,9/23/2015 23:56
6340,20154719064707-283,2,9/22/2015 10:09,1442941740,C7,135660,1443077400,9/23/2015 23:50
4351,20154212104231-5,3,9/15/2015 19:14,1442369640,C3,705840,1443075480,9/23/2015 23:18
5629,20151526081503-628,1,9/9/2015 1:30,1441787400,C2,1287900,1443075300,9/23/2015 23:15
5641,20152205052244-453,2,9/17/2015 21:08,1442549280,C8,525180,1443074460,9/23/2015 23:01
4511,20151713061726-223,1,9/22/2015 9:35,1442939700,C6,131580,1443071280,9/23/2015 22:08
2620,20154906114942-746,3,9/22/2015 4:10,1442920200,C7,150540,1443070740,9/23/2015 21:59
6521,20154415064447-909,1,9/19/2015 10:36,1442684160,C5,379740,1443063900,9/23/2015 20:05
4905,20150920070902-234,1,9/14/2015 11:21,1442254860,C6,808920,1443063780,9/23/2015 20:03
4277,20150024040008-576,3,9/20/2015 1:02,1442736120,C7,325560,1443061680,9/23/2015 19:28
2282,20151713071733-979,1,9/20/2015 7:21,1442758860,C0,302520,1443061380,9/23/2015 19:23
6453,20153925033936-464,2,9/20/2015 12:59,1442779140,C0,279600,1443058740,9/23/2015 18:39
5114,20155409055424-104,1,9/18/2015 1:30,1442565000,C4,485280,1443050280,9/23/2015 16:18
4097,20155506045534-554,1,9/11/2015 16:22,1442013720,C5,1036140,1443049860,9/23/2015 16:11
4042,20155023105006-119,2,9/15/2015 20:08,1442372880,C2,673560,1443046440,9/23/2015 15:14
1556,20152424032429-194,2,9/19/2015 21:03,1442721780,C4,323820,1443045600,9/23/2015 15:00
2717,20153611093610-113,2,9/19/2015 12:56,1442692560,C2,351600,1443044160,9/23/2015 14:36
2404,20155417095454-820,3,9/20/2015 11:07,1442772420,C0,263580,1443036000,9/23/2015 12:20
4772,20154512084511-218,2,9/18/2015 5:26,1442579160,C4,454980,1443034140,9/23/2015 11:49
2231,20153910033927-41,1,9/12/2015 12:42,1442086920,C5,946860,1443033780,9/23/2015 11:43
249,20153708023759-709,1,9/18/2015 12:25,1442604300,C8,428040,1443032340,9/23/2015 11:19
75,20150419080423-232,1,9/22/2015 1:56,1442912160,C2,118560,1443030720,9/23/2015 10:52
3581,20155712125720-473,1,9/15/2015 7:21,1442326860,C0,699480,1443026340,9/23/2015 9:39
3395,20154903014907-481,2,9/21/2015 3:33,1442831580,C4,189780,1443021360,9/23/2015 8:16
1057,20152120122138-42,1,9/19/2015 2:37,1442655420,C7,365280,1443020700,9/23/2015 8:05
3546,20153710103741-345,1,9/19/2015 0:45,1442648700,C2,371040,1443019740,9/23/2015 7:49
1624,20154309104322-867,2,9/20/2015 22:38,1442813880,C8,198660,1443012540,9/23/2015 5:49
393,20153829123844-783,3,9/16/2015 6:20,1442409600,C8,601560,1443011160,9/23/2015 5:26
1617,20150515110551-961,1,9/18/2015 8:50,1442591400,C5,418500,1443009900,9/23/2015 5:05
4618,20154419024438-705,1,9/22/2015 7:14,1442931240,C2,77400,1443008640,9/23/2015 4:44
401,20153001123033-350,1,9/13/2015 21:10,1442203800,C4,803100,1443006900,9/23/2015 4:15
2091,20154114014105-799,1,9/21/2015 0:32,1442820720,C5,185820,1443006540,9/23/2015 4:09
2074,20154309084354-984,1,9/19/2015 16:19,1442704740,C5,297120,1443001860,9/23/2015 2:51
3575,20152107032156-241,1,9/19/2015 5:48,1442666880,C2,334140,1443001020,9/23/2015 2:37
3327,20154231024256-741,2,9/5/2015 6:02,1441458120,C8,1539600,1442997720,9/23/2015 1:42
3319,20154808094807-64,2,9/15/2015 16:11,1442358660,C4,627780,1442986440,9/22/2015 22:34
4232,20152816112859-104,1,9/11/2015 23:36,1442039760,C3,945060,1442984820,9/22/2015 22:07
4929,20155707045739-291,1,9/20/2015 23:06,1442815560,C5,163620,1442979180,9/22/2015 20:33
2516,20151813061817-670,2,9/21/2015 5:48,1442839680,C8,137880,1442977560,9/22/2015 20:06
3185,20151926041922-655,1,9/13/2015 0:11,1442128260,C5,845940,1442974200,9/22/2015 19:10
2553,20151310101330-91,1,9/19/2015 15:43,1442702580,C4,265800,1442968380,9/22/2015 17:33
4881,20153927083928-87,1,9/16/2015 8:07,1442416020,C4,550560,1442966580,9/22/2015 17:03
4828,20155516015509-611,2,9/22/2015 0:35,1442907300,C4,58800,1442966100,9/22/2015 16:55
501,20151116071131-16,1,9/20/2015 13:03,1442779380,C2,183360,1442962740,9/22/2015 15:59
4285,20152416092443-318,2,9/20/2015 13:38,1442781480,C4,180420,1442961900,9/22/2015 15:45
6189,20154529064528-757,3,9/19/2015 14:20,1442697600,C7,263100,1442960700,9/22/2015 15:25
509,20155304065306-536,1,9/17/2015 3:41,1442486460,C5,473760,1442960220,9/22/2015 15:17
292,20151118061145-872,2,9/21/2015 12:32,1442863920,C3,94020,1442957940,9/22/2015 14:39
5020,20152618022623-126,1,9/21/2015 5:16,1442837760,C2,113100,1442950860,9/22/2015 12:41
3429,20152119022156-795,1,9/21/2015 18:48,1442886480,C5,62940,1442949420,9/22/2015 12:17
787,20155815115806-862,3,9/18/2015 5:50,1442580600,C0,364440,1442945040,9/22/2015 11:04
4869,20154625064609-206,1,9/18/2015 22:30,1442640600,C5,304320,1442944920,9/22/2015 11:02
2041,20150609060600-167,1,9/20/2015 23:10,1442815800,C3,126480,1442942280,9/22/2015 10:18
2288,20152914112948-207,1,9/14/2015 15:05,1442268300,C0,671220,1442939520,9/22/2015 9:32
1820,20153705113718-477,2,9/6/2015 10:13,1441559580,C8,1379880,1442939460,9/22/2015 9:31
4784,20153213073258-209,1,9/17/2015 20:21,1442546460,C3,391740,1442938200,9/22/2015 9:10
4279,20154220044203-784,1,9/21/2015 12:38,1442864280,C2,71760,1442936040,9/22/2015 8:34
96,20150713110726-288,1,9/19/2015 8:55,1442678100,C8,255240,1442933340,9/22/2015 7:49
2283,20152711122705-744,2,9/20/2015 23:01,1442815260,C8,116520,1442931780,9/22/2015 7:23
4733,20155722095743-296,1,9/17/2015 3:32,1442485920,C8,444660,1442930580,9/22/2015 7:03
2303,20155905015919-324,1,9/20/2015 4:55,1442750100,C5,180480,1442930580,9/22/2015 7:03
857,20151724021705-148,1,9/11/2015 1:24,1441959840,C8,968460,1442928300,9/22/2015 6:25
858,20151808121857-411,1,9/10/2015 12:10,1441912200,C5,1015140,1442927340,9/22/2015 6:09
5642,20155613105649-467,1,9/19/2015 7:40,1442673600,C4,253320,1442926920,9/22/2015 6:02
2085,20151309121323-469,2,9/17/2015 23:47,1442558820,C7,366420,1442925240,9/22/2015 5:34
3113,20150115010131-543,1,9/21/2015 8:54,1442850840,C2,71940,1442922780,9/22/2015 4:53
1236,20153914023919-152,1,9/21/2015 5:54,1442840040,C8,81900,1442921940,9/22/2015 4:39
4366,20154211074259-773,1,9/20/2015 14:30,1442784600,C6,133680,1442918280,9/22/2015 3:38
925,20154213094240-842,1,9/21/2015 1:06,1442822760,C5,94320,1442917080,9/22/2015 3:18
5686,20151730041740-897,2,9/18/2015 9:12,1442592720,C8,323220,1442915940,9/22/2015 2:59
4103,20151928121941-484,3,9/13/2015 21:55,1442206500,C5,708480,1442914980,9/22/2015 2:43
1598,20154615114635-60,1,9/17/2015 22:10,1442553000,C2,361080,1442914080,9/22/2015 2:28
5190,20151829061839-838,1,9/19/2015 2:48,1442656080,C8,257400,1442913480,9/22/2015 2:18
1339,20155316115321-402,3,9/20/2015 4:27,1442748420,C8,159420,1442907840,9/22/2015 0:44
3930,20150313110328-797,2,9/19/2015 3:57,1442660220,C8,246420,1442906640,9/22/2015 0:24
1011,20155615125621-835,1,9/21/2015 4:09,1442833740,C8,69540,1442903280,9/21/2015 23:28
1924,20155130025118-645,3,9/18/2015 5:56,1442580960,C8,321900,1442902860,9/21/2015 23:21
317,20152206042213-803,1,9/16/2015 20:56,1442462160,C8,440220,1442902380,9/21/2015 23:13
415,20155126025133-294,1,9/19/2015 0:27,1442647620,C4,252720,1442900340,9/21/2015 22:39
2478,20155012055005-718,2,9/18/2015 20:32,1442633520,C8,264060,1442897580,9/21/2015 21:53
1008,20150020040021-389,2,9/21/2015 6:43,1442842980,C3,52980,1442895960,9/21/2015 21:26
4627,20150412010421-959,1,9/20/2015 17:11,1442794260,C4,100860,1442895120,9/21/2015 21:12
4058,20155612065603-160,2,9/19/2015 11:29,1442687340,C3,207060,1442894400,9/21/2015 21:00
6463,20151716101753-304,1,9/20/2015 1:11,1442736660,C8,156420,1442893080,9/21/2015 20:38
1531,20153106033136-478,1,9/20/2015 3:47,1442746020,C0,145920,1442891940,9/21/2015 20:19
1114,20153317113300-397,1,9/19/2015 15:50,1442703000,C4,188220,1442891220,9/21/2015 20:07
6004,20153911083955-135,1,9/20/2015 12:27,1442777220,C8,113040,1442890260,9/21/2015 19:51
3356,20154509104501-59,2,9/16/2015 23:57,1442473020,C0,416340,1442889360,9/21/2015 19:36
1317,20154411024426-868,2,9/20/2015 12:56,1442778960,C2,110160,1442889120,9/21/2015 19:32
5969,20153802033804-576,1,9/18/2015 14:38,1442612280,C8,275760,1442888040,9/21/2015 19:14
4417,20152304062326-36,1,9/16/2015 8:55,1442418900,C3,465540,1442884440,9/21/2015 18:14
138,20152131052130-113,1,9/15/2015 5:56,1442321760,C5,561900,1442883660,9/21/2015 18:01
4001,20150719050720-439,1,9/21/2015 1:27,1442824020,C5,58200,1442882220,9/21/2015 17:37
951,20151729051759-488,1,9/17/2015 20:47,1442548020,C8,330840,1442878860,9/21/2015 16:41
5722,20155012015018-20,2,9/20/2015 20:00,1442804400,C8,71340,1442875740,9/21/2015 15:49
2358,20151814071826-934,1,9/20/2015 17:18,1442794680,C5,79200,1442873880,9/21/2015 15:18
5868,20154212114258-729,1,9/20/2015 11:37,1442774220,C7,98700,1442872920,9/21/2015 15:02
1387,20152931072940-294,1,9/18/2015 0:14,1442560440,C8,305820,1442866260,9/21/2015 13:11
34,20151211081210-391,2,9/18/2015 3:20,1442571600,C0,293640,1442865240,9/21/2015 12:54
4241,20152028072051-354,2,9/13/2015 10:56,1442166960,C8,697680,1442864640,9/21/2015 12:44
3054,20154612084611-217,3,9/20/2015 5:04,1442750640,C6,112980,1442863620,9/21/2015 12:27
5606,20151212011243-975,1,9/20/2015 8:20,1442762400,C4,96240,1442858640,9/21/2015 11:04
6195,20155314095341-355,2,9/17/2015 22:08,1442552880,C4,303300,1442856180,9/21/2015 10:23
1195,20154120094127-321,3,9/14/2015 10:13,1442250780,C5,605040,1442855820,9/21/2015 10:17
2089,20152607062650-779,1,9/17/2015 21:17,1442549820,C3,305820,1442855640,9/21/2015 10:14
447,20155012065039-980,2,9/18/2015 8:52,1442591520,C8,262860,1442854380,9/21/2015 9:53
4955,20150830030855-79,2,9/7/2015 14:13,1441660380,C8,1191660,1442852040,9/21/2015 9:14
1007,20150506060512-399,1,9/16/2015 7:53,1442415180,C8,435240,1442850420,9/21/2015 8:47
5914,20155309035345-751,2,9/19/2015 16:05,1442703900,C6,144120,1442848020,9/21/2015 8:07
5205,20150010070052-300,2,9/20/2015 2:36,1442741760,C2,106020,1442847780,9/21/2015 8:03
4274,20152917082955-286,3,9/19/2015 8:12,1442675520,C0,171780,1442847300,9/21/2015 7:55
1260,20155019025025-685,1,9/20/2015 11:18,1442773080,C4,73680,1442846760,9/21/2015 7:46
2941,20153115023128-580,1,9/20/2015 14:27,1442784420,C8,61680,1442846100,9/21/2015 7:35
2064,20153221123200-816,1,9/17/2015 10:17,1442510220,C4,332100,1442842320,9/21/2015 6:32
6008,20153016063017-510,3,9/16/2015 18:30,1442453400,C5,388800,1442842200,9/21/2015 6:30
823,20155317085330-284,2,9/19/2015 23:11,1442729460,C8,112140,1442841600,9/21/2015 6:20
4183,20155303125323-651,1,9/19/2015 0:28,1442647680,C3,191100,1442838780,9/21/2015 5:33
3029,20152310122351-816,3,9/20/2015 0:31,1442734260,C5,102660,1442836920,9/21/2015 5:02
808,20151013101006-462,1,9/20/2015 8:10,1442761800,C0,74700,1442836500,9/21/2015 4:55
3269,20150608090629-720,2,9/11/2015 19:54,1442026440,C8,807840,1442834280,9/21/2015 4:18
3611,20151228021221-216,1,9/18/2015 13:24,1442607840,C0,226440,1442834280,9/21/2015 4:18
3251,20151812081845-784,2,9/18/2015 23:03,1442642580,C5,190500,1442833080,9/21/2015 3:58
4707,20150322020344-232,2,9/17/2015 20:03,1442545380,C3,283500,1442828880,9/21/2015 2:48
907,20153931113929-38,1,9/15/2015 22:51,1442382660,C0,445440,1442828100,9/21/2015 2:35
1796,20155328055322-628,1,9/18/2015 11:37,1442601420,C5,223980,1442825400,9/21/2015 1:50
3232,20152128092124-904,3,9/17/2015 15:21,1442528460,C1,291600,1442820060,9/21/2015 0:21
5709,20154217024216-818,1,9/19/2015 7:29,1442672940,C3,146820,1442819760,9/21/2015 0:16
4966,20150008080048-814,2,9/19/2015 14:24,1442697840,C5,121680,1442819520,9/21/2015 0:12
6293,20152505102537-378,3,9/15/2015 19:33,1442370780,C0,448440,1442819220,9/21/2015 0:07
1137,20151101081129-848,1,9/11/2015 22:03,1442034180,C0,783840,1442818020,9/20/2015 23:47
5400,20152429012447-906,1,9/18/2015 3:55,1442573700,C5,241980,1442815680,9/20/2015 23:08
3525,20152310012347-406,2,9/19/2015 18:03,1442710980,C4,99300,1442810280,9/20/2015 21:38
1739,20154510014516-824,1,9/19/2015 17:05,1442707500,C5,98700,1442806200,9/20/2015 20:30
2019,20152308032332-748,2,9/17/2015 17:53,1442537580,C5,262200,1442799780,9/20/2015 18:43
3703,20151914041904-182,1,9/18/2015 17:49,1442623740,C2,175500,1442799240,9/20/2015 18:34
5252,20154310044355-435,1,9/15/2015 14:53,1442353980,C8,443400,1442797380,9/20/2015 18:03
6380,20152111122136-527,3,9/18/2015 9:54,1442595240,C5,198660,1442793900,9/20/2015 17:05
1517,20155313085338-538,3,9/18/2015 6:07,1442581620,C5,211020,1442792640,9/20/2015 16:44
555,20155518055520-844,3,9/20/2015 0:57,1442735820,C2,55860,1442791680,9/20/2015 16:28
5945,20150813060851-608,2,9/19/2015 14:08,1442696880,C6,91200,1442788080,9/20/2015 15:28
6437,20153612033615-297,1,9/19/2015 18:08,1442711280,C0,76740,1442788020,9/20/2015 15:27
6268,20153008093014-166,2,9/16/2015 13:24,1442435040,C5,352620,1442787660,9/20/2015 15:21
3728,20154809034821-765,1,9/16/2015 22:44,1442468640,C5,314880,1442783520,9/20/2015 14:12
4900,20155614125629-357,2,9/17/2015 12:55,1442519700,C2,259140,1442778840,9/20/2015 12:54
5518,20153425093430-367,2,9/17/2015 6:01,1442494860,C0,282060,1442776920,9/20/2015 12:22
5782,20152416102430-660,2,9/16/2015 3:02,1442397720,C8,378840,1442776560,9/20/2015 12:16
5885,20155823085830-345,1,9/16/2015 23:18,1442470680,C0,303600,1442774280,9/20/2015 11:38
1740,20155310035300-431,1,9/10/2015 4:41,1441885260,C6,886080,1442771340,9/20/2015 10:49
105,20154504024526-617,3,9/15/2015 3:39,1442313540,C8,455220,1442768760,9/20/2015 10:06
1468,20153312023328-539,2,9/19/2015 10:35,1442684100,C7,84360,1442768460,9/20/2015 10:01
2595,20150406120417-939,1,9/18/2015 15:58,1442617080,C4,150120,1442767200,9/20/2015 9:40
3801,20154026094053-772,2,9/17/2015 21:13,1442549580,C7,215820,1442765400,9/20/2015 9:10
1976,20150414070459-536,3,9/18/2015 20:19,1442632740,C5,131100,1442763840,9/20/2015 8:44
4938,20150631110616-558,3,9/18/2015 3:22,1442571720,C6,190920,1442762640,9/20/2015 8:24
5287,20151727081727-53,2,9/17/2015 7:35,1442500500,C7,258840,1442759340,9/20/2015 7:29
2970,20151027121055-218,2,9/17/2015 7:44,1442501040,C3,256920,1442757960,9/20/2015 7:06
1360,20152913042937-614,1,9/19/2015 10:16,1442682960,C5,70860,1442753820,9/20/2015 5:57
6021,20151614071616-110,3,9/18/2015 6:10,1442581800,C7,170820,1442752620,9/20/2015 5:37
4060,20154415114438-543,2,9/17/2015 20:02,1442545320,C4,202680,1442748000,9/20/2015 4:20
4576,20153311123312-935,2,9/15/2015 20:23,1442373780,C4,373800,1442747580,9/20/2015 4:13
3424,20151127101117-321,2,9/14/2015 5:14,1442232840,C4,512460,1442745300,9/20/2015 3:35
5950,20150901040932-288,1,9/13/2015 23:04,1442210640,C8,534300,1442744940,9/20/2015 3:29
2223,20155107125121-144,2,9/13/2015 20:04,1442199840,C3,544380,1442744220,9/20/2015 3:17
4301,20151729091748-733,1,9/12/2015 12:05,1442084700,C6,649680,1442734380,9/20/2015 0:33
4545,20155216015253-395,2,9/18/2015 20:08,1442632080,C4,97680,1442729760,9/19/2015 23:16
1188,20152913112927-997,3,9/17/2015 19:11,1442542260,C8,186660,1442728920,9/19/2015 23:02
6501,20154505034517-211,1,9/15/2015 3:39,1442313540,C8,410220,1442723760,9/19/2015 21:36
1731,20151124081137-232,2,9/16/2015 22:11,1442466660,C2,254700,1442721360,9/19/2015 20:56
218,20152523062510-74,2,9/16/2015 18:49,1442454540,C5,264780,1442719320,9/19/2015 20:22
2869,20153812113834-265,3,9/17/2015 9:24,1442507040,C5,211980,1442719020,9/19/2015 20:17
3746,20150912100912-409,3,9/17/2015 8:47,1442504820,C8,213540,1442718360,9/19/2015 20:06
5648,20154003054009-197,1,9/11/2015 2:28,1441963680,C5,749160,1442712840,9/19/2015 18:34
508,20154410124427-370,3,9/18/2015 14:45,1442612700,C4,99780,1442712480,9/19/2015 18:28
6003,20154909044956-518,3,9/14/2015 17:21,1442276460,C4,433920,1442710380,9/19/2015 17:53
5935,20154425114422-810,2,9/16/2015 22:16,1442466960,C3,242340,1442709300,9/19/2015 17:35
1773,20153116073142-631,2,9/18/2015 12:53,1442605980,C4,96060,1442702040,9/19/2015 15:34
3555,20151809121805-29,1,9/14/2015 11:59,1442257140,C8,444180,1442701320,9/19/2015 15:22
3336,20151502021555-920,2,9/11/2015 14:45,1442007900,C8,691560,1442699460,9/19/2015 14:51
883,20153423043438-15,3,9/16/2015 14:26,1442438760,C2,258240,1442697000,9/19/2015 14:10
4476,20152117012105-319,3,9/18/2015 13:43,1442608980,C4,87720,1442696700,9/19/2015 14:05
1666,20155118075124-295,1,9/14/2015 4:41,1442230860,C8,464280,1442695140,9/19/2015 13:39
2365,20153103053109-344,3,9/11/2015 15:08,1442009280,C0,682620,1442691900,9/19/2015 12:45
2287,20151004081041-724,1,9/14/2015 11:04,1442253840,C5,437220,1442691060,9/19/2015 12:31
1986,20151812081835-734,2,9/15/2015 22:05,1442379900,C2,308820,1442688720,9/19/2015 11:52
127,20150426120423-659,1,9/11/2015 9:22,1441988520,C5,686340,1442674860,9/19/2015 8:01
115,20155213045249-101,1,9/18/2015 8:57,1442591820,C8,80700,1442672520,9/19/2015 7:22
4690,20154612124610-968,2,9/15/2015 21:44,1442378640,C3,291480,1442670120,9/19/2015 6:42
809,20154027024014-523,1,9/16/2015 9:51,1442422260,C4,244380,1442666640,9/19/2015 5:44
3620,20151705081753-773,3,9/17/2015 19:23,1442542980,C7,119640,1442662620,9/19/2015 4:37
5744,20152513092548-480,1,9/15/2015 1:49,1442306940,C4,352980,1442659920,9/19/2015 3:52
2462,20155011115006-613,1,9/15/2015 7:28,1442327280,C2,329880,1442657160,9/19/2015 3:06
5703,20153329043300-437,2,9/13/2015 23:06,1442210760,C4,439860,1442650620,9/19/2015 1:17
6316,20152113092153-515,2,9/17/2015 3:51,1442487060,C3,162900,1442649960,9/19/2015 1:06
3366,20153709093741-767,1,9/17/2015 23:21,1442557260,C2,92580,1442649840,9/19/2015 1:04
2265,20155822075801-949,1,9/11/2015 16:47,1442015220,C7,634020,1442649240,9/19/2015 0:54
3024,20154803014805-523,1,9/11/2015 5:33,1441974780,C8,667980,1442642760,9/18/2015 23:06
2848,20154912104945-323,3,9/15/2015 16:55,1442361300,C6,281160,1442642460,9/18/2015 23:01
1038,20155615055609-330,1,9/17/2015 20:06,1442545560,C7,90300,1442635860,9/18/2015 21:11
5528,20152815072807-909,1,9/17/2015 16:24,1442532240,C7,102480,1442634720,9/18/2015 20:52
4424,20151324041323-86,1,9/15/2015 16:57,1442361420,C0,271920,1442633340,9/18/2015 20:29
2943,20155507025528-30,2,9/15/2015 2:35,1442309700,C8,323400,1442633100,9/18/2015 20:25
2051,20151114071159-705,3,9/17/2015 7:55,1442501700,C5,130920,1442632620,9/18/2015 20:17
2836,20153711033732-656,2,9/18/2015 0:49,1442562540,C5,68940,1442631480,9/18/2015 19:58
5398,20152520022515-874,2,9/15/2015 4:05,1442315100,C5,315600,1442630700,9/18/2015 19:45
493,20155024045011-587,3,9/4/2015 18:14,1441415640,C0,1211280,1442626920,9/18/2015 18:42
4330,20151931021927-541,3,9/15/2015 16:54,1442361240,C8,261060,1442622300,9/18/2015 17:25
980,20154315114328-382,1,9/14/2015 10:16,1442250960,C2,369540,1442620500,9/18/2015 16:55
5624,20154811054808-989,1,9/17/2015 21:32,1442550720,C0,66480,1442617200,9/18/2015 16:00
1156,20151318021301-158,2,9/10/2015 21:13,1441944780,C2,670800,1442615580,9/18/2015 15:33
274,20153615013648-281,3,9/17/2015 14:44,1442526240,C2,88440,1442614680,9/18/2015 15:18
135,20152610052623-296,1,9/9/2015 20:45,1441856700,C7,754620,1442611320,9/18/2015 14:22
5567,20155917095958-769,2,9/9/2015 13:23,1441830180,C6,779640,1442609820,9/18/2015 13:57
1842,20155703035752-285,1,9/13/2015 14:21,1442179260,C7,429120,1442608380,9/18/2015 13:33
4612,20154519024544-322,2,9/16/2015 5:28,1442406480,C4,200940,1442607420,9/18/2015 13:17
4781,20152211072240-895,1,9/16/2015 2:52,1442397120,C5,207900,1442605020,9/18/2015 12:37
4762,20153804013829-884,2,9/16/2015 18:42,1442454120,C0,150720,1442604840,9/18/2015 12:34
1270,20151217121243-265,1,9/10/2015 15:12,1441923120,C3,680400,1442603520,9/18/2015 12:12
3935,20152712102746-890,1,9/15/2015 11:19,1442341140,C6,262320,1442603460,9/18/2015 12:11
6460,20152405092403-279,1,9/15/2015 4:48,1442317680,C0,282480,1442600160,9/18/2015 11:16
5812,20155204055205-222,3,9/13/2015 11:52,1442170320,C6,429300,1442599620,9/18/2015 11:07
342,20154015034053-424,3,9/17/2015 12:30,1442518200,C8,80700,1442598900,9/18/2015 10:55
40,20155720055708-822,1,9/13/2015 15:27,1442183220,C8,412920,1442596140,9/18/2015 10:09
3248,20153331043359-711,1,9/16/2015 10:25,1442424300,C2,170040,1442594340,9/18/2015 9:39
414,20150321080317-281,1,9/15/2015 6:43,1442324580,C4,269400,1442593980,9/18/2015 9:33
2550,20152512042530-460,1,9/17/2015 15:53,1442530380,C7,61440,1442591820,9/18/2015 8:57
545,20150809030847-891,1,9/17/2015 6:18,1442495880,C2,94200,1442590080,9/18/2015 8:28
4467,20155208045228-597,3,9/15/2015 2:54,1442310840,C7,277260,1442588100,9/18/2015 7:55
4819,20150612040643-903,1,9/15/2015 11:51,1442343060,C0,243900,1442586960,9/18/2015 7:36
2646,20150916010937-480,1,9/16/2015 5:39,1442407140,C4,176760,1442583900,9/18/2015 6:45
5120,20155302025312-112,1,9/16/2015 7:25,1442413500,C3,168960,1442582460,9/18/2015 6:21
6033,20151106071138-520,2,9/14/2015 5:47,1442234820,C0,343080,1442577900,9/18/2015 5:05
6145,20151225041253-640,2,9/10/2015 8:18,1441898280,C5,676980,1442575260,9/18/2015 4:21
5473,20155326035314-70,1,9/15/2015 7:55,1442328900,C3,242760,1442571660,9/18/2015 3:21
4577,20151729071748-127,1,9/9/2015 15:47,1441838820,C8,731880,1442570700,9/18/2015 3:05
3437,20150607030612-158,1,9/15/2015 11:03,1442340180,C2,225540,1442565720,9/18/2015 1:42
1481,20152730052714-154,2,9/16/2015 0:47,1442389620,C4,176100,1442565720,9/18/2015 1:42
5203,20152904062902-66,1,9/13/2015 11:03,1442167380,C8,397020,1442564400,9/18/2015 1:20
3910,20151913061938-878,1,9/16/2015 19:28,1442456880,C0,102180,1442559060,9/17/2015 23:51
1378,20152531102541-22,1,9/12/2015 2:31,1442050260,C4,504180,1442554440,9/17/2015 22:34
2704,20153310073327-373,2,9/1/2015 7:43,1441118580,C8,1434360,1442552940,9/17/2015 22:09
237,20153209093250-358,3,9/4/2015 17:56,1441414560,C8,1138320,1442552880,9/17/2015 22:08
6391,20155911015958-174,2,9/15/2015 18:49,1442368140,C5,181500,1442549640,9/17/2015 21:14
3496,20150124040121-291,1,9/15/2015 4:33,1442316780,C5,232440,1442549220,9/17/2015 21:07
2306,20150312030323-538,1,9/16/2015 2:09,1442394540,C4,149580,1442544120,9/17/2015 19:42
1267,20151030111021-959,1,9/11/2015 16:40,1442014800,C8,528300,1442543100,9/17/2015 19:25
5718,20150412090424-439,1,9/9/2015 8:21,1441812060,C2,727860,1442539920,9/17/2015 18:32
3780,20153002053041-801,1,9/16/2015 1:22,1442391720,C3,143940,1442535660,9/17/2015 17:21
2819,20154920044949-964,2,9/3/2015 16:53,1441324380,C4,1209840,1442534220,9/17/2015 16:57
1064,20154412104452-262,1,9/16/2015 19:19,1442456340,C8,75300,1442531640,9/17/2015 16:14
5214,20155812045842-786,1,9/16/2015 0:20,1442388000,C8,142860,1442530860,9/17/2015 16:01
2350,20154823104821-280,3,9/14/2015 20:24,1442287440,C2,241920,1442529360,9/17/2015 15:36
4281,20152419032457-473,2,9/10/2015 9:09,1441901340,C5,626100,1442527440,9/17/2015 15:04
5951,20151411121401-100,1,9/15/2015 14:00,1442350800,C5,175980,1442526780,9/17/2015 14:53
2767,20155018105000-729,2,9/14/2015 5:38,1442234280,C4,289260,1442523540,9/17/2015 13:59
2026,20152409032441-824,2,9/5/2015 20:44,1441511040,C8,1006080,1442517120,9/17/2015 12:12
6299,20152608042656-439,1,9/16/2015 8:18,1442416680,C2,94560,1442511240,9/17/2015 10:34
2832,20154701054735-930,2,9/14/2015 19:02,1442282520,C8,225540,1442508060,9/17/2015 9:41
3149,20155424115433-691,1,9/9/2015 10:16,1441818960,C5,688260,1442507220,9/17/2015 9:27
6011,20150904100901-193,1,9/13/2015 1:29,1442132940,C7,373200,1442506140,9/17/2015 9:09
1936,20150524040536-313,1,9/10/2015 12:33,1441913580,C2,590640,1442504220,9/17/2015 8:37
4969,20150514100544-988,2,9/13/2015 1:38,1442133480,C2,365940,1442499420,9/17/2015 7:17
4505,20150812050828-793,3,9/16/2015 17:16,1442448960,C7,49440,1442498400,9/17/2015 7:00
4991,20151810051808-730,1,9/16/2015 12:14,1442430840,C5,62520,1442493360,9/17/2015 5:36
3879,20151912061915-319,1,9/15/2015 23:46,1442385960,C5,107340,1442493300,9/17/2015 5:35
4531,20154526064518-551,2,9/6/2015 20:14,1441595640,C4,895620,1442491260,9/17/2015 5:01
5747,20150420070433-947,1,9/10/2015 5:31,1441888260,C4,602940,1442491200,9/17/2015 5:00
4669,20150313090335-839,2,9/15/2015 21:47,1442378820,C8,109320,1442488140,9/17/2015 4:09
441,20150113020105-915,1,9/16/2015 5:13,1442405580,C4,75840,1442481420,9/17/2015 2:17
1333,20153917113956-553,3,9/6/2015 20:57,1441598220,C2,880740,1442478960,9/17/2015 1:36
6022,20155107025120-910,2,9/12/2015 7:01,1442066460,C0,403800,1442470260,9/16/2015 23:11
3017,20155307075336-227,2,9/15/2015 17:29,1442363340,C2,103680,1442467020,9/16/2015 22:17
2720,20152114022149-636,1,9/16/2015 3:33,1442399580,C2,66960,1442466540,9/16/2015 22:09
4167,20154104114100-134,2,9/8/2015 15:17,1441750620,C5,714420,1442465040,9/16/2015 21:44
3619,20152414102459-200,1,9/16/2015 1:40,1442392800,C5,70680,1442463480,9/16/2015 21:18
1501,20154102114141-894,3,9/15/2015 1:44,1442306640,C8,155340,1442461980,9/16/2015 20:53
214,20150413020432-24,3,9/15/2015 18:28,1442366880,C7,94320,1442461200,9/16/2015 20:40
2884,20151224041242-581,2,9/14/2015 6:28,1442237280,C2,222420,1442459700,9/16/2015 20:15
3925,20153515113516-627,3,9/11/2015 10:20,1441992000,C8,465660,1442457660,9/16/2015 19:41
3000,20150929030929-812,1,9/14/2015 13:07,1442261220,C2,196440,1442457660,9/16/2015 19:41
852,20150430020414-999,2,9/12/2015 11:55,1442084100,C4,371820,1442455920,9/16/2015 19:12
889,20155217105212-400,1,9/1/2015 10:13,1441127580,C5,1324020,1442451600,9/16/2015 18:00
1030,20151217101212-140,1,9/9/2015 21:00,1441857600,C5,588060,1442445660,9/16/2015 16:21
3030,20151627111655-590,1,9/10/2015 6:35,1441892100,C7,553020,1442445120,9/16/2015 16:12
5512,20151306121325-748,2,9/7/2015 15:01,1441663260,C7,779040,1442442300,9/16/2015 15:25
3681,20150619070601-944,3,9/10/2015 1:06,1441872360,C6,569700,1442442060,9/16/2015 15:21
4692,20154409084413-801,3,9/14/2015 5:02,1442232120,C8,209340,1442441460,9/16/2015 15:11
1149,20155122055108-85,1,9/13/2015 20:23,1442200980,C2,238740,1442439720,9/16/2015 14:42
3239,20150408090432-622,1,9/14/2015 12:58,1442260680,C5,177480,1442438160,9/16/2015 14:16
3701,20152212012249-243,1,9/15/2015 5:52,1442321520,C3,116100,1442437620,9/16/2015 14:07
5660,20155812115802-110,2,9/15/2015 5:02,1442318520,C5,117120,1442435640,9/16/2015 13:34
29,20152608012606-941,1,9/14/2015 13:23,1442262180,C5,172740,1442434920,9/16/2015 13:22
1961,20153430123444-403,1,9/14/2015 15:54,1442271240,C2,163500,1442434740,9/16/2015 13:19
3506,20155609015650-953,2,9/14/2015 19:02,1442282520,C0,150120,1442432640,9/16/2015 12:44
3946,20153412033456-768,1,9/15/2015 13:01,1442347260,C3,83340,1442430600,9/16/2015 12:10
3117,20153004123036-930,1,9/10/2015 12:14,1441912440,C4,517440,1442429880,9/16/2015 11:58
4391,20153612103624-436,2,9/15/2015 3:30,1442313000,C4,116820,1442429820,9/16/2015 11:57
5547,20154830054857-116,3,9/12/2015 6:57,1442066220,C4,361380,1442427600,9/16/2015 11:20
4852,20152322032341-450,1,9/10/2015 4:43,1441885380,C5,535200,1442420580,9/16/2015 9:23
4959,20151029121032-170,1,9/10/2015 10:14,1441905240,C5,514920,1442420160,9/16/2015 9:16
6252,20153605023617-415,1,9/15/2015 4:04,1442315040,C5,103260,1442418300,9/16/2015 8:45
5586,20153828023832-687,3,9/10/2015 2:42,1441878120,C8,540120,1442418240,9/16/2015 8:44
1162,20153113123129-802,1,9/15/2015 9:43,1442335380,C5,81360,1442416740,9/16/2015 8:19
954,20153701043709-900,1,9/11/2015 5:17,1441973820,C2,437700,1442411520,9/16/2015 6:52
3928,20151611081603-412,2,9/15/2015 1:13,1442304780,C5,106740,1442411520,9/16/2015 6:52
653,20155407095443-656,2,9/13/2015 7:52,1442155920,C3,255540,1442411460,9/16/2015 6:51
101,20150613120634-302,1,9/15/2015 8:26,1442330760,C7,79800,1442410560,9/16/2015 6:36
6497,20152330122319-139,3,9/13/2015 20:53,1442202780,C6,206700,1442409480,9/16/2015 6:18
622,20155228105231-492,1,9/13/2015 21:47,1442206020,C2,203100,1442409120,9/16/2015 6:12
3325,20151406051448-965,1,9/13/2015 1:52,1442134320,C7,274740,1442409060,9/16/2015 6:11
4311,20153411103429-694,1,9/11/2015 18:22,1442020920,C8,386640,1442407560,9/16/2015 5:46
6024,20152613102657-412,2,9/15/2015 6:52,1442325120,C8,79980,1442405100,9/16/2015 5:05
3360,20150105120114-572,3,9/14/2015 20:50,1442289000,C8,115620,1442404620,9/16/2015 4:57
168,20151109051100-693,3,9/14/2015 13:29,1442262540,C4,139560,1442402100,9/16/2015 4:15
4527,20150028050007-273,2,9/11/2015 5:00,1441972800,C2,429120,1442401920,9/16/2015 4:12
3824,20153929033958-663,1,9/10/2015 7:43,1441896180,C8,504120,1442400300,9/16/2015 3:45
5295,20153209113252-119,1,9/11/2015 22:52,1442037120,C4,361500,1442398620,9/16/2015 3:17
706,20153423063429-324,3,9/13/2015 3:39,1442140740,C2,257700,1442398440,9/16/2015 3:14
4030,20152527102521-92,2,9/6/2015 6:46,1441547160,C0,850860,1442398020,9/16/2015 3:07
6223,20153813093821-524,2,9/15/2015 4:48,1442317680,C3,77700,1442395380,9/16/2015 2:23
5232,20154221124220-61,1,9/13/2015 5:46,1442148360,C3,245280,1442393640,9/16/2015 1:54
3081,20154010044016-420,1,9/14/2015 6:48,1442238480,C8,155040,1442393520,9/16/2015 1:52
3487,20155323025342-437,3,9/13/2015 10:37,1442165820,C5,224880,1442390700,9/16/2015 1:05
518,20153607093625-365,1,9/13/2015 2:26,1442136360,C5,246300,1442382660,9/15/2015 22:51
2329,20153823083813-827,1,9/12/2015 23:18,1442125080,C3,254400,1442379480,9/15/2015 21:58
3696,20153816093827-264,1,9/10/2015 19:53,1441939980,C8,439380,1442379360,9/15/2015 21:56
2220,20151201031214-85,1,9/10/2015 20:24,1441941840,C4,434340,1442376180,9/15/2015 21:03
5038,20153110103147-254,3,9/10/2015 15:01,1441922460,C6,449100,1442371560,9/15/2015 19:46
2275,20150808010856-926,1,9/13/2015 23:47,1442213220,C3,156780,1442370000,9/15/2015 19:20
650,20150930080915-526,1,9/11/2015 16:21,1442013660,C4,355440,1442369100,9/15/2015 19:05
4026,20153124123117-215,2,9/12/2015 23:39,1442126340,C0,240240,1442366580,9/15/2015 18:23
5930,20152007032057-494,3,9/14/2015 20:32,1442287920,C5,77940,1442365860,9/15/2015 18:11
3900,20150328060314-923,1,9/8/2015 16:15,1441754100,C6,610920,1442365020,9/15/2015 17:57
3505,20151824121846-361,2,9/12/2015 22:58,1442123880,C2,240000,1442363880,9/15/2015 17:38
4214,20151113031115-28,1,9/7/2015 16:42,1441669320,C3,691980,1442361300,9/15/2015 16:55
4480,20150913060942-503,1,9/14/2015 11:27,1442255220,C6,105480,1442360700,9/15/2015 16:45
6548,20154522074508-296,3,9/9/2015 14:00,1441832400,C5,525900,1442358300,9/15/2015 16:05
4364,20150821110852-676,1,9/12/2015 12:27,1442086020,C0,272220,1442358240,9/15/2015 16:04
2152,20152211122236-998,2,9/14/2015 14:37,1442266620,C4,89100,1442355720,9/15/2015 15:22
1220,20152411022428-441,1,9/14/2015 4:42,1442230920,C4,112140,1442343060,9/15/2015 11:51
6524,20151311031311-115,1,9/14/2015 12:01,1442257260,C5,82560,1442339820,9/15/2015 10:57
1585,20151915021949-470,1,9/11/2015 14:17,1442006220,C4,333240,1442339460,9/15/2015 10:51
5653,20154926104933-124,1,9/12/2015 2:39,1442050740,C8,287880,1442338620,9/15/2015 10:37
4923,20155931025933-274,1,9/13/2015 14:08,1442178480,C7,160020,1442338500,9/15/2015 10:35
3618,20151017101005-541,1,9/12/2015 5:06,1442059560,C5,278520,1442338080,9/15/2015 10:28
5834,20152231032211-936,3,9/10/2015 12:04,1441911840,C4,426060,1442337900,9/15/2015 10:25
2355,20154704084736-736,3,9/14/2015 7:26,1442240760,C7,95460,1442336220,9/15/2015 9:57
5015,20152126112132-235,1,9/5/2015 10:34,1441474440,C6,861180,1442335620,9/15/2015 9:47
3797,20153809063840-685,3,9/13/2015 8:14,1442157240,C7,175680,1442332920,9/15/2015 9:02
6365,20152812042819-422,2,9/14/2015 11:20,1442254800,C5,77160,1442331960,9/15/2015 8:46
5675,20155305015326-67,1,9/12/2015 2:23,1442049780,C7,281700,1442331480,9/15/2015 8:38
3231,20152908042900-407,1,9/13/2015 2:51,1442137860,C8,191460,1442329320,9/15/2015 8:02
2826,20155211075227-27,1,9/13/2015 23:36,1442212560,C0,114720,1442327280,9/15/2015 7:28
4631,20150408020442-543,1,9/13/2015 1:32,1442133120,C3,193440,1442326560,9/15/2015 7:16
3134,20151304011353-532,1,9/9/2015 22:01,1441861260,C4,463680,1442324940,9/15/2015 6:49
3602,20152420122408-685,3,9/12/2015 1:30,1442046600,C5,278280,1442324880,9/15/2015 6:48
144,20154305054350-339,1,9/12/2015 2:15,1442049300,C5,274560,1442323860,9/15/2015 6:31
382,20151507031539-411,3,9/11/2015 9:15,1441988100,C7,333600,1442321700,9/15/2015 5:55
490,20154715114704-310,1,9/11/2015 9:25,1441988700,C2,332040,1442320740,9/15/2015 5:39
5878,20150730090701-127,3,9/9/2015 22:03,1441861380,C5,455280,1442316660,9/15/2015 4:31
4299,20150906120952-835,1,9/10/2015 4:55,1441886100,C5,428280,1442314380,9/15/2015 3:53
3826,20152614032611-671,1,9/7/2015 6:26,1441632360,C4,680400,1442312760,9/15/2015 3:26
5278,20152030082047-827,2,9/13/2015 3:47,1442141220,C4,170460,1442311680,9/15/2015 3:08
3695,20154030024055-701,3,9/13/2015 9:44,1442162640,C6,148980,1442311620,9/15/2015 3:07
4563,20154208074227-295,2,9/12/2015 18:56,1442109360,C8,193020,1442302380,9/15/2015 0:33
5218,20155206105202-711,1,9/12/2015 20:49,1442116140,C0,184740,1442300880,9/15/2015 0:08
1052,20153604073635-88,2,9/13/2015 19:36,1442198160,C4,102600,1442300760,9/15/2015 0:06
5929,20153325123355-404,1,9/7/2015 15:15,1441664100,C6,635220,1442299320,9/14/2015 23:42
4339,20154011014020-687,2,9/7/2015 16:52,1441669920,C5,627840,1442297760,9/14/2015 23:16
859,20151528041551-821,1,9/8/2015 22:19,1441775940,C7,521520,1442297460,9/14/2015 23:11
5411,20153711073708-752,1,9/11/2015 11:40,1441996800,C7,299220,1442296020,9/14/2015 22:47
5366,20150306050305-235,2,9/12/2015 20:33,1442115180,C2,177000,1442292180,9/14/2015 21:43
3170,20155807055827-460,2,9/10/2015 3:00,1441879200,C3,411960,1442291160,9/14/2015 21:26
5417,20151725071716-115,1,9/12/2015 13:57,1442091420,C6,197400,1442288820,9/14/2015 20:47
3545,20153129093103-446,1,9/9/2015 8:51,1441813860,C3,474000,1442287860,9/14/2015 20:31
2246,20154612024622-150,1,9/6/2015 18:58,1441591080,C0,693360,1442284440,9/14/2015 19:34
604,20152806082844-502,1,9/13/2015 8:18,1442157480,C8,120840,1442278320,9/14/2015 17:52
3965,20150707050739-597,2,9/12/2015 22:34,1442122440,C3,150540,1442272980,9/14/2015 16:23
3364,20150219120223-913,1,9/8/2015 7:22,1441722120,C4,548700,1442270820,9/14/2015 15:47
4732,20150720100717-213,1,9/7/2015 14:54,1441662840,C0,607260,1442270100,9/14/2015 15:35
6234,20150517080528-116,3,9/5/2015 4:31,1441452660,C2,814380,1442267040,9/14/2015 14:44
5376,20151907121926-813,2,9/12/2015 19:37,1442111820,C3,152760,1442264580,9/14/2015 14:03
3066,20152123032134-92,2,9/11/2015 20:11,1442027460,C8,237000,1442264460,9/14/2015 14:01
3046,20153406083425-63,3,9/13/2015 15:06,1442181960,C2,78540,1442260500,9/14/2015 12:55
284,20150328090330-172,1,9/12/2015 14:55,1442094900,C3,164640,1442259540,9/14/2015 12:39
5725,20155230025241-974,3,9/10/2015 18:58,1441936680,C5,321720,1442258400,9/14/2015 12:20
3307,20153430053418-339,3,9/10/2015 19:34,1441938840,C5,319200,1442258040,9/14/2015 12:14
1215,20155006025053-216,2,9/11/2015 20:58,1442030280,C4,227040,1442257320,9/14/2015 12:02
5409,20153219093219-284,1,9/7/2015 8:38,1441640280,C7,616680,1442256960,9/14/2015 11:56
4856,20150001070006-104,1,9/8/2015 23:12,1441779120,C5,477360,1442256480,9/14/2015 11:48
5103,20155605105623-939,1,9/12/2015 5:23,1442060580,C5,194940,1442255520,9/14/2015 11:32
2038,20151901101926-562,1,9/12/2015 7:14,1442067240,C8,187860,1442255100,9/14/2015 11:25
5654,20155429065420-360,1,9/10/2015 9:24,1441902240,C5,348600,1442250840,9/14/2015 10:14
1646,20152909022912-907,1,9/3/2015 6:14,1441286040,C8,961740,1442247780,9/14/2015 9:23
1772,20154308124319-670,1,9/12/2015 10:17,1442078220,C5,168420,1442246640,9/14/2015 9:04
1522,20150820090832-399,3,9/8/2015 2:52,1441705920,C5,537180,1442243100,9/14/2015 8:05
362,20150526110553-791,2,8/25/2015 8:26,1440516360,C4,1724820,1442241180,9/14/2015 7:33
4315,20154102054122-35,1,9/8/2015 12:20,1441740000,C2,499140,1442239140,9/14/2015 6:59
6134,20150209060217-820,2,9/12/2015 14:32,1442093520,C5,144900,1442238420,9/14/2015 6:47
6282,20154105024125-706,2,9/9/2015 7:20,1441808400,C4,428220,1442236620,9/14/2015 6:17
2789,20152821032823-470,3,9/6/2015 9:10,1441555800,C2,679860,1442235660,9/14/2015 6:01
1423,20152310032333-876,2,9/13/2015 8:08,1442156880,C2,77700,1442234580,9/14/2015 5:43
5185,20154828034832-528,2,9/8/2015 6:56,1441720560,C2,513840,1442234400,9/14/2015 5:40
3670,20155819015821-968,1,9/10/2015 11:58,1441911480,C6,315600,1442227080,9/14/2015 3:38
1426,20150428030425-959,2,9/12/2015 7:20,1442067600,C5,158520,1442226120,9/14/2015 3:22
5261,20154622044617-838,2,9/11/2015 7:31,1441981860,C2,242100,1442223960,9/14/2015 2:46
1091,20152812122818-384,3,9/7/2015 0:44,1441611840,C0,610320,1442222160,9/14/2015 2:16
2096,20150504020535-36,1,9/10/2015 22:11,1441948260,C3,273780,1442222040,9/14/2015 2:14
5319,20153221023253-382,1,9/8/2015 5:17,1441714620,C4,507300,1442221920,9/14/2015 2:12
5341,20153209083207-54,1,9/9/2015 14:56,1441835760,C5,385920,1442221680,9/14/2015 2:08
6534,20152928122912-286,2,9/12/2015 5:01,1442059260,C5,158640,1442217900,9/14/2015 1:05
5156,20153614123621-352,3,9/10/2015 5:13,1441887180,C4,329460,1442216640,9/14/2015 0:44
1484,20152127102149-247,2,9/8/2015 13:57,1441745820,C5,466020,1442211840,9/13/2015 23:24
151,20155621045635-67,1,9/6/2015 5:00,1441540800,C2,669720,1442210520,9/13/2015 23:02
398,20154511024505-828,1,9/12/2015 18:29,1442107740,C6,99840,1442207580,9/13/2015 22:13
4892,20151204031221-340,1,9/10/2015 19:42,1441939320,C7,267300,1442206620,9/13/2015 21:57
2471,20153211073233-705,1,9/12/2015 14:42,1442094120,C4,112200,1442206320,9/13/2015 21:52
3452,20151405051442-519,3,9/12/2015 21:12,1442117520,C7,88440,1442205960,9/13/2015 21:46
992,20150921120902-568,2,9/10/2015 22:58,1441951080,C7,252420,1442203500,9/13/2015 21:05
1410,20150321010307-127,1,9/6/2015 2:19,1441531140,C5,671880,1442203020,9/13/2015 20:57
5646,20151910031909-576,1,9/13/2015 1:22,1442132520,C5,69660,1442202180,9/13/2015 20:43
2527,20155403055431-688,1,9/11/2015 8:00,1441983600,C4,218520,1442202120,9/13/2015 20:42
1080,20153801033808-197,2,9/9/2015 18:52,1441849920,C2,351420,1442201340,9/13/2015 20:29
5133,20151728051728-164,2,9/9/2015 19:14,1441851240,C5,347940,1442199180,9/13/2015 19:53
3021,20153012083040-807,1,8/28/2015 14:10,1440796200,C4,1402800,1442199000,9/13/2015 19:50
4876,20151326031321-981,2,9/11/2015 12:50,1442001000,C8,196260,1442197260,9/13/2015 19:21
4312,20151322111353-436,3,9/6/2015 8:37,1441553820,C3,643320,1442197140,9/13/2015 19:19
6366,20154001094026-804,3,9/8/2015 23:08,1441778880,C2,416460,1442195340,9/13/2015 18:49
6318,20154730074747-926,1,9/10/2015 3:44,1441881840,C3,311940,1442193780,9/13/2015 18:23
3608,20153211053257-976,2,9/13/2015 2:04,1442135040,C4,58560,1442193600,9/13/2015 18:20
3287,20150001050042-811,1,9/9/2015 17:20,1441844400,C7,346200,1442190600,9/13/2015 17:30
5108,20154510114523-240,1,9/9/2015 10:25,1441819500,C4,369600,1442189100,9/13/2015 17:05
735,20154903014909-323,3,9/10/2015 7:43,1441896180,C8,291420,1442187600,9/13/2015 16:40
2407,20155410055413-237,2,9/8/2015 20:12,1441768320,C6,418980,1442187300,9/13/2015 16:35
2753,20154011054033-757,2,9/12/2015 16:51,1442101860,C6,83460,1442185320,9/13/2015 16:02
5109,20152622012613-387,2,9/6/2015 6:54,1441547640,C2,636240,1442183880,9/13/2015 15:38
2616,20154207064238-836,1,9/12/2015 1:12,1442045520,C5,137400,1442182920,9/13/2015 15:22
6070,20151531051542-946,1,9/11/2015 10:25,1441992300,C8,185160,1442177460,9/13/2015 13:51
1051,20152505052550-320,3,9/11/2015 14:01,1442005260,C4,168720,1442173980,9/13/2015 12:53
3444,20155628075607-90,1,9/9/2015 11:08,1441822080,C0,349440,1442171520,9/13/2015 12:12
4587,20154314054309-806,1,9/3/2015 13:55,1441313700,C8,857160,1442170860,9/13/2015 12:01
2086,20152120072110-350,2,9/5/2015 9:51,1441471860,C5,695700,1442167560,9/13/2015 11:06
5403,20150501070559-328,3,9/7/2015 6:59,1441634340,C6,532740,1442167080,9/13/2015 10:58
364,20150127030133-376,1,9/10/2015 15:06,1441922760,C8,241980,1442164740,9/13/2015 10:19
2735,20154812034822-196,3,9/9/2015 10:40,1441820400,C3,342960,1442163360,9/13/2015 9:56
1941,20153807073822-145,3,9/11/2015 9:06,1441987560,C2,175440,1442163000,9/13/2015 9:50
6538,20152101122110-544,1,9/12/2015 0:37,1442043420,C4,113520,1442156940,9/13/2015 8:09
4744,20154726024709-573,2,9/4/2015 10:44,1441388640,C4,763020,1442151660,9/13/2015 6:41
3357,20154615054634-509,2,9/10/2015 2:10,1441876200,C2,273780,1442149980,9/13/2015 6:13
1614,20154529014510-493,2,9/11/2015 10:06,1441991160,C8,158580,1442149740,9/13/2015 6:09
2786,20154821044824-752,1,9/7/2015 14:18,1441660680,C5,486600,1442147280,9/13/2015 5:28
2699,20155807055837-636,2,9/12/2015 13:50,1442091000,C2,52140,1442143140,9/13/2015 4:19
4419,20154825014843-884,2,9/10/2015 19:56,1441940160,C5,200640,1442140800,9/13/2015 3:40
5498,20154311024355-911,1,9/12/2015 9:01,1442073660,C0,65880,1442139540,9/13/2015 3:19
412,20154709124756-980,1,9/5/2015 20:07,1441508820,C4,629700,1442138520,9/13/2015 3:02
324,20150208060247-95,1,9/11/2015 21:38,1442032680,C5,105120,1442137800,9/13/2015 2:50
3959,20154904024927-977,1,9/10/2015 23:37,1441953420,C3,183360,1442136780,9/13/2015 2:33
6550,20153229013212-110,1,9/8/2015 6:12,1441717920,C5,418800,1442136720,9/13/2015 2:32
1510,20150710110737-521,1,9/12/2015 4:53,1442058780,C2,75180,1442133960,9/13/2015 1:46
3769,20151212081202-125,3,9/2/2015 14:37,1441229820,C8,903180,1442133000,9/13/2015 1:30
2897,20154508084534-828,1,9/11/2015 20:36,1442028960,C5,100620,1442129580,9/13/2015 0:33
4340,20150507120531-544,2,9/11/2015 4:17,1441970220,C4,158760,1442128980,9/13/2015 0:23
3947,20151710031722-962,1,9/12/2015 5:21,1442060460,C5,68520,1442128980,9/13/2015 0:23
6450,20153011043031-930,1,9/12/2015 8:23,1442071380,C0,57180,1442128560,9/13/2015 0:16
3042,20150302060320-142,3,9/7/2015 14:28,1441661280,C6,462300,1442123580,9/12/2015 22:53
1349,20152130082153-677,1,9/11/2015 0:09,1441955340,C6,167880,1442123220,9/12/2015 22:47
4169,20152031092038-925,1,9/7/2015 11:32,1441650720,C7,470160,1442120880,9/12/2015 22:08
3162,20155024015018-365,3,9/9/2015 15:15,1441836900,C8,277500,1442114400,9/12/2015 20:20
314,20151823061856-404,2,9/7/2015 16:36,1441668960,C4,444360,1442113320,9/12/2015 20:02
351,20153131083117-488,1,9/9/2015 15:01,1441836060,C5,267000,1442103060,9/12/2015 17:11
73,20151026041051-922,1,9/7/2015 0:46,1441611960,C0,490680,1442102640,9/12/2015 17:04
1042,20150704020738-670,3,9/10/2015 0:03,1441868580,C5,233880,1442102460,9/12/2015 17:01
2230,20152405042448-474,2,9/12/2015 1:34,1442046840,C2,55140,1442101980,9/12/2015 16:53
5708,20153308013340-678,2,9/11/2015 15:54,1442012040,C4,89220,1442101260,9/12/2015 16:41
3153,20155125045126-764,1,9/3/2015 16:39,1441323540,C6,776880,1442100420,9/12/2015 16:27
1290,20154404044452-704,2,9/11/2015 15:13,1442009580,C4,85620,1442095200,9/12/2015 15:00
758,20152129102151-57,1,9/5/2015 12:37,1441481820,C3,612960,1442094780,9/12/2015 14:53
3888,20155922065913-325,2,9/10/2015 5:39,1441888740,C5,204600,1442093340,9/12/2015 14:29
2379,20154828014849-145,1,9/7/2015 13:48,1441658880,C5,432000,1442090880,9/12/2015 13:48
2145,20151510101536-354,2,9/11/2015 10:58,1441994280,C6,88980,1442083260,9/12/2015 11:41
3551,20154919024910-736,3,9/8/2015 10:29,1441733340,C8,342480,1442075820,9/12/2015 9:37
3338,20153228113210-234,1,9/10/2015 12:12,1441912320,C7,160800,1442073120,9/12/2015 8:52
5662,20151108071113-261,2,9/11/2015 0:07,1441955220,C5,116880,1442072100,9/12/2015 8:35
3227,20152303052328-94,2,9/4/2015 11:31,1441391460,C4,677760,1442069220,9/12/2015 7:47
730,20154727044758-903,2,9/10/2015 13:43,1441917780,C2,149820,1442067600,9/12/2015 7:20
4907,20150228110224-816,1,9/10/2015 9:22,1441902120,C4,159600,1442061720,9/12/2015 5:42
3271,20153824013848-746,1,9/9/2015 21:24,1441859040,C8,201480,1442060520,9/12/2015 5:22
1676,20152527092517-772,1,9/10/2015 4:59,1441886340,C3,170520,1442056860,9/12/2015 4:21
5932,20155430065423-661,3,9/8/2015 22:27,1441776420,C2,277860,1442054280,9/12/2015 3:38
6259,20153605103654-343,1,9/9/2015 21:44,1441860240,C8,192840,1442053080,9/12/2015 3:18
483,20150805020849-559,1,9/7/2015 10:20,1441646400,C8,405360,1442051760,9/12/2015 2:56
5816,20150510040554-767,1,9/8/2015 12:21,1441740060,C2,311520,1442051580,9/12/2015 2:53
3912,20152208042243-251,3,9/10/2015 23:08,1441951680,C5,98580,1442050260,9/12/2015 2:31
3689,20151924061907-803,1,9/5/2015 20:56,1441511760,C2,538260,1442050020,9/12/2015 2:27
5520,20154604024619-103,1,9/7/2015 17:10,1441671000,C3,368280,1442039280,9/11/2015 23:28
4395,20153629023651-616,2,9/10/2015 6:57,1441893420,C5,144180,1442037600,9/11/2015 23:00
606,20152208052219-435,1,9/10/2015 20:40,1441942800,C4,92340,1442035140,9/11/2015 22:19
4502,20154920114956-385,1,9/5/2015 23:33,1441521180,C2,512880,1442034060,9/11/2015 22:01
5390,20155230075218-899,3,9/10/2015 6:08,1441890480,C5,134880,1442025360,9/11/2015 19:36
3637,20155619125653-865,1,9/5/2015 22:26,1441517160,C3,501000,1442018160,9/11/2015 17:36
2056,20150226090228-180,3,9/6/2015 5:40,1441543200,C0,469140,1442012340,9/11/2015 15:59
2510,20155205045234-468,2,9/9/2015 16:14,1441840440,C5,171660,1442012100,9/11/2015 15:55
4611,20154519024544-322,2,9/9/2015 7:09,1441807740,C4,201780,1442009520,9/11/2015 15:12
685,20153023103028-824,2,9/1/2015 14:28,1441142880,C5,866040,1442008920,9/11/2015 15:02
6290,20153809053851-563,1,9/10/2015 23:16,1441952160,C5,53340,1442005500,9/11/2015 14:05
2409,20154404024444-783,1,9/9/2015 5:56,1441803360,C5,200160,1442003520,9/11/2015 13:32
5098,20152125062113-255,1,9/9/2015 7:19,1441808340,C7,185640,1441993980,9/11/2015 10:53
3304,20154620024644-66,2,9/7/2015 18:51,1441677060,C8,313980,1441991040,9/11/2015 10:04
3662,20155929085958-172,2,9/9/2015 22:59,1441864740,C2,125100,1441989840,9/11/2015 9:44
3892,20152801042854-889,1,9/8/2015 3:52,1441709520,C4,279720,1441989240,9/11/2015 9:34
4834,20151629101604-17,2,9/7/2015 1:10,1441613400,C7,372420,1441985820,9/11/2015 8:37
2441,20150208050254-21,2,8/31/2015 3:20,1441016400,C5,968940,1441985340,9/11/2015 8:29
438,20153109043127-486,3,9/7/2015 6:10,1441631400,C2,352620,1441984020,9/11/2015 8:07
4801,20153622113627-960,2,9/8/2015 0:16,1441696560,C8,285600,1441982160,9/11/2015 7:36
6520,20150724010736-623,1,9/9/2015 8:03,1441810980,C2,170520,1441981500,9/11/2015 7:25
527,20152524042528-383,1,9/9/2015 7:37,1441809420,C6,168840,1441978260,9/11/2015 6:31
4462,20153805033854-367,3,9/8/2015 10:49,1441734540,C6,241860,1441976400,9/11/2015 6:00
5575,20154601104625-869,1,9/10/2015 0:34,1441870440,C7,105840,1441976280,9/11/2015 5:58
2505,20150908120943-943,1,9/10/2015 7:55,1441896900,C8,78780,1441975680,9/11/2015 5:48
5224,20154501024521-895,1,9/10/2015 0:00,1441868400,C4,103500,1441971900,9/11/2015 4:45
5188,20154828094837-453,2,9/7/2015 17:51,1441673460,C4,297660,1441971120,9/11/2015 4:32
4963,20152104032137-992,3,9/8/2015 23:57,1441781820,C2,188280,1441970100,9/11/2015 4:15
5986,20150701070722-706,1,9/8/2015 16:37,1441755420,C2,213000,1441968420,9/11/2015 3:47
5545,20151307011356-805,2,9/9/2015 22:31,1441863060,C0,103140,1441966200,9/11/2015 3:10
6220,20154119074133-741,2,9/8/2015 14:05,1441746300,C3,218880,1441965180,9/11/2015 2:53
3413,20150323050310-883,1,9/4/2015 23:21,1441434060,C4,529740,1441963800,9/11/2015 2:30
3817,20153705073720-86,2,9/7/2015 0:17,1441610220,C5,353100,1441963320,9/11/2015 2:22
4243,20152605082604-337,1,9/9/2015 15:47,1441838820,C5,124020,1441962840,9/11/2015 2:14
4056,20150031070053-947,1,9/5/2015 16:36,1441496160,C2,466560,1441962720,9/11/2015 2:12
277,20153230043217-141,2,9/7/2015 6:30,1441632600,C5,327540,1441960140,9/11/2015 1:29
4788,20153208023216-402,2,9/9/2015 19:51,1441853460,C2,105540,1441959000,9/11/2015 1:10
6228,20152924112938-506,3,9/5/2015 15:05,1441490700,C0,466020,1441956720,9/11/2015 0:32
5679,20153430063422-994,1,9/9/2015 13:05,1441829100,C3,126780,1441955880,9/11/2015 0:18
2299,20153716123710-632,1,9/7/2015 19:39,1441679940,C3,275160,1441955100,9/11/2015 0:05
5865,20153621043606-60,3,9/8/2015 10:54,1441734840,C3,219240,1441954080,9/10/2015 23:48
5051,20153508053556-774,1,9/7/2015 7:03,1441634580,C3,319260,1441953840,9/10/2015 23:44
1736,20150605090619-525,2,9/9/2015 2:46,1441791960,C7,161400,1441953360,9/10/2015 23:36
2139,20150404010414-57,1,9/8/2015 19:02,1441764120,C3,183540,1441947660,9/10/2015 22:01
5080,20155107095150-103,2,9/9/2015 23:57,1441868220,C0,74520,1441942740,9/10/2015 20:39
279,20155610055624-279,1,9/3/2015 2:16,1441271760,C7,670800,1441942560,9/10/2015 20:36
3603,20152317092314-52,1,9/7/2015 8:11,1441638660,C6,301680,1441940340,9/10/2015 19:59
6456,20155028065044-583,2,9/9/2015 7:46,1441809960,C2,130020,1441939980,9/10/2015 19:53
222,20155303075313-600,1,9/6/2015 13:05,1441569900,C6,369540,1441939440,9/10/2015 19:44
4490,20151128091137-757,1,9/6/2015 8:09,1441552140,C0,386940,1441939080,9/10/2015 19:38
4790,20155125115109-261,1,9/5/2015 8:43,1441467780,C4,469560,1441937340,9/10/2015 19:09
203,20153127113132-635,1,9/6/2015 0:01,1441522860,C8,411300,1441934160,9/10/2015 18:16
1477,20150817020855-736,1,9/6/2015 17:23,1441585380,C8,347940,1441933320,9/10/2015 18:02
1808,20150930040930-759,1,9/6/2015 23:03,1441605780,C5,314820,1441920600,9/10/2015 14:30
3720,20152830112817-503,2,9/9/2015 4:27,1441798020,C4,119820,1441917840,9/10/2015 13:44
1587,20154428114412-322,1,9/6/2015 5:00,1441540800,C2,376680,1441917480,9/10/2015 13:38
4000,20155926045943-896,2,9/5/2015 14:31,1441488660,C8,427560,1441916220,9/10/2015 13:17
789,20150903020949-595,1,9/8/2015 18:12,1441761120,C2,148860,1441909980,9/10/2015 11:33
1800,20155731115721-967,1,9/7/2015 3:07,1441620420,C5,286500,1441906920,9/10/2015 10:42
6484,20154804054850-394,1,9/8/2015 12:58,1441742280,C5,164100,1441906380,9/10/2015 10:33
3753,20151506071555-282,1,9/9/2015 1:23,1441786980,C2,119040,1441906020,9/10/2015 10:27
3759,20152128042140-763,3,9/8/2015 19:38,1441766280,C4,137460,1441903740,9/10/2015 9:49
6545,20152703072711-146,1,9/6/2015 20:19,1441595940,C4,305520,1441901460,9/10/2015 9:11
2002,20153922113902-456,1,9/8/2015 0:05,1441695900,C7,203880,1441899780,9/10/2015 8:43
937,20155806065835-432,1,9/9/2015 0:08,1441782480,C7,117300,1441899780,9/10/2015 8:43
3680,20155830045808-582,1,9/8/2015 13:28,1441744080,C8,153000,1441897080,9/10/2015 7:58
5976,20150508040515-409,1,9/9/2015 11:40,1441824000,C6,70500,1441894500,9/10/2015 7:15
4919,20154704054739-174,1,9/7/2015 11:50,1441651800,C2,237780,1441889580,9/10/2015 5:53
620,20153318063343-519,1,9/7/2015 14:09,1441660140,C4,219420,1441879560,9/10/2015 3:06
4789,20151814091820-723,1,9/2/2015 21:00,1441252800,C3,623160,1441875960,9/10/2015 2:06
3418,20155430065457-569,1,9/8/2015 20:30,1441769400,C5,103320,1441872720,9/10/2015 1:12
1837,20154014024032-779,3,9/7/2015 1:20,1441614000,C5,253200,1441867200,9/9/2015 23:40
3007,20155504075536-383,1,9/5/2015 9:20,1441470000,C5,395700,1441865700,9/9/2015 23:15
5513,20155924025958-524,2,9/2/2015 1:49,1441183740,C8,681720,1441865460,9/9/2015 23:11
2243,20155308025321-11,1,8/30/2015 4:03,1440932580,C5,930900,1441863480,9/9/2015 22:38
1408,20152606102611-230,2,9/8/2015 18:02,1441760520,C2,100080,1441860600,9/9/2015 21:50
5663,20154729044749-19,1,9/6/2015 3:59,1441537140,C5,322560,1441859700,9/9/2015 21:35
2791,20154321074307-245,2,9/7/2015 17:11,1441671060,C2,187860,1441858920,9/9/2015 21:22
5361,20154224124203-336,1,9/7/2015 20:17,1441682220,C8,176700,1441858920,9/9/2015 21:22
3118,20150605090617-10,1,9/7/2015 14:44,1441662240,C6,193080,1441855320,9/9/2015 20:22
3069,20152422012450-156,1,9/7/2015 19:00,1441677600,C0,175320,1441852920,9/9/2015 19:42
821,20154904074940-639,1,9/8/2015 10:40,1441734000,C5,118620,1441852620,9/9/2015 19:37
2547,20151910111953-81,2,9/5/2015 23:51,1441522260,C4,327360,1441849620,9/9/2015 18:47
2333,20150129120100-835,1,9/6/2015 0:23,1441524180,C8,324660,1441848840,9/9/2015 18:34
833,20155418105443-181,1,9/6/2015 22:30,1441603800,C4,240480,1441844280,9/9/2015 17:18
3992,20151631041644-215,1,9/7/2015 9:31,1441643460,C4,193500,1441836960,9/9/2015 15:16
1809,20155528075553-143,1,8/31/2015 11:06,1441044360,C3,791580,1441835940,9/9/2015 14:59
3890,20150227070212-936,2,9/6/2015 6:53,1441547580,C3,287820,1441835400,9/9/2015 14:50
5180,20152829022835-670,3,9/5/2015 21:32,1441513920,C4,315120,1441829040,9/9/2015 13:04
3596,20150525050544-558,2,9/7/2015 21:21,1441686060,C5,142320,1441828380,9/9/2015 12:53
2346,20150213100239-978,2,9/6/2015 2:33,1441531980,C5,292380,1441824360,9/9/2015 11:46
5696,20151926071934-564,3,9/1/2015 2:31,1441099860,C5,721440,1441821300,9/9/2015 10:55
2378,20151612061624-150,1,9/1/2015 23:50,1441176600,C7,638520,1441815120,9/9/2015 9:12
4988,20151426091421-412,2,9/5/2015 20:50,1441511400,C5,301920,1441813320,9/9/2015 8:42
6064,20153516013555-105,3,9/3/2015 9:47,1441298820,C5,513840,1441812660,9/9/2015 8:31
2866,20153220023240-486,1,9/3/2015 16:40,1441323600,C5,486960,1441810560,9/9/2015 7:56
5554,20152106052156-327,1,8/26/2015 19:21,1440642060,C6,1167600,1441809660,9/9/2015 7:41
5691,20152908112909-319,2,9/2/2015 7:21,1441203660,C4,602940,1441806600,9/9/2015 6:50
871,20153103063126-891,3,9/4/2015 15:03,1441404180,C3,399360,1441803540,9/9/2015 5:59
6381,20153604033631-714,3,8/22/2015 10:36,1440264960,C4,1537200,1441802160,9/9/2015 5:36
1493,20155514115538-38,1,9/6/2015 0:19,1441523940,C7,277920,1441801860,9/9/2015 5:31
1247,20153327063301-504,3,9/7/2015 14:30,1441661400,C3,139860,1441801260,9/9/2015 5:21
2347,20152314062351-552,1,9/2/2015 17:26,1441239960,C3,560460,1441800420,9/9/2015 5:07
3970,20151304071316-371,2,9/6/2015 17:57,1441587420,C6,211440,1441798860,9/9/2015 4:41
2494,20150731120739-57,1,9/6/2015 6:39,1441546740,C5,249360,1441796100,9/9/2015 3:55
3167,20154303094318-187,3,9/7/2015 17:13,1441671180,C2,124200,1441795380,9/9/2015 3:43
4387,20151209111219-195,2,9/5/2015 7:26,1441463160,C7,331320,1441794480,9/9/2015 3:28
674,20154018114036-212,1,8/26/2015 23:28,1440656880,C3,1137360,1441794240,9/9/2015 3:24
5258,20151104081118-17,1,8/31/2015 3:44,1441017840,C2,772260,1441790100,9/9/2015 2:15
5374,20150906030915-616,1,8/28/2015 21:47,1440823620,C3,962340,1441785960,9/9/2015 1:06
1025,20150022040009-518,1,9/2/2015 23:28,1441261680,C0,522240,1441783920,9/9/2015 0:32
3733,20151431121439-712,1,9/6/2015 21:02,1441598520,C2,183360,1441781880,9/8/2015 23:58
5977,20153315033346-643,1,9/5/2015 22:12,1441516320,C2,262620,1441778940,9/8/2015 23:09
1867,20154405084402-280,2,9/8/2015 1:17,1441700220,C2,77460,1441777680,9/8/2015 22:48
4721,20154725054747-248,2,9/3/2015 7:06,1441289160,C4,488220,1441777380,9/8/2015 22:43
2011,20154127114159-870,2,9/4/2015 2:13,1441357980,C3,416940,1441774920,9/8/2015 22:02
1639,20155727015757-542,1,9/4/2015 19:17,1441419420,C2,355200,1441774620,9/8/2015 21:57
2558,20150209060231-719,1,8/24/2015 15:17,1440454620,C8,1319940,1441774560,9/8/2015 21:56
3157,20150001080008-525,3,9/6/2015 9:16,1441556160,C5,218280,1441774440,9/8/2015 21:54
5508,20151929081907-753,2,9/5/2015 8:23,1441466580,C4,302520,1441769100,9/8/2015 20:25
175,20155922035939-710,2,9/6/2015 16:29,1441582140,C5,185400,1441767540,9/8/2015 19:59
3385,20153406023410-438,1,9/8/2015 1:46,1441701960,C0,63360,1441765320,9/8/2015 19:22
1344,20150904110914-670,3,9/7/2015 16:57,1441670220,C4,93360,1441763580,9/8/2015 18:53
6441,20154305094304-138,1,8/31/2015 14:39,1441057140,C0,706080,1441763220,9/8/2015 18:47
6153,20152201082225-621,1,9/7/2015 12:37,1441654620,C8,106740,1441761360,9/8/2015 18:16
1132,20153227063207-318,1,9/4/2015 14:10,1441401000,C8,359340,1441760340,9/8/2015 17:59
2761,20154419084429-25,1,9/3/2015 15:17,1441318620,C3,439860,1441758480,9/8/2015 17:28
5644,20154618044618-128,1,9/3/2015 12:25,1441308300,C7,449460,1441757760,9/8/2015 17:16
6315,20155221075249-459,3,9/1/2015 15:10,1441145400,C6,609180,1441754580,9/8/2015 16:23
1336,20155409095404-1,1,9/5/2015 7:30,1441463400,C3,290520,1441753920,9/8/2015 16:12
391,20150902120906-170,1,9/5/2015 14:03,1441486980,C3,266040,1441753020,9/8/2015 15:57
623,20154124044141-426,3,9/6/2015 18:52,1441590720,C7,161580,1441752300,9/8/2015 15:45
6155,20150603110619-327,2,8/30/2015 14:12,1440969120,C5,781320,1441750440,9/8/2015 15:14
3829,20154104114100-580,2,9/7/2015 6:01,1441630860,C8,119400,1441750260,9/8/2015 15:11
1273,20152431122444-914,2,9/6/2015 14:27,1441574820,C0,175260,1441750080,9/8/2015 15:08
2362,20151823071855-858,2,9/3/2015 4:12,1441278720,C8,469620,1441748340,9/8/2015 14:39
5772,20151320101309-415,1,9/6/2015 4:57,1441540620,C5,207120,1441747740,9/8/2015 14:29
5789,20151824051853-291,1,9/4/2015 21:09,1441426140,C4,321420,1441747560,9/8/2015 14:26
3883,20150708090712-967,1,9/4/2015 16:40,1441410000,C2,337140,1441747140,9/8/2015 14:19
3442,20150904110945-706,1,8/31/2015 7:43,1441032180,C4,714120,1441746300,9/8/2015 14:05
5913,20153703033757-677,1,9/7/2015 22:38,1441690680,C4,52980,1441743660,9/8/2015 13:21
457,20150602050643-221,3,9/7/2015 18:54,1441677240,C4,62640,1441739880,9/8/2015 12:18
4873,20152424062441-168,2,8/30/2015 23:12,1441001520,C4,731160,1441732680,9/8/2015 10:18
3335,20152506122555-795,2,9/1/2015 7:29,1441117740,C3,613380,1441731120,9/8/2015 9:52
5830,20153017033036-185,1,9/5/2015 16:15,1441494900,C8,234900,1441729800,9/8/2015 9:30
336,20154320014344-198,1,9/2/2015 3:59,1441191540,C5,538080,1441729620,9/8/2015 9:27
1147,20150823010813-63,1,9/3/2015 2:26,1441272360,C7,455940,1441728300,9/8/2015 9:05
6256,20152129012109-280,1,9/7/2015 3:23,1441621380,C2,105960,1441727340,9/8/2015 8:49
5414,20152229062214-724,1,9/3/2015 7:16,1441289760,C2,435240,1441725000,9/8/2015 8:10
4637,20155201025239-418,2,9/6/2015 2:22,1441531320,C2,193500,1441724820,9/8/2015 8:07
153,20154015074020-606,2,8/27/2015 7:30,1440685800,C6,1036200,1441722000,9/8/2015 7:20
466,20150727060728-239,1,9/2/2015 21:35,1441254900,C4,464640,1441719540,9/8/2015 6:39
1592,20154504064547-329,1,9/6/2015 22:31,1441603860,C0,114780,1441718640,9/8/2015 6:24
6319,20155904105902-891,2,9/6/2015 22:25,1441603500,C5,106980,1441710480,9/8/2015 4:08
5406,20151903101941-31,1,9/6/2015 23:34,1441607640,C3,102300,1441709940,9/8/2015 3:59
2424,20155531015543-259,2,9/7/2015 5:03,1441627380,C4,81840,1441709220,9/8/2015 3:47
5163,20155130055132-838,1,9/3/2015 22:47,1441345620,C2,363360,1441708980,9/8/2015 3:43
2723,20152107042148-742,1,8/31/2015 6:18,1441027080,C2,679140,1441706220,9/8/2015 2:57
1158,20152930102944-762,1,9/5/2015 5:19,1441455540,C5,249900,1441705440,9/8/2015 2:44
701,20151001081041-702,1,9/5/2015 20:10,1441509000,C0,194400,1441703400,9/8/2015 2:10
4850,20151919051957-409,3,9/5/2015 22:31,1441517460,C2,185940,1441703400,9/8/2015 2:10
585,20155402095430-944,2,9/5/2015 5:56,1441457760,C2,244920,1441702680,9/8/2015 1:58
6483,20155707085753-292,2,8/31/2015 3:33,1441017180,C0,684720,1441701900,9/8/2015 1:45
737,20154513024507-271,1,8/26/2015 8:11,1440601860,C4,1099560,1441701420,9/8/2015 1:37
5997,20151927121927-686,3,9/5/2015 4:04,1441451040,C4,249300,1441700340,9/8/2015 1:19
4927,20151019101012-506,1,9/1/2015 16:53,1441151580,C5,546540,1441698120,9/8/2015 0:42
5769,20152302122333-628,2,9/1/2015 22:18,1441171080,C8,525540,1441696620,9/8/2015 0:17
4492,20152131072114-536,3,9/7/2015 1:03,1441612980,C8,83160,1441696140,9/8/2015 0:09
4837,20153130043132-951,1,9/5/2015 4:47,1441453620,C5,238080,1441691700,9/7/2015 22:55
4933,20155026055055-745,3,9/3/2015 20:42,1441338120,C3,350760,1441688880,9/7/2015 22:08
840,20153622113605-844,1,9/2/2015 9:38,1441211880,C5,471660,1441683540,9/7/2015 20:39
487,20150531030537-639,1,9/3/2015 14:41,1441316460,C5,367020,1441683480,9/7/2015 20:38
4575,20153523043519-62,1,9/5/2015 22:09,1441516140,C8,163320,1441679460,9/7/2015 19:31
667,20154226054229-220,2,9/1/2015 18:08,1441156080,C2,519960,1441676040,9/7/2015 18:34
3553,20152229062233-1,1,9/6/2015 4:32,1441539120,C8,136920,1441676040,9/7/2015 18:34
5234,20154504054501-314,2,9/6/2015 23:15,1441606500,C2,64200,1441670700,9/7/2015 17:05
1727,20153930103903-13,1,9/3/2015 13:44,1441313040,C6,356700,1441669740,9/7/2015 16:49
5056,20155321115343-478,1,9/4/2015 19:48,1441421280,C8,247620,1441668900,9/7/2015 16:35
597,20150330090357-596,2,9/6/2015 15:14,1441577640,C7,89580,1441667220,9/7/2015 16:07
4853,20153404063406-832,1,9/6/2015 12:44,1441568640,C7,97500,1441666140,9/7/2015 15:49
7,20150229070248-397,1,9/4/2015 12:48,1441396080,C4,269580,1441665660,9/7/2015 15:41
1017,20150301050357-768,1,9/6/2015 21:39,1441600740,C0,64080,1441664820,9/7/2015 15:27
4229,20150721100700-126,1,9/3/2015 7:07,1441289220,C5,370800,1441660020,9/7/2015 14:07
1612,20151518031527-459,2,8/28/2015 14:33,1440797580,C6,861480,1441659060,9/7/2015 13:51
4020,20153117053105-892,1,9/4/2015 22:40,1441431600,C7,224820,1441656420,9/7/2015 13:07
2564,20152225012231-425,3,9/4/2015 7:01,1441375260,C2,280380,1441655640,9/7/2015 12:54
452,20155005035047-766,1,9/6/2015 20:42,1441597320,C8,51960,1441649280,9/7/2015 11:08
6068,20153228033219-364,2,9/6/2015 5:27,1441542420,C7,105900,1441648320,9/7/2015 10:52
4560,20150014100049-755,2,9/3/2015 10:40,1441302000,C8,346080,1441648080,9/7/2015 10:48
3735,20155824015823-693,1,8/27/2015 5:28,1440678480,C2,969000,1441647480,9/7/2015 10:38
2592,20151317041326-366,1,8/29/2015 8:29,1440862140,C5,784920,1441647060,9/7/2015 10:31
614,20150401110417-611,1,9/5/2015 8:56,1441468560,C0,168960,1441637520,9/7/2015 7:52
1068,20152125052113-381,3,9/5/2015 16:26,1441495560,C8,135300,1441630860,9/7/2015 6:01
1911,20150914040900-949,2,9/4/2015 6:00,1441371600,C3,253980,1441625580,9/7/2015 4:33
4143,20153520013555-33,1,9/1/2015 1:50,1441097400,C5,524700,1441622100,9/7/2015 3:35
6280,20155622065626-576,1,9/4/2015 12:06,1441393560,C8,228360,1441621920,9/7/2015 3:32
4920,20154303104350-928,2,9/5/2015 21:07,1441512420,C7,105120,1441617540,9/7/2015 2:19
299,20154408044436-655,2,8/28/2015 7:04,1440770640,C5,846600,1441617240,9/7/2015 2:14
1910,20150122090127-897,1,9/1/2015 20:19,1441163940,C3,452340,1441616280,9/7/2015 1:58
1874,20153204023235-178,1,9/3/2015 6:32,1441287120,C2,320400,1441607520,9/6/2015 23:32
2366,20150631050638-897,2,9/6/2015 4:42,1441539720,C8,67680,1441607400,9/6/2015 23:30
2000,20153728073721-430,1,9/3/2015 17:37,1441327020,C3,277200,1441604220,9/6/2015 22:37
5621,20152124062158-615,1,9/3/2015 12:15,1441307700,C0,295080,1441602780,9/6/2015 22:13
5497,20155012065005-217,1,9/3/2015 17:01,1441324860,C3,276780,1441601640,9/6/2015 21:54
4035,20154728024720-591,3,9/3/2015 19:27,1441333620,C3,267600,1441601220,9/6/2015 21:47
5776,20155731045731-907,1,8/31/2015 15:12,1441059120,C8,534420,1441593540,9/6/2015 19:39
133,20152001022003-999,1,9/5/2015 1:26,1441441560,C4,149580,1441591140,9/6/2015 18:59
3284,20151226121233-295,2,9/5/2015 8:27,1441466820,C5,121500,1441588320,9/6/2015 18:12
5092,20155823115852-975,2,9/4/2015 22:59,1441432740,C4,153780,1441586520,9/6/2015 17:42
5864,20152531082521-227,1,9/4/2015 14:29,1441402140,C5,183720,1441585860,9/6/2015 17:31
5875,20154102014133-632,3,9/5/2015 16:29,1441495740,C3,89760,1441585500,9/6/2015 17:25
1363,20151004051005-26,1,9/6/2015 1:08,1441526880,C8,57540,1441584420,9/6/2015 17:07
2675,20155504115554-356,1,9/5/2015 14:28,1441488480,C0,95580,1441584060,9/6/2015 17:01
256,20151622101656-331,2,9/1/2015 14:40,1441143600,C5,439920,1441583520,9/6/2015 16:52
1286,20151501071532-943,3,8/28/2015 14:18,1440796680,C3,786060,1441582740,9/6/2015 16:39
756,20151625011628-348,1,9/5/2015 7:56,1441464960,C6,116400,1441581360,9/6/2015 16:16
1832,20150403120405-547,3,9/5/2015 21:07,1441512420,C0,68460,1441580880,9/6/2015 16:08
2636,20150919070956-883,1,9/4/2015 8:58,1441382280,C8,198420,1441580700,9/6/2015 16:05
3744,20152726042751-686,1,9/3/2015 0:11,1441264260,C5,316320,1441580580,9/6/2015 16:03
389,20150204010234-9,1,9/5/2015 14:26,1441488360,C2,91440,1441579800,9/6/2015 15:50
221,20154930094911-931,1,9/5/2015 20:05,1441508700,C5,69420,1441578120,9/6/2015 15:22
3625,20150625010640-723,1,9/4/2015 21:42,1441428120,C6,149160,1441577280,9/6/2015 15:08
757,20153303063323-954,1,9/5/2015 11:53,1441479180,C3,96000,1441575180,9/6/2015 14:33
3816,20153913023914-536,2,9/3/2015 13:08,1441310880,C5,258420,1441569300,9/6/2015 12:55
1293,20151403071408-116,2,9/2/2015 5:33,1441197180,C5,369420,1441566600,9/6/2015 12:10
1401,20153826073859-860,3,9/1/2015 5:29,1441110540,C5,455580,1441566120,9/6/2015 12:02
1855,20154314044331-360,2,8/31/2015 18:31,1441071060,C5,491760,1441562820,9/6/2015 11:07
6201,20150026070015-698,1,9/5/2015 1:16,1441440960,C8,120480,1441561440,9/6/2015 10:44
695,20153228023246-901,2,9/4/2015 5:29,1441369740,C3,190740,1441560480,9/6/2015 10:28
6093,20155523025523-457,2,9/4/2015 2:45,1441359900,C8,198600,1441558500,9/6/2015 9:55
4166,20152620032609-833,1,9/4/2015 7:32,1441377120,C0,181080,1441558200,9/6/2015 9:50
2008,20152505102515-978,1,8/29/2015 12:15,1440875700,C5,679800,1441555500,9/6/2015 9:05
6341,20151629101611-370,1,9/5/2015 8:31,1441467060,C3,85500,1441552560,9/6/2015 8:16
1392,20155428025436-507,2,9/5/2015 5:57,1441457820,C5,94140,1441551960,9/6/2015 8:06
5039,20153619053636-962,1,8/31/2015 6:12,1441026720,C2,524880,1441551600,9/6/2015 8:00
5936,20152318072357-176,1,8/31/2015 1:44,1441010640,C5,540180,1441550820,9/6/2015 7:47
1811,20154102104114-973,2,9/5/2015 0:33,1441438380,C7,111360,1441549740,9/6/2015 7:29
357,20153629093635-690,3,8/27/2015 10:36,1440696960,C6,850200,1441547160,9/6/2015 6:46
1254,20150329020331-802,2,8/29/2015 15:31,1440887460,C4,659460,1441546920,9/6/2015 6:42
3838,20153014053026-5,1,8/28/2015 8:15,1440774900,C8,770940,1441545840,9/6/2015 6:24
3453,20152202092258-284,1,9/4/2015 23:18,1441433880,C8,111480,1441545360,9/6/2015 6:16
1577,20155801015824-240,1,9/5/2015 11:03,1441476180,C8,67020,1441543200,9/6/2015 5:40
3070,20152329032334-147,3,8/24/2015 8:37,1440430620,C5,1111020,1441541640,9/6/2015 5:14
3198,20150004030017-259,1,9/5/2015 10:07,1441472820,C4,68820,1441541640,9/6/2015 5:14
276,20154202014210-253,2,9/4/2015 9:12,1441383120,C3,156600,1441539720,9/6/2015 4:42
5968,20152208012227-661,3,9/2/2015 23:30,1441261800,C6,274560,1441536360,9/6/2015 3:46
1152,20152914042953-652,3,9/2/2015 22:41,1441258860,C6,277320,1441536180,9/6/2015 3:43
6283,20154201094221-490,3,8/28/2015 19:13,1440814380,C7,720780,1441535160,9/6/2015 3:26
1641,20151624051659-955,3,8/30/2015 21:37,1440995820,C6,534060,1441529880,9/6/2015 1:58
5828,20155922045901-406,1,9/2/2015 10:59,1441216740,C3,309600,1441526340,9/6/2015 0:59
3770,20155030075008-549,2,9/3/2015 19:16,1441332960,C8,193380,1441526340,9/6/2015 0:59
6304,20152304092306-366,2,8/31/2015 13:23,1441052580,C8,469440,1441522020,9/5/2015 23:47
266,20154126094133-632,1,9/2/2015 10:39,1441215540,C5,304140,1441519680,9/5/2015 23:08
1906,20154521044507-247,1,8/31/2015 20:25,1441077900,C8,438600,1441516500,9/5/2015 22:15
4478,20154224114240-680,1,8/30/2015 16:29,1440977340,C2,535620,1441512960,9/5/2015 21:16
6122,20151031111040-488,2,9/4/2015 1:40,1441356000,C5,155700,1441511700,9/5/2015 20:55
1504,20152128102128-573,3,9/4/2015 22:21,1441430460,C6,81000,1441511460,9/5/2015 20:51
661,20154104054114-147,1,8/29/2015 19:33,1440901980,C4,605640,1441507620,9/5/2015 19:47
3812,20151731021746-364,1,9/4/2015 22:37,1441431420,C8,75120,1441506540,9/5/2015 19:29
1479,20155524115511-739,3,8/30/2015 13:01,1440964860,C6,533460,1441498320,9/5/2015 17:12
6543,20155726105718-69,3,9/2/2015 6:57,1441202220,C5,295200,1441497420,9/5/2015 16:57
1499,20153102063137-742,1,9/4/2015 13:25,1441398300,C8,98820,1441497120,9/5/2015 16:52
4817,20155326105306-68,1,9/2/2015 6:47,1441201620,C3,295020,1441496640,9/5/2015 16:44
4695,20154424014431-732,1,9/2/2015 15:38,1441233480,C3,261480,1441494960,9/5/2015 16:16
3476,20152228012256-73,1,9/4/2015 11:16,1441390560,C6,99540,1441490100,9/5/2015 14:55
1109,20151730081700-38,2,9/2/2015 11:33,1441218780,C3,270960,1441489740,9/5/2015 14:49
5167,20151709101746-425,1,8/29/2015 8:01,1440860460,C5,628320,1441488780,9/5/2015 14:33
5006,20155725035758-59,3,9/2/2015 20:30,1441251000,C4,235860,1441486860,9/5/2015 14:01
3141,20152830052802-839,2,9/4/2015 14:28,1441402080,C8,84240,1441486320,9/5/2015 13:52
2625,20152024032005-799,2,9/2/2015 14:11,1441228260,C5,257820,1441486080,9/5/2015 13:48
3133,20150303100335-568,2,8/29/2015 9:55,1440867300,C3,615540,1441482840,9/5/2015 12:54
2939,20151022031032-538,2,8/31/2015 21:38,1441082280,C8,400440,1441482720,9/5/2015 12:52
3984,20152427042457-76,1,9/3/2015 6:39,1441287540,C4,189900,1441477440,9/5/2015 11:24
4276,20154514114507-203,3,8/29/2015 3:27,1440844020,C4,633060,1441477080,9/5/2015 11:18
300,20150803030838-612,2,9/4/2015 13:08,1441397280,C2,79200,1441476480,9/5/2015 11:08
3867,20150529010519-318,2,9/3/2015 3:11,1441275060,C7,198180,1441473240,9/5/2015 10:14
5726,20151303111344-23,1,9/4/2015 10:43,1441388580,C3,84600,1441473180,9/5/2015 10:13
4641,20155807095823-910,3,9/2/2015 4:30,1441193400,C5,278340,1441471740,9/5/2015 9:49
3742,20150028060003-741,1,9/1/2015 7:18,1441117080,C0,350280,1441467360,9/5/2015 8:36
4029,20155529095519-855,2,9/3/2015 0:47,1441266420,C7,199560,1441465980,9/5/2015 8:13
2426,20153829073814-789,2,9/1/2015 19:55,1441162500,C3,303420,1441465920,9/5/2015 8:12
6014,20151514121511-340,2,8/27/2015 12:45,1440704700,C8,760680,1441465380,9/5/2015 8:03
5065,20151428061408-195,2,9/1/2015 6:59,1441115940,C0,348300,1441464240,9/5/2015 7:44
3832,20152801052822-733,1,9/1/2015 11:12,1441131120,C4,331980,1441463100,9/5/2015 7:25
728,20152013022053-492,2,9/2/2015 11:16,1441217760,C3,245280,1441463040,9/5/2015 7:24
4887,20151102061116-400,1,9/1/2015 0:46,1441093560,C0,367500,1441461060,9/5/2015 6:51
5754,20151712081746-902,3,8/30/2015 5:47,1440938820,C0,515400,1441454220,9/5/2015 4:57
2608,20155103115100-856,2,9/4/2015 8:20,1441380000,C3,73740,1441453740,9/5/2015 4:49
230,20154016054052-85,1,9/3/2015 0:28,1441265280,C6,186660,1441451940,9/5/2015 4:19
4294,20151913121932-661,3,8/24/2015 20:02,1440471720,C0,978180,1441449900,9/5/2015 3:45
3881,20153519123507-498,1,9/3/2015 7:15,1441289700,C5,159600,1441449300,9/5/2015 3:35
3937,20150801100806-862,1,9/3/2015 21:32,1441341120,C8,106920,1441448040,9/5/2015 3:14
2929,20151530051543-867,3,9/3/2015 7:37,1441291020,C5,155460,1441446480,9/5/2015 2:48
4767,20153426023405-923,2,9/4/2015 1:14,1441354440,C2,91200,1441445640,9/5/2015 2:34
1664,20152801082834-605,1,9/3/2015 20:08,1441336080,C8,107400,1441443480,9/5/2015 1:58
2947,20154631104618-531,1,9/3/2015 21:52,1441342320,C4,99720,1441442040,9/5/2015 1:34
1596,20150116100148-276,2,9/2/2015 21:05,1441253100,C4,188580,1441441680,9/5/2015 1:28
4639,20151502121502-816,3,9/3/2015 18:16,1441329360,C6,108060,1441437420,9/5/2015 0:17
662,20154524044508-686,1,9/3/2015 2:55,1441274100,C8,162840,1441436940,9/5/2015 0:09
2198,20152825092803-463,1,9/3/2015 19:28,1441333680,C4,101700,1441435380,9/4/2015 23:43
15,20154727034733-671,2,9/3/2015 21:37,1441341420,C5,89400,1441430820,9/4/2015 22:27
5770,20153230033205-767,1,9/3/2015 4:00,1441278000,C5,152040,1441430040,9/4/2015 22:14
497,20151217121251-526,1,9/2/2015 14:57,1441231020,C0,198900,1441429920,9/4/2015 22:12
2004,20154722114730-650,1,9/1/2015 13:05,1441137900,C5,289560,1441427460,9/4/2015 21:31
2818,20150501010554-108,1,9/3/2015 18:33,1441330380,C2,96240,1441426620,9/4/2015 21:17
6159,20150214060215-80,3,8/29/2015 6:24,1440854640,C8,567960,1441422600,9/4/2015 20:10
719,20151411031453-479,2,8/29/2015 18:50,1440899400,C2,522720,1441422120,9/4/2015 20:02
2876,20150130120133-197,2,8/31/2015 18:09,1441069740,C4,348360,1441418100,9/4/2015 18:55
86,20155721045702-819,1,9/3/2015 0:35,1441265700,C4,152040,1441417740,9/4/2015 18:49
431,20151225071221-449,2,9/3/2015 11:21,1441304460,C4,113220,1441417680,9/4/2015 18:48
3626,20152012032040-682,2,8/29/2015 0:15,1440832500,C0,584700,1441417200,9/4/2015 18:40
5791,20152625082631-507,1,9/3/2015 10:29,1441301340,C4,112140,1441413480,9/4/2015 17:38
594,20155119115134-6,1,9/2/2015 16:24,1441236240,C8,175140,1441411380,9/4/2015 17:03
30,20153330053323-666,3,9/3/2015 1:03,1441267380,C8,143100,1441410480,9/4/2015 16:48
4610,20154519024544-322,2,9/2/2015 8:04,1441206240,C4,202080,1441408320,9/4/2015 16:12
1281,20154630124612-292,1,9/2/2015 22:58,1441259880,C2,147960,1441407840,9/4/2015 16:04
2383,20151021011021-123,3,8/24/2015 9:10,1440432600,C5,974400,1441407000,9/4/2015 15:50
1576,20151520101518-905,1,9/2/2015 17:48,1441241280,C4,164340,1441405620,9/4/2015 15:27
4888,20152925032929-380,1,8/21/2015 23:17,1440224220,C5,1180440,1441404660,9/4/2015 15:11
3842,20150308080350-359,2,9/1/2015 5:00,1441108800,C4,294660,1441403460,9/4/2015 14:51
718,20153003103059-290,3,8/31/2015 14:14,1441055640,C0,347520,1441403160,9/4/2015 14:46
4293,20153926103929-911,2,9/1/2015 13:17,1441138620,C4,263940,1441402560,9/4/2015 14:36
3677,20155102055140-273,3,9/3/2015 16:12,1441321920,C0,80460,1441402380,9/4/2015 14:33
2253,20150701080732-301,1,9/3/2015 12:21,1441308060,C4,94020,1441402080,9/4/2015 14:28
1729,20155029015020-507,1,9/1/2015 13:33,1441139580,C4,258180,1441397760,9/4/2015 13:16
5817,20154124024118-504,1,9/2/2015 17:26,1441239960,C8,157500,1441397460,9/4/2015 13:11
413,20151804041847-645,3,9/1/2015 10:09,1441127340,C7,266340,1441393680,9/4/2015 12:08
6230,20151724061714-521,1,9/3/2015 1:57,1441270620,C7,121200,1441391820,9/4/2015 11:37
3951,20151322091316-1,2,8/29/2015 22:51,1440913860,C8,476040,1441389900,9/4/2015 11:05
5378,20150920110938-724,2,8/30/2015 9:41,1440952860,C3,429360,1441382220,9/4/2015 8:57
5767,20151412091419-116,1,8/29/2015 8:50,1440863400,C0,518220,1441381620,9/4/2015 8:47
3450,20152102122135-146,2,8/28/2015 6:29,1440768540,C2,612960,1441381500,9/4/2015 8:45
5831,20155631105647-912,2,8/30/2015 8:50,1440949800,C6,430740,1441380540,9/4/2015 8:29
1266,20151518051530-830,1,9/1/2015 13:30,1441139400,C8,239220,1441378620,9/4/2015 7:57
2538,20152527022531-64,2,9/3/2015 10:01,1441299660,C2,73620,1441373280,9/4/2015 6:28
2972,20154007124035-405,2,8/27/2015 22:04,1440738240,C3,634320,1441372560,9/4/2015 6:16
1699,20155530055509-649,2,9/3/2015 11:05,1441303500,C8,64200,1441367700,9/4/2015 4:55
2932,20154928074942-377,1,9/1/2015 21:33,1441168380,C5,197520,1441365900,9/4/2015 4:25
5614,20155704015757-89,1,8/28/2015 8:05,1440774300,C3,591360,1441365660,9/4/2015 4:21
5797,20154518064540-758,1,8/29/2015 13:07,1440878820,C3,486660,1441365480,9/4/2015 4:18
5926,20154923124957-839,2,9/1/2015 6:25,1441113900,C0,251520,1441365420,9/4/2015 4:17
5340,20151625021614-449,1,8/27/2015 7:52,1440687120,C0,677520,1441364640,9/4/2015 4:04
3936,20152229092222-160,2,9/2/2015 5:24,1441196640,C5,165660,1441362300,9/4/2015 3:25
2966,20150311040359-426,1,9/1/2015 3:55,1441104900,C5,252960,1441357860,9/4/2015 2:11
1921,20150707020749-480,2,9/1/2015 0:47,1441093620,C2,264000,1441357620,9/4/2015 2:07
919,20154626024603-797,1,9/1/2015 6:18,1441113480,C3,243960,1441357440,9/4/2015 2:04
5275,20155218085224-640,2,8/29/2015 2:34,1440840840,C8,515160,1441356000,9/4/2015 1:40
6430,20155922045952-606,2,9/2/2015 12:34,1441222440,C5,133500,1441355940,9/4/2015 1:39
2601,20154618074635-802,2,8/26/2015 16:29,1440631740,C6,722580,1441354320,9/4/2015 1:12
3261,20150907070922-234,1,8/28/2015 12:21,1440789660,C0,563940,1441353600,9/4/2015 1:00
3014,20153029033048-19,2,9/3/2015 10:26,1441301160,C5,51720,1441352880,9/4/2015 0:48
275,20155303125317-749,1,8/27/2015 4:20,1440674400,C4,674460,1441348860,9/3/2015 23:41
6141,20152531032502-40,2,9/2/2015 20:53,1441252380,C2,96240,1441348620,9/3/2015 23:37
1127,20150423020418-599,2,8/31/2015 4:20,1441020000,C8,328080,1441348080,9/3/2015 23:28
3874,20152004122028-933,1,8/28/2015 3:32,1440757920,C5,590040,1441347960,9/3/2015 23:26
2985,20150212030241-721,2,8/29/2015 1:02,1440835320,C3,512100,1441347420,9/3/2015 23:17
4390,20154529014544-620,1,9/3/2015 1:40,1441269600,C8,77700,1441347300,9/3/2015 23:15
1958,20152030102012-63,1,9/1/2015 16:40,1441150800,C0,195600,1441346400,9/3/2015 23:00
4382,20155731065708-964,2,9/2/2015 17:33,1441240380,C5,105480,1441345860,9/3/2015 22:51
2659,20150825110832-749,1,8/29/2015 21:03,1440907380,C5,437100,1441344480,9/3/2015 22:28
4454,20150501030502-599,3,9/3/2015 3:59,1441277940,C0,66420,1441344360,9/3/2015 22:26
3715,20152731032706-323,1,9/2/2015 20:05,1441249500,C7,94740,1441344240,9/3/2015 22:24
5255,20152028032005-469,2,9/1/2015 19:58,1441162680,C4,181140,1441343820,9/3/2015 22:17
2476,20155930115903-142,1,9/1/2015 16:53,1441151580,C4,190440,1441342020,9/3/2015 21:47
1791,20155627075627-902,2,9/1/2015 8:54,1441122840,C8,217740,1441340580,9/3/2015 21:23
2268,20154418044437-34,2,9/1/2015 20:42,1441165320,C5,174840,1441340160,9/3/2015 21:16
4558,20152228112223-26,1,9/1/2015 16:58,1441151880,C5,182880,1441334760,9/3/2015 19:46
4742,20152014122034-385,1,8/27/2015 10:56,1440698160,C6,632760,1441330920,9/3/2015 18:42
5198,20152529022528-642,2,9/2/2015 11:28,1441218480,C5,111660,1441330140,9/3/2015 18:29
1712,20153912093939-687,1,8/27/2015 7:19,1440685140,C4,643800,1441328940,9/3/2015 18:09
5616,20152501072548-463,3,8/30/2015 13:45,1440967500,C7,361200,1441328700,9/3/2015 18:05
2534,20153930123905-665,1,9/1/2015 15:18,1441145880,C6,182340,1441328220,9/3/2015 17:57
3228,20155624045618-21,1,8/26/2015 20:24,1440645840,C0,681960,1441327800,9/3/2015 17:50
5452,20153827023814-492,1,8/29/2015 23:19,1440915540,C8,411780,1441327320,9/3/2015 17:42
1397,20150628010656-511,3,9/3/2015 0:18,1441264680,C5,59040,1441323720,9/3/2015 16:42
1527,20155627015611-22,1,9/1/2015 21:53,1441169580,C5,153540,1441323120,9/3/2015 16:32
4326,20150230100245-923,2,9/1/2015 13:01,1441137660,C6,183540,1441321200,9/3/2015 16:00
1721,20153426033412-312,3,8/30/2015 15:34,1440974040,C3,345600,1441319640,9/3/2015 15:34
4863,20152824082829-991,3,8/31/2015 23:52,1441090320,C4,220080,1441310400,9/3/2015 13:00
4634,20153731113748-614,3,9/2/2015 12:17,1441221420,C4,87600,1441309020,9/3/2015 12:37
5908,20153228043201-577,2,8/30/2015 10:08,1440954480,C2,353520,1441308000,9/3/2015 12:20
2885,20151308041318-416,1,8/31/2015 6:36,1441028160,C3,278940,1441307100,9/3/2015 12:05
240,20152925092904-816,1,8/31/2015 10:37,1441042620,C8,261240,1441303860,9/3/2015 11:11
5894,20153912083903-728,1,9/1/2015 0:07,1441091220,C2,212160,1441303380,9/3/2015 11:03
3711,20150030120002-677,2,9/2/2015 3:14,1441188840,C5,113820,1441302660,9/3/2015 10:51
2934,20151917071938-502,1,9/1/2015 7:00,1441116000,C4,184980,1441300980,9/3/2015 10:23
5246,20152819072857-484,2,8/25/2015 22:32,1440567120,C2,730380,1441297500,9/3/2015 9:25
486,20150503080511-131,2,8/29/2015 22:53,1440913980,C6,383280,1441297260,9/3/2015 9:21
6173,20154310044352-738,1,8/31/2015 9:43,1441039380,C3,255600,1441294980,9/3/2015 8:43
5558,20152030042019-172,3,9/1/2015 12:10,1441134600,C4,157800,1441292400,9/3/2015 8:00
3700,20152327092353-670,3,8/30/2015 20:08,1440990480,C1,297900,1441288380,9/3/2015 6:53
1436,20151302121348-104,1,8/31/2015 2:37,1441013820,C7,274560,1441288380,9/3/2015 6:53
141,20155331025312-334,1,9/2/2015 14:47,1441230420,C0,57480,1441287900,9/3/2015 6:45
6251,20153529063501-322,2,8/31/2015 18:27,1441070820,C4,215520,1441286340,9/3/2015 6:19
4218,20150104120123-255,2,8/30/2015 13:00,1440964800,C7,321420,1441286220,9/3/2015 6:17
4407,20151531031549-230,1,9/2/2015 9:01,1441209660,C8,75180,1441284840,9/3/2015 5:54
1302,20152701112759-138,1,8/26/2015 6:12,1440594720,C7,688500,1441283220,9/3/2015 5:27
1308,20150624120647-627,3,8/28/2015 9:24,1440779040,C6,502380,1441281420,9/3/2015 4:57
5582,20155904105919-416,1,8/29/2015 5:54,1440852840,C8,428340,1441281180,9/3/2015 4:53
6292,20155625025623-196,3,9/2/2015 5:36,1441197360,C5,82200,1441279560,9/3/2015 4:26
4283,20152822082859-49,3,9/1/2015 20:12,1441163520,C5,113280,1441276800,9/3/2015 3:40
3323,20155820075838-714,1,8/31/2015 7:58,1441033080,C5,241920,1441275000,9/3/2015 3:10
202,20155531065512-853,2,8/29/2015 21:04,1440907440,C3,365220,1441272660,9/3/2015 2:31
3554,20155413065431-352,1,8/31/2015 12:03,1441047780,C5,224820,1441272600,9/3/2015 2:30
4003,20150831110802-88,1,9/1/2015 18:48,1441158480,C2,114000,1441272480,9/3/2015 2:28
618,20152202022209-169,1,8/26/2015 6:45,1440596700,C0,674940,1441271640,9/3/2015 2:14
355,20150524010519-501,2,9/2/2015 0:25,1441178700,C4,91500,1441270200,9/3/2015 1:50
3125,20152630092647-226,1,9/1/2015 20:14,1441163640,C7,105840,1441269480,9/3/2015 1:38
5433,20153130073133-253,3,8/26/2015 20:35,1440646500,C0,621480,1441267980,9/3/2015 1:13
1092,20154627014626-335,2,8/29/2015 6:56,1440856560,C0,403800,1441260360,9/2/2015 23:06
5714,20155415015459-549,1,8/24/2015 0:29,1440401340,C7,857100,1441258440,9/2/2015 22:34
5389,20151515101538-806,1,8/31/2015 21:11,1441080660,C5,177720,1441258380,9/2/2015 22:33
1265,20151620061621-385,1,8/29/2015 9:02,1440864120,C4,393780,1441257900,9/2/2015 22:25
4473,20150831020803-228,1,9/1/2015 18:11,1441156260,C2,100980,1441257240,9/2/2015 22:14
3682,20154928054922-765,1,9/1/2015 4:31,1441107060,C4,148860,1441255920,9/2/2015 21:52
4449,20152027042059-327,1,8/31/2015 19:58,1441076280,C7,179340,1441255620,9/2/2015 21:47
766,20153516103511-94,1,8/31/2015 21:31,1441081860,C6,166920,1441248780,9/2/2015 19:53
171,20154930084931-614,1,9/1/2015 22:19,1441171140,C0,73800,1441244940,9/2/2015 18:49
5895,20152208112234-845,1,8/25/2015 8:16,1440515760,C8,728820,1441244580,9/2/2015 18:43
4433,20154629034625-561,1,9/1/2015 17:58,1441155480,C5,89040,1441244520,9/2/2015 18:42
2301,20151907011919-265,1,8/25/2015 0:53,1440489180,C4,755220,1441244400,9/2/2015 18:40
5041,20155027025003-704,1,8/31/2015 16:32,1441063920,C8,175860,1441239780,9/2/2015 17:23
2911,20150715010737-325,3,8/27/2015 15:49,1440715740,C2,523260,1441239000,9/2/2015 17:10
6509,20151230091228-162,1,9/1/2015 14:10,1441141800,C8,95340,1441237140,9/2/2015 16:39
5598,20150724070715-550,3,9/1/2015 15:15,1441145700,C4,90060,1441235760,9/2/2015 16:16
5837,20150807080814-971,1,8/29/2015 6:53,1440856380,C8,379260,1441235640,9/2/2015 16:14
5097,20155622015608-652,1,8/28/2015 23:08,1440828480,C5,403740,1441232220,9/2/2015 15:17
793,20153603053623-213,1,8/29/2015 19:17,1440901020,C5,321780,1441222800,9/2/2015 12:40
4785,20154716114727-41,2,8/31/2015 14:59,1441058340,C6,163440,1441221780,9/2/2015 12:23
2312,20155431095434-843,1,9/1/2015 11:00,1441130400,C4,90360,1441220760,9/2/2015 12:06
3244,20151413091400-23,3,8/30/2015 3:09,1440929340,C8,289380,1441218720,9/2/2015 11:32
1496,20154311034317-220,1,8/29/2015 20:13,1440904380,C8,314280,1441218660,9/2/2015 11:31
2382,20152827022858-442,2,8/31/2015 12:22,1441048920,C2,169020,1441217940,9/2/2015 11:19
1649,20153924093924-473,1,9/1/2015 7:35,1441118100,C5,97680,1441215780,9/2/2015 10:43
2978,20154323084319-194,2,8/30/2015 1:55,1440924900,C5,290160,1441215060,9/2/2015 10:31
1081,20153122043149-695,2,8/30/2015 17:31,1440981060,C0,231600,1441212660,9/2/2015 9:51
4360,20152129102109-855,2,9/1/2015 1:17,1441095420,C8,113280,1441208700,9/2/2015 8:45
2701,20152719102718-287,1,8/26/2015 9:33,1440606780,C2,601560,1441208340,9/2/2015 8:39
3833,20150316010332-387,1,8/28/2015 0:23,1440746580,C2,458700,1441205280,9/2/2015 7:48
3967,20151722021752-58,1,8/30/2015 15:14,1440972840,C5,231540,1441204380,9/2/2015 7:33
5293,20152430012458-590,1,8/29/2015 1:41,1440837660,C2,364260,1441201920,9/2/2015 6:52
6541,20153828103812-353,1,9/1/2015 1:38,1441096680,C2,104400,1441201080,9/2/2015 6:38
2850,20155023025023-616,3,9/1/2015 1:15,1441095300,C8,104100,1441199400,9/2/2015 6:10
224,20154024034000-968,2,8/30/2015 7:40,1440945600,C3,244800,1441190400,9/2/2015 3:40
2961,20151113081103-202,1,8/26/2015 18:52,1440640320,C5,548580,1441188900,9/2/2015 3:15
5152,20154325074316-323,2,8/30/2015 12:39,1440963540,C8,224880,1441188420,9/2/2015 3:07
245,20152919082940-780,2,8/28/2015 12:21,1440789660,C4,395760,1441185420,9/2/2015 2:17
1932,20150530010559-140,2,8/31/2015 19:39,1441075140,C0,110040,1441185180,9/2/2015 2:13
5780,20152328082316-929,1,8/31/2015 12:05,1441047900,C5,136260,1441184160,9/2/2015 1:56
2224,20152814122805-968,2,8/26/2015 20:58,1440647880,C0,533700,1441181580,9/2/2015 1:13
5553,20153031103041-989,1,9/1/2015 5:42,1441111320,C6,69120,1441180440,9/2/2015 0:54
1224,20152027102031-111,2,8/31/2015 14:47,1441057620,C4,120540,1441178160,9/2/2015 0:16
3499,20150929090940-494,1,8/31/2015 19:03,1441072980,C5,104220,1441177200,9/2/2015 0:00
5949,20151630081603-922,1,8/21/2015 18:36,1440207360,C4,969000,1441176360,9/1/2015 23:46
315,20153624093600-684,1,8/28/2015 14:00,1440795600,C5,379980,1441175580,9/1/2015 23:33
5353,20152504102511-329,2,8/18/2015 1:31,1439886660,C4,1285320,1441171980,9/1/2015 22:33
1681,20153803043831-603,2,8/29/2015 5:50,1440852600,C8,315360,1441167960,9/1/2015 21:26
5994,20150019010055-677,1,8/29/2015 13:12,1440879120,C4,288240,1441167360,9/1/2015 21:16
3668,20155009105054-571,2,8/25/2015 1:46,1440492360,C2,674880,1441167240,9/1/2015 21:14
782,20154918094949-366,1,8/25/2015 15:30,1440541800,C2,625260,1441167060,9/1/2015 21:11
367,20154330014342-384,2,8/28/2015 16:54,1440806040,C8,359580,1441165620,9/1/2015 20:47
1807,20152009032045-131,3,8/25/2015 2:34,1440495240,C0,668220,1441163460,9/1/2015 20:11
3924,20153629103642-718,2,8/31/2015 16:38,1441064280,C8,97260,1441161540,9/1/2015 19:39
3176,20153115083101-873,1,8/30/2015 7:19,1440944340,C6,215280,1441159620,9/1/2015 19:07
3818,20150122110107-735,2,8/29/2015 8:11,1440861060,C4,297300,1441158360,9/1/2015 18:46
3671,20153220053251-142,3,8/25/2015 14:32,1440538320,C8,619920,1441158240,9/1/2015 18:44
4397,20153926083902-744,2,8/29/2015 13:37,1440880620,C6,277080,1441157700,9/1/2015 18:35
1966,20155330035349-797,1,8/31/2015 17:06,1441065960,C2,90780,1441156740,9/1/2015 18:19
1313,20150917020950-55,3,8/27/2015 16:51,1440719460,C8,436860,1441156320,9/1/2015 18:12
586,20154227124221-606,1,8/31/2015 0:20,1441005600,C8,150540,1441156140,9/1/2015 18:09
5044,20150024110036-855,1,8/22/2015 22:18,1440307080,C3,848760,1441155840,9/1/2015 18:04
2376,20151409101410-293,2,8/29/2015 20:00,1440903600,C4,251880,1441155480,9/1/2015 17:58
6530,20151722061712-453,1,8/29/2015 5:55,1440852900,C5,301740,1441154640,9/1/2015 17:44
4425,20152202052214-494,1,8/25/2015 22:58,1440568680,C4,585720,1441154400,9/1/2015 17:40
2418,20153430083434-174,1,8/28/2015 13:30,1440793800,C0,360480,1441154280,9/1/2015 17:38
3175,20154606044639-126,3,8/24/2015 0:54,1440402840,C3,749040,1441151880,9/1/2015 16:58
2208,20153122113109-139,3,8/29/2015 7:01,1440856860,C2,294300,1441151160,9/1/2015 16:46
4483,20150619060603-933,1,8/25/2015 6:36,1440509760,C8,639720,1441149480,9/1/2015 16:18
4860,20154120094138-417,2,8/28/2015 13:53,1440795180,C0,353160,1441148340,9/1/2015 15:59
805,20155602045649-200,1,8/22/2015 15:58,1440284280,C4,862260,1441146540,9/1/2015 15:29
5299,20155123015147-690,2,8/30/2015 8:48,1440949680,C5,195540,1441145220,9/1/2015 15:07
2828,20151724031732-555,1,8/27/2015 18:03,1440723780,C7,421080,1441144860,9/1/2015 15:01
3798,20155328105351-17,2,8/31/2015 5:29,1441024140,C3,119880,1441144020,9/1/2015 14:47
4059,20150219040226-843,1,8/23/2015 8:45,1440344700,C5,798540,1441143240,9/1/2015 14:34
3297,20154124024130-878,1,8/29/2015 21:27,1440908820,C5,228180,1441137000,9/1/2015 12:50
2481,20153026053028-239,2,8/30/2015 13:40,1440967200,C8,165900,1441133100,9/1/2015 11:45
1218,20153819103829-614,1,8/27/2015 13:02,1440705720,C6,422280,1441128000,9/1/2015 10:20
3974,20152219112242-277,1,8/28/2015 1:44,1440751440,C4,371460,1441122900,9/1/2015 8:55
4936,20154623094608-73,2,8/29/2015 9:00,1440864000,C7,257820,1441121820,9/1/2015 8:37
4074,20154527054509-903,1,8/28/2015 9:37,1440779820,C3,341940,1441121760,9/1/2015 8:36
2948,20155730045709-115,1,8/31/2015 12:44,1441050240,C2,71220,1441121460,9/1/2015 8:31
5087,20151822111805-247,1,8/31/2015 5:58,1441025880,C5,94800,1441120680,9/1/2015 8:18
1365,20150326050302-149,2,8/30/2015 11:07,1440958020,C7,162120,1441120140,9/1/2015 8:09
2309,20150507060531-534,1,8/10/2015 19:29,1439260140,C0,1859280,1441119420,9/1/2015 7:57
3960,20153930043916-979,1,8/24/2015 4:06,1440414360,C3,704940,1441119300,9/1/2015 7:55
1010,20152801102848-547,2,8/28/2015 20:52,1440820320,C2,296280,1441116600,9/1/2015 7:10
552,20151024111054-335,3,8/30/2015 23:35,1441002900,C8,112620,1441115520,9/1/2015 6:52
1393,20152224012227-459,3,8/27/2015 23:30,1440743400,C5,371760,1441115160,9/1/2015 6:46
2986,20151705091722-67,3,8/25/2015 20:13,1440558780,C5,555720,1441114500,9/1/2015 6:35
563,20150728080743-392,1,8/31/2015 6:55,1441029300,C0,84960,1441114260,9/1/2015 6:31
6168,20150724060708-783,2,8/29/2015 13:59,1440881940,C5,230160,1441112100,9/1/2015 5:55
4225,20155727045735-743,3,8/31/2015 2:27,1441013220,C4,97800,1441111020,9/1/2015 5:37
5517,20151511111500-654,3,8/25/2015 7:25,1440512700,C7,597900,1441110600,9/1/2015 5:30
3195,20150429050401-796,2,8/31/2015 8:58,1441036680,C2,71820,1441108500,9/1/2015 4:55
2037,20155029035009-826,1,8/27/2015 23:06,1440741960,C8,361680,1441103640,9/1/2015 3:34
2586,20151122081111-220,1,8/31/2015 1:23,1441009380,C4,94140,1441103520,9/1/2015 3:32
1382,20152619072610-850,2,8/25/2015 17:24,1440548640,C2,554280,1441102920,9/1/2015 3:22
3821,20150602070645-93,1,8/24/2015 15:18,1440454680,C5,643440,1441098120,9/1/2015 2:02
6127,20150914080950-53,1,8/30/2015 2:41,1440927660,C5,170340,1441098000,9/1/2015 2:00
5623,20152813042852-20,2,8/27/2015 11:22,1440699720,C0,397080,1441096800,9/1/2015 1:40
4005,20153129033116-421,1,8/28/2015 8:27,1440775620,C4,320820,1441096440,9/1/2015 1:34
2234,20154429034402-935,3,8/30/2015 20:35,1440992100,C6,103860,1441095960,9/1/2015 1:26
3636,20150002120037-795,1,8/28/2015 18:08,1440810480,C5,283560,1441094040,9/1/2015 0:54
421,20154421024437-278,2,8/26/2015 19:45,1440643500,C0,450060,1441093560,9/1/2015 0:46
3354,20151025061010-490,2,8/25/2015 20:10,1440558600,C2,532080,1441090680,8/31/2015 23:58
132,20155227095221-937,1,8/29/2015 16:53,1440892380,C4,198060,1441090440,8/31/2015 23:54
4082,20152507082537-2,1,8/27/2015 21:10,1440735000,C8,354780,1441089780,8/31/2015 23:43
1252,20154024064023-567,1,8/20/2015 12:25,1440098700,C8,989100,1441087800,8/31/2015 23:10
3752,20152122042102-592,3,8/28/2015 20:45,1440819900,C7,267120,1441087020,8/31/2015 22:57
4236,20150610080607-677,1,8/29/2015 13:02,1440878520,C6,207420,1441085940,8/31/2015 22:39
72,20153601023624-894,1,8/21/2015 19:40,1440211200,C3,873120,1441084320,8/31/2015 22:12
321,20155305065314-246,1,8/28/2015 23:01,1440828060,C3,255660,1441083720,8/31/2015 22:02
5906,20150411110416-875,1,8/25/2015 10:49,1440524940,C4,555300,1441080240,8/31/2015 21:04
785,20150017120055-53,2,8/27/2015 1:50,1440665400,C3,413700,1441079100,8/31/2015 20:45
1716,20151717021725-292,1,8/20/2015 13:02,1440100920,C2,977700,1441078620,8/31/2015 20:37
3493,20152031042004-676,2,8/27/2015 22:43,1440740580,C4,336540,1441077120,8/31/2015 20:12
2146,20150423050415-924,1,8/30/2015 21:36,1440995760,C5,77640,1441073400,8/31/2015 19:10
2975,20152415082432-673,2,8/26/2015 7:24,1440599040,C8,473400,1441072440,8/31/2015 18:54
3257,20155920065907-68,2,8/30/2015 8:22,1440948120,C7,124140,1441072260,8/31/2015 18:51
4638,20152221092251-883,2,8/28/2015 7:36,1440772560,C7,299220,1441071780,8/31/2015 18:43
6058,20152726012729-506,2,8/30/2015 0:31,1440919860,C8,149520,1441069380,8/31/2015 18:03
5372,20151502101538-958,1,8/26/2015 20:00,1440644400,C8,421740,1441066140,8/31/2015 17:09
5524,20155304125320-819,1,8/28/2015 16:29,1440804540,C2,260820,1441065360,8/31/2015 16:56
2634,20150307050341-35,3,8/28/2015 16:56,1440806160,C7,259140,1441065300,8/31/2015 16:55
3013,20154021074026-934,1,8/28/2015 5:46,1440765960,C8,298980,1441064940,8/31/2015 16:49
1096,20153329013347-72,2,8/30/2015 23:29,1441002540,C7,61080,1441063620,8/31/2015 16:27
301,20150424020445-861,2,8/29/2015 7:10,1440857400,C8,203580,1441060980,8/31/2015 15:43
5271,20155703055749-564,1,8/12/2015 0:13,1439363580,C8,1696080,1441059660,8/31/2015 15:21
3025,20154212104211-65,1,8/29/2015 5:26,1440851160,C4,207120,1441058280,8/31/2015 14:58
5187,20150109100114-5,3,8/29/2015 3:29,1440844140,C5,213060,1441057200,8/31/2015 14:40
1678,20151326031310-457,1,8/30/2015 17:53,1440982380,C8,71040,1441053420,8/31/2015 13:37
4444,20153112113145-165,2,8/25/2015 4:09,1440500940,C2,548340,1441049280,8/31/2015 12:28
3539,20155813025810-185,3,8/29/2015 11:54,1440874440,C4,171420,1441045860,8/31/2015 11:31
4533,20154423044431-936,2,8/27/2015 13:50,1440708600,C0,335160,1441043760,8/31/2015 10:56
2834,20155308105343-910,1,8/27/2015 14:28,1440710880,C8,330900,1441041780,8/31/2015 10:23
1760,20150224010242-67,1,8/29/2015 2:52,1440841920,C8,197700,1441039620,8/31/2015 9:47
1296,20155629035637-921,1,8/30/2015 12:04,1440961440,C6,72480,1441033920,8/31/2015 8:12
3390,20154728064727-282,3,8/27/2015 1:50,1440665400,C5,367740,1441033140,8/31/2015 7:59
3163,20152603092611-468,1,8/22/2015 0:14,1440227640,C4,804240,1441031880,8/31/2015 7:38
1233,20152031082031-756,1,8/20/2015 23:32,1440138720,C4,891360,1441030080,8/31/2015 7:08
2952,20150024010045-514,3,8/27/2015 21:53,1440737580,C6,291180,1441028760,8/31/2015 6:46
1300,20153312023359-569,1,8/21/2015 22:35,1440221700,C3,806520,1441028220,8/31/2015 6:37
4715,20150121060147-159,1,8/27/2015 22:19,1440739140,C8,288540,1441027680,8/31/2015 6:28
4359,20150105090139-623,1,8/24/2015 3:06,1440410760,C0,614100,1441024860,8/31/2015 5:41
4192,20150922090902-582,3,8/27/2015 5:33,1440678780,C7,344160,1441022940,8/31/2015 5:09
1418,20150129070156-888,1,8/27/2015 2:09,1440666540,C4,355440,1441021980,8/31/2015 4:53
5787,20152119062102-718,1,8/29/2015 16:50,1440892200,C4,128820,1441021020,8/31/2015 4:37
4081,20152220092213-786,3,8/25/2015 18:53,1440553980,C2,466260,1441020240,8/31/2015 4:24
2447,20151416101425-25,2,8/26/2015 6:16,1440594960,C5,424860,1441019820,8/31/2015 4:17
1206,20151728041704-292,1,8/29/2015 22:07,1440911220,C0,107400,1441018620,8/31/2015 3:57
5531,20150827120843-66,1,8/29/2015 22:30,1440912600,C4,105060,1441017660,8/31/2015 3:41
1342,20151626071648-759,1,8/29/2015 12:20,1440876000,C5,138720,1441014720,8/31/2015 2:52
2054,20155323065317-442,1,8/28/2015 11:43,1440787380,C3,224700,1441012080,8/31/2015 2:08
2406,20155618075600-258,1,8/29/2015 16:04,1440889440,C4,122460,1441011900,8/31/2015 2:05
5355,20155418015419-112,1,8/26/2015 21:40,1440650400,C7,359580,1441009980,8/31/2015 1:33
189,20153115123154-557,1,8/25/2015 20:51,1440561060,C4,447000,1441008060,8/31/2015 1:01
38,20155520105535-51,1,8/25/2015 20:03,1440558180,C8,449040,1441007220,8/31/2015 0:47
3522,20151315121331-773,1,8/23/2015 6:28,1440336480,C0,670500,1441006980,8/31/2015 0:43
6260,20155616035612-493,1,8/25/2015 8:17,1440515820,C8,489780,1441005600,8/31/2015 0:20
4368,20150804090809-57,2,8/28/2015 0:44,1440747840,C2,255420,1441003260,8/30/2015 23:41
3758,20150123100107-508,1,8/29/2015 17:06,1440893160,C8,108780,1441001940,8/30/2015 23:19
6191,20154422124407-513,1,8/28/2015 3:30,1440757800,C0,242580,1441000380,8/30/2015 22:53
4018,20155327095347-642,1,8/30/2015 0:53,1440921180,C5,75600,1440996780,8/30/2015 21:53
6056,20152412092409-540,2,8/22/2015 15:34,1440282840,C8,712920,1440995760,8/30/2015 21:36
3089,20153326053328-53,1,8/29/2015 20:18,1440904680,C4,89700,1440994380,8/30/2015 21:13
5669,20152826092847-177,1,8/29/2015 18:04,1440896640,C5,96720,1440993360,8/30/2015 20:56
347,20154122034142-353,2,8/28/2015 2:45,1440755100,C8,235920,1440991020,8/30/2015 20:17
2412,20151624101641-279,3,8/30/2015 0:05,1440918300,C8,68820,1440987120,8/30/2015 19:12
3433,20153123063116-913,2,8/28/2015 6:01,1440766860,C5,215100,1440981960,8/30/2015 17:46
1053,20153024123008-70,1,8/28/2015 15:54,1440802440,C5,178920,1440981360,8/30/2015 17:36
3286,20150721050735-636,3,8/29/2015 5:27,1440851220,C8,129840,1440981060,8/30/2015 17:31
80,20152424092415-398,2,8/28/2015 14:42,1440798120,C3,182340,1440980460,8/30/2015 17:21
2368,20155427055429-500,1,8/29/2015 17:02,1440892920,C7,84840,1440977760,8/30/2015 16:36
5514,20155717125750-508,1,8/26/2015 6:55,1440597300,C2,377940,1440975240,8/30/2015 15:54
875,20152826112825-682,3,8/29/2015 6:24,1440854640,C8,120480,1440975120,8/30/2015 15:52
6,20155924055911-559,1,8/27/2015 16:42,1440718920,C3,254580,1440973500,8/30/2015 15:25
5632,20153216013236-330,2,8/25/2015 22:46,1440567960,C5,405420,1440973380,8/30/2015 15:23
2241,20152504042522-96,2,8/23/2015 12:15,1440357300,C8,615000,1440972300,8/30/2015 15:05
5719,20153521053544-115,3,8/27/2015 15:49,1440715740,C8,256020,1440971760,8/30/2015 14:56
5457,20153802063824-325,3,8/23/2015 4:52,1440330720,C8,640920,1440971640,8/30/2015 14:54
736,20150421090407-354,2,8/29/2015 10:37,1440869820,C7,99540,1440969360,8/30/2015 14:16
5223,20150024120056-588,1,8/28/2015 13:28,1440793680,C3,175440,1440969120,8/30/2015 14:12
1834,20153324083347-572,2,8/18/2015 3:53,1439895180,C2,1071600,1440966780,8/30/2015 13:33
574,20155320075307-202,1,8/27/2015 3:33,1440671580,C5,294600,1440966180,8/30/2015 13:23
103,20151804021836-532,1,8/21/2015 21:40,1440218400,C5,747660,1440966060,8/30/2015 13:21
2321,20150223110259-667,1,8/29/2015 15:40,1440888000,C2,76440,1440964440,8/30/2015 12:54
6459,20155813075840-171,2,8/25/2015 4:14,1440501240,C2,462720,1440963960,8/30/2015 12:46
253,20155101045148-763,2,8/26/2015 21:39,1440650340,C5,311040,1440961380,8/30/2015 12:03
813,20152522062547-875,1,8/26/2015 9:07,1440605220,C2,355320,1440960540,8/30/2015 11:49
5720,20155114015106-386,2,8/28/2015 4:03,1440759780,C6,195720,1440955500,8/30/2015 10:25
6442,20150210100228-734,1,8/25/2015 9:59,1440521940,C2,431940,1440953880,8/30/2015 9:58
88,20155627105645-424,3,8/29/2015 9:58,1440867480,C5,84660,1440952140,8/30/2015 9:29
5001,20154115124146-703,3,8/26/2015 15:53,1440629580,C4,320640,1440950220,8/30/2015 8:57
92,20152125092114-567,1,8/26/2015 8:17,1440602220,C5,345120,1440947340,8/30/2015 8:09
6083,20152502062553-799,3,8/16/2015 6:44,1439732640,C3,1210740,1440943380,8/30/2015 7:03
3040,20150227050213-13,1,8/29/2015 9:36,1440866160,C7,73020,1440939180,8/30/2015 5:53
2314,20153706123730-475,2,8/16/2015 2:47,1439718420,C8,1219800,1440938220,8/30/2015 5:37
3172,20154809114818-832,1,8/28/2015 2:48,1440755280,C7,178800,1440934080,8/30/2015 4:28
5061,20154211064241-592,1,8/23/2015 22:15,1440393300,C4,538740,1440932040,8/30/2015 3:54
5270,20150227060225-629,2,8/28/2015 16:20,1440804000,C4,123480,1440927480,8/30/2015 2:38
5485,20151415121445-482,1,8/25/2015 4:36,1440502560,C5,418260,1440920820,8/30/2015 0:47
5029,20152017102041-706,3,8/28/2015 15:08,1440799680,C0,120960,1440920640,8/30/2015 0:44
4574,20153317043306-904,3,8/28/2015 11:19,1440785940,C8,133080,1440919020,8/30/2015 0:17
5555,20154614114643-419,1,8/24/2015 19:42,1440470520,C8,446280,1440916800,8/29/2015 23:40
1826,20154222064210-989,2,8/27/2015 9:54,1440694440,C4,221760,1440916200,8/29/2015 23:30
1464,20150720100758-108,2,8/28/2015 18:33,1440811980,C7,103080,1440915060,8/29/2015 23:11
2598,20155526015529-809,1,8/28/2015 20:05,1440817500,C5,97500,1440915000,8/29/2015 23:10
744,20151521031525-991,1,8/27/2015 3:31,1440671460,C2,238080,1440909540,8/29/2015 21:39
544,20153526043555-14,1,8/24/2015 3:40,1440412800,C8,491820,1440904620,8/29/2015 20:17
1283,20151025031037-733,1,8/21/2015 0:37,1440142620,C4,760140,1440902760,8/29/2015 19:46
3053,20150223080232-126,2,8/27/2015 15:42,1440715320,C4,186600,1440901920,8/29/2015 19:32
1507,20151711071703-72,1,8/26/2015 17:22,1440634920,C8,266460,1440901380,8/29/2015 19:23
6370,20155511105504-943,1,8/20/2015 15:07,1440108420,C3,792720,1440901140,8/29/2015 19:19
489,20152325032338-563,2,8/27/2015 17:18,1440721080,C0,179700,1440900780,8/29/2015 19:13
1662,20153509113502-414,1,8/27/2015 12:31,1440703860,C4,194820,1440898680,8/29/2015 18:38
4893,20155822095826-155,2,8/27/2015 7:20,1440685200,C8,211260,1440896460,8/29/2015 18:01
1766,20155611055605-588,3,8/20/2015 17:40,1440117600,C6,776640,1440894240,8/29/2015 17:24
4974,20152731042731-228,3,8/19/2015 23:51,1440053460,C5,834120,1440887580,8/29/2015 15:33
5713,20150627100641-287,1,8/28/2015 12:47,1440791220,C2,96060,1440887280,8/29/2015 15:28
3034,20153711063717-524,1,8/27/2015 7:51,1440687060,C5,198120,1440885180,8/29/2015 14:53
5084,20154813034829-169,1,8/13/2015 22:48,1439531280,C8,1351800,1440883080,8/29/2015 14:18
2449,20150426010444-611,1,8/28/2015 13:50,1440795000,C7,87780,1440882780,8/29/2015 14:13
6132,20153808033819-967,3,8/20/2015 11:38,1440095880,C3,786600,1440882480,8/29/2015 14:08
4752,20155926125912-498,2,8/28/2015 13:41,1440794460,C4,87660,1440882120,8/29/2015 14:02
983,20151420051444-405,2,8/26/2015 14:14,1440623640,C2,253800,1440877440,8/29/2015 12:44
888,20154023064009-80,1,8/26/2015 9:37,1440607020,C2,269820,1440876840,8/29/2015 12:34
5850,20152815022839-704,1,8/24/2015 21:02,1440475320,C5,400620,1440875940,8/29/2015 12:19
1044,20152925102939-681,1,8/28/2015 11:38,1440787080,C3,87780,1440874860,8/29/2015 12:01
4054,20152101072110-270,1,8/20/2015 0:53,1440057180,C5,809160,1440866340,8/29/2015 9:39
3672,20152720112739-23,1,8/26/2015 10:11,1440609060,C4,256920,1440865980,8/29/2015 9:33
4087,20150415020406-610,3,8/27/2015 2:09,1440666540,C8,198780,1440865320,8/29/2015 9:22
6152,20150822040817-521,3,8/28/2015 5:48,1440766080,C8,96240,1440862320,8/29/2015 8:32
978,20152919122944-137,3,8/22/2015 13:09,1440274140,C8,588000,1440862140,8/29/2015 8:29
5879,20153804013823-112,1,8/21/2015 1:48,1440146880,C8,713100,1440859980,8/29/2015 7:53
3664,20152225022204-845,1,8/28/2015 8:52,1440777120,C2,79800,1440856920,8/29/2015 7:02
3488,20155123095125-681,2,8/20/2015 22:10,1440133800,C3,722220,1440856020,8/29/2015 6:47
2933,20153222073210-586,1,8/25/2015 18:56,1440554160,C4,300240,1440854400,8/29/2015 6:20
6164,20150527100509-549,2,8/28/2015 8:00,1440774000,C6,78900,1440852900,8/29/2015 5:55
2502,20150521040525-743,1,8/28/2015 9:17,1440778620,C4,72540,1440851160,8/29/2015 5:26
3159,20151122021140-914,1,8/28/2015 11:39,1440787140,C0,63660,1440850800,8/29/2015 5:20
984,20151924061918-27,2,8/27/2015 12:25,1440703500,C5,140580,1440844080,8/29/2015 3:28
1552,20153124063149-216,1,8/27/2015 21:49,1440737340,C3,104760,1440842100,8/29/2015 2:55
942,20152919022949-193,2,8/25/2015 22:27,1440566820,C5,273540,1440840360,8/29/2015 2:26
2143,20153914023947-993,1,8/24/2015 5:53,1440420780,C4,416220,1440837000,8/29/2015 1:30
4177,20153107103116-521,1,8/21/2015 20:11,1440213060,C8,622200,1440835260,8/29/2015 1:01
6266,20154716064735-828,3,8/27/2015 10:32,1440696720,C8,137700,1440834420,8/29/2015 0:47
1783,20150322110349-365,1,8/26/2015 20:05,1440644700,C2,189060,1440833760,8/29/2015 0:36
433,20150919080932-475,1,8/23/2015 21:55,1440392100,C4,439080,1440831180,8/28/2015 23:53
5060,20153926083915-568,3,8/13/2015 1:48,1439455680,C2,1374180,1440829860,8/28/2015 23:31
468,20151329101325-617,2,8/25/2015 13:33,1440534780,C5,293100,1440827880,8/28/2015 22:58
2433,20153631043604-397,2,8/25/2015 18:44,1440553440,C5,270960,1440824400,8/28/2015 22:00
5995,20152822122853-937,2,8/25/2015 16:50,1440546600,C4,274920,1440821520,8/28/2015 21:12
5117,20152015112055-777,1,8/24/2015 9:30,1440433800,C4,385500,1440819300,8/28/2015 20:35
1047,20150412070442-715,2,8/20/2015 13:32,1440102720,C4,714480,1440817200,8/28/2015 20:00
5580,20154115114122-286,1,8/24/2015 9:03,1440432180,C5,384060,1440816240,8/28/2015 19:44
4088,20153214063240-340,1,8/21/2015 12:49,1440186540,C6,627420,1440813960,8/28/2015 19:06
193,20154731044702-403,1,8/25/2015 6:18,1440508680,C8,303180,1440811860,8/28/2015 18:31
1395,20152723012751-951,1,8/27/2015 0:29,1440660540,C4,149460,1440810000,8/28/2015 18:00
4071,20155925095934-285,2,8/27/2015 15:11,1440713460,C5,95760,1440809220,8/28/2015 17:47
2829,20154515064509-76,2,8/25/2015 8:06,1440515160,C5,289620,1440804780,8/28/2015 16:33
913,20155525025541-454,1,8/24/2015 9:58,1440435480,C5,367740,1440803220,8/28/2015 16:07
1035,20151319061333-620,1,8/23/2015 14:51,1440366660,C4,436440,1440803100,8/28/2015 16:05
939,20153519023513-548,3,8/23/2015 15:24,1440368640,C2,432420,1440801060,8/28/2015 15:31
4365,20153914043919-947,1,8/23/2015 23:45,1440398700,C3,401580,1440800280,8/28/2015 15:18
6298,20154906094920-919,1,8/26/2015 3:57,1440586620,C3,213360,1440799980,8/28/2015 15:13
1429,20153906043931-40,2,8/25/2015 20:54,1440561240,C8,236700,1440797940,8/28/2015 14:39
3604,20151523031533-237,1,8/27/2015 20:57,1440734220,C6,61020,1440795240,8/28/2015 13:54
2049,20152218052241-425,1,8/23/2015 15:31,1440369060,C2,425340,1440794400,8/28/2015 13:40
3623,20154222034228-99,1,8/26/2015 14:16,1440623760,C8,170220,1440793980,8/28/2015 13:33
3730,20151116121132-353,1,8/25/2015 13:11,1440533460,C2,260400,1440793860,8/28/2015 13:31
3111,20153129013121-858,2,8/24/2015 19:17,1440469020,C5,323880,1440792900,8/28/2015 13:15
4609,20154519024544-322,2,8/26/2015 5:24,1440591840,C4,200880,1440792720,8/28/2015 13:12
4525,20150114070109-176,2,8/26/2015 23:09,1440655740,C5,136860,1440792600,8/28/2015 13:10
3222,20152925102911-696,3,8/24/2015 6:35,1440423300,C7,368280,1440791580,8/28/2015 12:53
2127,20155919125917-79,2,8/27/2015 9:10,1440691800,C0,96780,1440788580,8/28/2015 12:03
569,20152724032744-453,2,8/22/2015 16:32,1440286320,C8,501900,1440788220,8/28/2015 11:57
4724,20152021072036-530,2,8/26/2015 1:22,1440577320,C8,205260,1440782580,8/28/2015 10:23
2945,20154505014505-202,2,8/19/2015 2:33,1439976780,C6,804960,1440781740,8/28/2015 10:09
3258,20150121030143-599,1,8/26/2015 3:41,1440585660,C5,195600,1440781260,8/28/2015 10:01
665,20152003102027-431,1,8/22/2015 4:12,1440241920,C6,537240,1440779160,8/28/2015 9:26
5982,20153721043705-857,2,8/26/2015 3:37,1440585420,C4,192600,1440778020,8/28/2015 9:07
5130,20154320094352-113,3,8/27/2015 8:54,1440690840,C8,85980,1440776820,8/28/2015 8:47
814,20152204122238-160,2,8/22/2015 5:34,1440246840,C2,526140,1440772980,8/28/2015 7:43
1900,20151714061754-756,1,8/23/2015 14:19,1440364740,C4,403260,1440768000,8/28/2015 6:20
5592,20150422010448-761,1,8/23/2015 0:10,1440313800,C6,453060,1440766860,8/28/2015 6:01
1362,20152425092455-910,1,8/26/2015 19:37,1440643020,C2,123180,1440766200,8/28/2015 5:50
1203,20150511080548-765,3,8/23/2015 23:56,1440399360,C3,364620,1440763980,8/28/2015 5:13
4678,20151717061717-630,2,8/24/2015 13:23,1440447780,C4,315180,1440762960,8/28/2015 4:56
4731,20150809060853-307,2,8/25/2015 1:08,1440490080,C8,272880,1440762960,8/28/2015 4:56
2776,20154223044243-199,2,8/27/2015 13:12,1440706320,C6,55500,1440761820,8/28/2015 4:37
3748,20155825095843-923,2,8/27/2015 6:22,1440681720,C0,79920,1440761640,8/28/2015 4:34
2070,20155022075049-151,3,8/26/2015 5:24,1440591840,C1,168420,1440760260,8/28/2015 4:11
4542,20153925013947-835,3,8/26/2015 20:54,1440647640,C4,112500,1440760140,8/28/2015 4:09
3322,20150115060113-519,3,8/24/2015 21:31,1440477060,C2,277800,1440754860,8/28/2015 2:41
1578,20153517083522-960,2,8/22/2015 21:06,1440302760,C4,450780,1440753540,8/28/2015 2:19
1264,20153213013249-868,1,8/23/2015 5:42,1440333720,C5,417900,1440751620,8/28/2015 1:47
6073,20154927084959-505,2,8/17/2015 11:49,1439837340,C0,912600,1440749940,8/28/2015 1:19
3249,20153620083607-408,1,8/27/2015 4:20,1440674400,C6,73680,1440748080,8/28/2015 0:48
5247,20153205073220-30,1,8/16/2015 15:17,1439763420,C2,978300,1440741720,8/27/2015 23:02
2615,20155403015401-677,2,8/25/2015 5:38,1440506280,C2,233880,1440740160,8/27/2015 22:36
775,20153920073940-995,1,8/25/2015 9:33,1440520380,C8,219420,1440739800,8/27/2015 22:30
5170,20153223063219-462,1,8/25/2015 14:28,1440538080,C6,201360,1440739440,8/27/2015 22:24
1776,20155620045633-63,3,8/26/2015 2:59,1440583140,C4,156060,1440739200,8/27/2015 22:20
1589,20151714081717-477,3,8/26/2015 9:45,1440607500,C5,130260,1440737760,8/27/2015 21:56
1177,20153004013007-217,3,8/24/2015 0:20,1440400800,C8,336120,1440736920,8/27/2015 21:42
1813,20152026042055-270,1,8/24/2015 7:40,1440427200,C3,309300,1440736500,8/27/2015 21:35
3540,20152719032729-250,1,8/23/2015 18:29,1440379740,C0,356520,1440736260,8/27/2015 21:31
68,20151722051720-973,1,8/23/2015 21:01,1440388860,C3,347280,1440736140,8/27/2015 21:29
4622,20150409090411-319,1,8/21/2015 17:02,1440201720,C5,532740,1440734460,8/27/2015 21:01
4322,20153315073301-37,3,8/23/2015 16:01,1440370860,C8,360840,1440731700,8/27/2015 20:15
28,20153024053044-807,2,8/27/2015 1:24,1440663840,C2,67080,1440730920,8/27/2015 20:02
1643,20151625021627-767,2,8/26/2015 16:55,1440633300,C4,95940,1440729240,8/27/2015 19:34
1546,20155621035652-898,2,8/25/2015 18:02,1440550920,C8,176580,1440727500,8/27/2015 19:05
1470,20155220085241-907,1,8/26/2015 20:37,1440646620,C8,80100,1440726720,8/27/2015 18:52
5504,20150126050104-905,3,8/19/2015 17:52,1440031920,C5,692220,1440724140,8/27/2015 18:09
366,20155418075447-174,2,8/24/2015 14:42,1440452520,C5,271440,1440723960,8/27/2015 18:06
4107,20151926091952-816,3,8/22/2015 8:29,1440257340,C8,465960,1440723300,8/27/2015 17:55
2067,20151411101443-797,1,8/19/2015 19:59,1440039540,C8,680940,1440720480,8/27/2015 17:08
4693,20152307032337-327,1,8/20/2015 23:21,1440138060,C4,575940,1440714000,8/27/2015 15:20
1253,20155010025035-931,3,8/25/2015 11:57,1440529020,C5,183660,1440712680,8/27/2015 14:58
1425,20153322063352-729,2,8/23/2015 13:45,1440362700,C4,348840,1440711540,8/27/2015 14:39
1555,20150922030934-439,1,8/21/2015 13:54,1440190440,C8,517500,1440707940,8/27/2015 13:39
3665,20155624115628-693,1,8/23/2015 18:28,1440379680,C5,326940,1440706620,8/27/2015 13:17
1693,20150023030012-350,3,8/26/2015 5:46,1440593160,C7,112980,1440706140,8/27/2015 13:09
1671,20153320073331-255,1,8/23/2015 6:37,1440337020,C0,366780,1440703800,8/27/2015 12:30
3022,20153931123938-639,2,8/24/2015 11:27,1440440820,C6,258660,1440699480,8/27/2015 11:18
2249,20152207122249-225,3,8/25/2015 5:50,1440507000,C4,191460,1440698460,8/27/2015 11:01
5489,20155518075547-219,1,8/24/2015 9:17,1440433020,C5,261660,1440694680,8/27/2015 9:58
3480,20150909120927-426,1,8/18/2015 10:59,1439920740,C6,773400,1440694140,8/27/2015 9:49
4049,20150125080138-74,3,8/23/2015 6:25,1440336300,C7,357120,1440693420,8/27/2015 9:37
1129,20154812014855-638,2,8/25/2015 17:56,1440550560,C2,142260,1440692820,8/27/2015 9:27
4127,20150205030232-909,1,8/20/2015 3:18,1440065880,C8,626880,1440692760,8/27/2015 9:26
119,20153723103750-402,3,8/25/2015 9:48,1440521280,C0,169860,1440691140,8/27/2015 8:59
5596,20154424084414-48,1,8/20/2015 6:12,1440076320,C4,614460,1440690780,8/27/2015 8:53
1280,20150311040324-846,3,8/21/2015 12:38,1440185880,C3,504300,1440690180,8/27/2015 8:43
2034,20150328070321-554,1,8/24/2015 0:07,1440400020,C0,288480,1440688500,8/27/2015 8:15
658,20152207072213-862,3,8/24/2015 19:36,1440470160,C0,216120,1440686280,8/27/2015 7:38
6373,20154524044536-939,3,8/26/2015 10:15,1440609300,C4,74700,1440684000,8/27/2015 7:00
952,20154025094008-773,2,8/26/2015 8:02,1440601320,C4,80520,1440681840,8/27/2015 6:24
804,20154826114830-851,2,8/23/2015 6:54,1440338040,C4,343080,1440681120,8/27/2015 6:12
2992,20153311113346-259,1,8/25/2015 6:46,1440510360,C4,170340,1440680700,8/27/2015 6:05
3943,20155219075248-264,1,8/25/2015 6:22,1440508920,C5,171000,1440679920,8/27/2015 5:52
684,20154108034131-291,1,8/25/2015 4:13,1440501180,C5,178440,1440679620,8/27/2015 5:47
4083,20155724015758-338,2,8/26/2015 8:23,1440602580,C5,76380,1440678960,8/27/2015 5:36
4371,20155417105422-842,1,8/26/2015 3:26,1440584760,C4,93840,1440678600,8/27/2015 5:30
3191,20151507041515-490,1,8/25/2015 1:03,1440489780,C3,187560,1440677340,8/27/2015 5:09
5959,20152130072111-229,2,8/23/2015 17:15,1440375300,C0,301320,1440676620,8/27/2015 4:57
5272,20153521033513-856,2,8/24/2015 9:57,1440435420,C2,238920,1440674340,8/27/2015 4:19
1975,20155211075244-304,1,8/25/2015 4:15,1440501300,C4,170940,1440672240,8/27/2015 3:44
2993,20155318045348-403,2,8/25/2015 0:59,1440489540,C3,182520,1440672060,8/27/2015 3:41
450,20154224024247-121,2,8/22/2015 22:47,1440308820,C2,362100,1440670920,8/27/2015 3:22
4679,20153712043748-60,3,8/22/2015 1:57,1440233820,C5,436200,1440670020,8/27/2015 3:07
1225,20150218020205-444,1,8/22/2015 19:35,1440297300,C3,365580,1440662880,8/27/2015 1:08
2861,20152322022341-751,2,8/26/2015 9:53,1440607980,C6,54900,1440662880,8/27/2015 1:08
2046,20150319120301-287,3,8/23/2015 3:57,1440327420,C7,332760,1440660180,8/27/2015 0:23
1320,20151403101408-211,1,8/20/2015 3:54,1440068040,C0,589200,1440657240,8/26/2015 23:34
3019,20152424042420-968,1,8/26/2015 9:30,1440606600,C5,49320,1440655920,8/26/2015 23:12
1759,20151019011020-645,3,8/22/2015 15:58,1440284280,C3,368460,1440652740,8/26/2015 22:19
5445,20153310053343-896,3,8/25/2015 3:01,1440496860,C4,155460,1440652320,8/26/2015 22:12
5470,20152310122332-782,2,8/21/2015 15:43,1440196980,C6,455100,1440652080,8/26/2015 22:08
3919,20150223060208-554,3,8/25/2015 15:38,1440542280,C7,103680,1440645960,8/26/2015 20:26
4773,20155107025107-822,1,8/23/2015 14:51,1440366660,C8,276480,1440643140,8/26/2015 19:39
2438,20152507072524-315,2,8/24/2015 8:48,1440431280,C3,210540,1440641820,8/26/2015 19:17
6422,20152023122039-382,1,8/22/2015 12:24,1440271440,C7,370320,1440641760,8/26/2015 19:16
169,20155810125837-406,1,8/22/2015 17:34,1440290040,C0,351120,1440641160,8/26/2015 19:06
2059,20150723030707-46,2,8/25/2015 23:52,1440571920,C2,68100,1440640020,8/26/2015 18:47
228,20154201024259-199,2,8/21/2015 3:45,1440153900,C7,485220,1440639120,8/26/2015 18:32
4076,20153412053414-307,3,8/24/2015 17:34,1440462840,C6,172800,1440635640,8/26/2015 17:34
1269,20153224043244-563,1,8/25/2015 16:56,1440546960,C2,87840,1440634800,8/26/2015 17:20
2796,20150617100636-148,1,8/23/2015 14:50,1440366600,C5,267720,1440634320,8/26/2015 17:12
1216,20155820025827-627,2,8/24/2015 16:26,1440458760,C5,175440,1440634200,8/26/2015 17:10
6049,20150018110057-525,1,8/24/2015 15:30,1440455400,C4,178200,1440633600,8/26/2015 17:00
185,20150714060734-528,1,8/22/2015 13:11,1440274260,C4,358320,1440632580,8/26/2015 16:43
3409,20155804015811-880,1,8/17/2015 10:46,1439833560,C4,797760,1440631320,8/26/2015 16:22
407,20155615105630-534,3,8/25/2015 6:36,1440509760,C8,121200,1440630960,8/26/2015 16:16
5583,20153813083855-252,1,8/22/2015 5:36,1440246960,C4,383340,1440630300,8/26/2015 16:05
4913,20153317103355-433,1,8/24/2015 7:51,1440427860,C5,198360,1440626220,8/26/2015 14:57
583,20152023022026-39,1,8/25/2015 14:26,1440537960,C7,86580,1440624540,8/26/2015 14:29
1523,20150207080240-722,1,8/20/2015 4:16,1440069360,C8,554820,1440624180,8/26/2015 14:23
3317,20150214070255-757,1,8/25/2015 0:59,1440489540,C7,132660,1440622200,8/26/2015 13:50
2398,20153409013402-796,1,8/20/2015 21:40,1440132000,C5,489780,1440621780,8/26/2015 13:43
4162,20155809115800-678,1,8/14/2015 13:10,1439583000,C4,1038240,1440621240,8/26/2015 13:34
4489,20154515054549-826,1,8/24/2015 18:00,1440464400,C8,155700,1440620100,8/26/2015 13:15
5216,20153624073607-630,3,8/25/2015 10:23,1440523380,C4,96420,1440619800,8/26/2015 13:10
2928,20153123053121-598,2,8/25/2015 14:11,1440537060,C0,80400,1440617460,8/26/2015 12:31
856,20152018072024-196,1,8/22/2015 9:33,1440261180,C3,353580,1440614760,8/26/2015 11:46
965,20150509020558-681,1,8/24/2015 17:59,1440464340,C7,145560,1440609900,8/26/2015 10:25
6263,20151220061227-950,1,8/25/2015 9:37,1440520620,C8,88860,1440609480,8/26/2015 10:18
6360,20155615035612-506,2,8/25/2015 4:36,1440502560,C6,102900,1440605460,8/26/2015 9:11
4827,20152921082952-995,2,8/21/2015 4:59,1440158340,C1,444300,1440602640,8/26/2015 8:24
2905,20151708101713-388,1,8/21/2015 20:47,1440215220,C5,387000,1440602220,8/26/2015 8:17
1435,20150503040553-197,2,8/23/2015 11:37,1440355020,C7,244560,1440599580,8/26/2015 7:33
3514,20154516014531-348,2,8/23/2015 1:23,1440318180,C7,280140,1440598320,8/26/2015 7:12
1198,20154530024516-715,3,8/12/2015 22:51,1439445060,C2,1152360,1440597420,8/26/2015 6:57
981,20153219093204-479,1,8/22/2015 20:06,1440299160,C0,297240,1440596400,8/26/2015 6:40
3685,20151721041729-734,1,8/25/2015 2:56,1440496560,C0,99180,1440595740,8/26/2015 6:29
5836,20154420094443-603,3,8/25/2015 9:56,1440521760,C6,72120,1440593880,8/26/2015 5:58
1239,20153811123837-345,3,8/24/2015 1:20,1440404400,C6,180420,1440584820,8/26/2015 3:27
6269,20150419040419-734,1,8/23/2015 23:28,1440397680,C4,186120,1440583800,8/26/2015 3:10
480,20151607071627-500,1,8/19/2015 20:20,1440040800,C4,541920,1440582720,8/26/2015 2:52
2596,20152122082127-299,1,8/24/2015 20:39,1440473940,C7,108540,1440582480,8/26/2015 2:48
1331,20155618025650-853,1,8/25/2015 3:30,1440498600,C4,80520,1440579120,8/26/2015 1:52
4813,20151614121612-952,1,8/24/2015 18:56,1440467760,C6,111000,1440578760,8/26/2015 1:46
4412,20153023053020-213,2,8/25/2015 6:52,1440510720,C7,67260,1440577980,8/26/2015 1:33
1069,20154319104353-504,3,8/25/2015 4:51,1440503460,C8,71040,1440574500,8/26/2015 0:35
1380,20151415041441-660,3,8/20/2015 20:21,1440127260,C7,446460,1440573720,8/26/2015 0:22
2963,20151723051709-947,1,8/25/2015 10:26,1440523560,C2,49380,1440572940,8/26/2015 0:09
5329,20153111043111-321,2,8/22/2015 9:49,1440262140,C4,308760,1440570900,8/25/2015 23:35
3891,20154703044754-258,3,8/20/2015 9:44,1440089040,C4,481140,1440570180,8/25/2015 23:23
1136,20154502094535-864,3,8/23/2015 0:18,1440314280,C2,254340,1440568620,8/25/2015 22:57
830,20152318102340-546,2,8/25/2015 0:07,1440486420,C8,81120,1440567540,8/25/2015 22:39
788,20153022043047-509,2,8/25/2015 3:00,1440496800,C0,70200,1440567000,8/25/2015 22:30
2612,20153721083755-788,3,8/24/2015 9:45,1440434700,C8,131640,1440566340,8/25/2015 22:19
1444,20155111095109-411,1,8/20/2015 20:47,1440128820,C5,436920,1440565740,8/25/2015 22:09
5140,20154521054515-644,2,8/23/2015 19:49,1440384540,C2,180240,1440564780,8/25/2015 21:53
4265,20155521125533-941,1,8/17/2015 1:13,1439799180,C5,763560,1440562740,8/25/2015 21:19
337,20154016054003-520,2,8/22/2015 20:02,1440298920,C2,263460,1440562380,8/25/2015 21:13
2081,20153921023939-728,2,8/23/2015 17:56,1440377760,C3,184620,1440562380,8/25/2015 21:13
1075,20155829125801-230,2,8/16/2015 17:56,1439772960,C0,786540,1440559500,8/25/2015 20:25
1536,20153223113254-722,1,8/25/2015 0:22,1440487320,C3,66300,1440553620,8/25/2015 18:47
2415,20150721010748-517,1,8/24/2015 17:07,1440461220,C5,91200,1440552420,8/25/2015 18:27
1520,20155118115128-12,1,8/23/2015 7:43,1440340980,C5,208560,1440549540,8/25/2015 17:39
2125,20151023091027-655,3,8/24/2015 13:22,1440447720,C2,101520,1440549240,8/25/2015 17:34
2228,20153816123820-926,1,8/22/2015 15:38,1440283080,C7,264600,1440547680,8/25/2015 17:08
1819,20154906014902-527,1,8/23/2015 13:33,1440361980,C5,183480,1440545460,8/25/2015 16:31
566,20152510092527-332,1,8/20/2015 13:37,1440103020,C8,439560,1440542580,8/25/2015 15:43
6148,20154708104711-651,2,8/21/2015 7:26,1440167160,C0,370380,1440537540,8/25/2015 14:19
3254,20150722110730-245,1,8/21/2015 6:45,1440164700,C8,368040,1440532740,8/25/2015 12:59
3090,20152317122348-82,3,8/21/2015 12:41,1440186060,C2,346680,1440532740,8/25/2015 12:59
6402,20154612104653-119,1,8/20/2015 15:18,1440109080,C5,423240,1440532320,8/25/2015 12:52
3615,20154426054401-248,1,8/15/2015 14:18,1439673480,C8,857820,1440531300,8/25/2015 12:35
5131,20150423040436-953,1,8/24/2015 21:34,1440477240,C5,53100,1440530340,8/25/2015 12:19
5619,20154116094115-530,1,8/22/2015 11:15,1440267300,C5,262020,1440529320,8/25/2015 12:02
4292,20152818012813-881,1,8/20/2015 17:57,1440118620,C0,409620,1440528240,8/25/2015 11:44
430,20153815113857-329,3,8/22/2015 3:42,1440240120,C0,288120,1440528240,8/25/2015 11:44
649,20151826121830-361,3,8/15/2015 11:46,1439664360,C5,863040,1440527400,8/25/2015 11:30
690,20153118123109-283,1,8/24/2015 13:18,1440447480,C0,74460,1440521940,8/25/2015 9:59
4965,20150916010956-355,3,8/22/2015 10:59,1440266340,C5,255300,1440521640,8/25/2015 9:54
2043,20152005092011-809,1,8/22/2015 13:08,1440274080,C6,247080,1440521160,8/25/2015 9:46
2144,20150115080147-541,1,8/22/2015 21:19,1440303540,C4,217560,1440521100,8/25/2015 9:45
2215,20155020045059-811,1,8/16/2015 10:50,1439747400,C5,770400,1440517800,8/25/2015 8:50
4561,20154407014405-908,2,8/22/2015 9:19,1440260340,C8,256020,1440516360,8/25/2015 8:26
6368,20154707014750-447,2,8/23/2015 2:11,1440321060,C5,191520,1440512580,8/25/2015 7:23
5573,20153226033231-156,3,8/21/2015 13:08,1440187680,C4,319680,1440507360,8/25/2015 5:56
4033,20150911080911-37,2,8/21/2015 17:18,1440202680,C4,298980,1440501660,8/25/2015 4:21
2009,20154909074911-878,1,8/22/2015 21:43,1440304980,C6,195540,1440500520,8/25/2015 4:02
420,20155519125535-358,1,8/19/2015 22:01,1440046860,C6,451860,1440498720,8/25/2015 3:32
2758,20151122081111-931,3,8/24/2015 4:59,1440417540,C5,80640,1440498180,8/25/2015 3:23
2263,20153609013658-819,3,8/23/2015 4:37,1440329820,C5,168180,1440498000,8/25/2015 3:20
1294,20153707063710-587,1,8/22/2015 3:37,1440239820,C8,257040,1440496860,8/25/2015 3:01
938,20151522081515-994,1,8/23/2015 17:37,1440376620,C6,120120,1440496740,8/25/2015 2:59
6306,20154214044236-934,2,8/22/2015 11:45,1440269100,C0,224460,1440493560,8/25/2015 2:06
3957,20151623041622-269,2,8/24/2015 8:59,1440431940,C3,60180,1440492120,8/25/2015 1:42
2749,20154714074732-183,3,8/21/2015 11:43,1440182580,C8,309480,1440492060,8/25/2015 1:41
6361,20153017023011-609,1,8/21/2015 8:00,1440169200,C6,322200,1440491400,8/25/2015 1:30
5304,20155115095152-620,1,8/21/2015 19:57,1440212220,C2,277380,1440489600,8/25/2015 1:00
5147,20150620030643-457,2,8/22/2015 19:32,1440297120,C4,188760,1440485880,8/24/2015 23:58
2852,20152630102651-351,3,8/20/2015 16:56,1440114960,C8,367560,1440482520,8/24/2015 23:02
5077,20152314082352-547,2,8/19/2015 15:42,1440024120,C4,458340,1440482460,8/24/2015 23:01
3922,20152312112319-869,2,8/20/2015 19:03,1440122580,C7,359400,1440481980,8/24/2015 22:53
3423,20153329073300-377,1,8/21/2015 23:49,1440226140,C6,255720,1440481860,8/24/2015 22:51
2416,20151018101055-192,2,8/22/2015 18:22,1440292920,C8,187560,1440480480,8/24/2015 22:28
3110,20151125071146-648,2,8/19/2015 19:31,1440037860,C8,440880,1440478740,8/24/2015 21:59
6328,20154003094041-201,1,8/19/2015 1:08,1439971680,C2,503760,1440475440,8/24/2015 21:04
4897,20155304095307-596,2,8/22/2015 13:29,1440275340,C4,196020,1440471360,8/24/2015 19:56
4155,20152421122448-609,1,8/20/2015 12:49,1440100140,C2,370500,1440470640,8/24/2015 19:44
2261,20151726061756-646,1,8/17/2015 9:26,1439828760,C4,637380,1440466140,8/24/2015 18:29
1689,20153918123921-858,1,8/20/2015 14:39,1440106740,C2,357300,1440464040,8/24/2015 17:54
5454,20154307124353-199,1,8/14/2015 23:09,1439618940,C7,844680,1440463620,8/24/2015 17:47
922,20153412103450-486,1,8/18/2015 14:04,1439931840,C3,531000,1440462840,8/24/2015 17:34
3181,20150207100251-836,1,8/22/2015 18:42,1440294120,C2,165900,1440460020,8/24/2015 16:47
3916,20155321105314-535,2,8/23/2015 14:41,1440366060,C2,93240,1440459300,8/24/2015 16:35
2134,20150007020012-126,1,8/18/2015 23:36,1439966160,C3,492480,1440458640,8/24/2015 16:24
1214,20150815120847-511,1,8/23/2015 14:48,1440366480,C2,87600,1440454080,8/24/2015 15:08
5276,20154920074921-321,1,8/23/2015 13:10,1440360600,C5,92820,1440453420,8/24/2015 14:57
2171,20153614113645-637,1,8/23/2015 10:48,1440352080,C6,96840,1440448920,8/24/2015 13:42
2563,20155618085617-440,2,8/19/2015 5:56,1439988960,C6,459000,1440447960,8/24/2015 13:26
394,20153813123814-541,1,8/23/2015 7:10,1440339000,C4,105540,1440444540,8/24/2015 12:29
5495,20153915113920-94,3,8/22/2015 5:39,1440247140,C5,194400,1440441540,8/24/2015 11:39
5773,20150016090035-720,1,8/23/2015 13:48,1440362880,C3,77760,1440440640,8/24/2015 11:24
1453,20153602043658-257,3,8/21/2015 7:54,1440168840,C6,268380,1440437220,8/24/2015 10:27
6556,20153518113519-608,1,8/22/2015 10:41,1440265260,C3,171180,1440436440,8/24/2015 10:14
2910,20153822023828-796,2,8/23/2015 12:18,1440357480,C4,78000,1440435480,8/24/2015 9:58
4443,20150904090957-319,2,8/21/2015 21:51,1440219060,C3,216360,1440435420,8/24/2015 9:57
2207,20153217083226-786,2,8/23/2015 12:42,1440358920,C0,76200,1440435120,8/24/2015 9:52
3183,20152913112925-155,1,8/23/2015 3:45,1440326700,C5,104520,1440431220,8/24/2015 8:47
5758,20152814062834-4,1,8/20/2015 23:52,1440139920,C2,290520,1440430440,8/24/2015 8:34
3632,20150214020240-113,1,8/23/2015 3:08,1440324480,C2,105480,1440429960,8/24/2015 8:26
1971,20151019101010-336,1,8/18/2015 8:30,1439911800,C8,517200,1440429000,8/24/2015 8:10
3147,20152220042220-374,1,8/23/2015 2:30,1440322200,C5,104640,1440426840,8/24/2015 7:34
76,20152309042301-368,2,8/22/2015 10:45,1440265500,C4,157560,1440423060,8/24/2015 6:31
5420,20150112080156-678,3,8/20/2015 6:31,1440077460,C7,342900,1440420360,8/24/2015 5:46
4504,20153617103638-247,1,8/21/2015 21:56,1440219360,C7,193200,1440412560,8/24/2015 3:36
3732,20154605074608-859,2,8/18/2015 14:26,1439933160,C4,478200,1440411360,8/24/2015 3:16
1006,20151817051852-380,1,8/21/2015 23:18,1440224280,C3,183600,1440407880,8/24/2015 2:18
3468,20152322042319-725,2,8/23/2015 9:08,1440346080,C4,60300,1440406380,8/24/2015 1:53
3151,20153711093723-390,1,8/22/2015 16:01,1440284460,C5,121680,1440406140,8/24/2015 1:49
5362,20151907011912-142,1,8/19/2015 22:10,1440047400,C5,356220,1440403620,8/24/2015 1:07
60,20154114034126-781,1,8/20/2015 21:43,1440132180,C8,270060,1440402240,8/24/2015 0:44
6147,20152027122000-634,2,8/20/2015 23:08,1440137280,C2,264060,1440401340,8/24/2015 0:29
4479,20152801032847-862,2,8/20/2015 19:16,1440123360,C6,275880,1440399240,8/23/2015 23:54
5046,20154602014652-42,1,8/21/2015 7:17,1440166620,C7,231180,1440397800,8/23/2015 23:30
1120,20150330050315-215,1,8/21/2015 6:23,1440163380,C5,232800,1440396180,8/23/2015 23:03
4547,20151221021214-964,2,8/23/2015 3:58,1440327480,C4,67980,1440395460,8/23/2015 22:51
4272,20155018015058-838,1,8/22/2015 2:58,1440237480,C5,153240,1440390720,8/23/2015 21:32
2384,20150722040736-505,1,8/23/2015 6:30,1440336600,C4,51780,1440388380,8/23/2015 20:53
904,20152619052654-46,3,8/15/2015 1:59,1439629140,C4,759060,1440388200,8/23/2015 20:50
1840,20154920044939-697,2,8/22/2015 19:27,1440296820,C5,91140,1440387960,8/23/2015 20:46
3500,20151505101551-848,3,8/17/2015 17:07,1439856420,C5,530760,1440387180,8/23/2015 20:33
3923,20152823092842-19,1,8/20/2015 8:16,1440083760,C5,301860,1440385620,8/23/2015 20:07
6229,20151021011047-387,1,8/22/2015 16:31,1440286260,C4,98460,1440384720,8/23/2015 19:52
3458,20152016012038-49,1,8/22/2015 0:08,1440227280,C2,156960,1440384240,8/23/2015 19:44
1355,20150514090518-434,2,8/21/2015 10:50,1440179400,C5,203700,1440383100,8/23/2015 19:25
2660,20153612043651-254,1,8/21/2015 22:21,1440220860,C8,159660,1440380520,8/23/2015 18:42
4934,20151806101819-946,1,8/21/2015 20:10,1440213000,C6,166440,1440379440,8/23/2015 18:24
5280,20154830024817-212,3,8/17/2015 16:48,1439855280,C5,520800,1440376080,8/23/2015 17:28
3524,20155206095205-734,1,8/21/2015 18:32,1440207120,C5,165900,1440373020,8/23/2015 16:37
580,20155414075423-495,1,8/21/2015 7:51,1440168660,C5,201540,1440370200,8/23/2015 15:50
1707,20154114104153-864,1,8/21/2015 8:23,1440170580,C0,198840,1440369420,8/23/2015 15:37
2984,20153510103505-180,2,8/18/2015 16:27,1439940420,C4,423840,1440364260,8/23/2015 14:11
4202,20155829085817-23,1,8/15/2015 4:18,1439637480,C8,726000,1440363480,8/23/2015 13:58
273,20152614122614-782,2,8/22/2015 6:32,1440250320,C6,111660,1440361980,8/23/2015 13:33
311,20155030075000-793,2,8/17/2015 11:32,1439836320,C5,522840,1440359160,8/23/2015 12:46
3161,20154805094814-860,2,8/21/2015 6:15,1440162900,C5,195660,1440358560,8/23/2015 12:36
5546,20152109072151-681,1,8/21/2015 3:01,1440151260,C8,204240,1440355500,8/23/2015 11:45
3837,20150525050525-344,3,8/19/2015 20:57,1440043020,C0,310560,1440353580,8/23/2015 11:13
3060,20151410061424-60,1,8/21/2015 23:10,1440223800,C5,126420,1440350220,8/23/2015 10:17
1056,20154212044215-152,1,8/19/2015 20:22,1440040920,C4,309000,1440349920,8/23/2015 10:12
3579,20151616091623-588,1,8/21/2015 1:40,1440146400,C5,202320,1440348720,8/23/2015 9:52
5101,20150713090739-797,1,8/20/2015 1:15,1440058500,C8,288240,1440346740,8/23/2015 9:19
6312,20150514060535-722,1,8/18/2015 19:41,1439952060,C6,394560,1440346620,8/23/2015 9:17
6222,20154518104543-3,1,8/22/2015 3:24,1440239040,C5,106380,1440345420,8/23/2015 8:57
495,20150231120236-701,1,8/20/2015 11:32,1440095520,C7,246600,1440342120,8/23/2015 8:02
2794,20155019085012-883,2,8/18/2015 22:26,1439961960,C4,377280,1440339240,8/23/2015 7:14
876,20151116021105-602,1,8/18/2015 13:53,1439931180,C5,407160,1440338340,8/23/2015 6:59
1003,20154931054946-146,1,8/19/2015 12:19,1440011940,C8,324360,1440336300,8/23/2015 6:25
767,20150220080208-953,1,8/22/2015 6:50,1440251400,C5,84240,1440335640,8/23/2015 6:14
3281,20153126023103-958,2,8/14/2015 0:25,1439537100,C7,795420,1440332520,8/23/2015 5:22
1357,20153102043137-348,1,8/20/2015 14:26,1440105960,C5,221100,1440327060,8/23/2015 3:51
5009,20151514111539-957,1,8/20/2015 23:00,1440136800,C5,186900,1440323700,8/23/2015 2:55
6503,20150707060746-607,2,8/20/2015 11:02,1440093720,C8,228180,1440321900,8/23/2015 2:25
6443,20154115084152-940,1,8/20/2015 12:03,1440097380,C2,222060,1440319440,8/23/2015 1:44
6019,20155812115832-295,1,8/21/2015 7:03,1440165780,C8,151980,1440317760,8/23/2015 1:16
5028,20150016120041-181,3,8/20/2015 20:44,1440128640,C5,188520,1440317160,8/23/2015 1:06
2754,20155321125321-407,2,8/22/2015 6:36,1440250560,C6,63780,1440314340,8/23/2015 0:19
1698,20152913092907-731,1,8/21/2015 14:59,1440194340,C6,118500,1440312840,8/22/2015 23:54
6151,20155318075328-481,3,8/19/2015 0:33,1439969580,C5,342300,1440311880,8/22/2015 23:38
3989,20150214110230-668,1,8/20/2015 3:18,1440065880,C0,245280,1440311160,8/22/2015 23:26
4064,20152015102054-215,3,8/22/2015 0:39,1440229140,C7,81420,1440310560,8/22/2015 23:16
4581,20151013041011-524,1,8/12/2015 21:22,1439439720,C8,870240,1440309960,8/22/2015 23:06
1250,20154630124653-489,1,8/20/2015 0:45,1440056700,C4,253020,1440309720,8/22/2015 23:02
4450,20154116074134-300,3,8/19/2015 14:56,1440021360,C4,285300,1440306660,8/22/2015 22:11
3171,20151416101435-915,1,8/20/2015 17:54,1440118440,C8,186600,1440305040,8/22/2015 21:44
4791,20155616025653-750,1,8/19/2015 18:08,1440032880,C4,270720,1440303600,8/22/2015 21:20
2843,20151910031914-568,1,8/18/2015 18:59,1439949540,C8,352200,1440301740,8/22/2015 20:49
3864,20150714090715-693,1,8/18/2015 14:40,1439934000,C6,365580,1440299580,8/22/2015 20:13
3,20150909100908-893,1,8/21/2015 8:25,1440170700,C5,128820,1440299520,8/22/2015 20:12
5237,20151716071747-621,1,8/19/2015 13:31,1440016260,C2,281640,1440297900,8/22/2015 19:45
4954,20153931053905-915,2,8/17/2015 6:48,1439819280,C3,476580,1440295860,8/22/2015 19:11
4507,20154407104408-451,2,8/18/2015 22:53,1439963580,C4,331380,1440294960,8/22/2015 18:56
5588,20153122063134-260,1,8/12/2015 6:35,1439386500,C5,907320,1440293820,8/22/2015 18:37
3977,20155028125010-618,1,8/19/2015 14:44,1440020640,C5,272520,1440293160,8/22/2015 18:26
2726,20154229104255-661,3,8/19/2015 17:28,1440030480,C0,262680,1440293160,8/22/2015 18:26
5434,20154729074714-800,2,8/18/2015 16:27,1439940420,C8,351840,1440292260,8/22/2015 18:11
3490,20151115041109-804,1,8/21/2015 20:21,1440213660,C0,76200,1440289860,8/22/2015 17:31
200,20150316120315-424,1,8/20/2015 15:25,1440109500,C5,178860,1440288360,8/22/2015 17:06
3839,20154303074311-913,1,8/16/2015 5:51,1439729460,C4,558240,1440287700,8/22/2015 16:55
1559,20154504094510-630,1,8/16/2015 14:23,1439760180,C5,526740,1440286920,8/22/2015 16:42
1616,20153013113059-327,1,8/17/2015 16:03,1439852580,C7,434340,1440286920,8/22/2015 16:42
2075,20150006080007-531,3,8/17/2015 5:40,1439815200,C7,471000,1440286200,8/22/2015 16:30
4086,20155704085706-777,3,8/16/2015 13:45,1439757900,C4,527040,1440284940,8/22/2015 16:09
6150,20152405122407-516,1,8/19/2015 18:59,1440035940,C8,246660,1440282600,8/22/2015 15:30
5896,20150425060412-481,2,8/19/2015 2:07,1439975220,C8,306540,1440281760,8/22/2015 15:16
6560,20153229043251-293,1,8/16/2015 15:23,1439763780,C2,517020,1440280800,8/22/2015 15:00
2762,20155618065604-631,2,8/21/2015 3:52,1440154320,C7,124080,1440278400,8/22/2015 14:20
4981,20154127124144-803,3,8/19/2015 7:51,1439995860,C2,281400,1440277260,8/22/2015 14:01
2475,20152917072944-998,1,8/18/2015 0:58,1439884680,C4,391620,1440276300,8/22/2015 13:45
5464,20151516011512-70,1,8/19/2015 13:30,1440016200,C2,260100,1440276300,8/22/2015 13:45
1679,20153722083744-703,1,8/19/2015 1:01,1439971260,C4,298980,1440270240,8/22/2015 12:04
3283,20153114093133-433,2,8/21/2015 16:34,1440200040,C7,70020,1440270060,8/22/2015 12:01
1859,20154607094631-516,2,8/17/2015 11:14,1439835240,C5,434640,1440269880,8/22/2015 11:58
1503,20150115020146-483,3,8/21/2015 17:29,1440203340,C2,66360,1440269700,8/22/2015 11:55
5249,20150420090434-499,1,8/21/2015 10:22,1440177720,C6,91080,1440268800,8/22/2015 11:40
4123,20154824034807-478,2,8/19/2015 6:20,1439990400,C5,276540,1440266940,8/22/2015 11:09
3483,20155201035224-590,1,8/16/2015 16:56,1439769360,C0,497280,1440266640,8/22/2015 11:04
402,20153007113051-98,2,8/17/2015 11:12,1439835120,C5,431460,1440266580,8/22/2015 11:03
4840,20151528061539-192,1,8/18/2015 6:15,1439903700,C8,362880,1440266580,8/22/2015 11:03
6202,20150116070109-391,1,8/19/2015 9:02,1440000120,C6,266460,1440266580,8/22/2015 11:03
738,20150418120408-87,3,8/20/2015 11:32,1440095520,C6,170880,1440266400,8/22/2015 11:00
2464,20154115044115-752,1,8/20/2015 4:49,1440071340,C8,194640,1440265980,8/22/2015 10:53
2216,20154216104223-278,1,8/20/2015 10:32,1440091920,C5,172500,1440264420,8/22/2015 10:27
206,20153318013311-102,2,8/18/2015 13:01,1439928060,C5,334560,1440262620,8/22/2015 9:57
3373,20154427024429-109,1,8/19/2015 13:08,1440014880,C4,247680,1440262560,8/22/2015 9:56
3206,20154423074437-690,2,8/19/2015 1:36,1439973360,C2,288840,1440262200,8/22/2015 9:50
2031,20152019052023-769,1,8/21/2015 17:23,1440202980,C5,57660,1440260640,8/22/2015 9:24
1015,20151318101343-137,1,8/21/2015 1:23,1440145380,C4,113700,1440259080,8/22/2015 8:58
5940,20152115072114-129,1,8/19/2015 23:49,1440053340,C5,202440,1440255780,8/22/2015 8:03
4677,20152212112246-498,1,8/19/2015 1:04,1439971440,C5,283860,1440255300,8/22/2015 7:55
5521,20150908080923-414,3,8/15/2015 7:57,1439650620,C4,604080,1440254700,8/22/2015 7:45
2218,20151225091206-465,2,8/18/2015 19:48,1439952480,C2,301680,1440254160,8/22/2015 7:36
5721,20155303045356-851,1,8/16/2015 2:29,1439717340,C2,535680,1440253020,8/22/2015 7:17
973,20155208085206-672,2,8/18/2015 19:22,1439950920,C5,300600,1440251520,8/22/2015 6:52
416,20153509033522-770,1,8/18/2015 1:41,1439887260,C5,363780,1440251040,8/22/2015 6:44
2602,20151812061805-214,1,8/18/2015 22:26,1439961960,C2,288240,1440250200,8/22/2015 6:30
5126,20154517094544-833,2,8/13/2015 6:54,1439474040,C4,774180,1440248220,8/22/2015 5:57
4400,20152216102203-558,1,8/13/2015 21:03,1439524980,C5,721380,1440246360,8/22/2015 5:26
3931,20155116025119-682,1,8/21/2015 12:34,1440185640,C3,60540,1440246180,8/22/2015 5:23
2954,20152915072932-837,1,8/21/2015 1:39,1440146340,C8,99480,1440245820,8/22/2015 5:17
816,20155325075339-490,2,8/18/2015 17:33,1439944380,C5,301200,1440245580,8/22/2015 5:13
370,20150616020625-232,1,8/21/2015 11:21,1440181260,C5,60300,1440241560,8/22/2015 4:06
6100,20154018084053-456,1,8/14/2015 0:18,1439536680,C7,699240,1440235920,8/22/2015 2:32
970,20153114033108-799,1,8/20/2015 19:46,1440125160,C8,106740,1440231900,8/22/2015 1:25
4671,20150726030718-420,2,8/13/2015 5:55,1439470500,C8,761040,1440231540,8/22/2015 1:19
1303,20151630041632-789,1,8/19/2015 5:58,1439989080,C2,241560,1440230640,8/22/2015 1:04
6199,20155206035248-482,3,8/20/2015 7:44,1440081840,C0,147540,1440229380,8/22/2015 0:43
5685,20151129101109-424,3,8/18/2015 15:35,1439937300,C6,291240,1440228540,8/22/2015 0:29
4367,20150420100416-232,1,8/5/2015 17:09,1438819740,C6,1407900,1440227640,8/22/2015 0:14
4321,20152714022709-931,2,8/20/2015 3:03,1440064980,C5,159120,1440224100,8/21/2015 23:15
1823,20154319044337-154,1,8/17/2015 17:41,1439858460,C8,358440,1440216900,8/21/2015 21:15
5774,20151218101204-383,3,8/20/2015 17:30,1440117000,C5,99540,1440216540,8/21/2015 21:09
3566,20150606090640-663,1,8/19/2015 21:12,1440043920,C0,166680,1440210600,8/21/2015 19:30
3805,20150321080345-584,2,8/18/2015 7:23,1439907780,C4,302100,1440209880,8/21/2015 19:18
3371,20152116012117-783,1,8/20/2015 0:57,1440057420,C2,150480,1440207900,8/21/2015 18:45
1754,20151114081116-872,2,8/17/2015 12:11,1439838660,C4,369000,1440207660,8/21/2015 18:41
4910,20154316124308-991,1,8/20/2015 0:39,1440056340,C4,151080,1440207420,8/21/2015 18:37
4608,20154519024544-322,2,8/19/2015 9:49,1440002940,C4,202980,1440205920,8/21/2015 18:12
5491,20153418023443-272,2,8/20/2015 16:50,1440114600,C5,90480,1440205080,8/21/2015 17:58
1338,20151518061551-586,2,8/10/2015 6:01,1439211660,C0,993180,1440204840,8/21/2015 17:54
686,20153511073525-756,1,8/16/2015 13:13,1439755980,C8,447240,1440203220,8/21/2015 17:27
3052,20155027045016-281,2,8/18/2015 22:42,1439962920,C5,240240,1440203160,8/21/2015 17:26
167,20150516060520-936,2,8/20/2015 7:29,1440080940,C3,116880,1440197820,8/21/2015 15:57
4358,20153219033258-970,3,8/20/2015 23:42,1440139320,C5,57900,1440197220,8/21/2015 15:47
6348,20152710022715-872,1,8/20/2015 13:06,1440101160,C7,95460,1440196620,8/21/2015 15:37
3913,20152815042814-977,2,8/18/2015 16:00,1439938800,C6,257520,1440196320,8/21/2015 15:32
2408,20151211091201-575,2,8/18/2015 5:24,1439900640,C7,295560,1440196200,8/21/2015 15:30
1312,20152030112009-638,2,8/18/2015 19:54,1439952840,C8,238920,1440191760,8/21/2015 14:16
3107,20152318082356-512,1,8/20/2015 12:11,1440097860,C5,93240,1440191100,8/21/2015 14:05
5792,20150411020405-25,3,8/18/2015 5:32,1439901120,C4,287040,1440188160,8/21/2015 13:16
4538,20152102102155-887,1,8/15/2015 4:05,1439636700,C5,550320,1440187020,8/21/2015 12:57
1846,20152419022425-210,1,8/17/2015 10:07,1439831220,C7,355740,1440186960,8/21/2015 12:56
693,20155410075450-130,1,8/15/2015 22:19,1439702340,C2,483900,1440186240,8/21/2015 12:44
102,20155109115123-786,1,8/18/2015 12:15,1439925300,C4,259680,1440184980,8/21/2015 12:23
4100,20152509052554-869,1,8/18/2015 12:40,1439926800,C2,253500,1440180300,8/21/2015 11:05
3518,20151518011542-627,3,8/20/2015 11:07,1440094020,C5,82560,1440176580,8/21/2015 10:03
4318,20154828014808-208,2,8/15/2015 9:48,1439657280,C2,516600,1440173880,8/21/2015 9:18
4598,20155222025217-753,1,8/17/2015 15:30,1439850600,C8,321240,1440171840,8/21/2015 8:44
2050,20153529033559-238,1,8/15/2015 11:59,1439665140,C5,505980,1440171120,8/21/2015 8:32
3534,20153603053617-529,3,8/18/2015 9:56,1439916960,C8,253680,1440170640,8/21/2015 8:24
333,20150726110738-643,1,8/14/2015 20:40,1439610000,C4,558660,1440168660,8/21/2015 7:51
4413,20151115121122-695,3,8/19/2015 9:01,1440000060,C2,167100,1440167160,8/21/2015 7:26
2294,20151318061334-243,2,8/19/2015 18:46,1440035160,C0,131580,1440166740,8/21/2015 7:19
2254,20150106030143-319,1,8/19/2015 11:15,1440008100,C2,158520,1440166620,8/21/2015 7:17
902,20155914045902-906,1,8/19/2015 2:27,1439976420,C8,189840,1440166260,8/21/2015 7:11
5622,20153707123730-758,3,8/19/2015 7:31,1439994660,C6,169740,1440164400,8/21/2015 6:40
872,20151425111443-882,3,8/17/2015 21:27,1439872020,C5,289140,1440161160,8/21/2015 5:46
1050,20152805012826-73,1,8/17/2015 7:37,1439822220,C2,338580,1440160800,8/21/2015 5:40
2877,20152118032137-233,2,8/19/2015 21:58,1440046680,C4,110220,1440156900,8/21/2015 4:35
3523,20150914110948-268,1,8/17/2015 8:18,1439824680,C7,325260,1440149940,8/21/2015 2:39
1544,20153717103748-173,3,8/19/2015 6:17,1439990220,C4,157200,1440147420,8/21/2015 1:57
6182,20155426075432-816,2,8/17/2015 20:32,1439868720,C4,278040,1440146760,8/21/2015 1:46
1743,20152207052205-192,1,8/19/2015 22:53,1440049980,C2,96060,1440146040,8/21/2015 1:34
657,20152115052114-277,1,8/20/2015 7:15,1440080100,C6,65940,1440146040,8/21/2015 1:34
5332,20155903075911-687,1,8/15/2015 3:17,1439633820,C2,509940,1440143760,8/21/2015 0:56
2425,20155206105220-877,1,8/15/2015 23:00,1439704800,C4,437460,1440142260,8/21/2015 0:31
6217,20151608061603-479,1,8/16/2015 18:10,1439773800,C8,367020,1440140820,8/21/2015 0:07
1245,20150202040220-736,3,8/14/2015 21:18,1439612280,C4,527880,1440140160,8/20/2015 23:56
1543,20153701093702-509,1,8/14/2015 11:03,1439575380,C2,564180,1440139560,8/20/2015 23:46
6138,20153821043846-584,2,8/17/2015 4:21,1439810460,C8,326940,1440137400,8/20/2015 23:10
3094,20154117054153-286,2,8/19/2015 21:13,1440043980,C8,92760,1440136740,8/20/2015 22:59
4445,20153924013929-447,1,8/13/2015 18:42,1439516520,C4,619740,1440136260,8/20/2015 22:51
4868,20155529075511-496,1,8/18/2015 9:55,1439916900,C0,216900,1440133800,8/20/2015 22:10
4439,20151916021928-359,1,8/20/2015 4:39,1440070740,C8,62160,1440132900,8/20/2015 21:55
2521,20150518040539-572,3,8/19/2015 18:58,1440035880,C2,96780,1440132660,8/20/2015 21:51
142,20154821124856-434,3,8/10/2015 18:40,1439257200,C8,874560,1440131760,8/20/2015 21:36
3063,20154217104228-732,1,8/3/2015 15:41,1438641660,C4,1486740,1440128400,8/20/2015 20:40
2873,20154231084240-825,2,8/18/2015 19:21,1439950860,C7,177060,1440127920,8/20/2015 20:32
3038,20153316013306-455,1,8/18/2015 16:56,1439942160,C0,184980,1440127140,8/20/2015 20:19
5326,20151823021857-278,3,8/17/2015 16:34,1439854440,C0,271020,1440125460,8/20/2015 19:51
2562,20152310062340-347,1,8/19/2015 12:03,1440010980,C7,114000,1440124980,8/20/2015 19:43
4136,20153818123807-188,1,8/19/2015 16:07,1440025620,C6,98940,1440124560,8/20/2015 19:36
3942,20153316073319-342,3,8/19/2015 7:05,1439993100,C7,128760,1440121860,8/20/2015 18:51
810,20155114095131-368,2,8/19/2015 23:19,1440051540,C2,68640,1440120180,8/20/2015 18:23
4918,20150112110110-857,1,8/16/2015 14:36,1439760960,C2,358500,1440119460,8/20/2015 18:11
5756,20152317012342-801,2,8/19/2015 15:53,1440024780,C3,90900,1440115680,8/20/2015 17:08
5429,20151402081427-528,2,8/15/2015 5:26,1439641560,C2,473940,1440115500,8/20/2015 17:05
4021,20155110125158-386,1,8/15/2015 12:53,1439668380,C2,444360,1440112740,8/20/2015 16:19
3779,20152001122012-967,1,8/17/2015 11:00,1439834400,C8,275520,1440109920,8/20/2015 15:32
2689,20155720095723-531,2,8/16/2015 4:15,1439723700,C6,385380,1440109080,8/20/2015 15:18
5613,20153222073236-42,1,8/17/2015 7:56,1439823360,C4,280980,1440104340,8/20/2015 13:59
4221,20155608105623-726,3,8/15/2015 3:41,1439635260,C5,465300,1440100560,8/20/2015 12:56
2552,20153417043413-536,2,8/16/2015 7:18,1439734680,C7,365520,1440100200,8/20/2015 12:50
4105,20152010062058-60,1,8/17/2015 23:08,1439878080,C4,221760,1440099840,8/20/2015 12:44
5404,20150003080058-668,3,8/14/2015 12:05,1439579100,C0,520500,1440099600,8/20/2015 12:40
6227,20152530082532-866,3,8/15/2015 5:22,1439641320,C4,457140,1440098460,8/20/2015 12:21
5953,20150207100246-511,1,8/18/2015 7:42,1439908920,C8,188400,1440097320,8/20/2015 12:02
1637,20154623104653-166,1,8/11/2015 3:34,1439289240,C5,807840,1440097080,8/20/2015 11:58
2661,20153521103532-680,3,8/17/2015 3:15,1439806500,C4,288300,1440094800,8/20/2015 11:20
1465,20152631112623-34,3,8/17/2015 2:16,1439802960,C8,287160,1440090120,8/20/2015 10:02
5633,20155602125643-208,2,8/18/2015 10:08,1439917680,C5,171540,1440089220,8/20/2015 9:47
2565,20151329111340-193,2,8/17/2015 22:33,1439875980,C5,210300,1440086280,8/20/2015 8:58
5030,20151514031512-498,1,8/19/2015 15:32,1440023520,C8,61860,1440085380,8/20/2015 8:43
5925,20150514030514-420,1,8/16/2015 6:25,1439731500,C2,352500,1440084000,8/20/2015 8:20
2980,20153604073602-444,1,8/14/2015 23:50,1439621400,C5,461220,1440082620,8/20/2015 7:57
3598,20154314064318-347,2,8/17/2015 6:56,1439819760,C4,259980,1440079740,8/20/2015 7:09
4675,20150217030209-500,2,8/19/2015 9:26,1440001560,C2,76320,1440077880,8/20/2015 6:38
853,20153005123012-657,1,8/15/2015 8:16,1439651760,C8,424380,1440076140,8/20/2015 6:09
4997,20151813031829-984,2,8/19/2015 12:22,1440012120,C0,63480,1440075600,8/20/2015 6:00
1735,20151217101248-377,3,8/19/2015 6:58,1439992680,C8,80580,1440073260,8/20/2015 5:21
1061,20153013113037-790,1,8/16/2015 20:16,1439781360,C3,290760,1440072120,8/20/2015 5:02
1340,20152501032501-316,1,8/18/2015 7:37,1439908620,C7,160080,1440068700,8/20/2015 4:05
2712,20154527064556-11,3,8/12/2015 4:53,1439380380,C5,687840,1440068220,8/20/2015 3:57
44,20154917014946-993,3,8/18/2015 20:26,1439954760,C4,110220,1440064980,8/20/2015 3:03
4717,20155615065643-355,3,8/17/2015 16:39,1439854740,C4,207780,1440062520,8/20/2015 2:22
2334,20154011014002-294,1,8/17/2015 23:01,1439877660,C0,184020,1440061680,8/20/2015 2:08
1781,20151914041953-619,1,8/18/2015 5:59,1439902740,C5,154200,1440056940,8/20/2015 0:49
1620,20151212051226-954,3,8/19/2015 2:51,1439977860,C4,79020,1440056880,8/20/2015 0:48
1565,20155916015917-666,1,8/15/2015 2:35,1439631300,C1,425160,1440056460,8/20/2015 0:41
5229,20153715093725-365,1,8/18/2015 11:33,1439922780,C7,133080,1440055860,8/20/2015 0:31
4593,20154715054748-43,2,8/19/2015 11:30,1440009000,C2,46140,1440055140,8/20/2015 0:19
2800,20151113121156-771,2,8/13/2015 18:16,1439514960,C8,540060,1440055020,8/20/2015 0:17
6327,20154517024507-611,1,8/19/2015 4:47,1439984820,C4,68460,1440053280,8/19/2015 23:48
1439,20152008042053-423,1,8/16/2015 5:06,1439726760,C7,325380,1440052140,8/19/2015 23:29
1255,20153320083339-666,1,8/14/2015 20:58,1439611080,C8,440940,1440052020,8/19/2015 23:27
3719,20151531021539-858,2,8/16/2015 17:55,1439772900,C8,279120,1440052020,8/19/2015 23:27
212,20154122074105-174,2,8/16/2015 8:03,1439737380,C3,308760,1440046140,8/19/2015 21:49
3789,20150914030948-203,2,8/19/2015 5:31,1439987460,C3,56760,1440044220,8/19/2015 21:17
2804,20153731033739-510,2,8/17/2015 17:21,1439857260,C4,184380,1440041640,8/19/2015 20:34
3276,20153320043305-28,2,8/13/2015 4:01,1439463660,C2,577560,1440041220,8/19/2015 20:27
3905,20152816122841-313,1,8/18/2015 17:44,1439945040,C0,95880,1440040920,8/19/2015 20:22
3243,20150601070655-151,1,8/14/2015 7:54,1439564040,C5,475560,1440039600,8/19/2015 20:00
6559,20151307121323-821,1,8/18/2015 10:45,1439919900,C4,118140,1440038040,8/19/2015 19:34
4484,20154307124354-819,2,8/18/2015 10:43,1439919780,C5,117900,1440037680,8/19/2015 19:28
5796,20151514111535-583,1,8/18/2015 0:39,1439883540,C0,153720,1440037260,8/19/2015 19:21
3887,20153402013445-750,1,8/17/2015 15:28,1439850480,C0,186120,1440036600,8/19/2015 19:10
5174,20152414112403-762,2,8/18/2015 11:09,1439921340,C5,114900,1440036240,8/19/2015 19:04
3435,20151318051330-957,3,8/9/2015 2:15,1439111700,C7,923460,1440035160,8/19/2015 18:46
3262,20150823060803-803,1,8/16/2015 17:04,1439769840,C3,264120,1440033960,8/19/2015 18:26
6346,20150701020723-76,1,8/10/2015 16:08,1439248080,C4,784860,1440032940,8/19/2015 18:09
784,20153915063956-914,3,8/18/2015 6:17,1439903820,C8,128940,1440032760,8/19/2015 18:06
5602,20152408052435-531,2,8/16/2015 23:33,1439793180,C5,237780,1440030960,8/19/2015 17:36
817,20151409111437-111,2,8/16/2015 7:28,1439735280,C7,295620,1440030900,8/19/2015 17:35
1020,20153503063500-934,2,8/17/2015 15:48,1439851680,C7,177540,1440029220,8/19/2015 17:07
1584,20150304070342-20,2,8/14/2015 11:59,1439578740,C0,445020,1440023760,8/19/2015 15:36
5443,20150024060019-914,1,8/13/2015 8:48,1439480880,C5,541260,1440022140,8/19/2015 15:09
6387,20155525045542-362,3,8/13/2015 9:31,1439483460,C5,538320,1440021780,8/19/2015 15:03
4418,20150903050915-821,1,8/17/2015 19:49,1439866140,C5,152400,1440018540,8/19/2015 14:09
3137,20154215114244-418,2,8/18/2015 13:27,1439929620,C0,88500,1440018120,8/19/2015 14:02
4670,20152004082011-358,1,8/14/2015 10:28,1439573280,C2,443760,1440017040,8/19/2015 13:44
6110,20154415014417-163,2,8/17/2015 13:40,1439844000,C2,172560,1440016560,8/19/2015 13:36
1144,20152716102734-529,1,8/18/2015 12:17,1439925420,C7,89700,1440015120,8/19/2015 13:12
4051,20150509110512-433,2,8/16/2015 4:23,1439724180,C5,290340,1440014520,8/19/2015 13:02
1879,20152305112331-211,1,8/18/2015 2:59,1439891940,C7,121440,1440013380,8/19/2015 12:43
6052,20150018020030-238,3,8/15/2015 12:43,1439667780,C8,344940,1440012720,8/19/2015 12:32
5107,20155816065857-340,1,8/17/2015 21:17,1439871420,C4,137940,1440009360,8/19/2015 11:36
5811,20154027014057-847,1,8/15/2015 15:50,1439679000,C8,329880,1440008880,8/19/2015 11:28
5118,20155117065115-489,3,8/17/2015 9:06,1439827560,C0,179100,1440006660,8/19/2015 10:51
806,20150113120141-485,1,8/17/2015 11:03,1439834580,C8,171060,1440005640,8/19/2015 10:34
327,20154804044849-878,3,8/14/2015 8:32,1439566320,C2,439080,1440005400,8/19/2015 10:30
1459,20153626093628-77,2,8/13/2015 10:00,1439485200,C2,518580,1440003780,8/19/2015 10:03
4102,20153014103053-84,3,8/12/2015 1:58,1439369880,C3,633360,1440003240,8/19/2015 9:54
2470,20152707072751-974,1,8/17/2015 21:19,1439871540,C8,130560,1440002100,8/19/2015 9:35
4335,20155907045941-874,3,8/14/2015 14:51,1439589060,C2,409440,1439998500,8/19/2015 8:35
4247,20150818040832-50,2,8/11/2015 10:02,1439312520,C5,683880,1439996400,8/19/2015 8:00
208,20154501084500-257,2,8/17/2015 1:49,1439801340,C4,193920,1439995260,8/19/2015 7:41
1065,20151324061307-900,2,8/13/2015 1:25,1439454300,C6,537840,1439992140,8/19/2015 6:49
3537,20154212044243-346,1,8/17/2015 2:06,1439802360,C7,189720,1439992080,8/19/2015 6:48
2799,20150717060746-729,3,8/8/2015 6:07,1439039220,C7,950400,1439989620,8/19/2015 6:07
6239,20153915043953-171,2,8/17/2015 11:23,1439835780,C4,153840,1439989620,8/19/2015 6:07
3896,20150201070216-808,2,8/10/2015 6:32,1439213520,C4,775800,1439989320,8/19/2015 6:02
5594,20154011084036-355,3,8/14/2015 9:20,1439569200,C5,420000,1439989200,8/19/2015 6:00
1128,20155216055230-781,1,8/18/2015 9:38,1439915880,C3,71580,1439987460,8/19/2015 5:31
5960,20154412024403-809,1,8/16/2015 23:48,1439794080,C7,189120,1439983200,8/19/2015 4:20
4940,20151801021811-599,1,8/2/2015 23:26,1438583160,C4,1398840,1439982000,8/19/2015 4:00
2371,20151206061257-541,2,8/14/2015 19:56,1439607360,C4,370320,1439977680,8/19/2015 2:48
528,20154414024400-712,1,8/15/2015 2:52,1439632320,C3,340260,1439972580,8/19/2015 1:23
5181,20155529095550-67,1,8/12/2015 4:11,1439377860,C8,594480,1439972340,8/19/2015 1:19
2960,20151225031208-655,1,8/15/2015 23:43,1439707380,C5,263580,1439970960,8/19/2015 0:56
4230,20152707102724-384,1,8/15/2015 3:59,1439636340,C8,333960,1439970300,8/19/2015 0:45
4885,20155213095235-98,2,8/17/2015 3:46,1439808360,C4,161820,1439970180,8/19/2015 0:43
2722,20151612121658-752,1,8/18/2015 4:32,1439897520,C8,70080,1439967600,8/19/2015 0:00
2087,20153225063218-391,1,8/10/2015 17:58,1439254680,C5,711780,1439966460,8/18/2015 23:41
1550,20151911041901-689,3,8/18/2015 3:31,1439893860,C6,69840,1439963700,8/18/2015 22:55
6111,20151028081039-84,1,8/11/2015 17:40,1439340000,C5,621900,1439961900,8/18/2015 22:25
6410,20151028111000-621,2,8/15/2015 20:46,1439696760,C6,264960,1439961720,8/18/2015 22:22
543,20155707125735-181,2,8/16/2015 1:27,1439713620,C2,245400,1439959020,8/18/2015 21:37
4331,20150208100221-140,3,8/17/2015 13:43,1439844180,C7,112980,1439957160,8/18/2015 21:06
4215,20153729093742-70,1,8/16/2015 14:25,1439760300,C4,196560,1439956860,8/18/2015 21:01
5393,20153302123354-327,1,8/16/2015 3:33,1439721180,C8,235440,1439956620,8/18/2015 20:57
3419,20150207030221-800,2,8/15/2015 2:56,1439632560,C4,323820,1439956380,8/18/2015 20:53
5905,20152126102142-711,1,8/14/2015 22:31,1439616660,C8,337080,1439953740,8/18/2015 20:09
5069,20154709044702-412,3,8/15/2015 18:03,1439686980,C7,261480,1439948460,8/18/2015 18:41
4072,20152007102018-450,1,8/17/2015 7:45,1439822700,C7,122100,1439944800,8/18/2015 17:40
1970,20154910024932-203,1,8/16/2015 0:37,1439710620,C5,233640,1439944260,8/18/2015 17:31
3071,20154610024627-393,3,8/17/2015 16:59,1439855940,C8,87540,1439943480,8/18/2015 17:18
91,20153813033817-519,2,8/13/2015 12:44,1439495040,C6,444660,1439939700,8/18/2015 16:15
915,20153711073747-446,1,8/12/2015 6:42,1439386920,C8,552300,1439939220,8/18/2015 16:07
3077,20154622054623-743,3,8/9/2015 16:30,1439163000,C7,775320,1439938320,8/18/2015 15:52
4165,20153401073445-361,2,8/16/2015 11:34,1439750040,C0,187200,1439937240,8/18/2015 15:34
2120,20155314085317-744,3,8/16/2015 12:10,1439752200,C2,184620,1439936820,8/18/2015 15:27
4957,20153601083623-683,1,8/15/2015 17:36,1439685360,C8,248400,1439933760,8/18/2015 14:36
3737,20155205095236-132,1,8/15/2015 7:19,1439648340,C2,284940,1439933280,8/18/2015 14:28
5589,20155910035914-610,3,8/15/2015 22:57,1439704620,C8,228540,1439933160,8/18/2015 14:26
448,20153731093738-268,2,8/16/2015 7:35,1439735700,C8,196440,1439932140,8/18/2015 14:09
6218,20153303113325-724,1,8/13/2015 13:09,1439496540,C0,434880,1439931420,8/18/2015 13:57
932,20154028084056-791,2,8/11/2015 12:02,1439319720,C5,610860,1439930580,8/18/2015 13:43
4457,20155117075129-610,2,8/13/2015 23:03,1439532180,C6,397920,1439930100,8/18/2015 13:35
4219,20152022082028-22,2,8/9/2015 11:28,1439144880,C5,783240,1439928120,8/18/2015 13:02
2079,20154315064331-937,1,8/17/2015 10:41,1439833260,C5,93540,1439926800,8/18/2015 12:40
2519,20153406113422-942,1,8/14/2015 12:04,1439579040,C8,346500,1439925540,8/18/2015 12:19
652,20154009074056-552,1,8/16/2015 23:10,1439791800,C8,132120,1439923920,8/18/2015 11:52
6137,20150010120037-8,1,8/5/2015 11:50,1438800600,C2,1122900,1439923500,8/18/2015 11:45
3456,20155824085808-856,3,8/15/2015 8:18,1439651880,C7,271200,1439923080,8/18/2015 11:38
5794,20152215092246-386,1,8/16/2015 22:30,1439789400,C2,133680,1439923080,8/18/2015 11:38
225,20151109101115-984,1,8/17/2015 10:51,1439833860,C4,86700,1439920560,8/18/2015 10:56
3127,20150812050800-581,1,8/17/2015 17:04,1439856240,C7,61680,1439917920,8/18/2015 10:12
3023,20151324041317-432,1,8/15/2015 7:37,1439649420,C7,267120,1439916540,8/18/2015 9:49
1672,20154912014924-804,2,8/15/2015 11:39,1439663940,C2,251400,1439915340,8/18/2015 9:29
3852,20155814095824-763,1,8/17/2015 1:34,1439800440,C4,114480,1439914920,8/18/2015 9:22
4405,20152509072510-961,1,8/16/2015 2:46,1439718360,C4,196020,1439914380,8/18/2015 9:13
4748,20150010040007-631,2,8/17/2015 6:42,1439818920,C6,95220,1439914140,8/18/2015 9:09
5698,20153029063040-935,2,8/15/2015 20:29,1439695740,C5,217020,1439912760,8/18/2015 8:46
4280,20152805082823-737,2,8/15/2015 2:34,1439631240,C5,280920,1439912160,8/18/2015 8:36
1311,20153724023747-163,1,8/10/2015 1:15,1439194500,C7,710340,1439904840,8/18/2015 6:34
4093,20151030091029-116,2,8/12/2015 19:42,1439433720,C5,469140,1439902860,8/18/2015 6:01
2571,20151914011913-652,3,8/16/2015 9:40,1439743200,C2,159660,1439902860,8/18/2015 6:01
5221,20150014030027-293,2,8/17/2015 8:12,1439824320,C4,78240,1439902560,8/18/2015 5:56
3079,20151124081114-91,1,8/15/2015 2:37,1439631420,C8,268680,1439900100,8/18/2015 5:15
4176,20151305041332-847,3,8/14/2015 0:35,1439537700,C5,360660,1439898360,8/18/2015 4:46
3676,20153408043401-757,3,8/17/2015 14:04,1439845440,C5,51240,1439896680,8/18/2015 4:18
4259,20154702084714-863,1,8/14/2015 5:14,1439554440,C5,341340,1439895780,8/18/2015 4:03
522,20150407050402-325,1,8/12/2015 22:21,1439443260,C3,451020,1439894280,8/18/2015 3:38
588,20152330112343-461,1,8/16/2015 1:39,1439714340,C2,179220,1439893560,8/18/2015 3:26
1424,20155008055031-646,1,8/15/2015 0:02,1439622120,C8,270360,1439892480,8/18/2015 3:08
3099,20152813072833-760,1,8/14/2015 2:56,1439546160,C2,343560,1439889720,8/18/2015 2:22
435,20154304074334-798,1,8/13/2015 2:47,1439459220,C3,429780,1439889000,8/18/2015 2:10
437,20155012025014-139,1,8/15/2015 8:25,1439652300,C6,236100,1439888400,8/18/2015 2:00
6072,20150613070601-595,2,8/16/2015 11:14,1439748840,C8,137040,1439885880,8/18/2015 1:18
5446,20151114121111-116,2,8/16/2015 20:33,1439782380,C8,101460,1439883840,8/18/2015 0:44
2532,20153222103251-804,1,8/9/2015 3:48,1439117280,C5,765480,1439882760,8/18/2015 0:26
1560,20152315102309-132,2,8/17/2015 3:23,1439806980,C2,73800,1439880780,8/17/2015 23:53
1979,20152607092603-350,2,8/12/2015 16:23,1439421780,C6,457020,1439878800,8/17/2015 23:20
3246,20150302120354-207,2,8/16/2015 5:55,1439729700,C4,148440,1439878140,8/17/2015 23:09
2147,20150911060927-249,2,8/15/2015 16:47,1439682420,C8,191940,1439874360,8/17/2015 22:06
3869,20155230015235-98,1,8/11/2015 19:14,1439345640,C2,528060,1439873700,8/17/2015 21:55
281,20151710111713-168,3,8/16/2015 15:57,1439765820,C8,107040,1439872860,8/17/2015 21:41
85,20154008014020-3,2,8/14/2015 18:50,1439603400,C3,268500,1439871900,8/17/2015 21:25
4455,20152502092544-104,1,8/12/2015 17:23,1439425380,C8,446340,1439871720,8/17/2015 21:22
1024,20150702040744-309,2,8/16/2015 4:31,1439724660,C5,145980,1439870640,8/17/2015 21:04
6439,20155925035953-311,2,8/12/2015 1:05,1439366700,C0,500520,1439867220,8/17/2015 20:07
20,20155430085434-503,1,8/12/2015 23:36,1439447760,C7,418680,1439866440,8/17/2015 19:54
285,20155815125829-147,1,8/17/2015 1:26,1439799960,C5,65640,1439865600,8/17/2015 19:40
6431,20154408124457-555,2,8/14/2015 17:08,1439597280,C5,267120,1439864400,8/17/2015 19:20
2944,20154113114117-693,2,8/13/2015 9:06,1439481960,C7,381300,1439863260,8/17/2015 19:01
5240,20155405125402-226,1,8/15/2015 17:49,1439686140,C8,176340,1439862480,8/17/2015 18:48
3997,20153731083734-496,1,8/13/2015 9:16,1439482560,C5,375180,1439857740,8/17/2015 17:29
2901,20150917070930-301,3,8/13/2015 18:19,1439515140,C5,339000,1439854140,8/17/2015 16:29
6170,20152412032434-101,1,8/17/2015 1:13,1439799180,C4,54420,1439853600,8/17/2015 16:20
3820,20154302094310-152,1,8/12/2015 13:29,1439411340,C7,438780,1439850120,8/17/2015 15:22
4760,20151315011308-405,1,8/16/2015 13:53,1439758380,C0,88800,1439847180,8/17/2015 14:33
1540,20150615050655-209,3,8/16/2015 23:02,1439791320,C8,53880,1439845200,8/17/2015 14:00
2815,20154403054427-199,2,8/15/2015 20:00,1439694000,C7,149280,1439843280,8/17/2015 13:28
5135,20151631031602-96,2,8/15/2015 9:35,1439656500,C7,182220,1439838720,8/17/2015 12:12
1658,20150514090525-937,3,8/16/2015 10:11,1439745060,C5,88380,1439833440,8/17/2015 10:44
3784,20150809010801-971,1,8/15/2015 10:47,1439660820,C2,169980,1439830800,8/17/2015 10:00
2212,20153818113831-85,1,8/13/2015 16:00,1439506800,C4,323160,1439829960,8/17/2015 9:46
2697,20153014043029-662,2,8/16/2015 17:18,1439770680,C4,58560,1439829240,8/17/2015 9:34
589,20152517012540-586,2,8/10/2015 14:29,1439242140,C0,583680,1439825820,8/17/2015 8:37
4999,20150831030801-105,2,8/13/2015 3:53,1439463180,C4,360900,1439824080,8/17/2015 8:08
2162,20155622095638-223,2,8/11/2015 2:36,1439285760,C5,536700,1439822460,8/17/2015 7:41
1379,20155631045627-683,1,8/15/2015 4:50,1439639400,C4,178920,1439818320,8/17/2015 6:32
5071,20151114071121-782,2,8/15/2015 18:47,1439689620,C0,128160,1439817780,8/17/2015 6:23
2588,20153706123753-969,1,8/11/2015 21:13,1439352780,C3,462960,1439815740,8/17/2015 5:49
4524,20150108050153-619,3,8/16/2015 4:13,1439723580,C0,92160,1439815740,8/17/2015 5:49
2664,20153706063755-802,1,8/11/2015 17:50,1439340600,C0,472380,1439812980,8/17/2015 5:03
4961,20150929090919-621,1,8/10/2015 22:23,1439270580,C8,542220,1439812800,8/17/2015 5:00
5483,20150429010400-59,1,8/14/2015 20:57,1439611020,C8,201540,1439812560,8/17/2015 4:56
5399,20152211072207-967,1,8/15/2015 5:44,1439642640,C7,169860,1439812500,8/17/2015 4:55
5962,20151309041300-869,1,8/16/2015 6:04,1439730240,C3,81180,1439811420,8/17/2015 4:37
4437,20153710023738-627,1,8/13/2015 21:14,1439525640,C4,283020,1439808660,8/17/2015 3:51
6186,20150804040846-173,1,8/12/2015 23:36,1439447760,C3,359040,1439806800,8/17/2015 3:20
6349,20154525024508-630,2,8/14/2015 7:29,1439562540,C5,243120,1439805660,8/17/2015 3:01
5763,20150430110428-833,2,8/14/2015 21:57,1439614620,C7,190740,1439805360,8/17/2015 2:56
4745,20150031060051-429,1,8/12/2015 21:36,1439440560,C5,364320,1439804880,8/17/2015 2:48
5460,20155709095720-363,1,8/12/2015 5:36,1439382960,C5,417420,1439800380,8/17/2015 1:33
5608,20153910113938-766,3,8/14/2015 20:49,1439610540,C8,189300,1439799840,8/17/2015 1:24
5481,20150314100300-561,2,8/15/2015 17:21,1439684460,C6,112680,1439797140,8/17/2015 0:39
4242,20153609113649-758,1,8/16/2015 1:41,1439714460,C4,81300,1439795760,8/17/2015 0:16
3764,20154708044705-32,1,8/14/2015 5:35,1439555700,C8,239040,1439794740,8/16/2015 23:59
1130,20154428104404-828,1,8/13/2015 17:34,1439512440,C8,281400,1439793840,8/16/2015 23:44
5832,20153526053516-741,2,8/14/2015 7:57,1439564220,C2,229560,1439793780,8/16/2015 23:43
1541,20152610112615-740,1,8/14/2015 19:24,1439605440,C2,187140,1439792580,8/16/2015 23:23
4550,20155611085614-73,1,8/15/2015 2:28,1439630880,C4,161160,1439792040,8/16/2015 23:14
5933,20151723021731-685,3,8/13/2015 21:59,1439528340,C5,263160,1439791500,8/16/2015 23:05
3915,20152712082719-296,1,8/15/2015 9:53,1439657580,C8,132180,1439789760,8/16/2015 22:36
308,20150312070334-705,1,8/15/2015 17:54,1439686440,C4,99420,1439785860,8/16/2015 21:31
4204,20155805085848-703,3,8/15/2015 10:21,1439659260,C7,124140,1439783400,8/16/2015 20:50
1055,20150509010550-822,2,8/15/2015 0:50,1439625000,C3,158100,1439783100,8/16/2015 20:45
3704,20154507064517-275,1,8/15/2015 16:00,1439679600,C4,103500,1439783100,8/16/2015 20:45
5800,20152412032403-590,3,8/11/2015 19:48,1439347680,C6,434640,1439782320,8/16/2015 20:32
578,20151307021320-869,1,8/15/2015 15:25,1439677500,C2,99360,1439776860,8/16/2015 19:01
4756,20150704110737-327,1,8/15/2015 8:11,1439651460,C5,117480,1439768940,8/16/2015 16:49
6451,20155208075242-780,3,8/14/2015 14:31,1439587860,C4,180780,1439768640,8/16/2015 16:44
4307,20151023041017-423,1,8/10/2015 16:28,1439249280,C2,518760,1439768040,8/16/2015 16:34
559,20153507033523-248,2,8/15/2015 16:23,1439680980,C6,86760,1439767740,8/16/2015 16:29
819,20154328084349-846,1,8/11/2015 4:51,1439293860,C0,473460,1439767320,8/16/2015 16:22
3474,20153610123659-887,3,8/15/2015 21:10,1439698200,C7,66120,1439764320,8/16/2015 15:32
2969,20153525023538-936,2,8/13/2015 10:59,1439488740,C6,271440,1439760180,8/16/2015 14:23
2137,20150923010958-595,3,8/9/2015 20:12,1439176320,C5,583740,1439760060,8/16/2015 14:21
1021,20151418011444-201,3,8/13/2015 8:42,1439480520,C4,278760,1439759280,8/16/2015 14:08
1718,20154423014424-392,1,8/8/2015 13:58,1439067480,C2,691620,1439759100,8/16/2015 14:05
659,20152713122742-24,1,8/15/2015 13:27,1439670420,C8,88200,1439758620,8/16/2015 13:57
465,20154425094430-276,1,8/9/2015 4:28,1439119680,C2,638520,1439758200,8/16/2015 13:50
1524,20155310055324-613,1,8/13/2015 15:42,1439505720,C2,251340,1439757060,8/16/2015 13:31
4106,20153208123237-878,1,8/12/2015 12:27,1439407620,C0,345300,1439752920,8/16/2015 12:22
3772,20151513041529-826,3,8/15/2015 12:49,1439668140,C4,80220,1439748360,8/16/2015 11:06
5970,20150825040838-487,1,8/14/2015 6:41,1439559660,C7,188220,1439747880,8/16/2015 10:58
1111,20150309030327-506,3,8/15/2015 19:53,1439693580,C5,53580,1439747160,8/16/2015 10:46
319,20151031071048-450,1,8/14/2015 9:58,1439571480,C5,174240,1439745720,8/16/2015 10:22
723,20151612081630-430,3,8/12/2015 0:40,1439365200,C5,378720,1439743920,8/16/2015 9:52
1241,20153722113716-211,1,8/13/2015 6:52,1439473920,C2,269100,1439743020,8/16/2015 9:37
5239,20153111053127-294,2,8/14/2015 20:11,1439608260,C7,134400,1439742660,8/16/2015 9:31
884,20153010043052-895,2,8/15/2015 15:44,1439678640,C3,61320,1439739960,8/16/2015 8:46
4057,20155410035426-585,1,8/15/2015 9:19,1439655540,C8,81660,1439737200,8/16/2015 8:00
1741,20154629034645-799,1,8/10/2015 10:14,1439226840,C7,508440,1439735280,8/16/2015 7:28
4023,20153813103815-223,1,8/4/2015 23:48,1438757280,C7,974100,1439731380,8/16/2015 6:23
4806,20151429111451-30,3,8/14/2015 6:42,1439559720,C5,170760,1439730480,8/16/2015 6:08
1845,20150127110109-336,1,8/12/2015 22:46,1439444760,C8,284940,1439729700,8/16/2015 5:55
4629,20151804111828-884,1,8/1/2015 23:42,1438497720,C8,1231920,1439729640,8/16/2015 5:54
1351,20150217070227-343,1,8/12/2015 21:34,1439440440,C4,287340,1439727780,8/16/2015 5:23
2940,20154209044216-651,2,8/15/2015 9:19,1439655540,C5,70260,1439725800,8/16/2015 4:50
2030,20153703073756-936,1,8/9/2015 17:47,1439167620,C3,555000,1439722620,8/16/2015 3:57
5158,20154303014356-798,2,8/11/2015 7:11,1439302260,C4,418260,1439720520,8/16/2015 3:22
2436,20153107123119-251,1,8/13/2015 6:19,1439471940,C8,248040,1439719980,8/16/2015 3:13
3100,20150112080120-851,2,8/15/2015 4:16,1439637360,C3,81900,1439719260,8/16/2015 3:01
3793,20154030094014-979,1,8/14/2015 6:04,1439557440,C2,160380,1439717820,8/16/2015 2:37
2559,20152411112403-168,1,8/4/2015 0:28,1438673280,C8,1043520,1439716800,8/16/2015 2:20
2515,20152911062908-132,3,8/14/2015 11:29,1439576940,C2,138600,1439715540,8/16/2015 1:59
2903,20151211061241-520,1,8/13/2015 15:42,1439505720,C6,207000,1439712720,8/16/2015 1:12
1375,20151808051800-604,1,8/15/2015 1:47,1439628420,C7,78420,1439706840,8/15/2015 23:34
6214,20155308045321-417,1,8/14/2015 18:13,1439601180,C8,104640,1439705820,8/15/2015 23:17
6320,20151431041410-501,3,8/14/2015 1:04,1439539440,C4,165000,1439704440,8/15/2015 22:54
6118,20152407022444-628,1,8/13/2015 20:45,1439523900,C5,180420,1439704320,8/15/2015 22:52
4832,20154127094129-318,1,8/11/2015 1:32,1439281920,C4,422220,1439704140,8/15/2015 22:49
5750,20151106071155-474,1,8/14/2015 17:36,1439598960,C7,104100,1439703060,8/15/2015 22:31
5075,20151510051559-717,1,8/13/2015 7:41,1439476860,C2,224760,1439701620,8/15/2015 22:07
1166,20151511081530-342,1,8/14/2015 9:23,1439569380,C2,131640,1439701020,8/15/2015 21:57
3068,20153113063149-619,2,8/7/2015 22:49,1439012940,C4,687240,1439700180,8/15/2015 21:43
1441,20155026015047-456,2,8/10/2015 19:20,1439259600,C3,438600,1439698200,8/15/2015 21:10
3481,20152109022102-894,3,8/12/2015 16:16,1439421360,C4,266100,1439687460,8/15/2015 18:11
6166,20150411120449-453,2,8/14/2015 8:08,1439564880,C4,122520,1439687400,8/15/2015 18:10
4599,20153629093621-951,1,8/13/2015 19:28,1439519280,C4,166440,1439685720,8/15/2015 17:42
1957,20155519095518-431,3,8/12/2015 7:06,1439388360,C0,294780,1439683140,8/15/2015 16:59
2822,20153208083206-395,2,8/14/2015 18:46,1439603160,C5,79320,1439682480,8/15/2015 16:48
3339,20154311044358-220,2,8/13/2015 16:42,1439509320,C2,172740,1439682060,8/15/2015 16:41
1185,20154622104622-839,1,8/12/2015 15:47,1439419620,C3,261780,1439681400,8/15/2015 16:30
2364,20154107124142-501,1,8/14/2015 7:41,1439563260,C8,117360,1439680620,8/15/2015 16:17
163,20153011093025-374,1,8/14/2015 14:30,1439587800,C4,92400,1439680200,8/15/2015 16:10
432,20155903065939-454,3,8/14/2015 1:45,1439541900,C8,133080,1439674980,8/15/2015 14:43
3589,20152606022653-437,3,8/12/2015 14:26,1439414760,C7,259200,1439673960,8/15/2015 14:26
186,20152304012310-843,1,8/12/2015 19:35,1439433300,C4,237840,1439671140,8/15/2015 13:39
3207,20153604053608-723,2,8/10/2015 21:28,1439267280,C0,401340,1439668620,8/15/2015 12:57
3851,20154312114332-412,1,8/14/2015 12:07,1439579220,C3,87120,1439666340,8/15/2015 12:19
4288,20150429080442-199,2,8/6/2015 22:07,1438924020,C6,741780,1439665800,8/15/2015 12:10
3710,20151929111950-606,1,8/11/2015 5:52,1439297520,C2,367860,1439665380,8/15/2015 12:03
2508,20150609030606-244,1,8/12/2015 13:00,1439409600,C6,251640,1439661240,8/15/2015 10:54
5892,20152131042143-820,2,8/13/2015 14:20,1439500800,C8,159420,1439660220,8/15/2015 10:37
3124,20154321124336-179,1,7/28/2015 3:09,1438078140,C0,1581180,1439659320,8/15/2015 10:22
4323,20153209023251-83,1,8/14/2015 16:48,1439596080,C8,62880,1439658960,8/15/2015 10:16
4148,20152526082520-23,3,8/13/2015 4:41,1439466060,C5,192720,1439658780,8/15/2015 10:13
5435,20151501051519-505,1,8/13/2015 21:31,1439526660,C6,131520,1439658180,8/15/2015 10:03
5603,20152904022933-687,2,8/10/2015 17:49,1439254140,C2,401100,1439655240,8/15/2015 9:14
812,20155313015324-374,1,8/10/2015 16:41,1439250060,C6,404880,1439654940,8/15/2015 9:09
2278,20150303100354-126,2,8/11/2015 8:33,1439307180,C5,342900,1439650080,8/15/2015 7:48
3430,20155501115503-638,2,8/13/2015 13:57,1439499420,C8,149160,1439648580,8/15/2015 7:23
1696,20150122100136-869,1,8/9/2015 7:37,1439131020,C2,515520,1439646540,8/15/2015 6:49
4374,20151719041725-731,1,8/11/2015 11:23,1439317380,C6,328260,1439645640,8/15/2015 6:34
2925,20150112050122-27,1,8/11/2015 1:27,1439281620,C5,362280,1439643900,8/15/2015 6:05
5843,20151503081552-98,2,8/11/2015 6:23,1439299380,C8,342240,1439641620,8/15/2015 5:27
3138,20154711064710-266,3,8/13/2015 21:41,1439527260,C7,113220,1439640480,8/15/2015 5:08
6225,20150521080528-185,1,8/9/2015 2:37,1439113020,C6,526740,1439639760,8/15/2015 4:56
3306,20150329080354-90,3,8/13/2015 2:01,1439456460,C4,182040,1439638500,8/15/2015 4:35
2242,20152331102327-0,1,8/13/2015 8:01,1439478060,C7,159240,1439637300,8/15/2015 4:15
5106,20152307042315-347,2,8/11/2015 10:16,1439313360,C0,323580,1439636940,8/15/2015 4:09
3803,20155804085814-147,1,8/13/2015 22:10,1439529000,C5,103140,1439632140,8/15/2015 2:49
2157,20154931024946-567,1,8/10/2015 6:45,1439214300,C7,417480,1439631780,8/15/2015 2:43
2352,20155613045650-872,1,8/14/2015 9:32,1439569920,C4,59760,1439629680,8/15/2015 2:08
4469,20150205050251-251,2,8/11/2015 22:54,1439358840,C7,269760,1439628600,8/15/2015 1:50
2272,20152803022825-787,3,8/11/2015 5:24,1439295840,C3,329280,1439625120,8/15/2015 0:52
2345,20155610055653-905,2,8/13/2015 21:44,1439527440,C3,90960,1439618400,8/14/2015 23:00
1272,20153028093055-321,3,8/10/2015 12:27,1439234820,C4,377940,1439612760,8/14/2015 21:26
2990,20151709111735-195,1,8/10/2015 18:53,1439257980,C5,349020,1439607000,8/14/2015 19:50
4583,20153616093612-196,1,8/7/2015 11:03,1438970580,C4,635340,1439605920,8/14/2015 19:32
5233,20151621011611-3,2,8/12/2015 2:28,1439371680,C4,232740,1439604420,8/14/2015 19:07
3756,20151826071854-437,1,8/11/2015 12:53,1439322780,C8,280500,1439603280,8/14/2015 18:48
6379,20152524072545-996,1,8/12/2015 9:01,1439395260,C6,205920,1439601180,8/14/2015 18:13
6029,20152426062434-212,1,8/12/2015 7:40,1439390400,C7,210480,1439600880,8/14/2015 18:08
79,20151720091715-120,1,8/11/2015 13:38,1439325480,C8,273780,1439599260,8/14/2015 17:41
4607,20154519024544-322,2,8/12/2015 9:18,1439396280,C4,202800,1439599080,8/14/2015 17:38
1862,20150307020308-823,1,8/13/2015 22:27,1439530020,C6,68580,1439598600,8/14/2015 17:30
6485,20150406120427-726,3,8/9/2015 19:37,1439174220,C3,423540,1439597760,8/14/2015 17:16
4171,20150418040454-388,3,8/11/2015 17:00,1439337600,C5,259620,1439597220,8/14/2015 17:07
434,20152626032621-951,3,8/9/2015 22:41,1439185260,C3,411900,1439597160,8/14/2015 17:06
519,20150405080425-970,2,8/9/2015 15:11,1439158260,C5,435660,1439593920,8/14/2015 16:12
2740,20150427060448-246,3,8/8/2015 12:24,1439061840,C7,529800,1439591640,8/14/2015 15:34
1905,20155908025917-368,1,8/11/2015 15:14,1439331240,C6,260100,1439591340,8/14/2015 15:29
3995,20152831092837-751,1,8/12/2015 5:43,1439383380,C8,204660,1439588040,8/14/2015 14:34
46,20150109040106-69,3,8/13/2015 18:06,1439514360,C8,70620,1439584980,8/14/2015 13:43
6018,20155304095343-996,2,8/11/2015 4:23,1439292180,C7,292500,1439584680,8/14/2015 13:38
1952,20150310050337-557,1,8/13/2015 14:18,1439500680,C3,83100,1439583780,8/14/2015 13:23
3316,20153817033857-516,1,7/31/2015 14:25,1438377900,C2,1205220,1439583120,8/14/2015 13:12
5425,20155904015930-845,3,8/13/2015 7:17,1439475420,C4,107640,1439583060,8/14/2015 13:11
678,20155423015434-702,2,8/11/2015 19:12,1439345520,C8,237240,1439582760,8/14/2015 13:06
2214,20153322063340-765,3,8/11/2015 21:45,1439354700,C4,222840,1439577540,8/14/2015 11:39
5536,20155230115226-97,3,7/30/2015 11:40,1438281600,C8,1295640,1439577240,8/14/2015 11:34
1574,20150626110605-541,1,8/2/2015 5:24,1438518240,C2,1058760,1439577000,8/14/2015 11:30
6180,20153002083005-261,1,8/13/2015 5:57,1439470620,C7,104580,1439575200,8/14/2015 11:00
3814,20154728094759-13,2,8/10/2015 4:35,1439206500,C5,368160,1439574660,8/14/2015 10:51
3076,20150624080630-565,1,8/10/2015 22:11,1439269860,C8,303900,1439573760,8/14/2015 10:36
2431,20150228040218-159,1,8/12/2015 8:08,1439392080,C5,181080,1439573160,8/14/2015 10:26
5469,20151607011652-132,2,8/12/2015 2:54,1439373240,C5,197340,1439570580,8/14/2015 9:43
330,20152704022721-344,2,8/11/2015 3:17,1439288220,C8,282300,1439570520,8/14/2015 9:42
3599,20155304035331-275,1,7/31/2015 19:45,1438397100,C8,1173360,1439570460,8/14/2015 9:41
6409,20153310073359-286,3,8/13/2015 9:03,1439481780,C2,88200,1439569980,8/14/2015 9:33
4245,20152809032822-774,1,7/23/2015 10:58,1437674280,C5,1892700,1439566980,8/14/2015 8:43
5387,20150709120708-806,3,8/13/2015 3:28,1439461680,C5,104820,1439566500,8/14/2015 8:35
1677,20150115110144-566,1,8/11/2015 0:29,1439278140,C2,286860,1439565000,8/14/2015 8:10
6462,20151506031520-642,2,8/10/2015 11:26,1439231160,C3,331860,1439563020,8/14/2015 7:37
2570,20151621071645-193,3,8/11/2015 7:16,1439302560,C5,259200,1439561760,8/14/2015 7:16
2914,20153604073634-474,1,8/11/2015 18:54,1439344440,C0,215160,1439559600,8/14/2015 6:40
3346,20153710073716-970,1,8/13/2015 6:28,1439472480,C3,85020,1439557500,8/14/2015 6:05
4385,20151902011959-320,1,8/12/2015 22:31,1439443860,C3,112140,1439556000,8/14/2015 5:40
5328,20151303081343-855,1,8/8/2015 18:45,1439084700,C4,469920,1439554620,8/14/2015 5:17
909,20152726032711-587,1,8/11/2015 2:47,1439286420,C8,267360,1439553780,8/14/2015 5:03
1405,20150702020734-303,1,8/8/2015 9:33,1439051580,C2,501960,1439553540,8/14/2015 4:59
5370,20153403083413-579,3,8/8/2015 18:43,1439084580,C3,468540,1439553120,8/14/2015 4:52
575,20150808090842-727,1,8/4/2015 15:20,1438726800,C6,824520,1439551320,8/14/2015 4:22
5462,20155227125212-315,3,8/8/2015 6:50,1439041800,C7,507540,1439549340,8/14/2015 3:49
6185,20151625101651-52,1,8/7/2015 22:33,1439011980,C3,537060,1439549040,8/14/2015 3:44
3921,20153426053424-13,1,8/6/2015 1:54,1438851240,C8,697200,1439548440,8/14/2015 3:34
3479,20150609050629-558,3,8/13/2015 11:36,1439490960,C6,54300,1439545260,8/14/2015 2:41
4812,20150323030348-749,1,8/6/2015 22:43,1438926180,C4,618600,1439544780,8/14/2015 2:33
2092,20152123102144-807,1,8/11/2015 16:21,1439335260,C5,207900,1439543160,8/14/2015 2:06
4065,20152806032847-86,3,8/9/2015 19:12,1439172720,C3,368880,1439541600,8/14/2015 1:40
2055,20151407071448-332,1,8/12/2015 21:04,1439438640,C8,96360,1439535000,8/13/2015 23:50
1607,20151707041712-312,3,8/11/2015 21:13,1439352780,C8,181680,1439534460,8/13/2015 23:41
4567,20152718012719-661,3,8/11/2015 0:39,1439278740,C5,253440,1439532180,8/13/2015 23:03
5684,20154431104451-420,2,8/11/2015 16:04,1439334240,C8,193920,1439528160,8/13/2015 21:56
6417,20151110101156-652,2,8/12/2015 18:01,1439427660,C5,100500,1439528160,8/13/2015 21:56
6525,20155623095618-430,1,8/6/2015 17:52,1438908720,C5,619080,1439527800,8/13/2015 21:50
2937,20153711013755-30,1,8/13/2015 2:17,1439457420,C4,66000,1439523420,8/13/2015 20:37
5810,20153015023001-696,2,8/6/2015 13:03,1438891380,C5,631860,1439523240,8/13/2015 20:34
3968,20150925070901-487,2,8/11/2015 9:49,1439311740,C0,211200,1439522940,8/13/2015 20:29
2114,20151330041314-275,2,8/12/2015 6:29,1439386140,C3,136020,1439522160,8/13/2015 20:16
1722,20154211104241-339,1,8/13/2015 0:52,1439452320,C5,68700,1439521020,8/13/2015 19:57
5062,20155719125713-529,1,8/10/2015 22:01,1439269260,C4,241680,1439510940,8/13/2015 17:09
4824,20154309044344-578,3,8/13/2015 3:01,1439460060,C6,49380,1439509440,8/13/2015 16:44
2949,20152803082807-792,1,8/12/2015 12:52,1439409120,C6,99180,1439508300,8/13/2015 16:25
5523,20154109014116-716,2,8/12/2015 15:17,1439417820,C2,88320,1439506140,8/13/2015 15:49
2180,20152716122736-950,1,8/9/2015 15:15,1439158500,C1,347280,1439505780,8/13/2015 15:43
3250,20152922072911-283,2,8/11/2015 3:53,1439290380,C5,214380,1439504760,8/13/2015 15:26
5702,20154008044039-692,1,8/12/2015 8:13,1439392380,C5,105060,1439497440,8/13/2015 13:24
6337,20154128094123-201,1,8/8/2015 9:41,1439052060,C5,442800,1439494860,8/13/2015 12:41
6324,20155307125327-646,1,8/7/2015 8:28,1438961280,C8,532500,1439493780,8/13/2015 12:23
3791,20152928092934-717,3,8/11/2015 11:49,1439318940,C2,174000,1439492940,8/13/2015 12:09
2895,20151112011137-325,1,8/9/2015 11:19,1439144340,C2,344640,1439488980,8/13/2015 11:03
916,20155209065239-593,1,8/12/2015 1:10,1439367000,C5,119340,1439486340,8/13/2015 10:19
2793,20150223110226-578,1,8/11/2015 2:06,1439283960,C5,201180,1439485140,8/13/2015 9:59
1467,20150724010756-126,2,8/10/2015 13:43,1439239380,C6,245160,1439484540,8/13/2015 9:49
6406,20153802043859-167,1,8/12/2015 5:10,1439381400,C3,102840,1439484240,8/13/2015 9:44
3560,20154103084118-72,1,8/10/2015 0:49,1439192940,C8,288240,1439481180,8/13/2015 8:53
1330,20153416013430-901,2,8/10/2015 6:30,1439213400,C2,266820,1439480220,8/13/2015 8:37
5343,20150218120246-220,1,8/10/2015 2:46,1439199960,C0,279120,1439479080,8/13/2015 8:18
3472,20151303091355-495,3,8/10/2015 20:19,1439263140,C5,214920,1439478060,8/13/2015 8:01
1084,20152028062056-368,3,8/9/2015 6:41,1439127660,C0,346020,1439473680,8/13/2015 6:48
6458,20151101121144-520,2,8/8/2015 12:03,1439060580,C4,410340,1439470920,8/13/2015 6:02
5846,20155509115514-291,1,8/11/2015 23:43,1439361780,C5,107640,1439469420,8/13/2015 5:37
2027,20150816060823-385,3,8/3/2015 21:44,1438663440,C3,805680,1439469120,8/13/2015 5:32
93,20154508114523-645,1,8/10/2015 20:37,1439264220,C2,204720,1439468940,8/13/2015 5:29
4487,20152109052119-324,1,8/11/2015 11:15,1439316900,C6,150840,1439467740,8/13/2015 5:09
694,20155601065611-898,2,8/11/2015 20:48,1439351280,C2,114240,1439465520,8/13/2015 4:32
3938,20154708044711-639,1,8/12/2015 1:26,1439367960,C2,96780,1439464740,8/13/2015 4:19
1509,20151210021258-493,1,8/11/2015 21:09,1439352540,C4,111420,1439463960,8/13/2015 4:06
1244,20150126050104-378,1,8/4/2015 10:29,1438709340,C4,754080,1439463420,8/13/2015 3:57
2587,20152119042123-730,2,8/10/2015 10:37,1439228220,C5,235020,1439463240,8/13/2015 3:54
1928,20155830065855-504,3,8/11/2015 4:16,1439291760,C6,171180,1439462940,8/13/2015 3:49
4589,20154303024314-609,1,8/11/2015 23:02,1439359320,C7,103020,1439462340,8/13/2015 3:39
4977,20153909123939-465,3,8/12/2015 5:48,1439383680,C3,78180,1439461860,8/13/2015 3:31
6274,20150207100218-368,1,8/11/2015 5:38,1439296680,C8,164880,1439461560,8/13/2015 3:26
3831,20154202074243-737,1,8/9/2015 12:50,1439149800,C4,311640,1439461440,8/13/2015 3:24
5315,20150621090620-651,2,8/7/2015 6:10,1438953000,C0,506280,1439459280,8/13/2015 2:48
32,20152902022959-436,1,7/30/2015 6:39,1438263540,C0,1195500,1439459040,8/13/2015 2:44
2330,20153607053604-567,2,8/12/2015 9:01,1439395260,C3,57300,1439452560,8/13/2015 0:56
3889,20153007013003-908,1,8/8/2015 23:22,1439101320,C5,350040,1439451360,8/13/2015 0:36
1485,20154912084916-322,1,8/9/2015 12:09,1439147340,C6,303900,1439451240,8/13/2015 0:34
4668,20155323025342-343,1,8/6/2015 4:51,1438861860,C8,586740,1439448600,8/12/2015 23:50
4946,20152913082912-781,1,8/2/2015 18:35,1438565700,C5,882180,1439447880,8/12/2015 23:38
3367,20151522041501-365,1,8/10/2015 6:44,1439214240,C4,229620,1439443860,8/12/2015 22:31
5760,20150704010749-266,1,8/10/2015 3:05,1439201100,C7,241140,1439442240,8/12/2015 22:04
6113,20150324060332-594,2,8/9/2015 15:03,1439157780,C8,282960,1439440740,8/12/2015 21:39
2349,20152830062810-554,1,8/9/2015 11:46,1439145960,C2,294360,1439440320,8/12/2015 21:32
4803,20151007011028-996,1,8/12/2015 0:00,1439362800,C8,76920,1439439720,8/12/2015 21:22
6209,20152608082638-702,2,8/10/2015 14:32,1439242320,C4,194760,1439437080,8/12/2015 20:38
442,20155710055728-180,3,8/12/2015 3:43,1439376180,C4,60780,1439436960,8/12/2015 20:36
5007,20155520045513-443,2,8/9/2015 22:22,1439184120,C8,249660,1439433780,8/12/2015 19:43
2798,20154709044740-841,1,8/11/2015 18:33,1439343180,C4,89580,1439432760,8/12/2015 19:26
3182,20152531072521-938,3,8/9/2015 16:01,1439161260,C4,269520,1439430780,8/12/2015 18:53
3547,20151606081628-560,1,8/10/2015 15:12,1439244720,C3,185280,1439430000,8/12/2015 18:40
6401,20152629022625-52,1,8/7/2015 20:50,1439005800,C2,424080,1439429880,8/12/2015 18:38
4534,20150010080005-370,1,8/11/2015 12:46,1439322360,C4,103560,1439425920,8/12/2015 17:32
5678,20151002071039-91,1,8/9/2015 4:36,1439120160,C8,297780,1439417940,8/12/2015 15:19
6101,20154118114130-34,1,8/8/2015 10:31,1439055060,C8,362040,1439417100,8/12/2015 15:05
1545,20153905113904-390,2,8/7/2015 4:15,1438946100,C6,470760,1439416860,8/12/2015 15:01
4138,20153710023741-996,1,8/8/2015 22:13,1439097180,C4,316620,1439413800,8/12/2015 14:10
1805,20152626022659-583,1,8/10/2015 10:51,1439229060,C8,183300,1439412360,8/12/2015 13:46
4491,20155407095431-303,3,8/11/2015 6:39,1439300340,C5,111300,1439411640,8/12/2015 13:34
1972,20154006014046-882,1,8/10/2015 12:50,1439236200,C2,171300,1439407500,8/12/2015 12:25
2597,20150405090426-651,2,8/6/2015 3:34,1438857240,C8,549000,1439406240,8/12/2015 12:04
4720,20151025071006-134,3,8/9/2015 21:04,1439179440,C6,224340,1439403780,8/12/2015 11:23
4233,20153124113131-106,2,8/10/2015 8:43,1439221380,C4,182340,1439403720,8/12/2015 11:22
1256,20155124035131-240,1,8/6/2015 4:39,1438861140,C7,541440,1439402580,8/12/2015 11:03
8,20155525065551-662,1,8/10/2015 4:32,1439206320,C8,196260,1439402580,8/12/2015 11:03
2399,20151106031107-912,2,8/11/2015 18:47,1439344020,C2,55620,1439399640,8/12/2015 10:14
846,20150917110936-396,3,8/9/2015 3:59,1439117940,C4,280200,1439398140,8/12/2015 9:49
5082,20151002021015-986,1,8/9/2015 3:14,1439115240,C5,282720,1439397960,8/12/2015 9:46
4979,20152217062234-111,3,8/9/2015 3:17,1439115420,C4,282300,1439397720,8/12/2015 9:42
2097,20150405120404-360,2,8/11/2015 6:04,1439298240,C8,99360,1439397600,8/12/2015 9:40
1877,20155525045517-999,1,8/10/2015 4:23,1439205780,C5,191040,1439396820,8/12/2015 9:27
2549,20152101012104-141,1,8/11/2015 3:45,1439289900,C2,103680,1439393580,8/12/2015 8:33
2116,20153606053617-896,3,8/10/2015 11:24,1439231040,C8,161640,1439392680,8/12/2015 8:18
1669,20155731015742-412,1,8/9/2015 9:30,1439137800,C5,253860,1439391660,8/12/2015 8:01
3184,20154703044709-708,1,8/7/2015 8:51,1438962660,C3,427920,1439390580,8/12/2015 7:43
345,20151002041036-991,1,8/9/2015 2:22,1439112120,C3,277560,1439389680,8/12/2015 7:28
2373,20154131064108-797,1,8/9/2015 7:08,1439129280,C2,259740,1439389020,8/12/2015 7:17
392,20154922104905-300,1,8/10/2015 5:07,1439208420,C7,180120,1439388540,8/12/2015 7:09
2392,20152821042813-361,2,8/9/2015 13:57,1439153820,C3,233220,1439387040,8/12/2015 6:44
2199,20155531115507-502,2,8/10/2015 7:30,1439217000,C8,169620,1439386620,8/12/2015 6:37
1960,20155108015134-360,3,8/11/2015 0:37,1439278620,C5,105780,1439384400,8/12/2015 6:00
1078,20154605024652-886,1,8/10/2015 13:37,1439239020,C0,142620,1439381640,8/12/2015 5:14
2680,20155529045530-793,2,8/10/2015 17:03,1439251380,C2,129660,1439381040,8/12/2015 5:04
4044,20155402045434-428,2,8/9/2015 0:18,1439104680,C5,272520,1439377200,8/12/2015 4:00
5431,20154731124720-805,1,8/10/2015 20:47,1439264820,C5,111600,1439376420,8/12/2015 3:47
2713,20152205052223-701,2,8/11/2015 8:14,1439306040,C5,69360,1439375400,8/12/2015 3:30
1865,20154020024044-998,3,8/9/2015 7:03,1439128980,C5,242940,1439371920,8/12/2015 2:32
1812,20150708100721-172,3,8/8/2015 5:43,1439037780,C5,332820,1439370600,8/12/2015 2:10
943,20153613053658-337,1,8/7/2015 4:11,1438945860,C8,422340,1439368200,8/12/2015 1:30
617,20154506054510-602,3,8/7/2015 12:31,1438975860,C3,392280,1439368140,8/12/2015 1:29
4370,20151428111428-181,3,8/9/2015 15:04,1439157840,C8,210120,1439367960,8/12/2015 1:26
6178,20153801063819-939,1,8/8/2015 10:54,1439056440,C5,310080,1439366520,8/12/2015 1:02
5867,20155914105910-953,1,8/8/2015 20:19,1439090340,C4,274200,1439364540,8/12/2015 0:29
5102,20155716015702-925,3,8/3/2015 22:51,1438667460,C6,696540,1439364000,8/12/2015 0:20
3302,20154026024058-952,2,8/9/2015 23:04,1439186640,C4,177120,1439363760,8/12/2015 0:16
5333,20155508035530-98,1,8/10/2015 21:19,1439266740,C0,96120,1439362860,8/12/2015 0:01
1041,20154606054615-464,2,8/7/2015 10:54,1438970040,C7,391440,1439361480,8/11/2015 23:38
2007,20154723054713-268,1,8/5/2015 19:41,1438828860,C7,531720,1439360580,8/11/2015 23:23
2781,20152027032011-806,2,8/6/2015 20:40,1438918800,C2,441600,1439360400,8/11/2015 23:20
4302,20150326090318-883,1,8/6/2015 10:25,1438881900,C5,477660,1439359560,8/11/2015 23:06
5712,20153201063205-376,1,8/10/2015 10:08,1439226480,C6,131760,1439358240,8/11/2015 22:44
2663,20151608091658-472,1,8/10/2015 17:34,1439253240,C7,101340,1439354580,8/11/2015 21:43
4442,20151003111052-171,1,8/7/2015 16:22,1438989720,C4,364320,1439354040,8/11/2015 21:34
2982,20152012042036-344,1,8/6/2015 20:35,1438918500,C8,435060,1439353560,8/11/2015 21:26
4061,20150228010235-447,2,8/10/2015 1:27,1439195220,C3,154500,1439349720,8/11/2015 20:22
4855,20150629090627-62,2,8/10/2015 8:26,1439220360,C0,129300,1439349660,8/11/2015 20:21
633,20150206080212-82,1,8/2/2015 16:59,1438559940,C4,788340,1439348280,8/11/2015 19:58
2402,20155706045723-418,1,8/10/2015 2:51,1439200260,C8,147420,1439347680,8/11/2015 19:48
5305,20153122093107-869,1,8/9/2015 13:15,1439151300,C5,196080,1439347380,8/11/2015 19:43
5367,20152030032051-557,2,8/8/2015 18:26,1439083560,C4,262920,1439346480,8/11/2015 19:28
3868,20155530035556-433,2,8/7/2015 18:15,1438996500,C8,349800,1439346300,8/11/2015 19:25
906,20152209112223-837,2,8/11/2015 0:24,1439277840,C0,66660,1439344500,8/11/2015 18:55
2996,20150701070729-336,1,8/9/2015 3:31,1439116260,C5,226080,1439342340,8/11/2015 18:19
6490,20151409051437-834,2,8/11/2015 1:12,1439280720,C4,57540,1439338260,8/11/2015 17:11
2803,20150130030134-783,1,8/10/2015 11:34,1439231640,C7,104220,1439335860,8/11/2015 16:31
3233,20154505024531-4,2,8/10/2015 19:21,1439259660,C6,74760,1439334420,8/11/2015 16:07
2108,20155330095316-775,3,8/8/2015 14:23,1439068980,C0,264600,1439333580,8/11/2015 15:53
4486,20151309051316-267,3,8/11/2015 0:13,1439277180,C5,55800,1439332980,8/11/2015 15:43
4553,20154320064328-347,2,8/4/2015 4:33,1438687980,C2,644100,1439332080,8/11/2015 15:28
1306,20153108053138-793,1,8/10/2015 15:31,1439245860,C0,82800,1439328660,8/11/2015 14:31
1825,20151230021228-117,1,8/8/2015 14:24,1439069040,C2,259440,1439328480,8/11/2015 14:28
1202,20150109060133-67,1,8/10/2015 9:46,1439225160,C2,99900,1439325060,8/11/2015 13:31
6297,20152328052341-673,3,8/4/2015 15:15,1438726500,C2,597120,1439323620,8/11/2015 13:07
837,20153707093749-951,2,8/10/2015 3:57,1439204220,C3,119400,1439323620,8/11/2015 13:07
5395,20152903032937-233,3,8/8/2015 21:39,1439095140,C5,227100,1439322240,8/11/2015 12:44
248,20150030100046-714,2,8/7/2015 10:54,1438970040,C7,347220,1439317260,8/11/2015 11:21
3614,20155102045128-941,1,8/10/2015 14:18,1439241480,C7,75780,1439317260,8/11/2015 11:21
6192,20151421031443-290,2,8/4/2015 12:32,1438716720,C7,599940,1439316660,8/11/2015 11:11
1590,20153531103551-510,1,8/10/2015 5:23,1439209380,C2,105660,1439315040,8/11/2015 10:44
2708,20151607061640-872,1,8/10/2015 1:14,1439194440,C7,120540,1439314980,8/11/2015 10:43
3114,20152707022754-808,3,8/9/2015 12:30,1439148600,C6,165780,1439314380,8/11/2015 10:33
4716,20154408074420-516,1,8/10/2015 9:36,1439224560,C7,89760,1439314320,8/11/2015 10:32
912,20153308073320-351,1,8/10/2015 9:29,1439224140,C8,89880,1439314020,8/11/2015 10:27
5021,20150401070439-330,1,8/10/2015 6:24,1439213040,C4,96900,1439309940,8/11/2015 9:19
5472,20150606050653-525,1,8/10/2015 20:50,1439265000,C4,44880,1439309880,8/11/2015 9:18
6500,20155119025114-185,2,8/7/2015 14:06,1438981560,C8,327780,1439309340,8/11/2015 9:09
1462,20150102080153-960,2,8/8/2015 8:45,1439048700,C5,260520,1439309220,8/11/2015 9:07
2010,20150503070532-763,3,8/7/2015 7:58,1438959480,C4,348780,1439308260,8/11/2015 8:51
2297,20151101081109-505,3,8/10/2015 5:47,1439210820,C5,96120,1439306940,8/11/2015 8:29
307,20155216055209-787,2,7/29/2015 13:08,1438200480,C6,1106160,1439306640,8/11/2015 8:24
359,20151001041055-580,1,8/8/2015 2:52,1439027520,C7,278460,1439305980,8/11/2015 8:13
4006,20154726114709-355,1,8/9/2015 7:56,1439132160,C4,170820,1439302980,8/11/2015 7:23
4341,20155326105308-899,1,8/3/2015 9:01,1438617660,C2,684480,1439302140,8/11/2015 7:09
5014,20151907021947-595,2,8/9/2015 10:38,1439141880,C0,159540,1439301420,8/11/2015 6:57
2247,20154931014916-410,2,8/9/2015 22:17,1439183820,C0,115440,1439299260,8/11/2015 6:21
2385,20155507025512-789,2,8/10/2015 1:03,1439193780,C5,104640,1439298420,8/11/2015 6:07
1083,20154125044106-999,1,8/9/2015 4:21,1439119260,C2,178800,1439298060,8/11/2015 6:01
6120,20150818050817-70,1,8/3/2015 9:22,1438618920,C4,677220,1439296140,8/11/2015 5:29
3389,20155013085022-330,2,8/4/2015 16:26,1438730760,C5,565020,1439295780,8/11/2015 5:23
4825,20154228074250-471,3,8/4/2015 6:27,1438694820,C4,600300,1439295120,8/11/2015 5:12
150,20154211034247-278,1,8/1/2015 0:20,1438413600,C8,879540,1439293140,8/11/2015 4:39
3840,20153901033952-705,3,8/1/2015 1:21,1438417260,C5,875640,1439292900,8/11/2015 4:35
232,20153609033627-164,2,8/10/2015 9:57,1439225820,C0,66060,1439291880,8/11/2015 4:18
3027,20151313051340-385,2,8/6/2015 10:18,1438881480,C8,409740,1439291220,8/11/2015 4:07
5570,20152102082141-663,1,8/8/2015 5:19,1439036340,C7,253740,1439290080,8/11/2015 3:48
1094,20151805101809-893,1,8/10/2015 4:13,1439205180,C8,82020,1439287200,8/11/2015 3:00
1703,20150213100244-187,1,8/3/2015 22:32,1438666320,C2,619800,1439286120,8/11/2015 2:42
2367,20154604044619-717,2,8/7/2015 21:44,1439009040,C6,277080,1439286120,8/11/2015 2:42
2025,20155317125332-60,2,7/29/2015 19:47,1438224420,C4,1061640,1439286060,8/11/2015 2:41
834,20155407095436-165,2,8/9/2015 20:56,1439178960,C4,106260,1439285220,8/11/2015 2:27
3080,20154205034205-330,1,8/10/2015 11:50,1439232600,C5,52260,1439284860,8/11/2015 2:21
2286,20154402034401-435,2,8/10/2015 0:50,1439193000,C8,91080,1439284080,8/11/2015 2:08
6303,20154309054331-529,3,8/10/2015 9:48,1439225280,C6,57900,1439283180,8/11/2015 1:53
551,20154718044706-170,1,8/8/2015 2:26,1439025960,C5,251820,1439277780,8/11/2015 0:23
6108,20155725075727-219,1,8/8/2015 21:43,1439095380,C4,179880,1439275260,8/10/2015 23:41
1093,20154822094857-448,2,7/28/2015 13:13,1438114380,C8,1160220,1439274600,8/10/2015 23:30
6452,20150517100545-515,1,8/7/2015 11:05,1438970700,C6,303000,1439273700,8/10/2015 23:15
5484,20150607050608-159,2,8/9/2015 8:06,1439132760,C2,140400,1439273160,8/10/2015 23:06
4766,20152922072959-445,3,8/8/2015 11:54,1439060040,C0,212100,1439272140,8/10/2015 22:49
5290,20150206080226-163,1,8/9/2015 18:47,1439171220,C5,99300,1439270520,8/10/2015 22:22
1625,20151008061031-83,1,8/6/2015 16:28,1438903680,C7,363240,1439266920,8/10/2015 21:22
3215,20151907011937-909,3,8/5/2015 3:54,1438772040,C8,494340,1439266380,8/10/2015 21:13
1345,20150108120140-67,1,8/10/2015 2:03,1439197380,C5,68460,1439265840,8/10/2015 21:04
4894,20150725010752-511,1,8/8/2015 19:39,1439087940,C4,176160,1439264100,8/10/2015 20:35
4953,20152008102034-994,1,8/10/2015 0:50,1439193000,C8,69300,1439262300,8/10/2015 20:05
6294,20154028074004-866,1,8/9/2015 7:56,1439132160,C5,129720,1439261880,8/10/2015 19:58
1853,20153203113245-908,1,8/8/2015 9:00,1439049600,C5,211440,1439261040,8/10/2015 19:44
881,20153508033513-874,1,8/9/2015 17:24,1439166240,C2,92940,1439259180,8/10/2015 19:13
3510,20153827043838-171,1,8/6/2015 1:56,1438851360,C0,405540,1439256900,8/10/2015 18:35
6286,20155307115300-161,1,8/9/2015 22:50,1439185800,C4,70740,1439256540,8/10/2015 18:29
792,20153828073820-71,1,8/6/2015 6:42,1438868520,C8,387120,1439255640,8/10/2015 18:14
4271,20152831082802-61,1,8/9/2015 6:16,1439126160,C6,128280,1439254440,8/10/2015 17:54
373,20155807125802-565,1,8/9/2015 16:14,1439162040,C0,92280,1439254320,8/10/2015 17:52
1854,20152106092141-219,1,8/9/2015 7:01,1439128860,C5,125400,1439254260,8/10/2015 17:51
4431,20153115033133-708,1,8/3/2015 17:02,1438646520,C2,605580,1439252100,8/10/2015 17:15
2226,20152221072217-797,1,8/8/2015 3:46,1439030760,C7,220320,1439251080,8/10/2015 16:58
6321,20150902110946-207,1,8/9/2015 16:03,1439161380,C7,88920,1439250300,8/10/2015 16:45
498,20154430054442-410,2,8/8/2015 20:19,1439090340,C8,157380,1439247720,8/10/2015 16:02
6240,20152922022915-661,2,8/8/2015 13:01,1439064060,C5,182940,1439247000,8/10/2015 15:50
5784,20155204125243-368,2,8/9/2015 21:05,1439179500,C8,65940,1439245440,8/10/2015 15:24
5870,20150604040619-38,1,8/7/2015 15:16,1438985760,C6,256200,1439241960,8/10/2015 14:26
5909,20153007073050-177,1,8/3/2015 10:10,1438621800,C0,616800,1439238600,8/10/2015 13:30
3741,20151001091013-536,1,8/9/2015 9:33,1439137980,C2,98940,1439236920,8/10/2015 13:02
778,20151731051740-917,3,8/5/2015 15:08,1438812480,C2,424260,1439236740,8/10/2015 12:59
2644,20155607015659-126,2,8/9/2015 11:26,1439144760,C7,81900,1439226660,8/10/2015 10:11
625,20151828051857-513,3,8/7/2015 5:30,1438950600,C2,273840,1439224440,8/10/2015 9:34
1682,20155019115035-365,1,8/3/2015 2:10,1438593000,C7,630600,1439223600,8/10/2015 9:20
2133,20153401123448-154,1,8/7/2015 9:48,1438966080,C5,254220,1439220300,8/10/2015 8:25
4655,20155708025703-505,3,8/6/2015 16:09,1438902540,C0,313740,1439216280,8/10/2015 7:18
6109,20153617013601-315,1,8/2/2015 9:02,1438531320,C8,682980,1439214300,8/10/2015 6:45
2284,20150329030344-472,2,8/7/2015 8:12,1438960320,C0,250980,1439211300,8/10/2015 5:55
6311,20150102020155-899,1,8/9/2015 6:54,1439128440,C4,82740,1439211180,8/10/2015 5:53
5853,20153530053501-879,2,8/8/2015 10:50,1439056200,C8,150660,1439206860,8/10/2015 4:41
4659,20150206110226-989,2,8/9/2015 5:23,1439122980,C4,79620,1439202600,8/10/2015 3:30
5036,20153011023028-435,1,8/6/2015 19:50,1438915800,C6,283200,1439199000,8/10/2015 2:30
5134,20155729095741-271,1,8/4/2015 21:18,1438748280,C5,450180,1439198460,8/10/2015 2:21
1029,20154905084932-890,3,8/1/2015 3:55,1438426500,C0,771720,1439198220,8/10/2015 2:17
5396,20152728102719-723,3,8/3/2015 18:18,1438651080,C2,546660,1439197740,8/10/2015 2:09
3103,20151202101257-746,1,8/9/2015 2:44,1439113440,C0,82560,1439196000,8/10/2015 1:40
1752,20154112014114-381,1,8/7/2015 16:20,1438989600,C6,203280,1439192880,8/10/2015 0:48
5818,20150509050552-677,1,8/6/2015 21:17,1438921020,C7,270480,1439191500,8/10/2015 0:25
4084,20152123012154-34,2,8/5/2015 15:09,1438812540,C5,376560,1439189100,8/9/2015 23:45
6338,20153408093405-996,1,8/5/2015 20:39,1438832340,C2,351300,1439183640,8/9/2015 22:14
2023,20150929080924-256,2,8/8/2015 13:37,1439066220,C5,110460,1439176680,8/9/2015 20:18
363,20153107033125-767,1,8/9/2015 2:35,1439112900,C5,63120,1439176020,8/9/2015 20:07
5164,20150325010306-666,3,8/4/2015 17:19,1438733940,C4,439680,1439173620,8/9/2015 19:27
5268,20150811050851-143,2,8/6/2015 21:20,1438921200,C7,251280,1439172480,8/9/2015 19:08
4805,20155309115343-721,3,8/2/2015 22:41,1438580460,C5,588060,1439168520,8/9/2015 18:02
5645,20154915104900-986,2,8/3/2015 14:17,1438636620,C6,530760,1439167380,8/9/2015 17:43
3757,20151626021639-5,1,8/5/2015 0:00,1438758000,C4,406320,1439164320,8/9/2015 16:52
1861,20151725041726-478,2,8/7/2015 18:14,1438996440,C3,161460,1439157900,8/9/2015 15:05
688,20155431025449-131,3,8/8/2015 11:33,1439058780,C2,97020,1439155800,8/9/2015 14:30
1922,20152423072412-875,1,8/5/2015 6:18,1438780680,C0,373080,1439153760,8/9/2015 13:56
3650,20155929065908-355,1,8/8/2015 3:49,1439030940,C7,121800,1439152740,8/9/2015 13:39
6071,20155703055759-244,2,8/8/2015 19:59,1439089140,C2,62760,1439151900,8/9/2015 13:25
4496,20150607040626-348,2,8/8/2015 22:06,1439096760,C0,54000,1439150760,8/9/2015 13:06
929,20151128071144-68,3,8/6/2015 11:20,1438885200,C2,264180,1439149380,8/9/2015 12:43
5124,20154126024158-664,2,8/7/2015 18:49,1438998540,C3,150240,1439148780,8/9/2015 12:33
2271,20152905062952-3,1,8/7/2015 9:24,1438964640,C4,183300,1439147940,8/9/2015 12:19
2526,20150122090132-684,1,8/4/2015 3:49,1438685340,C5,462060,1439147400,8/9/2015 12:10
5244,20155129055147-431,1,8/5/2015 21:55,1438836900,C8,309720,1439146620,8/9/2015 11:57
2124,20154705044710-733,2,8/8/2015 22:47,1439099220,C6,46800,1439146020,8/9/2015 11:47
1622,20155330095334-363,2,8/8/2015 8:49,1439048940,C4,96720,1439145660,8/9/2015 11:41
1119,20155525115532-571,1,8/4/2015 11:39,1438713540,C0,431520,1439145060,8/9/2015 11:31
4053,20150521120547-745,1,8/6/2015 7:25,1438871100,C8,273120,1439144220,8/9/2015 11:17
1528,20154429124439-546,3,8/8/2015 1:59,1439024340,C0,117900,1439142240,8/9/2015 10:44
3238,20152714062757-568,3,8/6/2015 4:11,1438859460,C5,282720,1439142180,8/9/2015 10:43
6174,20154415064448-712,1,7/27/2015 20:27,1438054020,C3,1086180,1439140200,8/9/2015 10:10
320,20153407113449-132,1,8/5/2015 7:17,1438784220,C8,355740,1439139960,8/9/2015 10:06
6198,20151728111711-22,1,8/6/2015 10:14,1438881240,C5,257940,1439139180,8/9/2015 9:53
4970,20152123022155-571,1,8/3/2015 12:48,1438631280,C4,505260,1439136540,8/9/2015 9:09
2463,20150228020203-565,3,8/3/2015 11:28,1438626480,C4,509160,1439135640,8/9/2015 8:54
748,20151031021043-605,2,8/6/2015 10:10,1438881000,C5,252000,1439133000,8/9/2015 8:10
4008,20155129085126-994,2,8/7/2015 22:48,1439012880,C7,118260,1439131140,8/9/2015 7:39
3944,20150922010936-575,1,8/7/2015 2:15,1438938900,C4,191880,1439130780,8/9/2015 7:33
1289,20155701085744-294,1,8/7/2015 7:48,1438958880,C5,171420,1439130300,8/9/2015 7:25
5753,20152706112749-394,2,8/7/2015 21:19,1439007540,C4,121920,1439129460,8/9/2015 7:11
4258,20155118055120-195,1,8/2/2015 2:33,1438507980,C5,620460,1439128440,8/9/2015 6:54
676,20155631115626-437,3,8/6/2015 8:26,1438874760,C5,252900,1439127660,8/9/2015 6:41
720,20151001051049-770,1,8/8/2015 8:46,1439048760,C3,71820,1439120580,8/9/2015 4:43
3544,20153411103404-448,1,8/5/2015 1:34,1438763640,C6,354600,1439118240,8/9/2015 4:04
304,20155918045905-885,3,8/2/2015 0:15,1438499700,C5,617880,1439117580,8/9/2015 3:53
5110,20152505102539-470,3,8/1/2015 23:05,1438495500,C2,621300,1439116800,8/9/2015 3:40
709,20151704041733-844,1,8/5/2015 3:29,1438770540,C5,339840,1439110380,8/9/2015 1:53
4794,20155004035020-880,3,8/8/2015 7:25,1439043900,C8,63060,1439106960,8/9/2015 0:56
3855,20152028072036-773,3,8/7/2015 17:28,1438993680,C5,112560,1439106240,8/9/2015 0:44
504,20153404123427-942,1,7/31/2015 2:49,1438336140,C0,765900,1439102040,8/8/2015 23:34
2893,20154325114323-182,1,8/7/2015 3:59,1438945140,C0,156480,1439101620,8/8/2015 23:27
3502,20150406040417-783,1,8/8/2015 4:38,1439033880,C8,65820,1439099700,8/8/2015 22:55
698,20152605012634-824,1,8/6/2015 19:11,1438913460,C4,185700,1439099160,8/8/2015 22:46
1998,20152525102559-950,2,8/7/2015 11:55,1438973700,C7,125400,1439099100,8/8/2015 22:45
5881,20150530020556-90,1,8/5/2015 19:51,1438829460,C5,269580,1439099040,8/8/2015 22:44
721,20155501065521-181,2,8/6/2015 8:45,1438875900,C8,219300,1439095200,8/8/2015 21:40
1315,20153704073745-278,2,8/2/2015 23:12,1438582320,C8,512340,1439094660,8/8/2015 21:31
994,20151603061654-187,1,8/7/2015 11:13,1438971180,C2,121140,1439092320,8/8/2015 20:52
2295,20151219051238-555,2,7/29/2015 18:59,1438221540,C6,870420,1439091960,8/8/2015 20:46
5318,20151730061703-165,2,8/7/2015 19:05,1438999500,C5,92160,1439091660,8/8/2015 20:41
6275,20151601101604-955,2,8/7/2015 22:08,1439010480,C0,80160,1439090640,8/8/2015 20:24
1187,20152705042730-318,2,8/7/2015 18:51,1438998660,C4,90720,1439089380,8/8/2015 20:03
1450,20152105062151-555,2,7/28/2015 7:27,1438093620,C5,995580,1439089200,8/8/2015 20:00
4835,20154003074029-430,1,8/4/2015 6:24,1438694640,C4,394320,1439088960,8/8/2015 19:56
4379,20155904025922-23,1,8/6/2015 17:24,1438907040,C2,181500,1439088540,8/8/2015 19:49
5844,20151906011943-68,2,8/4/2015 15:27,1438727220,C2,359040,1439086260,8/8/2015 19:11
2112,20150904060946-997,1,8/7/2015 6:33,1438954380,C0,130320,1439084700,8/8/2015 18:45
3265,20153102063100-491,1,8/5/2015 12:35,1438803300,C4,281040,1439084340,8/8/2015 18:39
1686,20150010030002-664,2,8/5/2015 12:52,1438804320,C3,279840,1439084160,8/8/2015 18:36
5012,20151008121044-244,1,8/2/2015 15:28,1438554480,C7,529320,1439083800,8/8/2015 18:30
3091,20155625015640-270,2,8/6/2015 23:47,1438930020,C0,153180,1439083200,8/8/2015 18:20
1305,20153206033254-715,2,8/7/2015 16:42,1438990920,C4,90600,1439081520,8/8/2015 17:52
773,20150105060134-242,1,7/22/2015 11:14,1437588840,C6,1487580,1439076420,8/8/2015 16:27
1860,20154127084151-732,2,8/7/2015 6:33,1438954380,C3,117840,1439072220,8/8/2015 15:17
3235,20152331032358-34,3,8/7/2015 11:47,1438973220,C6,98640,1439071860,8/8/2015 15:11
3188,20150815100857-72,1,8/5/2015 13:52,1438807920,C5,261120,1439069040,8/8/2015 14:24
3428,20150626070610-771,1,8/4/2015 3:48,1438685280,C4,382860,1439068140,8/8/2015 14:09
4156,20150104050127-736,1,8/7/2015 14:43,1438983780,C0,83640,1439067420,8/8/2015 13:57
1882,20152513102558-161,2,8/5/2015 15:29,1438813740,C2,250680,1439064420,8/8/2015 13:07
5689,20151624031658-684,3,8/6/2015 16:10,1438902600,C8,160920,1439063520,8/8/2015 12:52
5605,20150623110625-496,3,8/6/2015 12:16,1438888560,C4,173400,1439061960,8/8/2015 12:26
6523,20155418045421-624,1,8/1/2015 13:54,1438462440,C4,599400,1439061840,8/8/2015 12:24
1261,20154305014335-971,3,8/4/2015 6:33,1438695180,C5,366600,1439061780,8/8/2015 12:23
2506,20151929111952-130,2,8/5/2015 3:41,1438771260,C4,288660,1439059920,8/8/2015 11:52
1780,20154530034541-167,1,8/6/2015 6:21,1438867260,C5,190320,1439057580,8/8/2015 11:13
6553,20151727081750-912,1,8/6/2015 10:27,1438882020,C8,174360,1439056380,8/8/2015 10:53
2196,20154908044958-492,1,7/31/2015 18:19,1438391940,C2,664200,1439056140,8/8/2015 10:49
2435,20154024044050-101,2,8/4/2015 17:52,1438735920,C2,318240,1439054160,8/8/2015 10:16
5104,20155202025227-496,1,8/6/2015 11:48,1438886880,C3,167280,1439054160,8/8/2015 10:16
121,20155330125308-863,3,8/5/2015 10:59,1438797540,C2,255780,1439053320,8/8/2015 10:02
5057,20151431021452-330,1,8/7/2015 13:10,1438978200,C5,75120,1439053320,8/8/2015 10:02
6358,20151227041255-244,3,8/2/2015 12:58,1438545480,C0,506760,1439052240,8/8/2015 9:44
6285,20155019065049-871,3,8/6/2015 4:02,1438858920,C6,193140,1439052060,8/8/2015 9:41
399,20150415070401-918,2,8/5/2015 8:42,1438789320,C4,260040,1439049360,8/8/2015 8:56
1659,20150224100248-221,1,8/5/2015 20:42,1438832520,C8,215040,1439047560,8/8/2015 8:26
78,20155824015804-38,1,8/4/2015 15:43,1438728180,C4,318900,1439047080,8/8/2015 8:18
5186,20150013110015-112,2,8/5/2015 11:08,1438798080,C3,248460,1439046540,8/8/2015 8:09
2916,20153113043100-622,2,7/26/2015 12:15,1437938100,C4,1107840,1439045940,8/8/2015 7:59
2380,20150619040651-207,2,8/3/2015 9:51,1438620660,C5,424500,1439045160,8/8/2015 7:46
727,20155926095918-705,1,8/6/2015 20:39,1438918740,C4,123600,1439042340,8/8/2015 6:59
2393,20150618050611-599,2,8/5/2015 17:14,1438820040,C3,222240,1439042280,8/8/2015 6:58
1835,20155224025254-187,1,8/6/2015 15:24,1438899840,C4,140640,1439040480,8/8/2015 6:28
878,20153602053648-835,1,8/6/2015 9:50,1438879800,C5,158820,1439038620,8/8/2015 5:57
5826,20153723013743-159,1,8/4/2015 7:46,1438699560,C5,338580,1439038140,8/8/2015 5:49
500,20150201080243-358,2,8/5/2015 22:26,1438838760,C5,198720,1439037480,8/8/2015 5:38
2817,20155906055936-524,1,8/7/2015 11:47,1438973220,C2,64080,1439037300,8/8/2015 5:35
5987,20151127061136-939,2,8/4/2015 5:31,1438691460,C5,344400,1439035860,8/8/2015 5:11
4661,20155009035026-293,1,7/29/2015 8:40,1438184400,C2,851100,1439035500,8/8/2015 5:05
6099,20150115080143-276,2,7/31/2015 5:45,1438346700,C7,687120,1439033820,8/8/2015 4:37
1949,20154831094847-710,1,8/6/2015 20:08,1438916880,C8,111120,1439028000,8/8/2015 3:00
4337,20150112110147-385,1,7/31/2015 0:13,1438326780,C6,699120,1439025900,8/8/2015 2:25
6106,20154301074308-402,1,8/6/2015 22:53,1438926780,C8,97320,1439024100,8/8/2015 1:55
5617,20151704061733-850,1,8/6/2015 19:13,1438913580,C8,109680,1439023260,8/8/2015 1:41
3241,20152804122805-486,2,8/7/2015 4:04,1438945440,C4,76320,1439021760,8/8/2015 1:16
4238,20150807050820-790,1,7/28/2015 19:43,1438137780,C8,883140,1439020920,8/8/2015 1:02
1263,20154022104050-662,1,8/3/2015 21:22,1438662120,C5,358440,1439020560,8/8/2015 0:56
2414,20155731055752-472,2,8/7/2015 2:54,1438941240,C4,78660,1439019900,8/8/2015 0:45
5136,20155229095213-604,1,8/6/2015 22:00,1438923600,C5,91860,1439015460,8/7/2015 23:31
4579,20150702020750-193,2,8/6/2015 14:55,1438898100,C0,116160,1439014260,8/7/2015 23:11
1683,20154706044711-22,1,8/7/2015 7:47,1438958820,C3,54000,1439012820,8/7/2015 22:47
17,20152715102727-628,3,8/4/2015 0:17,1438672620,C8,338280,1439010900,8/7/2015 22:15
549,20151927091933-671,2,8/1/2015 23:49,1438498140,C6,512700,1439010840,8/7/2015 22:14
110,20154226054249-628,1,8/3/2015 20:28,1438658880,C4,350580,1439009460,8/7/2015 21:51
6092,20154514034553-145,2,8/5/2015 4:49,1438775340,C5,232680,1439008020,8/7/2015 21:27
6247,20154107124133-326,2,8/1/2015 1:37,1438418220,C5,589020,1439007240,8/7/2015 21:14
5775,20150327100356-183,1,8/4/2015 1:03,1438675380,C5,329400,1439004780,8/7/2015 20:33
6038,20151824041829-872,1,7/31/2015 18:11,1438391460,C0,611580,1439003040,8/7/2015 20:04
5033,20155601125604-18,1,8/5/2015 17:18,1438820280,C7,180660,1439000940,8/7/2015 19:29
799,20150527050515-636,2,8/4/2015 2:33,1438680780,C8,319440,1439000220,8/7/2015 19:17
4571,20153323043307-820,2,8/2/2015 18:05,1438563900,C8,434760,1438998660,8/7/2015 18:51
6542,20150003020050-522,2,8/3/2015 20:48,1438660080,C5,337860,1438997940,8/7/2015 18:39
1319,20155630105651-729,2,8/6/2015 20:00,1438916400,C2,79680,1438996080,8/7/2015 18:08
991,20155926125915-298,3,8/3/2015 16:19,1438643940,C8,351600,1438995540,8/7/2015 17:59
3699,20152701022725-153,3,8/3/2015 2:15,1438593300,C2,401040,1438994340,8/7/2015 17:39
4472,20155825075830-372,3,8/4/2015 9:01,1438704060,C0,289260,1438993320,8/7/2015 17:22
2401,20151201061251-794,3,8/4/2015 11:47,1438714020,C6,279300,1438993320,8/7/2015 17:22
3660,20154701104706-898,1,8/5/2015 15:03,1438812180,C2,180480,1438992660,8/7/2015 17:11
2907,20151730011708-691,3,8/4/2015 23:39,1438756740,C5,234660,1438991400,8/7/2015 16:50
6371,20155726015743-944,2,8/3/2015 15:33,1438641180,C2,348480,1438989660,8/7/2015 16:21
6231,20155111095142-349,1,8/4/2015 15:35,1438727700,C4,261780,1438989480,8/7/2015 16:18
3314,20155505035539-722,3,8/6/2015 16:04,1438902240,C2,86940,1438989180,8/7/2015 16:13
3556,20151811021803-685,1,7/29/2015 15:16,1438208160,C5,779340,1438987500,8/7/2015 15:45
4606,20154519024544-322,2,8/5/2015 6:48,1438782480,C4,201480,1438983960,8/7/2015 14:46
3205,20150103020130-343,1,7/31/2015 8:41,1438357260,C4,624000,1438981260,8/7/2015 14:01
1654,20155522095506-197,2,8/5/2015 13:11,1438805460,C7,174480,1438979940,8/7/2015 13:39
33,20154729054707-256,2,8/4/2015 14:09,1438722540,C4,252660,1438975200,8/7/2015 12:20
6498,20153431103412-743,1,8/6/2015 14:30,1438896600,C4,76080,1438972680,8/7/2015 11:38
2672,20155410115442-469,2,8/4/2015 8:58,1438703880,C3,268680,1438972560,8/7/2015 11:36
231,20155223015236-307,3,8/2/2015 12:18,1438543080,C8,429180,1438972260,8/7/2015 11:31
5984,20154225044228-490,2,8/5/2015 8:17,1438787820,C8,184020,1438971840,8/7/2015 11:24
3439,20152829102829-430,2,8/4/2015 11:04,1438711440,C5,260280,1438971720,8/7/2015 11:22
291,20151429041405-463,1,8/2/2015 14:48,1438552080,C5,418920,1438971000,8/7/2015 11:10
2842,20155431125443-408,1,8/5/2015 3:34,1438770840,C0,199200,1438970040,8/7/2015 10:54
5439,20155702055701-405,3,8/5/2015 21:11,1438834260,C7,135420,1438969680,8/7/2015 10:48
3760,20152131082145-700,2,8/6/2015 9:45,1438879500,C6,87240,1438966740,8/7/2015 9:59
5861,20152901062908-724,1,8/4/2015 8:02,1438700520,C2,264780,1438965300,8/7/2015 9:35
1284,20152217012232-158,3,8/2/2015 4:31,1438515060,C2,450180,1438965240,8/7/2015 9:34
4263,20150019010004-372,1,8/5/2015 0:58,1438761480,C7,203640,1438965120,8/7/2015 9:32
216,20154431124424-721,1,8/5/2015 2:28,1438766880,C7,197520,1438964400,8/7/2015 9:20
3372,20154214064232-812,2,8/4/2015 8:34,1438702440,C0,260160,1438962600,8/7/2015 8:50
5348,20151102031156-128,2,8/1/2015 9:51,1438447860,C8,514560,1438962420,8/7/2015 8:47
1399,20150001100019-538,1,8/6/2015 12:06,1438887960,C6,73260,1438961220,8/7/2015 8:27
4115,20153510103502-685,1,7/31/2015 8:26,1438356360,C5,602220,1438958580,8/7/2015 7:43
5358,20154302084358-573,1,8/6/2015 1:58,1438851480,C2,107100,1438958580,8/7/2015 7:43
5964,20151819091842-213,1,8/1/2015 4:47,1438429620,C3,528420,1438958040,8/7/2015 7:34
641,20153712013720-181,3,8/4/2015 22:28,1438752480,C6,203940,1438956420,8/7/2015 7:07
1591,20153709093756-988,1,8/2/2015 11:07,1438538820,C8,415800,1438954620,8/7/2015 6:37
5631,20150831010810-141,1,8/3/2015 21:35,1438662900,C2,289620,1438952520,8/7/2015 6:02
2186,20150431030458-145,3,8/3/2015 22:09,1438664940,C4,284700,1438949640,8/7/2015 5:14
4686,20153928053942-429,3,8/2/2015 11:12,1438539120,C0,408780,1438947900,8/7/2015 4:45
734,20151901091942-196,1,8/5/2015 6:07,1438780020,C4,167040,1438947060,8/7/2015 4:31
3045,20155827095826-435,1,8/2/2015 2:04,1438506240,C8,440280,1438946520,8/7/2015 4:22
1197,20155625015652-201,2,8/1/2015 20:18,1438485480,C2,459960,1438945440,8/7/2015 4:04
6036,20153414123429-267,1,8/3/2015 4:39,1438601940,C8,339900,1438941840,8/7/2015 3:04
3569,20150901080955-679,1,8/5/2015 16:12,1438816320,C3,124860,1438941180,8/7/2015 2:53
139,20152830082847-300,2,8/4/2015 12:38,1438717080,C8,223500,1438940580,8/7/2015 2:43
3130,20150425050434-33,1,7/31/2015 20:56,1438401360,C6,532320,1438933680,8/7/2015 0:48
3813,20155704015728-85,1,8/2/2015 20:24,1438572240,C4,361260,1438933500,8/7/2015 0:45
3158,20154625104616-641,2,8/3/2015 21:13,1438661580,C5,271740,1438933320,8/7/2015 0:42
5148,20153402093448-712,1,8/4/2015 17:02,1438732920,C2,199680,1438932600,8/7/2015 0:30
4468,20152030112000-524,1,8/5/2015 2:23,1438766580,C2,162060,1438928640,8/6/2015 23:24
3955,20151431101444-411,1,8/4/2015 18:58,1438739880,C5,188520,1438928400,8/6/2015 23:20
3911,20154930044907-211,1,8/6/2015 3:37,1438857420,C4,69660,1438927080,8/6/2015 22:58
5176,20151029031046-528,2,8/4/2015 20:37,1438745820,C0,179340,1438925160,8/6/2015 22:26
1792,20153722023710-935,2,8/1/2015 19:21,1438482060,C0,440520,1438922580,8/6/2015 21:43
531,20150802090855-889,2,8/4/2015 15:17,1438726620,C6,194940,1438921560,8/6/2015 21:26
3337,20155818035853-341,2,7/31/2015 17:38,1438389480,C5,531600,1438921080,8/6/2015 21:18
3774,20150224010207-397,2,8/2/2015 1:02,1438502520,C0,415800,1438918320,8/6/2015 20:32
3762,20155724055744-118,2,8/5/2015 4:35,1438774500,C7,141240,1438915740,8/6/2015 19:49
6445,20152614072648-135,1,8/3/2015 20:42,1438659720,C7,253680,1438913400,8/6/2015 19:10
210,20155710015717-292,2,7/30/2015 23:36,1438324560,C5,587580,1438912140,8/6/2015 18:49
2913,20150620030629-901,1,8/3/2015 20:11,1438657860,C8,245580,1438903440,8/6/2015 16:24
1383,20150021080000-521,3,8/1/2015 5:28,1438432080,C3,470640,1438902720,8/6/2015 16:12
1915,20151503041535-262,3,8/2/2015 21:11,1438575060,C0,326220,1438901280,8/6/2015 15:48
1638,20151507011530-88,1,8/3/2015 7:23,1438611780,C5,288960,1438900740,8/6/2015 15:39
5054,20154517094500-459,2,7/31/2015 8:53,1438357980,C8,542640,1438900620,8/6/2015 15:37
1779,20152824122825-461,2,7/26/2015 20:22,1437967320,C4,931080,1438898400,8/6/2015 15:00
1475,20150121020117-781,1,8/2/2015 14:28,1438550880,C5,346140,1438897020,8/6/2015 14:37
190,20150910080926-255,1,7/28/2015 12:13,1438110780,C8,784920,1438895700,8/6/2015 14:15
5277,20150701060721-840,1,8/3/2015 21:16,1438661760,C2,227340,1438889100,8/6/2015 12:25
5458,20155620125614-440,1,8/2/2015 6:23,1438521780,C4,366540,1438888320,8/6/2015 12:12
316,20155526025520-19,1,8/3/2015 18:46,1438652760,C3,235020,1438887780,8/6/2015 12:03
5790,20154818114855-997,1,7/31/2015 3:26,1438338360,C5,546540,1438884900,8/6/2015 11:15
1782,20151124111122-818,1,8/3/2015 5:14,1438604040,C2,280860,1438884900,8/6/2015 11:15
855,20153019033053-367,2,8/3/2015 11:50,1438627800,C8,256560,1438884360,8/6/2015 11:06
3862,20151231081203-407,2,8/4/2015 22:06,1438751160,C4,131880,1438883040,8/6/2015 10:44
197,20152931062933-133,2,8/4/2015 21:38,1438749480,C3,133380,1438882860,8/6/2015 10:41
2467,20150730030734-264,1,8/4/2015 3:51,1438685460,C2,195720,1438881180,8/6/2015 10:13
3275,20153431073442-374,1,8/4/2015 9:12,1438704720,C8,175740,1438880460,8/6/2015 10:01
5944,20154121094145-294,1,7/29/2015 9:50,1438188600,C0,691740,1438880340,8/6/2015 9:59
3927,20150526060526-540,2,7/31/2015 19:32,1438396320,C0,480420,1438876740,8/6/2015 8:59
1668,20150829110854-562,2,8/5/2015 9:02,1438790520,C4,85320,1438875840,8/6/2015 8:44
1833,20151902061935-596,3,8/4/2015 23:49,1438757340,C0,117900,1438875240,8/6/2015 8:34
6213,20155328125314-729,1,8/5/2015 8:53,1438789980,C5,84600,1438874580,8/6/2015 8:23
967,20155916045900-996,2,8/3/2015 18:24,1438651440,C7,222900,1438874340,8/6/2015 8:19
4332,20155730085755-371,1,8/4/2015 0:31,1438673460,C7,200820,1438874280,8/6/2015 8:18
2837,20153706033723-432,3,7/30/2015 14:09,1438290540,C3,582540,1438873080,8/6/2015 7:58
3427,20151916101912-704,2,8/1/2015 2:04,1438419840,C2,450900,1438870740,8/6/2015 7:19
818,20151003011029-293,3,8/5/2015 9:00,1438790400,C5,78900,1438869300,8/6/2015 6:55
5561,20154523124510-943,1,8/4/2015 13:09,1438718940,C4,148320,1438867260,8/6/2015 6:21
488,20150001080044-124,1,7/28/2015 6:45,1438091100,C5,776100,1438867200,8/6/2015 6:20
95,20151103021143-224,1,8/4/2015 22:00,1438750800,C3,114540,1438865340,8/6/2015 5:49
3902,20150827060823-4,1,8/3/2015 17:32,1438648320,C2,215280,1438863600,8/6/2015 5:20
5016,20153622083653-391,1,8/1/2015 6:14,1438434840,C5,427740,1438862580,8/6/2015 5:03
5129,20150802090811-979,1,8/4/2015 22:20,1438752000,C5,110160,1438862160,8/6/2015 4:56
482,20150231060233-191,1,8/4/2015 16:35,1438731300,C5,127860,1438859160,8/6/2015 4:06
4549,20150503030532-116,1,8/4/2015 21:34,1438749240,C6,109740,1438858980,8/6/2015 4:03
2076,20155626095622-144,3,8/4/2015 19:34,1438742040,C3,116040,1438858080,8/6/2015 3:48
5934,20150425010459-670,1,8/4/2015 20:32,1438745520,C3,111360,1438856880,8/6/2015 3:28
269,20153025093014-930,1,8/3/2015 4:36,1438601760,C4,253320,1438855080,8/6/2015 2:58
5803,20153121043157-485,1,8/3/2015 13:11,1438632660,C8,222240,1438854900,8/6/2015 2:55
1902,20155726085710-998,2,7/31/2015 17:45,1438389900,C4,463680,1438853580,8/6/2015 2:33
4436,20153004113046-680,3,8/5/2015 6:40,1438782000,C4,69000,1438851000,8/6/2015 1:50
2638,20151426021410-715,1,7/31/2015 19:45,1438397100,C3,451860,1438848960,8/6/2015 1:16
5169,20154728034746-685,2,8/5/2015 5:39,1438778340,C4,59520,1438837860,8/5/2015 22:11
223,20155314125319-412,3,8/3/2015 1:53,1438591980,C7,241200,1438833180,8/5/2015 20:53
4922,20152813042802-5,2,8/2/2015 0:08,1438499280,C8,333840,1438833120,8/5/2015 20:52
5157,20152027062003-395,2,8/2/2015 15:36,1438554960,C0,275880,1438830840,8/5/2015 20:14
2845,20150918090928-755,2,7/30/2015 16:29,1438298940,C5,531600,1438830540,8/5/2015 20:09
57,20155726065746-437,3,8/4/2015 11:48,1438714080,C7,113580,1438827660,8/5/2015 19:21
6552,20151229041225-130,1,8/1/2015 3:25,1438424700,C2,400740,1438825440,8/5/2015 18:44
5100,20155924015914-772,2,8/4/2015 17:50,1438735800,C6,87660,1438823460,8/5/2015 18:11
4032,20152709092720-465,2,8/2/2015 17:11,1438560660,C2,262680,1438823340,8/5/2015 18:09
526,20155431045446-47,1,8/4/2015 1:20,1438676400,C3,144780,1438821180,8/5/2015 17:33
4113,20154903084903-690,2,8/4/2015 13:07,1438718820,C0,101880,1438820700,8/5/2015 17:25
6357,20153920123932-501,2,7/29/2015 0:04,1438153440,C8,664860,1438818300,8/5/2015 16:45
5972,20154111034148-335,1,8/2/2015 12:55,1438545300,C0,270120,1438815420,8/5/2015 15:57
4582,20154821044806-248,2,7/31/2015 15:58,1438383480,C4,430500,1438813980,8/5/2015 15:33
844,20153321033321-89,1,8/1/2015 21:33,1438489980,C5,324000,1438813980,8/5/2015 15:33
800,20154120014128-465,1,8/3/2015 15:12,1438639920,C5,173580,1438813500,8/5/2015 15:25
1090,20150216030218-144,1,7/31/2015 14:41,1438378860,C5,431580,1438810440,8/5/2015 14:34
1516,20155825095828-312,3,8/4/2015 4:56,1438689360,C7,120840,1438810200,8/5/2015 14:30
3298,20152330112343-14,1,8/4/2015 13:58,1438721880,C8,88260,1438810140,8/5/2015 14:29
6486,20150830090823-240,1,8/1/2015 0:59,1438415940,C8,390780,1438806720,8/5/2015 13:32
3988,20152210032211-174,3,8/2/2015 7:37,1438526220,C4,279900,1438806120,8/5/2015 13:22
2498,20155502025511-119,2,8/4/2015 13:47,1438721220,C2,84360,1438805580,8/5/2015 13:13
5011,20152430032437-581,2,8/3/2015 13:52,1438635120,C5,170040,1438805160,8/5/2015 13:06
4842,20155910035954-864,1,8/2/2015 7:11,1438524660,C8,279360,1438804020,8/5/2015 12:47
5966,20154726014714-186,2,8/4/2015 9:31,1438705860,C4,95280,1438801140,8/5/2015 11:59
39,20154625054615-85,3,8/1/2015 21:44,1438490640,C2,309540,1438800180,8/5/2015 11:43
1248,20152431022403-301,2,8/4/2015 20:15,1438744500,C0,52380,1438796880,8/5/2015 10:48
896,20151824101840-224,2,8/1/2015 9:50,1438447800,C8,344760,1438792560,8/5/2015 9:36
2936,20151312101325-662,3,7/28/2015 9:27,1438100820,C2,689820,1438790640,8/5/2015 9:04
6300,20151221091244-979,2,7/31/2015 8:22,1438356120,C7,430500,1438786620,8/5/2015 7:57
5347,20153224123257-617,1,8/2/2015 8:56,1438530960,C5,254880,1438785840,8/5/2015 7:44
4420,20154218024228-691,1,7/30/2015 10:02,1438275720,C4,510000,1438785720,8/5/2015 7:42
4738,20152128072158-862,1,8/3/2015 7:30,1438612200,C2,172980,1438785180,8/5/2015 7:33
5385,20155908025926-104,2,8/2/2015 5:39,1438519140,C6,265800,1438784940,8/5/2015 7:29
1271,20150703080734-840,2,8/1/2015 4:32,1438428720,C2,356100,1438784820,8/5/2015 7:27
1123,20152928122936-347,2,8/3/2015 8:35,1438616100,C5,168120,1438784220,8/5/2015 7:17
1770,20154901124955-525,2,8/3/2015 9:49,1438620540,C4,162000,1438782540,8/5/2015 6:49
372,20155401115443-339,2,8/4/2015 0:26,1438673160,C7,108960,1438782120,8/5/2015 6:42
4623,20150828090847-178,1,8/3/2015 22:53,1438667580,C8,113580,1438781160,8/5/2015 6:26
3379,20155625015640-843,2,8/2/2015 14:17,1438550220,C5,230820,1438781040,8/5/2015 6:24
4118,20150410080439-253,3,8/2/2015 0:05,1438499100,C5,279780,1438778880,8/5/2015 5:48
1821,20153924083911-558,2,8/1/2015 6:31,1438435860,C5,341760,1438777620,8/5/2015 5:27
1723,20155712035738-767,3,7/24/2015 10:33,1437759180,C4,1017360,1438776540,8/5/2015 5:09
2474,20151318101338-951,2,7/30/2015 6:47,1438264020,C7,512220,1438776240,8/5/2015 5:04
537,20152008052025-846,2,8/2/2015 3:44,1438512240,C3,263880,1438776120,8/5/2015 5:02
637,20152502112545-83,1,8/3/2015 20:13,1438657980,C4,118080,1438776060,8/5/2015 5:01
5266,20153402113431-964,2,8/3/2015 20:02,1438657320,C4,116880,1438774200,8/5/2015 4:30
4130,20150209060231-540,1,8/1/2015 19:31,1438482660,C5,290820,1438773480,8/5/2015 4:18
765,20155602105614-229,1,8/4/2015 6:18,1438694280,C4,78060,1438772340,8/5/2015 3:59
1714,20154520064525-417,3,8/3/2015 13:48,1438634880,C7,137220,1438772100,8/5/2015 3:55
2217,20152711032704-985,2,8/2/2015 2:11,1438506660,C3,264720,1438771380,8/5/2015 3:43
2195,20154423094459-117,2,7/31/2015 21:28,1438403280,C3,366720,1438770000,8/5/2015 3:20
424,20153602033634-853,1,8/4/2015 7:02,1438696920,C5,70980,1438767900,8/5/2015 2:45
722,20155401015444-439,1,8/3/2015 8:18,1438615080,C4,152640,1438767720,8/5/2015 2:42
6396,20154721044741-483,2,7/31/2015 6:41,1438350060,C4,413820,1438763880,8/5/2015 1:38
1914,20151501041530-577,2,7/27/2015 10:39,1438018740,C4,742080,1438760820,8/5/2015 0:47
5891,20152703012733-565,3,8/4/2015 7:04,1438697040,C6,63420,1438760460,8/5/2015 0:41
4540,20152823122846-410,1,8/3/2015 15:16,1438640160,C4,120060,1438760220,8/5/2015 0:37
2926,20151128051129-591,1,8/4/2015 2:22,1438680120,C8,78780,1438758900,8/5/2015 0:15
2131,20150727070729-782,1,7/31/2015 15:07,1438380420,C2,374400,1438754820,8/4/2015 23:07
4657,20150624050603-927,3,8/1/2015 4:58,1438430280,C8,323760,1438754040,8/4/2015 22:54
4903,20154326034342-937,2,8/3/2015 18:05,1438650300,C0,99960,1438750260,8/4/2015 21:51
5161,20151529031505-215,2,8/4/2015 5:07,1438690020,C3,60240,1438750260,8/4/2015 21:51
4822,20154202034222-47,2,8/4/2015 3:32,1438684320,C4,64500,1438748820,8/4/2015 21:27
5045,20153317083347-992,1,7/26/2015 14:52,1437947520,C0,800340,1438747860,8/4/2015 21:11
3501,20150030050037-993,1,8/4/2015 7:00,1438696800,C4,49500,1438746300,8/4/2015 20:45
1757,20153011023048-461,3,8/1/2015 19:03,1438480980,C5,261540,1438742520,8/4/2015 19:42
1518,20151623071615-935,2,8/1/2015 16:22,1438471320,C0,270120,1438741440,8/4/2015 19:24
1049,20154201104219-611,1,8/3/2015 16:08,1438643280,C4,96180,1438739460,8/4/2015 18:51
4384,20151102121127-564,2,8/3/2015 15:24,1438640640,C2,97980,1438738620,8/4/2015 18:37
5,20154502084548-823,3,8/3/2015 13:32,1438633920,C0,103620,1438737540,8/4/2015 18:19
2935,20153913013912-134,2,8/1/2015 23:30,1438497000,C4,239580,1438736580,8/4/2015 18:03
5421,20154221064205-207,1,7/30/2015 4:37,1438256220,C7,480300,1438736520,8/4/2015 18:02
6030,20155323075349-302,2,8/3/2015 3:56,1438599360,C0,133740,1438733100,8/4/2015 17:05
1535,20150829100839-801,1,8/2/2015 14:36,1438551360,C2,180840,1438732200,8/4/2015 16:50
5413,20151820041854-851,3,8/3/2015 0:34,1438587240,C2,144120,1438731360,8/4/2015 16:36
1138,20155827015856-404,3,8/2/2015 15:19,1438553940,C5,174420,1438728360,8/4/2015 15:46
5781,20155025015032-304,3,8/2/2015 23:15,1438582500,C8,145020,1438727520,8/4/2015 15:32
1634,20155130035117-109,3,8/2/2015 23:35,1438583700,C5,143520,1438727220,8/4/2015 15:27
5294,20154029064002-238,1,8/1/2015 11:01,1438452060,C4,274860,1438726920,8/4/2015 15:22
2103,20152405122436-184,3,8/1/2015 6:24,1438435440,C2,288900,1438724340,8/4/2015 14:39
3242,20154626054643-936,2,8/3/2015 11:51,1438627860,C4,95700,1438723560,8/4/2015 14:26
4995,20153802053822-860,3,8/3/2015 23:22,1438669320,C7,53520,1438722840,8/4/2015 14:14
4096,20152818022812-310,3,8/2/2015 16:52,1438559520,C4,163080,1438722600,8/4/2015 14:10
5325,20152031102058-485,1,8/3/2015 13:11,1438632660,C4,89820,1438722480,8/4/2015 14:08
6204,20151031101009-945,1,8/3/2015 13:04,1438632240,C4,89880,1438722120,8/4/2015 14:02
2052,20154524114509-609,1,8/3/2015 4:37,1438601820,C5,119760,1438721580,8/4/2015 13:53
584,20153029033042-152,1,8/2/2015 13:34,1438547640,C7,169320,1438716960,8/4/2015 12:36
5584,20150325060300-912,1,8/3/2015 5:46,1438605960,C4,110940,1438716900,8/4/2015 12:35
178,20155407085436-987,2,8/1/2015 9:26,1438446360,C5,270240,1438716600,8/4/2015 12:30
160,20150717050734-803,1,7/29/2015 13:43,1438202580,C5,512280,1438714860,8/4/2015 12:01
3465,20152819042821-876,1,8/2/2015 17:40,1438562400,C5,151740,1438714140,8/4/2015 11:49
3470,20154502054501-178,1,8/3/2015 14:41,1438638060,C4,75360,1438713420,8/4/2015 11:37
1618,20153501083518-306,1,8/3/2015 10:35,1438623300,C8,90000,1438713300,8/4/2015 11:35
233,20151731021708-898,2,8/2/2015 12:52,1438545120,C0,167700,1438712820,8/4/2015 11:27
6126,20153628093659-387,1,8/2/2015 1:40,1438504800,C5,201720,1438706520,8/4/2015 9:42
5193,20152628082657-500,3,8/2/2015 1:10,1438503000,C5,202920,1438705920,8/4/2015 9:32
4403,20150501090516-171,3,8/3/2015 9:21,1438618860,C2,86880,1438705740,8/4/2015 9:29
204,20155417065414-463,1,8/2/2015 8:22,1438528920,C0,173460,1438702380,8/4/2015 8:33
1856,20154812054846-708,1,7/29/2015 16:36,1438212960,C2,488160,1438701120,8/4/2015 8:12
2161,20150925110937-663,3,7/30/2015 9:38,1438274280,C6,426540,1438700820,8/4/2015 8:07
148,20151231031233-897,2,8/2/2015 11:22,1438539720,C3,159000,1438698720,8/4/2015 7:32
4377,20154431124423-688,2,8/3/2015 8:14,1438614840,C4,81000,1438695840,8/4/2015 6:44
2039,20154801104828-144,2,8/3/2015 7:36,1438612560,C5,80640,1438693200,8/4/2015 6:00
3320,20153022073058-275,1,8/2/2015 1:55,1438505700,C8,186060,1438691760,8/4/2015 5:36
774,20151317071311-118,3,8/1/2015 5:43,1438432980,C8,258120,1438691100,8/4/2015 5:25
2348,20151626121657-196,2,8/2/2015 1:01,1438502460,C3,188100,1438690560,8/4/2015 5:16
2388,20153423073421-295,3,7/31/2015 5:56,1438347360,C8,342660,1438690020,8/4/2015 5:07
5195,20154218114238-384,1,8/2/2015 2:52,1438509120,C5,180600,1438689720,8/4/2015 5:02
619,20152027072040-298,1,8/1/2015 13:40,1438461600,C7,227400,1438689000,8/4/2015 4:50
3473,20153329053307-752,2,8/3/2015 13:49,1438634940,C5,52320,1438687260,8/4/2015 4:21
2922,20152301022309-569,2,7/30/2015 23:17,1438323420,C5,362520,1438685940,8/4/2015 3:59
1761,20155028105016-754,3,8/1/2015 21:28,1438489680,C2,191940,1438681620,8/4/2015 2:47
6465,20153223113200-303,1,7/31/2015 5:18,1438345080,C3,334380,1438679460,8/4/2015 2:11
2857,20151119031125-461,2,7/31/2015 5:20,1438345200,C2,333780,1438678980,8/4/2015 2:03
1542,20155509065515-933,2,8/1/2015 12:01,1438455660,C7,222840,1438678500,8/4/2015 1:55
4198,20150403120428-179,2,7/27/2015 4:22,1437996120,C2,681960,1438678080,8/4/2015 1:48
5723,20150804100804-119,1,7/31/2015 5:40,1438346400,C7,330960,1438677360,8/4/2015 1:36
3592,20155201035213-815,2,8/2/2015 20:30,1438572600,C0,103080,1438675680,8/4/2015 1:08
5461,20154122054140-30,1,8/2/2015 11:59,1438541940,C5,132840,1438674780,8/4/2015 0:53
2437,20151301021340-472,2,8/2/2015 19:23,1438568580,C2,105000,1438673580,8/4/2015 0:33
2455,20153931123943-847,3,8/2/2015 20:17,1438571820,C5,100140,1438671960,8/4/2015 0:06
184,20151008101045-291,3,7/21/2015 16:56,1437522960,C2,1147560,1438670520,8/3/2015 23:42
4635,20152601112611-300,2,7/30/2015 17:53,1438303980,C4,361260,1438665240,8/3/2015 22:14
2182,20150801120848-517,1,8/3/2015 2:20,1438593600,C5,68760,1438662360,8/3/2015 21:26
1549,20153610043627-233,2,7/28/2015 20:12,1438139520,C5,522720,1438662240,8/3/2015 21:24
477,20155914045934-20,2,7/29/2015 7:31,1438180260,C2,481740,1438662000,8/3/2015 21:20
2473,20150004010010-724,2,7/31/2015 2:14,1438334040,C3,327720,1438661760,8/3/2015 21:16
1580,20151826021816-332,1,8/2/2015 23:06,1438581960,C2,79560,1438661520,8/3/2015 21:12
2035,20154107104138-147,2,7/31/2015 10:47,1438364820,C2,296280,1438661100,8/3/2015 21:05
1830,20150122050120-946,1,7/30/2015 18:59,1438307940,C4,349140,1438657080,8/3/2015 19:58
5807,20153125023152-681,2,7/25/2015 0:31,1437809460,C4,847200,1438656660,8/3/2015 19:51
1802,20154101014157-341,1,7/30/2015 16:03,1438297380,C7,359160,1438656540,8/3/2015 19:49
4753,20155430115403-341,1,8/2/2015 17:30,1438561800,C0,93120,1438654920,8/3/2015 19:22
5162,20155917015932-755,3,7/29/2015 1:33,1438158780,C8,496020,1438654800,8/3/2015 19:20
5201,20153802053827-252,1,8/3/2015 6:14,1438607640,C2,45360,1438653000,8/3/2015 18:50
4528,20152824112857-18,1,7/24/2015 16:58,1437782280,C2,870600,1438652880,8/3/2015 18:48
4224,20150124050126-399,3,8/2/2015 2:26,1438507560,C8,145020,1438652580,8/3/2015 18:43
3971,20155905015920-414,1,7/25/2015 0:47,1437810420,C8,840240,1438650660,8/3/2015 18:11
629,20153601103622-897,1,8/2/2015 14:11,1438549860,C6,99300,1438649160,8/3/2015 17:46
2320,20154816064800-119,1,7/28/2015 15:54,1438124040,C5,523080,1438647120,8/3/2015 17:12
3885,20150828090834-36,2,8/1/2015 14:20,1438464000,C5,182160,1438646160,8/3/2015 16:56
4212,20155804035844-100,3,7/30/2015 22:40,1438321200,C5,324360,1438645560,8/3/2015 16:46
2840,20150201060238-845,2,8/2/2015 11:15,1438539300,C3,105180,1438644480,8/3/2015 16:28
4706,20154119074113-792,1,8/1/2015 18:02,1438477320,C5,165780,1438643100,8/3/2015 16:05
6215,20152726042723-397,1,8/2/2015 16:06,1438556760,C8,86220,1438642980,8/3/2015 16:03
3656,20152024062006-883,3,7/31/2015 4:38,1438342680,C5,299340,1438642020,8/3/2015 15:47
6400,20151621091605-465,1,7/30/2015 5:30,1438259400,C7,382020,1438641420,8/3/2015 15:37
5235,20153910033908-495,3,7/28/2015 15:31,1438122660,C3,518340,1438641000,8/3/2015 15:30
4099,20151105091109-417,2,7/30/2015 11:05,1438279500,C6,361140,1438640640,8/3/2015 15:24
3669,20155605065613-54,2,7/28/2015 0:56,1438070160,C6,569700,1438639860,8/3/2015 15:11
5153,20153521083522-988,1,8/2/2015 3:39,1438511940,C5,127380,1438639320,8/3/2015 15:02
354,20153327123320-68,1,8/2/2015 14:27,1438550820,C6,87540,1438638360,8/3/2015 14:46
5303,20154714074704-144,3,7/28/2015 7:51,1438095060,C4,543120,1438638180,8/3/2015 14:43
5289,20152830082817-542,1,8/1/2015 11:00,1438452000,C6,181920,1438633920,8/3/2015 13:32
1490,20152726032754-124,1,7/29/2015 19:00,1438221600,C5,409140,1438630740,8/3/2015 12:39
2338,20153226073247-72,1,8/2/2015 11:44,1438541040,C2,88560,1438629600,8/3/2015 12:20
2782,20154130124118-316,1,8/2/2015 4:21,1438514460,C7,114600,1438629060,8/3/2015 12:11
1259,20155631125645-432,1,8/2/2015 12:24,1438543440,C4,85440,1438628880,8/3/2015 12:08
70,20151924091930-39,1,7/31/2015 1:47,1438332420,C5,288840,1438621260,8/3/2015 10:01
4133,20155227085257-55,1,8/1/2015 1:26,1438417560,C2,202620,1438620180,8/3/2015 9:43
5316,20153117083124-431,2,8/1/2015 6:34,1438436040,C7,184140,1438620180,8/3/2015 9:43
5590,20152001012059-836,1,8/2/2015 11:29,1438540140,C4,79740,1438619880,8/3/2015 9:38
6154,20152118042118-402,3,8/1/2015 9:42,1438447320,C2,169380,1438616700,8/3/2015 8:45
5996,20153419013456-499,2,7/29/2015 9:22,1438186920,C2,424440,1438611360,8/3/2015 7:16
910,20155427065441-961,1,7/31/2015 22:58,1438408680,C0,201720,1438610400,8/3/2015 7:00
2805,20153404053446-388,1,7/30/2015 14:07,1438290420,C2,319140,1438609560,8/3/2015 6:46
6385,20153125033101-388,2,8/2/2015 4:42,1438515720,C7,93180,1438608900,8/3/2015 6:35
6085,20155109045104-759,3,7/31/2015 4:31,1438342260,C4,265200,1438607460,8/3/2015 6:11
134,20155701025756-944,2,8/2/2015 10:15,1438535700,C4,69480,1438605180,8/3/2015 5:33
4248,20152421062416-977,1,7/27/2015 17:51,1438044660,C4,559620,1438604280,8/3/2015 5:18
2998,20150124090106-75,1,7/31/2015 17:46,1438389960,C3,212100,1438602060,8/3/2015 4:41
164,20152830022802-299,1,8/1/2015 23:52,1438498320,C2,103320,1438601640,8/3/2015 4:34
194,20154428124429-300,2,8/2/2015 11:30,1438540200,C7,61080,1438601280,8/3/2015 4:28
4620,20155618095623-707,1,7/30/2015 5:26,1438259160,C3,340200,1438599360,8/3/2015 3:56
6356,20152830032844-398,2,8/1/2015 23:44,1438497840,C8,101280,1438599120,8/3/2015 3:52
3830,20155929045944-214,1,7/30/2015 7:55,1438268100,C0,330720,1438598820,8/3/2015 3:47
1814,20155724015737-87,3,7/30/2015 22:45,1438321500,C3,275040,1438596540,8/3/2015 3:09
5916,20154530104517-465,1,8/2/2015 4:42,1438515720,C0,79140,1438594860,8/3/2015 2:41
3294,20153018053053-129,2,8/1/2015 4:26,1438428360,C7,166080,1438594440,8/3/2015 2:34
1391,20153730013710-947,1,8/1/2015 8:02,1438441320,C3,152700,1438594020,8/3/2015 2:27
2785,20152512062545-262,1,7/28/2015 14:58,1438120680,C2,471060,1438591740,8/3/2015 1:49
3939,20151723091752-582,1,7/28/2015 17:25,1438129500,C4,461280,1438590780,8/3/2015 1:33
6408,20151710021746-134,1,7/28/2015 3:53,1438080780,C4,505920,1438586700,8/3/2015 0:25
2755,20151603061640-724,2,7/23/2015 18:20,1437700800,C8,885720,1438586520,8/3/2015 0:22
842,20150316030333-652,2,7/31/2015 19:52,1438397520,C5,187620,1438585140,8/2/2015 23:59
2994,20152529092534-521,3,8/1/2015 10:41,1438450860,C8,131880,1438582740,8/2/2015 23:19
2930,20155822115853-505,1,7/30/2015 3:30,1438252200,C7,330360,1438582560,8/2/2015 23:16
1098,20150231010230-879,1,8/2/2015 3:50,1438512600,C8,69840,1438582440,8/2/2015 23:14
1104,20155229095223-993,1,7/31/2015 16:30,1438385400,C6,196680,1438582080,8/2/2015 23:08
1892,20152208032247-227,1,7/31/2015 3:14,1438337640,C0,242940,1438580580,8/2/2015 22:43
1751,20154112014114-381,1,7/31/2015 14:15,1438377300,C6,201840,1438579140,8/2/2015 22:19
2827,20155317095355-5,1,7/31/2015 13:29,1438374540,C6,203760,1438578300,8/2/2015 22:05
4793,20155226125229-218,3,8/1/2015 23:48,1438498080,C3,79680,1438577760,8/2/2015 21:56
1472,20155129045107-400,2,8/1/2015 19:57,1438484220,C3,90120,1438574340,8/2/2015 20:59
2879,20154931034945-124,3,8/2/2015 2:51,1438509060,C7,63060,1438572120,8/2/2015 20:22
6255,20155729095756-876,3,8/1/2015 8:51,1438444260,C5,127620,1438571880,8/2/2015 20:18
2594,20154129034133-355,1,8/1/2015 18:53,1438480380,C5,90240,1438570620,8/2/2015 19:57
5155,20151125121136-226,2,7/31/2015 17:56,1438390560,C5,179700,1438570260,8/2/2015 19:51
2211,20153504073526-319,1,7/28/2015 21:45,1438145100,C8,424920,1438570020,8/2/2015 19:47
747,20154615054615-774,3,7/31/2015 19:22,1438395720,C5,173520,1438569240,8/2/2015 19:34
6527,20152624102605-26,1,7/30/2015 15:46,1438296360,C8,268800,1438565160,8/2/2015 18:26
4950,20150007090049-931,2,7/26/2015 17:10,1437955800,C2,609000,1438564800,8/2/2015 18:20
2764,20151231121203-449,2,8/2/2015 0:16,1438499760,C5,64920,1438564680,8/2/2015 18:18
3351,20150031030030-236,1,8/1/2015 16:35,1438472100,C2,92100,1438564200,8/2/2015 18:10
1588,20152227032235-207,1,8/1/2015 23:49,1438498140,C0,66060,1438564200,8/2/2015 18:10
523,20152130052126-284,1,7/29/2015 14:42,1438206120,C5,356580,1438562700,8/2/2015 17:45
5031,20152921082906-529,3,7/28/2015 10:25,1438104300,C4,457680,1438561980,8/2/2015 17:33
2651,20154530054541-361,2,8/1/2015 16:51,1438473060,C5,84780,1438557840,8/2/2015 16:24
3106,20152330112320-637,1,8/1/2015 21:05,1438488300,C2,69240,1438557540,8/2/2015 16:19
6494,20154926124914-356,1,7/31/2015 6:35,1438349700,C2,204780,1438554480,8/2/2015 15:28
2965,20155705025745-109,1,7/30/2015 20:03,1438311780,C7,242040,1438553820,8/2/2015 15:17
3393,20150518020501-460,1,7/28/2015 14:29,1438118940,C6,432180,1438551120,8/2/2015 14:32
1406,20150725040701-369,2,8/1/2015 16:47,1438472820,C5,75900,1438548720,8/2/2015 13:52
293,20155628055649-858,1,8/1/2015 22:58,1438495080,C0,51960,1438547040,8/2/2015 13:24
5074,20150825050807-78,1,7/29/2015 15:14,1438208040,C4,338760,1438546800,8/2/2015 13:20
3827,20153626053623-916,3,7/24/2015 7:30,1437748200,C4,794280,1438542480,8/2/2015 12:08
491,20154805104835-68,3,7/30/2015 9:12,1438272720,C2,269280,1438542000,8/2/2015 12:00
1670,20152907092902-279,2,7/19/2015 11:05,1437329100,C5,1211520,1438540620,8/2/2015 11:37
74,20152824082844-651,3,7/30/2015 10:34,1438277640,C8,262980,1438540620,8/2/2015 11:37
4408,20152207042208-551,1,7/24/2015 21:08,1437797280,C8,742980,1438540260,8/2/2015 11:31
3443,20154023084005-11,1,7/30/2015 22:25,1438320300,C4,218100,1438538400,8/2/2015 11:00
4179,20155303025331-674,1,7/29/2015 4:35,1438169700,C6,368220,1438537920,8/2/2015 10:52
677,20154306084336-628,2,7/14/2015 9:57,1436893020,C3,1643820,1438536840,8/2/2015 10:34
4972,20152727032734-400,2,7/31/2015 12:11,1438369860,C8,166920,1438536780,8/2/2015 10:33
3941,20155021015058-471,1,7/27/2015 10:16,1438017360,C6,505560,1438522920,8/2/2015 6:42
2189,20155325045321-836,1,7/29/2015 11:45,1438195500,C0,327120,1438522620,8/2/2015 6:37
4990,20155424065455-846,2,8/1/2015 3:26,1438424760,C7,96960,1438521720,8/2/2015 6:22
2400,20155005065043-343,1,7/26/2015 6:20,1437916800,C4,604200,1438521000,8/2/2015 6:10
341,20151326031334-997,1,8/1/2015 3:33,1438425180,C8,95280,1438520460,8/2/2015 6:01
4151,20154315094344-834,2,7/28/2015 18:43,1438134180,C2,385200,1438519380,8/2/2015 5:43
4506,20154726064756-747,1,7/30/2015 21:59,1438318740,C7,200160,1438518900,8/2/2015 5:35
6084,20152731082747-677,1,8/1/2015 6:36,1438436160,C2,79740,1438515900,8/2/2015 4:45
6487,20154413074407-257,1,7/27/2015 15:36,1438036560,C5,478740,1438515300,8/2/2015 4:35
6206,20152205022233-507,2,7/30/2015 2:54,1438250040,C0,264840,1438514880,8/2/2015 4:28
3290,20150725030751-337,1,8/1/2015 5:26,1438431960,C4,81420,1438513380,8/2/2015 4:03
1595,20153816023820-577,2,7/30/2015 9:33,1438273980,C8,238260,1438512240,8/2/2015 3:44
4565,20154124104119-137,3,8/1/2015 1:23,1438417380,C8,93960,1438511340,8/2/2015 3:29
3486,20150311010308-753,3,7/25/2015 21:59,1437886740,C5,620880,1438507620,8/2/2015 2:27
3574,20150530110520-639,3,7/31/2015 18:41,1438393260,C2,113760,1438507020,8/2/2015 2:17
6413,20155026125036-291,2,7/29/2015 19:15,1438222500,C2,282300,1438504800,8/2/2015 1:40
6219,20151329051347-815,3,7/31/2015 22:43,1438407780,C8,96300,1438504080,8/2/2015 1:28
3807,20150910090926-819,1,7/29/2015 19:27,1438223220,C6,279780,1438503000,8/2/2015 1:10
5751,20154612014642-990,1,7/22/2015 19:27,1437618420,C2,884460,1438502880,8/2/2015 1:08
4448,20155123035157-563,2,7/31/2015 20:47,1438400820,C2,101280,1438502100,8/2/2015 0:55
3630,20150105080122-729,1,7/29/2015 13:29,1438201740,C5,299040,1438500780,8/2/2015 0:33
3398,20151422011417-46,1,7/31/2015 16:48,1438386480,C7,112920,1438499400,8/2/2015 0:10
4906,20153617033658-794,3,7/31/2015 1:29,1438331340,C5,165540,1438496880,8/1/2015 23:28
187,20151328091352-263,1,7/31/2015 19:52,1438397520,C5,99180,1438496700,8/1/2015 23:25
4532,20154103084141-252,3,7/25/2015 13:38,1437856680,C4,639540,1438496220,8/1/2015 23:17
3143,20155625055644-429,1,8/1/2015 1:22,1438417320,C2,77880,1438495200,8/1/2015 23:00
711,20151612101618-908,3,7/30/2015 0:22,1438240920,C6,253260,1438494180,8/1/2015 22:43
969,20154725114714-121,3,8/1/2015 0:21,1438413660,C7,80520,1438494180,8/1/2015 22:43
976,20153324033341-637,2,7/30/2015 4:09,1438254540,C4,238680,1438493220,8/1/2015 22:27
6149,20152626062625-468,1,7/31/2015 6:11,1438348260,C5,143700,1438491960,8/1/2015 22:06
1994,20151426111428-477,2,7/30/2015 18:26,1438305960,C2,185760,1438491720,8/1/2015 22:02
5339,20152709082754-396,1,7/29/2015 23:14,1438236840,C7,254460,1438491300,8/1/2015 21:55
3406,20152207112247-321,3,7/30/2015 2:02,1438246920,C4,244200,1438491120,8/1/2015 21:52
911,20154625084640-549,1,7/31/2015 23:12,1438409520,C4,81480,1438491000,8/1/2015 21:50
3815,20155627055642-893,2,8/1/2015 7:48,1438440480,C5,49440,1438489920,8/1/2015 21:32
4665,20153927083929-384,1,7/31/2015 12:09,1438369740,C4,119400,1438489140,8/1/2015 21:19
2590,20155621035631-676,2,7/28/2015 7:08,1438092480,C5,395640,1438488120,8/1/2015 21:02
2173,20150719120749-370,1,7/30/2015 15:32,1438295520,C8,192540,1438488060,8/1/2015 21:01
454,20155209085255-542,3,7/29/2015 11:46,1438195560,C6,289740,1438485300,8/1/2015 20:15
3536,20153526063512-278,1,7/30/2015 15:13,1438294380,C8,188340,1438482720,8/1/2015 19:32
3072,20155029045031-175,2,7/31/2015 6:07,1438348020,C3,134220,1438482240,8/1/2015 19:24
3557,20151501041514-837,1,7/28/2015 21:56,1438145760,C7,336180,1438481940,8/1/2015 19:19
5569,20154428094403-173,1,7/31/2015 7:58,1438354680,C7,126420,1438481100,8/1/2015 19:05
5200,20151121031117-949,1,7/29/2015 23:14,1438236840,C4,240060,1438476900,8/1/2015 17:55
3819,20151022101006-317,1,7/28/2015 6:18,1438089480,C4,387060,1438476540,8/1/2015 17:49
4729,20153123063158-685,1,7/31/2015 12:44,1438371840,C0,101940,1438473780,8/1/2015 17:03
1763,20154417054458-449,1,7/27/2015 17:06,1438041960,C7,430860,1438472820,8/1/2015 16:47
5127,20155724015759-778,1,7/29/2015 23:49,1438238940,C7,233760,1438472700,8/1/2015 16:45
1621,20150817040833-849,2,7/30/2015 19:15,1438308900,C8,162060,1438470960,8/1/2015 16:16
4626,20151923121906-266,3,7/30/2015 9:01,1438272060,C5,197640,1438469700,8/1/2015 15:55
3786,20150320030349-572,1,7/27/2015 9:10,1438013400,C5,453660,1438467060,8/1/2015 15:11
2335,20150217100259-352,1,7/30/2015 17:28,1438302480,C2,164280,1438466760,8/1/2015 15:06
4566,20153306073311-379,2,7/28/2015 5:48,1438087680,C8,378900,1438466580,8/1/2015 15:03
1146,20152012092008-483,1,7/30/2015 2:07,1438247220,C5,218460,1438465680,8/1/2015 14:48
670,20150029080012-457,2,7/31/2015 12:04,1438369440,C5,93720,1438463160,8/1/2015 14:06
4085,20153922073948-796,1,7/29/2015 23:24,1438237440,C3,220500,1438457940,8/1/2015 12:39
4025,20150604010643-971,3,7/23/2015 4:34,1437651240,C5,805440,1438456680,8/1/2015 12:18
940,20153726073704-996,3,7/30/2015 23:01,1438322460,C5,133680,1438456140,8/1/2015 12:09
791,20151029071056-312,1,7/31/2015 10:06,1438362360,C8,91680,1438454040,8/1/2015 11:34
3750,20155225025231-666,2,7/31/2015 17:16,1438388160,C4,65880,1438454040,8/1/2015 11:34
5522,20153322053343-539,1,7/27/2015 14:28,1438032480,C2,420900,1438453380,8/1/2015 11:23
5711,20154215124253-8,3,7/28/2015 5:15,1438085700,C4,365460,1438451160,8/1/2015 10:46
1756,20154924014948-415,1,7/31/2015 7:37,1438353420,C6,97080,1438450500,8/1/2015 10:35
5860,20151622041646-326,1,7/29/2015 4:26,1438169160,C8,281100,1438450260,8/1/2015 10:31
2417,20153603093633-912,2,7/27/2015 13:26,1438028760,C8,417480,1438446240,8/1/2015 9:24
43,20151617011611-701,1,7/27/2015 10:12,1438017120,C3,426480,1438443600,8/1/2015 8:40
5670,20155306095352-482,3,7/29/2015 2:43,1438162980,C5,280200,1438443180,8/1/2015 8:33
4398,20151704071753-165,1,7/28/2015 20:13,1438139580,C5,302880,1438442460,8/1/2015 8:21
4168,20150304020357-184,1,7/23/2015 2:13,1437642780,C3,799500,1438442280,8/1/2015 8:18
3131,20152219092238-393,3,7/29/2015 2:31,1438162260,C2,279780,1438442040,8/1/2015 8:14
6477,20154212064205-889,2,7/30/2015 2:34,1438248840,C6,192540,1438441380,8/1/2015 8:03
4470,20155820065827-219,2,7/30/2015 19:54,1438311240,C2,130080,1438441320,8/1/2015 8:02
2126,20153017103047-976,1,7/27/2015 8:10,1438009800,C0,427800,1438437600,8/1/2015 7:00
4975,20153718113730-766,1,7/27/2015 9:53,1438015980,C2,420420,1438436400,8/1/2015 6:40
258,20150624060606-582,1,7/29/2015 14:28,1438205280,C7,231060,1438436340,8/1/2015 6:39
254,20153425013459-560,1,7/28/2015 4:30,1438083000,C5,352320,1438435320,8/1/2015 6:22
4394,20151113061132-529,3,7/22/2015 17:31,1437611460,C2,818400,1438429860,8/1/2015 4:51
2678,20151824121833-994,1,7/28/2015 8:34,1438097640,C6,332160,1438429800,8/1/2015 4:50
2296,20155206025224-627,2,7/29/2015 8:36,1438184160,C0,245580,1438429740,8/1/2015 4:49
4114,20155008095000-690,2,7/29/2015 5:17,1438172220,C0,256860,1438429080,8/1/2015 4:38
6389,20150426070452-144,1,7/31/2015 4:04,1438340640,C8,84240,1438424880,8/1/2015 3:28
376,20155210025230-794,1,7/24/2015 23:14,1437804840,C4,619860,1438424700,8/1/2015 3:25
971,20154914104905-829,3,7/27/2015 17:13,1438042380,C0,382080,1438424460,8/1/2015 3:21
252,20153624073615-56,1,7/29/2015 12:04,1438196640,C3,224040,1438420680,8/1/2015 2:18
4774,20151124031108-240,1,7/31/2015 3:24,1438338240,C2,80340,1438418580,8/1/2015 1:43
3086,20150915010905-807,2,7/29/2015 23:53,1438239180,C2,178320,1438417500,8/1/2015 1:25
4713,20151224121210-614,2,7/30/2015 4:06,1438254360,C5,163080,1438417440,8/1/2015 1:24
4009,20150925050919-689,3,7/29/2015 22:33,1438234380,C7,182520,1438416900,8/1/2015 1:15
2420,20153611043604-222,2,7/29/2015 12:04,1438196640,C0,219840,1438416480,8/1/2015 1:08
2706,20150806030837-471,1,7/28/2015 20:39,1438141140,C5,274380,1438415520,8/1/2015 0:52
3471,20151428031458-998,1,7/30/2015 21:24,1438316640,C8,97500,1438414140,8/1/2015 0:29
1368,20155230025233-218,1,7/31/2015 7:15,1438352100,C6,58980,1438411080,7/31/2015 23:38
3300,20152118022105-958,1,7/25/2015 6:51,1437832260,C2,577800,1438410060,7/31/2015 23:21
2493,20150117060105-392,1,7/30/2015 7:29,1438266540,C5,141060,1438407600,7/31/2015 22:40
864,20152520092520-405,2,7/30/2015 11:23,1438280580,C3,124440,1438405020,7/31/2015 21:57
3810,20154706014712-28,2,7/28/2015 17:47,1438130820,C2,273600,1438404420,7/31/2015 21:47
1089,20155216015226-188,2,7/20/2015 13:46,1437425160,C5,979080,1438404240,7/31/2015 21:44
100,20153313023303-282,3,7/28/2015 20:28,1438140480,C8,263460,1438403940,7/31/2015 21:39
2528,20155514015554-802,2,7/30/2015 3:34,1438252440,C7,149460,1438401900,7/31/2015 21:05
1297,20153801123847-62,1,7/21/2015 17:40,1437525600,C4,873060,1438398660,7/31/2015 20:11
4636,20152519082511-770,2,7/27/2015 16:15,1438038900,C5,359700,1438398600,7/31/2015 20:10
4152,20155424105453-864,1,7/29/2015 8:54,1438185240,C1,212400,1438397640,7/31/2015 19:54
4778,20154217104217-430,1,7/30/2015 0:38,1438241880,C2,155280,1438397160,7/31/2015 19:46
6128,20153225093249-352,1,7/30/2015 17:47,1438303620,C8,92340,1438395960,7/31/2015 19:26
6028,20150223090243-726,3,7/30/2015 17:54,1438304040,C0,90960,1438395000,7/31/2015 19:10
159,20155424015436-907,3,7/30/2015 21:13,1438315980,C2,77820,1438393800,7/31/2015 18:50
3882,20151920101933-665,1,7/21/2015 10:28,1437499680,C5,892980,1438392660,7/31/2015 18:31
2356,20150923010916-544,3,7/30/2015 17:42,1438303320,C0,88740,1438392060,7/31/2015 18:21
4605,20154519024544-322,2,7/29/2015 8:13,1438182780,C4,202140,1438384920,7/31/2015 16:22
5745,20155724025757-642,2,7/29/2015 21:30,1438230600,C5,151860,1438382460,7/31/2015 15:41
2858,20151216041200-755,1,7/26/2015 15:38,1437950280,C5,430980,1438381260,7/31/2015 15:21
4771,20153623073647-385,3,7/30/2015 13:54,1438289640,C5,89640,1438379280,7/31/2015 14:48
2276,20151027121025-240,1,7/20/2015 5:46,1437396360,C5,982080,1438378440,7/31/2015 14:34
1374,20152926022953-770,1,7/29/2015 22:01,1438232460,C3,143160,1438375620,7/31/2015 13:47
3688,20152824012815-413,1,7/29/2015 5:38,1438173480,C2,201900,1438375380,7/31/2015 13:43
3993,20150517090533-187,1,7/28/2015 0:17,1438067820,C4,306240,1438374060,7/31/2015 13:21
2957,20153020023013-76,1,7/26/2015 9:52,1437929520,C4,441960,1438371480,7/31/2015 12:38
4438,20151001091034-497,1,7/27/2015 4:40,1437997200,C1,371700,1438368900,7/31/2015 11:55
533,20153622103615-743,2,7/29/2015 4:27,1438169220,C4,194220,1438363440,7/31/2015 10:24
3933,20155825015847-776,3,7/30/2015 16:07,1438297620,C2,62820,1438360440,7/31/2015 9:34
2795,20154018034028-142,1,7/27/2015 2:56,1437990960,C8,365880,1438356840,7/31/2015 8:34
640,20153712013720-181,3,7/28/2015 22:51,1438149060,C6,206700,1438355760,7/31/2015 8:16
3565,20153609073654-587,1,7/24/2015 0:02,1437721320,C8,634380,1438355700,7/31/2015 8:15
4823,20152704022701-232,1,7/24/2015 15:30,1437777000,C5,577260,1438354260,7/31/2015 7:51
2397,20155722085740-393,1,7/28/2015 8:13,1438096380,C0,257880,1438354260,7/31/2015 7:51
2005,20150418030419-69,1,7/28/2015 2:49,1438076940,C5,273300,1438350240,7/31/2015 6:44
4189,20151920081921-606,3,7/29/2015 21:41,1438231260,C5,117960,1438349220,7/31/2015 6:27
3531,20153211063223-512,1,7/29/2015 0:56,1438156560,C5,191880,1438348440,7/31/2015 6:14
642,20154724114756-664,2,7/30/2015 12:03,1438282980,C6,64920,1438347900,7/31/2015 6:05
1786,20153424123435-575,2,7/28/2015 23:58,1438153080,C7,193320,1438346400,7/31/2015 5:40
2810,20153123103101-33,2,7/30/2015 5:23,1438258980,C8,83760,1438342740,7/31/2015 4:39
5503,20153915073941-756,1,7/25/2015 21:03,1437883380,C8,456120,1438339500,7/31/2015 3:45
1189,20154513114555-897,1,7/26/2015 16:27,1437953220,C5,380040,1438333260,7/31/2015 2:01
2136,20153217063258-545,2,7/27/2015 14:56,1438034160,C5,298080,1438332240,7/31/2015 1:44
2962,20154715084738-41,2,7/25/2015 23:03,1437890580,C2,438420,1438329000,7/31/2015 0:50
2750,20153328073330-51,1,7/29/2015 15:43,1438209780,C4,115800,1438325580,7/30/2015 23:53
1324,20152021062038-745,2,7/28/2015 12:59,1438113540,C4,209580,1438323120,7/30/2015 23:12
5050,20152917082925-523,1,7/27/2015 13:26,1438028760,C2,293940,1438322700,7/30/2015 23:05
2102,20153026053002-255,3,7/30/2015 9:35,1438274100,C4,45300,1438319400,7/30/2015 22:10
4188,20152528012542-188,1,7/29/2015 17:44,1438217040,C4,101940,1438318980,7/30/2015 22:03
824,20155017105044-579,1,7/28/2015 16:10,1438125000,C8,193920,1438318920,7/30/2015 22:02
4197,20155123015131-999,1,7/29/2015 1:51,1438159860,C5,158400,1438318260,7/30/2015 21:51
1370,20153925023931-202,2,7/29/2015 3:05,1438164300,C5,151980,1438316280,7/30/2015 21:18
1564,20154421044450-831,3,7/26/2015 7:00,1437919200,C4,396960,1438316160,7/30/2015 21:16
4992,20150820090851-701,2,7/29/2015 13:45,1438202700,C8,113460,1438316160,7/30/2015 21:16
137,20150826100844-912,2,7/29/2015 17:53,1438217580,C5,95700,1438313280,7/30/2015 20:28
798,20151116031103-753,1,7/26/2015 2:37,1437903420,C8,409380,1438312800,7/30/2015 20:20
250,20153227033233-52,1,7/30/2015 1:08,1438243680,C4,69120,1438312800,7/30/2015 20:20
899,20153920073949-207,1,7/25/2015 18:23,1437873780,C5,437520,1438311300,7/30/2015 19:55
4220,20151429051412-750,1,7/26/2015 22:20,1437974400,C8,335880,1438310280,7/30/2015 19:38
1326,20153228033232-771,1,7/29/2015 17:32,1438216320,C2,93600,1438309920,7/30/2015 19:32
4866,20153424103412-281,2,7/28/2015 16:30,1438126200,C5,183480,1438309680,7/30/2015 19:28
4320,20155121015153-897,1,7/27/2015 16:55,1438041300,C5,264720,1438306020,7/30/2015 18:27
6355,20152020062024-190,1,7/27/2015 6:24,1438003440,C8,302520,1438305960,7/30/2015 18:26
2846,20150923090925-163,3,7/29/2015 20:12,1438225920,C5,79740,1438305660,7/30/2015 18:21
4861,20152524032503-334,3,7/28/2015 17:05,1438128300,C4,175800,1438304100,7/30/2015 17:55
1228,20151801041821-719,2,7/27/2015 2:42,1437990120,C7,313920,1438304040,7/30/2015 17:54
2410,20153211103235-736,1,7/28/2015 7:57,1438095420,C4,208500,1438303920,7/30/2015 17:52
4862,20153726023718-952,1,7/28/2015 15:56,1438124160,C3,177540,1438301700,7/30/2015 17:15
3986,20153423013440-640,1,7/29/2015 21:50,1438231800,C3,68520,1438300320,7/30/2015 16:52
5149,20154526024508-653,1,7/30/2015 0:20,1438240800,C8,58740,1438299540,7/30/2015 16:39
5978,20152005042050-261,1,7/24/2015 10:29,1437758940,C5,540180,1438299120,7/30/2015 16:32
3213,20150704100721-493,2,7/27/2015 9:15,1438013700,C3,283440,1438297140,7/30/2015 15:59
5771,20154320014349-634,1,7/25/2015 15:07,1437862020,C5,432720,1438294740,7/30/2015 15:19
1764,20150624030614-941,1,7/29/2015 21:06,1438229160,C8,64800,1438293960,7/30/2015 15:06
3050,20153922013946-38,3,7/28/2015 14:39,1438119540,C2,174000,1438293540,7/30/2015 14:59
3177,20150308110350-292,2,7/27/2015 10:57,1438019820,C6,273540,1438293360,7/30/2015 14:56
3085,20152715102715-129,2,7/26/2015 19:45,1437965100,C4,327960,1438293060,7/30/2015 14:51
5667,20154929114937-129,2,7/26/2015 17:23,1437956580,C3,336120,1438292700,7/30/2015 14:45
6507,20155614075656-559,1,7/25/2015 4:10,1437822600,C8,468420,1438291020,7/30/2015 14:17
1732,20155126035129-589,2,7/26/2015 19:27,1437964020,C5,325620,1438289640,7/30/2015 13:54
5889,20151711081724-536,1,7/28/2015 10:33,1438104780,C4,184620,1438289400,7/30/2015 13:50
3230,20155723025701-227,1,7/28/2015 20:06,1438139160,C2,150180,1438289340,7/30/2015 13:49
14,20152923102955-348,2,7/29/2015 16:24,1438212240,C8,77100,1438289340,7/30/2015 13:49
3595,20155217115255-205,1,7/26/2015 5:06,1437912360,C5,376620,1438288980,7/30/2015 13:43
5609,20154509024548-175,1,7/23/2015 13:59,1437685140,C4,603420,1438288560,7/30/2015 13:36
5806,20150306080327-887,2,7/27/2015 12:50,1438026600,C7,261660,1438288260,7/30/2015 13:31
5159,20151307081300-707,1,7/24/2015 15:17,1437776220,C5,510780,1438287000,7/30/2015 13:10
471,20150528080517-604,1,7/29/2015 10:31,1438191060,C6,95160,1438286220,7/30/2015 12:57
4092,20155027085049-858,2,7/29/2015 11:22,1438194120,C8,90960,1438285080,7/30/2015 12:38
5184,20154513074545-202,1,7/28/2015 8:08,1438096080,C8,185340,1438281420,7/30/2015 11:37
6419,20152817062832-264,2,7/26/2015 1:40,1437900000,C5,380160,1438280160,7/30/2015 11:16
761,20155526125517-937,1,7/29/2015 3:35,1438166100,C8,112800,1438278900,7/30/2015 10:55
1249,20153522073506-41,1,7/28/2015 9:53,1438102380,C5,175560,1438277940,7/30/2015 10:39
5715,20154002114020-604,2,7/27/2015 8:04,1438009440,C5,268380,1438277820,7/30/2015 10:37
4666,20154626064610-637,1,7/29/2015 1:12,1438157520,C8,119580,1438277100,7/30/2015 10:25
4066,20152816102825-722,1,7/26/2015 22:01,1437973260,C5,301860,1438275120,7/30/2015 9:52
2797,20154203044240-260,1,7/23/2015 7:31,1437661860,C7,612420,1438274280,7/30/2015 9:38
2946,20155724065712-217,1,7/28/2015 20:18,1438139880,C2,131220,1438271100,7/30/2015 8:45
5217,20152421072403-434,3,7/28/2015 19:54,1438138440,C8,129960,1438268400,7/30/2015 8:00
794,20154517044506-783,3,7/28/2015 5:15,1438085700,C8,181800,1438267500,7/30/2015 7:45
1471,20152525042519-381,2,7/29/2015 3:52,1438167120,C2,100140,1438267260,7/30/2015 7:41
4891,20153824043829-635,3,7/29/2015 8:33,1438183980,C8,80580,1438264560,7/30/2015 6:56
5019,20153602043607-343,1,7/27/2015 5:16,1437999360,C4,264900,1438264260,7/30/2015 6:51
3528,20151127091156-609,3,7/29/2015 7:21,1438179660,C8,83100,1438262760,7/30/2015 6:26
975,20152610062612-425,1,7/26/2015 21:56,1437972960,C8,287640,1438260600,7/30/2015 5:50
1473,20154825104838-640,2,7/29/2015 0:51,1438156260,C5,103260,1438259520,7/30/2015 5:32
6284,20152819062830-519,2,7/24/2015 17:36,1437784560,C0,472080,1438256640,7/30/2015 4:44
226,20152322092332-533,3,7/29/2015 7:55,1438181700,C0,74940,1438256640,7/30/2015 4:44
2622,20152028022013-691,1,7/29/2015 9:15,1438186500,C6,68100,1438254600,7/30/2015 4:10
1460,20153024113026-294,2,7/28/2015 5:50,1438087800,C5,162600,1438250400,7/30/2015 3:00
6510,20155426095420-438,2,7/28/2015 20:56,1438142160,C8,106260,1438248420,7/30/2015 2:27
5907,20152923052943-630,1,7/27/2015 23:15,1438064100,C5,183180,1438247280,7/30/2015 2:08
1674,20155704065719-686,1,7/25/2015 18:47,1437875220,C8,371400,1438246620,7/30/2015 1:57
6027,20150825070821-784,2,7/28/2015 11:16,1438107360,C4,137040,1438244400,7/30/2015 1:20
2237,20154208034244-0,1,7/27/2015 8:45,1438011900,C4,230940,1438242840,7/30/2015 0:54
5392,20152513092550-113,1,7/27/2015 22:43,1438062180,C0,179640,1438241820,7/30/2015 0:37
538,20152126032100-410,3,7/29/2015 4:15,1438168500,C4,73080,1438241580,7/30/2015 0:33
5219,20154005114042-468,1,7/26/2015 22:45,1437975900,C4,264900,1438240800,7/30/2015 0:20
4485,20151410081406-824,1,7/23/2015 10:28,1437672480,C5,565620,1438238100,7/29/2015 23:35
1292,20152921092932-891,1,7/27/2015 2:41,1437990060,C5,246960,1438237020,7/29/2015 23:17
4206,20153208083240-926,3,7/12/2015 17:56,1436748960,C7,1485720,1438234680,7/29/2015 22:38
3402,20150910060904-59,2,7/27/2015 11:16,1438020960,C7,212460,1438233420,7/29/2015 22:17
2130,20155203065228-993,1,7/25/2015 11:22,1437848520,C8,383400,1438231920,7/29/2015 21:52
2875,20155327105347-925,1,7/29/2015 2:03,1438160580,C8,70500,1438231080,7/29/2015 21:38
5397,20151222061237-438,3,7/27/2015 8:14,1438010040,C3,219660,1438229700,7/29/2015 21:15
2302,20155620115651-849,1,7/26/2015 17:22,1437956520,C8,268980,1438225500,7/29/2015 20:05
1364,20151424021410-748,3,7/28/2015 1:58,1438073880,C7,150720,1438224600,7/29/2015 19:50
1775,20155023065033-796,3,7/28/2015 4:20,1438082400,C4,141000,1438223400,7/29/2015 19:30
5911,20153126013121-122,3,7/28/2015 17:29,1438129740,C7,93540,1438223280,7/29/2015 19:28
926,20154003074050-280,1,7/18/2015 20:35,1437276900,C0,944700,1438221600,7/29/2015 19:00
6333,20151322101302-482,1,7/27/2015 7:39,1438007940,C5,211380,1438219320,7/29/2015 18:22
1073,20155419055407-635,2,7/28/2015 15:38,1438123080,C4,96180,1438219260,7/29/2015 18:21
6473,20154305084350-216,2,7/23/2015 16:59,1437695940,C5,522120,1438218060,7/29/2015 18:01
1883,20150026110014-327,3,7/28/2015 15:36,1438122960,C5,94680,1438217640,7/29/2015 17:54
1500,20155620065658-617,1,7/24/2015 19:09,1437790140,C2,425940,1438216080,7/29/2015 17:28
1655,20152416072430-9,3,7/27/2015 11:09,1438020540,C8,192780,1438213320,7/29/2015 16:42
3447,20150923050915-668,1,7/28/2015 22:13,1438146780,C0,64320,1438211100,7/29/2015 16:05
3285,20151210101237-47,2,7/24/2015 20:12,1437793920,C2,415200,1438209120,7/29/2015 15:32
4474,20150523010518-241,1,7/28/2015 22:41,1438148460,C2,58320,1438206780,7/29/2015 14:53
2354,20151510031519-222,1,7/26/2015 10:20,1437931200,C8,272940,1438204140,7/29/2015 14:09
5477,20151522091559-339,1,7/27/2015 4:31,1437996660,C0,207480,1438204140,7/29/2015 14:09
155,20155219085255-410,1,7/28/2015 7:25,1438093500,C2,110340,1438203840,7/29/2015 14:04
1449,20154317114331-457,1,7/28/2015 5:03,1438084980,C2,115800,1438200780,7/29/2015 13:13
2568,20154816014841-737,1,7/18/2015 19:03,1437271380,C4,927900,1438199280,7/29/2015 12:48
1985,20150516080500-163,1,7/25/2015 2:51,1437817860,C4,379380,1438197240,7/29/2015 12:14
4435,20151921021945-394,3,7/27/2015 11:40,1438022400,C0,169620,1438192020,7/29/2015 10:47
1695,20151602031635-816,1,7/26/2015 11:00,1437933600,C3,257280,1438190880,7/29/2015 10:28
885,20150022090025-737,1,7/28/2015 5:20,1438086000,C8,101040,1438187040,7/29/2015 9:24
5363,20153219043201-719,1,7/28/2015 3:11,1438078260,C7,104220,1438182480,7/29/2015 8:08
705,20150111030116-821,1,7/27/2015 2:50,1437990600,C0,191220,1438181820,7/29/2015 7:57
892,20151501031546-207,3,7/20/2015 1:53,1437382380,C2,796740,1438179120,7/29/2015 7:12
5466,20152416012433-808,1,7/26/2015 2:39,1437903540,C4,275100,1438178640,7/29/2015 7:04
6087,20150619110604-788,1,7/26/2015 0:10,1437894600,C5,282720,1438177320,7/29/2015 6:42
1626,20151918061901-392,3,7/25/2015 14:31,1437859860,C8,317160,1438177020,7/29/2015 6:37
2036,20153017103045-244,1,7/27/2015 6:40,1438004400,C8,170040,1438174440,7/29/2015 5:54
1701,20155517065511-650,1,7/27/2015 17:45,1438044300,C2,129000,1438173300,7/29/2015 5:35
4653,20154023044021-772,2,7/27/2015 8:38,1438011480,C3,158340,1438169820,7/29/2015 4:37
5923,20153428103458-866,2,7/25/2015 18:02,1437872520,C4,294960,1438167480,7/29/2015 3:58
2509,20150221080233-162,1,7/19/2015 16:44,1437349440,C5,816840,1438166280,7/29/2015 3:38
1492,20151615061625-429,3,7/23/2015 15:35,1437690900,C5,473820,1438164720,7/29/2015 3:12
2741,20153623113600-392,1,7/26/2015 7:23,1437920580,C6,244020,1438164600,7/29/2015 3:10
4501,20152616042649-259,1,7/27/2015 13:04,1438027440,C3,134040,1438161480,7/29/2015 2:18
3041,20154708064723-472,3,7/26/2015 11:42,1437936120,C4,224700,1438160820,7/29/2015 2:07
2042,20151823031815-439,1,7/28/2015 10:54,1438106040,C4,52020,1438158060,7/29/2015 1:21
4234,20154704014703-466,1,7/26/2015 7:47,1437922020,C6,234900,1438156920,7/29/2015 1:02
3201,20153322083304-339,2,7/25/2015 16:36,1437867360,C2,288180,1438155540,7/29/2015 0:39
717,20153111123156-389,1,7/23/2015 4:31,1437651060,C2,504000,1438155060,7/29/2015 0:31
2899,20150817070821-454,2,7/27/2015 16:28,1438039680,C2,112200,1438151880,7/28/2015 23:38
1934,20153021083029-997,3,7/27/2015 16:50,1438041000,C8,109680,1438150680,7/28/2015 23:18
5707,20155623015620-828,1,7/27/2015 14:56,1438034160,C5,116400,1438150560,7/28/2015 23:16
1299,20151519021534-355,3,7/27/2015 18:29,1438046940,C4,100920,1438147860,7/28/2015 22:31
3067,20151623091621-956,1,7/27/2015 12:43,1438026180,C2,119340,1438145520,7/28/2015 21:52
1694,20151109081144-678,3,7/23/2015 23:56,1437720960,C3,422100,1438143060,7/28/2015 21:11
5965,20153915073941-58,1,7/24/2015 8:35,1437752100,C3,390480,1438142580,7/28/2015 21:03
4763,20151518111558-749,2,7/27/2015 16:59,1438041540,C2,99780,1438141320,7/28/2015 20:42
2045,20153317093336-203,2,7/27/2015 9:53,1438015980,C7,123600,1438139580,7/28/2015 20:13
1945,20153423013422-332,2,7/27/2015 22:19,1438060740,C8,75420,1438136160,7/28/2015 19:16
6364,20151413021408-91,2,7/26/2015 14:44,1437947040,C6,187500,1438134540,7/28/2015 18:49
1967,20154525054551-322,1,7/27/2015 18:21,1438046460,C5,87480,1438133940,7/28/2015 18:39
2062,20151314091343-744,1,7/22/2015 10:13,1437585180,C6,547800,1438132980,7/28/2015 18:23
242,20151923041923-108,2,7/27/2015 1:33,1437985980,C8,146220,1438132200,7/28/2015 18:10
2989,20154926124932-480,1,7/28/2015 0:09,1438067340,C7,63600,1438130940,7/28/2015 17:49
356,20153012023040-460,1,7/26/2015 16:50,1437954600,C7,174000,1438128600,7/28/2015 17:10
6354,20151621121625-608,3,7/27/2015 11:51,1438023060,C8,103380,1438126440,7/28/2015 16:34
4776,20150409070446-883,2,7/25/2015 10:49,1437846540,C8,279180,1438125720,7/28/2015 16:22
1700,20155616075650-682,1,7/26/2015 14:46,1437947160,C8,177720,1438124880,7/28/2015 16:08
2119,20150010020057-694,2,7/22/2015 15:22,1437603720,C5,520860,1438124580,7/28/2015 16:03
2083,20152119072136-180,1,7/27/2015 11:28,1438021680,C8,100860,1438122540,7/28/2015 15:29
5808,20155513115543-669,1,7/26/2015 11:19,1437934740,C6,186840,1438121580,7/28/2015 15:13
835,20155706075759-768,2,7/26/2015 3:41,1437907260,C2,214080,1438121340,7/28/2015 15:09
2543,20152724022714-969,3,7/26/2015 14:44,1437947040,C4,173820,1438120860,7/28/2015 15:01
5206,20152005092047-998,2,7/25/2015 16:18,1437866280,C5,250440,1438116720,7/28/2015 13:52
1159,20151710081736-544,3,7/26/2015 13:05,1437941100,C5,174960,1438116060,7/28/2015 13:41
5809,20154217044214-559,1,7/25/2015 20:24,1437881040,C5,234840,1438115880,7/28/2015 13:38
6404,20152709072703-969,1,7/21/2015 12:21,1437506460,C6,607740,1438114200,7/28/2015 13:10
6467,20151621031648-283,2,7/27/2015 17:40,1438044000,C4,65880,1438109880,7/28/2015 11:58
4874,20155823115812-779,1,7/27/2015 5:31,1438000260,C4,107460,1438107720,7/28/2015 11:22
2517,20151526051501-87,1,7/27/2015 14:12,1438031520,C4,75420,1438106940,7/28/2015 11:09
3600,20155518095558-521,1,7/25/2015 22:25,1437888300,C4,216600,1438104900,7/28/2015 10:35
4452,20155812015855-673,3,7/26/2015 15:50,1437951000,C5,152040,1438103040,7/28/2015 10:04
3577,20152001072036-614,1,7/19/2015 8:56,1437321360,C7,780480,1438101840,7/28/2015 9:44
2,20153118013100-425,2,7/25/2015 2:55,1437818100,C7,283320,1438101420,7/28/2015 9:37
1999,20152403122407-918,2,7/20/2015 2:18,1437383880,C5,716220,1438100100,7/28/2015 9:15
2151,20150312110353-306,1,7/26/2015 14:47,1437947220,C5,152880,1438100100,7/28/2015 9:15
2158,20153523083548-153,1,7/27/2015 2:38,1437989880,C2,108060,1438097940,7/28/2015 8:39
5336,20151922121927-280,2,7/26/2015 9:43,1437928980,C5,168120,1438097100,7/28/2015 8:25
593,20153204093236-149,2,7/20/2015 8:46,1437407160,C2,689820,1438096980,7/28/2015 8:23
5119,20150922110928-182,1,7/26/2015 8:59,1437926340,C5,168900,1438095240,7/28/2015 7:54
5122,20152207082206-772,2,7/24/2015 18:57,1437789420,C8,301380,1438090800,7/28/2015 6:40
418,20155809075828-607,1,7/21/2015 22:34,1437543240,C0,544680,1438087920,7/28/2015 5:52
3712,20152201042246-439,2,7/19/2015 8:52,1437321120,C7,764100,1438085220,7/28/2015 5:07
2167,20154819044802-78,2,7/25/2015 8:58,1437839880,C8,245100,1438084980,7/28/2015 5:03
2546,20152216022232-679,1,7/26/2015 21:18,1437970680,C3,111120,1438081800,7/28/2015 4:10
239,20152625102655-249,1,7/27/2015 6:12,1438002720,C4,78780,1438081500,7/28/2015 4:05
6080,20151722051724-428,1,7/24/2015 5:17,1437740220,C5,340200,1438080420,7/28/2015 3:47
3378,20150011070002-311,3,7/22/2015 12:46,1437594360,C0,485580,1438079940,7/28/2015 3:39
726,20155705065729-214,2,7/24/2015 21:09,1437797340,C6,282120,1438079460,7/28/2015 3:31
2391,20154323064305-880,1,7/26/2015 12:27,1437938820,C0,139920,1438078740,7/28/2015 3:19
6344,20154819014838-806,2,7/27/2015 4:28,1437996480,C5,82200,1438078680,7/28/2015 3:18
1209,20155416105428-103,2,7/26/2015 4:19,1437909540,C8,168060,1438077600,7/28/2015 3:00
1180,20153909083938-573,2,7/26/2015 0:47,1437896820,C5,180060,1438076880,7/28/2015 2:48
4471,20150411110416-472,2,7/26/2015 0:50,1437897000,C2,179880,1438076880,7/28/2015 2:48
5260,20154925034902-555,1,7/24/2015 1:09,1437725340,C5,350400,1438075740,7/28/2015 2:29
3906,20150828060845-403,3,7/23/2015 2:08,1437642480,C8,429120,1438071600,7/28/2015 1:20
6549,20150019010017-785,2,7/25/2015 4:48,1437824880,C4,244440,1438069320,7/28/2015 0:42
576,20151618051609-530,1,7/24/2015 21:50,1437799800,C5,267420,1438067220,7/28/2015 0:07
897,20152515112517-831,1,7/24/2015 20:22,1437794520,C0,269940,1438064460,7/27/2015 23:21
2235,20153011083029-396,1,7/23/2015 19:27,1437704820,C5,358740,1438063560,7/27/2015 23:06
12,20154219104241-223,1,7/25/2015 20:00,1437879600,C2,183960,1438063560,7/27/2015 23:06
263,20155704025719-973,1,7/20/2015 4:15,1437390900,C5,671940,1438062840,7/27/2015 22:54
848,20150417070431-372,1,7/22/2015 14:46,1437601560,C6,459720,1438061280,7/27/2015 22:28
3214,20155121075125-805,2,7/23/2015 20:47,1437709620,C4,351420,1438061040,7/27/2015 22:24
4344,20151920101907-951,1,7/27/2015 2:19,1437988740,C2,72000,1438060740,7/27/2015 22:19
2600,20155524065529-638,3,7/19/2015 11:49,1437331740,C0,725880,1438057620,7/27/2015 21:27
2458,20150922070941-505,3,7/26/2015 11:48,1437936480,C4,120780,1438057260,7/27/2015 21:21
741,20151526051513-980,1,7/23/2015 23:38,1437719880,C4,336540,1438056420,7/27/2015 21:07
6261,20154216104239-427,3,7/26/2015 10:34,1437932040,C8,123360,1438055400,7/27/2015 20:50
6243,20152118082127-664,2,7/24/2015 16:23,1437780180,C0,273660,1438053840,7/27/2015 20:24
887,20155401025432-410,1,7/19/2015 2:18,1437297480,C7,754920,1438052400,7/27/2015 20:00
1141,20154708044728-934,1,7/23/2015 1:11,1437639060,C4,413280,1438052340,7/27/2015 19:59
3001,20154719024718-326,1,7/25/2015 2:15,1437815700,C5,236640,1438052340,7/27/2015 19:59
3950,20153418033431-409,1,7/26/2015 17:42,1437957720,C4,87360,1438045080,7/27/2015 17:58
6254,20152817062846-890,2,7/25/2015 3:01,1437818460,C0,226260,1438044720,7/27/2015 17:52
3116,20155901075938-57,2,7/24/2015 10:30,1437759000,C8,285180,1438044180,7/27/2015 17:43
1384,20151208041208-309,1,7/24/2015 12:47,1437767220,C8,274020,1438041240,7/27/2015 16:54
2666,20154025124046-991,1,7/26/2015 23:26,1437978360,C3,62580,1438040940,7/27/2015 16:49
1386,20153205073222-529,2,7/22/2015 2:17,1437556620,C4,483300,1438039920,7/27/2015 16:32
5408,20154421044426-552,1,7/25/2015 16:16,1437866160,C7,171960,1438038120,7/27/2015 16:02
2459,20150214020239-72,2,7/22/2015 21:06,1437624360,C6,413580,1438037940,7/27/2015 15:59
2504,20155717065720-517,1,7/26/2015 3:45,1437907500,C6,127680,1438035180,7/27/2015 15:13
3109,20151811041814-115,2,7/25/2015 15:01,1437861660,C4,172140,1438033800,7/27/2015 14:50
869,20154109074131-62,2,7/25/2015 7:10,1437833400,C7,197220,1438030620,7/27/2015 13:57
3649,20151521011536-810,2,7/26/2015 13:35,1437942900,C8,86640,1438029540,7/27/2015 13:39
6342,20154111074111-452,1,7/22/2015 3:31,1437561060,C5,467700,1438028760,7/27/2015 13:26
2021,20151721111744-664,1,7/25/2015 12:19,1437851940,C8,174660,1438026600,7/27/2015 12:50
4730,20152117032144-298,1,7/22/2015 14:00,1437598800,C2,427140,1438025940,7/27/2015 12:39
4237,20150420090410-374,3,7/26/2015 15:06,1437948360,C4,77160,1438025520,7/27/2015 12:32
6000,20155508105537-280,1,7/21/2015 3:41,1437475260,C8,548580,1438023840,7/27/2015 12:04
124,20152316052346-175,2,7/24/2015 18:44,1437788640,C2,232020,1438020660,7/27/2015 11:11
4098,20154823074803-769,1,7/25/2015 9:29,1437841740,C4,178860,1438020600,7/27/2015 11:10
84,20152312122312-603,1,7/16/2015 5:23,1437049380,C0,970800,1438020180,7/27/2015 11:03
3345,20153324083337-471,3,7/26/2015 10:09,1437930540,C2,89280,1438019820,7/27/2015 10:57
2775,20150508030553-514,3,7/24/2015 7:10,1437747000,C8,270780,1438017780,7/27/2015 10:23
1785,20155810095859-88,1,7/18/2015 21:56,1437281760,C4,734280,1438016040,7/27/2015 9:54
3516,20155520035557-954,1,7/20/2015 14:43,1437428580,C7,585120,1438013700,7/27/2015 9:15
3410,20152711032724-725,3,7/19/2015 12:16,1437333360,C2,679740,1438013100,7/27/2015 9:05
831,20150408090423-286,1,7/25/2015 6:24,1437830640,C2,182400,1438013040,7/27/2015 9:04
2209,20154219114228-262,2,7/26/2015 1:22,1437898920,C8,113520,1438012440,7/27/2015 8:54
162,20154324014347-139,1,7/26/2015 10:01,1437930060,C5,79740,1438009800,7/27/2015 8:10
4163,20152721082743-391,1,7/25/2015 20:12,1437880320,C4,129300,1438009620,7/27/2015 8:07
5658,20154922084949-200,3,7/26/2015 1:52,1437900720,C0,106860,1438007580,7/27/2015 7:33
6235,20153725083712-151,3,7/22/2015 17:49,1437612540,C6,394320,1438006860,7/27/2015 7:21
2652,20152813122838-287,2,7/22/2015 10:20,1437585600,C6,420240,1438005840,7/27/2015 7:04
829,20155405035411-744,3,7/23/2015 16:29,1437694140,C8,311460,1438005600,7/27/2015 7:00
6277,20151029081008-399,1,7/23/2015 18:53,1437702780,C7,301740,1438004520,7/27/2015 6:42
6492,20153817073832-550,2,7/24/2015 18:41,1437788460,C4,214860,1438003320,7/27/2015 6:22
353,20154809124808-913,3,7/25/2015 0:58,1437811080,C4,191400,1438002480,7/27/2015 6:08
5900,20150123070109-172,2,7/25/2015 6:25,1437830700,C4,170640,1438001340,7/27/2015 5:49
2830,20151211061235-957,2,7/25/2015 3:17,1437819420,C5,171300,1437990720,7/27/2015 2:52
1750,20154112014114-381,1,7/24/2015 17:20,1437783600,C6,203760,1437987360,7/27/2015 1:56
5595,20154422084401-555,2,7/25/2015 21:11,1437883860,C5,101340,1437985200,7/27/2015 1:20
4530,20150723070741-205,2,7/26/2015 2:16,1437902160,C5,80580,1437982740,7/27/2015 0:39
3324,20155610125653-388,2,7/24/2015 23:05,1437804300,C5,178020,1437982320,7/27/2015 0:32
5862,20153505103526-82,1,7/21/2015 14:44,1437515040,C4,465780,1437980820,7/27/2015 0:07
5310,20154123054103-632,1,7/23/2015 6:29,1437658140,C3,318960,1437977100,7/26/2015 23:05
1887,20153310113338-127,2,7/24/2015 21:35,1437798900,C7,177960,1437976860,7/26/2015 23:01
71,20152909122903-463,1,7/25/2015 0:21,1437808860,C4,167340,1437976200,7/26/2015 22:50
2971,20152723112739-990,3,7/25/2015 18:51,1437875460,C8,99720,1437975180,7/26/2015 22:33
3223,20154611014601-555,3,7/21/2015 18:56,1437530160,C5,441300,1437971460,7/26/2015 21:31
3139,20150615090601-623,2,7/24/2015 0:15,1437722100,C3,248580,1437970680,7/26/2015 21:18
3541,20152917092938-198,1,7/25/2015 19:53,1437879180,C5,91080,1437970260,7/26/2015 21:11
1954,20151820101815-744,2,7/26/2015 1:45,1437900300,C5,69660,1437969960,7/26/2015 21:06
2001,20155919085959-705,1,7/25/2015 22:08,1437887280,C5,80820,1437968100,7/26/2015 20:35
4568,20153619073613-656,2,7/14/2015 8:06,1436886360,C0,1080900,1437967260,7/26/2015 20:21
6394,20154003034016-1,2,7/23/2015 22:45,1437716700,C8,250500,1437967200,7/26/2015 20:20
5910,20152217032234-627,2,7/25/2015 18:34,1437874440,C5,87840,1437962280,7/26/2015 18:58
1627,20152917012956-923,1,7/24/2015 11:29,1437762540,C4,199200,1437961740,7/26/2015 18:49
2423,20154624094613-438,2,7/22/2015 17:07,1437610020,C2,349380,1437959400,7/26/2015 18:10
1965,20151504071559-733,3,7/21/2015 1:33,1437467580,C3,482760,1437950340,7/26/2015 15:39
3597,20153103113118-650,1,7/23/2015 17:54,1437699240,C4,250140,1437949380,7/26/2015 15:23
2419,20155522055527-809,1,7/25/2015 15:58,1437865080,C0,84060,1437949140,7/26/2015 15:19
2581,20155313085311-65,3,7/24/2015 8:58,1437753480,C8,190140,1437943620,7/26/2015 13:47
3886,20154324024355-579,3,7/25/2015 22:01,1437886860,C8,56340,1437943200,7/26/2015 13:40
2891,20151523091548-948,2,7/25/2015 12:07,1437851220,C4,91560,1437942780,7/26/2015 13:33
2178,20153219083225-701,1,7/24/2015 3:52,1437735120,C8,207600,1437942720,7/26/2015 13:32
2973,20152624072652-602,3,7/18/2015 11:53,1437245580,C5,696540,1437942120,7/26/2015 13:22
5391,20153723103744-695,1,7/25/2015 12:27,1437852420,C3,89700,1437942120,7/26/2015 13:22
3736,20153008033000-100,1,7/10/2015 13:56,1436561760,C5,1379580,1437941340,7/26/2015 13:09
5146,20155707095706-832,1,7/20/2015 3:47,1437389220,C8,550500,1437939720,7/26/2015 12:42
2439,20153604123646-881,3,7/23/2015 18:29,1437701340,C5,237540,1437938880,7/26/2015 12:28
5468,20155501125529-527,3,7/18/2015 4:21,1437218460,C8,718980,1437937440,7/26/2015 12:04
2073,20150722090733-194,1,7/24/2015 10:33,1437759180,C4,177960,1437937140,7/26/2015 11:59
3794,20153717113702-835,1,7/25/2015 11:37,1437849420,C5,86400,1437935820,7/26/2015 11:37
2381,20153102093104-707,2,7/20/2015 10:46,1437414360,C3,519900,1437934260,7/26/2015 11:11
1106,20154824044810-764,1,7/25/2015 20:50,1437882600,C8,50460,1437933060,7/26/2015 10:51
1060,20155920055919-29,1,7/25/2015 20:32,1437881520,C7,49020,1437930540,7/26/2015 10:09
4736,20151319041336-619,2,7/25/2015 10:49,1437846540,C6,83160,1437929700,7/26/2015 9:55
635,20155619105610-134,2,7/22/2015 22:19,1437628740,C6,300180,1437928920,7/26/2015 9:42
3731,20150722040729-834,1,7/24/2015 12:47,1437767220,C2,160800,1437928020,7/26/2015 9:27
5202,20153117063125-391,3,7/25/2015 8:39,1437838740,C4,87360,1437926100,7/26/2015 8:55
2951,20153202033251-484,2,7/23/2015 17:32,1437697920,C5,227700,1437925620,7/26/2015 8:47
4182,20155013065048-240,1,7/21/2015 23:24,1437546240,C7,375420,1437921660,7/26/2015 7:41
1660,20152729112721-705,2,7/18/2015 1:03,1437206580,C6,713760,1437920340,7/26/2015 7:19
3462,20151321061336-628,2,7/14/2015 14:33,1436909580,C5,1008600,1437918180,7/26/2015 6:43
2700,20154213044259-545,1,7/24/2015 16:57,1437782220,C8,135900,1437918120,7/26/2015 6:42
5893,20152305012336-61,3,7/19/2015 8:47,1437320820,C3,596520,1437917340,7/26/2015 6:29
5081,20154106054126-881,3,7/24/2015 2:13,1437729180,C5,187440,1437916620,7/26/2015 6:17
631,20152021052037-513,2,7/24/2015 17:54,1437785640,C5,130620,1437916260,7/26/2015 6:11
2460,20152517072551-546,1,7/25/2015 2:54,1437818040,C0,96420,1437914460,7/26/2015 5:41
5279,20153324063329-147,1,7/25/2015 6:04,1437829440,C6,84660,1437914100,7/26/2015 5:35
4820,20151920081908-214,2,7/24/2015 5:57,1437742620,C4,168540,1437911160,7/26/2015 4:46
3375,20150221060206-207,2,7/24/2015 12:58,1437767880,C2,142080,1437909960,7/26/2015 4:26
1852,20153919053954-565,1,7/24/2015 13:39,1437770340,C3,139200,1437909540,7/26/2015 4:19
1210,20151724081751-413,2,7/25/2015 6:12,1437829920,C4,78900,1437908820,7/26/2015 4:07
2921,20154409044423-907,1,7/17/2015 22:23,1437196980,C2,711540,1437908520,7/26/2015 4:02
5638,20153826063809-399,1,7/23/2015 4:14,1437650040,C7,258240,1437908280,7/26/2015 3:58
140,20154116034139-452,1,7/25/2015 1:57,1437814620,C0,91020,1437905640,7/26/2015 3:14
453,20152119092102-380,1,7/25/2015 6:31,1437831060,C7,72600,1437903660,7/26/2015 2:41
4217,20152319052357-61,3,7/22/2015 1:15,1437552900,C0,349140,1437902040,7/26/2015 2:14
6522,20155409035441-881,2,7/21/2015 23:21,1437546060,C4,354540,1437900600,7/26/2015 1:50
4309,20150226090206-282,1,7/22/2015 18:30,1437615000,C3,285060,1437900060,7/26/2015 1:41
4985,20153215113217-764,3,7/24/2015 20:52,1437796320,C2,101400,1437897720,7/26/2015 1:02
2183,20152307122306-159,3,7/16/2015 18:34,1437096840,C4,799860,1437896700,7/26/2015 0:45
796,20151722091759-375,2,7/25/2015 2:47,1437817620,C0,78600,1437896220,7/26/2015 0:37
3088,20152120032107-809,1,7/25/2015 9:13,1437840780,C2,51240,1437892020,7/25/2015 23:27
825,20152216082220-757,1,7/24/2015 18:26,1437787560,C8,103920,1437891480,7/25/2015 23:18
4902,20153810053835-229,1,7/20/2015 21:16,1437452160,C8,438540,1437890700,7/25/2015 23:05
6158,20155413095429-78,2,7/21/2015 18:12,1437527520,C2,360540,1437888060,7/25/2015 22:21
2653,20154818074851-145,1,7/23/2015 9:30,1437669000,C2,219060,1437888060,7/25/2015 22:21
4494,20152019112015-444,3,7/23/2015 18:20,1437700800,C4,185400,1437886200,7/25/2015 21:50
4932,20152408032407-297,2,7/23/2015 22:28,1437715680,C5,165180,1437880860,7/25/2015 20:21
6184,20155715045720-815,2,7/20/2015 18:25,1437441900,C0,437280,1437879180,7/25/2015 19:53
4741,20154903044916-720,1,7/20/2015 6:43,1437399780,C2,477480,1437877260,7/25/2015 19:21
2974,20152221102210-862,1,7/24/2015 8:16,1437750960,C0,125820,1437876780,7/25/2015 19:13
5068,20152819122847-981,1,7/25/2015 0:11,1437808260,C7,67740,1437876000,7/25/2015 19:00
1615,20150304120307-360,1,7/18/2015 9:33,1437237180,C6,632100,1437869280,7/25/2015 17:08
236,20155320095336-544,2,7/24/2015 9:17,1437754620,C2,114480,1437869100,7/25/2015 17:05
475,20151713011710-914,3,7/21/2015 14:59,1437515940,C5,348660,1437864600,7/25/2015 15:50
123,20150219060243-351,3,7/24/2015 1:02,1437724920,C3,138000,1437862920,7/25/2015 15:22
6242,20155417075428-77,1,7/24/2015 16:34,1437780840,C6,79500,1437860340,7/25/2015 14:39
2883,20150006070032-991,2,7/19/2015 4:02,1437303720,C5,556260,1437859980,7/25/2015 14:33
822,20154604094636-292,2,7/20/2015 7:04,1437401040,C4,457560,1437858600,7/25/2015 14:10
1888,20152516072549-566,1,7/22/2015 11:43,1437590580,C5,266940,1437857520,7/25/2015 13:52
2589,20155222035235-759,1,7/24/2015 12:48,1437767280,C8,80880,1437848160,7/25/2015 11:16
4816,20151523061521-500,1,7/24/2015 8:45,1437752700,C4,95400,1437848100,7/25/2015 11:15
4601,20153803013812-529,1,7/18/2015 3:50,1437216600,C7,630360,1437846960,7/25/2015 10:56
2690,20154615114612-209,2,7/22/2015 3:04,1437559440,C4,286740,1437846180,7/25/2015 10:43
1487,20154619054626-112,2,7/24/2015 11:31,1437762660,C8,81900,1437844560,7/25/2015 10:16
5286,20155016015015-241,1,7/24/2015 6:45,1437745500,C8,95100,1437840600,7/25/2015 9:10
371,20154309074338-532,2,7/20/2015 0:37,1437377820,C5,462420,1437840240,7/25/2015 9:04
6050,20155317105335-21,1,7/24/2015 12:32,1437766320,C7,67860,1437834180,7/25/2015 7:23
4526,20154416044414-95,2,7/22/2015 10:16,1437585360,C8,247560,1437832920,7/25/2015 7:02
4750,20152211022237-502,2,7/23/2015 13:36,1437683760,C3,147720,1437831480,7/25/2015 6:38
5635,20155319105326-404,2,7/23/2015 8:01,1437663660,C5,167640,1437831300,7/25/2015 6:35
3543,20155901125946-822,2,7/22/2015 7:02,1437573720,C4,256140,1437829860,7/25/2015 6:11
2141,20153419063421-197,2,7/23/2015 18:13,1437700380,C2,129180,1437829560,7/25/2015 6:06
3776,20151203101246-894,2,7/19/2015 19:03,1437357780,C5,471420,1437829200,7/25/2015 6:00
4926,20155722025727-208,1,7/24/2015 8:49,1437752940,C8,75360,1437828300,7/25/2015 5:45
715,20151812021854-880,2,7/21/2015 0:32,1437463920,C2,364020,1437827940,7/25/2015 5:39
4040,20155504065559-69,1,7/21/2015 17:40,1437525600,C8,301500,1437827100,7/25/2015 5:25
5064,20155415065439-614,1,7/20/2015 5:02,1437393720,C8,431040,1437824760,7/25/2015 4:46
656,20151305011309-201,2,7/20/2015 6:34,1437399240,C3,424020,1437823260,7/25/2015 4:21
2093,20150208020258-125,1,7/23/2015 2:24,1437643440,C2,179160,1437822600,7/25/2015 4:10
3225,20154610074635-808,1,7/23/2015 1:04,1437638640,C6,183180,1437821820,7/25/2015 3:57
2671,20150115050115-511,2,7/20/2015 10:24,1437413040,C0,408180,1437821220,7/25/2015 3:47
5673,20152914062912-293,2,7/23/2015 18:48,1437702480,C7,117420,1437819900,7/25/2015 3:25
5848,20155122055116-333,1,7/17/2015 0:42,1437118920,C4,699420,1437818340,7/25/2015 2:59
5983,20151722101713-627,2,7/24/2015 5:13,1437739980,C5,77280,1437817260,7/25/2015 2:41
1640,20154822114816-84,1,7/24/2015 5:42,1437741720,C7,75420,1437817140,7/25/2015 2:39
4392,20154618064654-392,1,7/22/2015 19:40,1437619200,C8,196020,1437815220,7/25/2015 2:07
5442,20151518041531-923,1,7/23/2015 11:21,1437675660,C5,138120,1437813780,7/25/2015 1:43
6323,20152517092529-612,3,7/23/2015 22:43,1437716580,C6,94380,1437810960,7/25/2015 0:56
6480,20150303120312-233,3,7/22/2015 15:23,1437603780,C6,206700,1437810480,7/25/2015 0:48
5215,20152512062542-417,1,7/23/2015 14:25,1437686700,C4,122400,1437809100,7/25/2015 0:25
4319,20152115022106-782,1,7/23/2015 19:59,1437706740,C5,101640,1437808380,7/25/2015 0:13
1110,20150513060545-668,1,7/23/2015 12:22,1437679320,C4,126660,1437805980,7/24/2015 23:33
5647,20153917023952-510,3,7/24/2015 1:21,1437726060,C5,79560,1437805620,7/24/2015 23:27
4161,20154918014930-425,1,7/23/2015 21:14,1437711240,C8,91740,1437802980,7/24/2015 22:43
5676,20153721113747-248,3,7/23/2015 18:53,1437702780,C4,99480,1437802260,7/24/2015 22:31
4459,20152401092405-316,3,7/21/2015 23:01,1437544860,C7,253860,1437798720,7/24/2015 21:32
2024,20151621011631-58,1,7/21/2015 3:00,1437472800,C5,319380,1437792180,7/24/2015 19:43
4604,20154519024544-322,2,7/22/2015 11:00,1437588000,C4,203580,1437791580,7/24/2015 19:33
3987,20154018034049-540,2,7/21/2015 17:25,1437524700,C4,265500,1437790200,7/24/2015 19:10
1974,20150514120512-102,1,7/21/2015 8:29,1437492540,C7,295920,1437788460,7/24/2015 18:41
2259,20154505124525-350,1,7/22/2015 14:45,1437601500,C5,184500,1437786000,7/24/2015 18:00
3062,20151322051315-282,1,7/24/2015 1:43,1437727380,C8,58500,1437785880,7/24/2015 17:58
318,20150722110714-462,3,7/23/2015 14:21,1437686460,C3,98040,1437784500,7/24/2015 17:35
3751,20153824083801-208,1,7/21/2015 7:58,1437490680,C4,291300,1437781980,7/24/2015 16:53
5920,20151522081519-492,2,7/23/2015 12:13,1437678780,C4,100680,1437779460,7/24/2015 16:11
2890,20151512111517-621,1,7/20/2015 14:27,1437427620,C8,351360,1437778980,7/24/2015 16:03
4882,20152918122930-367,2,7/22/2015 14:49,1437601740,C8,177000,1437778740,7/24/2015 15:59
2061,20150519040533-38,2,7/23/2015 9:56,1437670560,C2,107820,1437778380,7/24/2015 15:53
5037,20151215111234-603,2,7/21/2015 14:16,1437513360,C5,264720,1437778080,7/24/2015 15:48
2821,20151327011349-700,2,7/15/2015 14:51,1436997060,C5,780540,1437777600,7/24/2015 15:40
3186,20150109020137-850,3,7/19/2015 14:23,1437340980,C8,432660,1437773640,7/24/2015 14:34
1795,20155909085910-596,1,6/29/2015 4:37,1435577820,C4,2195340,1437773160,7/24/2015 14:26
265,20151512011521-735,1,7/21/2015 13:54,1437512040,C4,259980,1437772020,7/24/2015 14:07
1944,20150509030549-76,1,7/20/2015 20:05,1437447900,C4,322800,1437770700,7/24/2015 13:45
243,20151921051948-603,3,7/23/2015 14:35,1437687300,C0,81480,1437768780,7/24/2015 13:13
5346,20155206025244-634,3,7/18/2015 13:38,1437251880,C4,516180,1437768060,7/24/2015 13:01
446,20152414072405-565,2,7/19/2015 12:04,1437332640,C0,434400,1437767040,7/24/2015 12:44
567,20151415051449-943,1,7/18/2015 23:08,1437286080,C6,478740,1437764820,7/24/2015 12:07
2077,20153722113733-394,1,7/23/2015 11:23,1437675780,C0,85560,1437761340,7/24/2015 11:09
1428,20151505031524-959,2,7/22/2015 8:19,1437578340,C3,180480,1437758820,7/24/2015 10:27
2071,20151121121126-475,1,7/23/2015 10:37,1437673020,C5,83580,1437756600,7/24/2015 9:50
325,20154508124538-434,2,7/22/2015 9:43,1437583380,C7,171240,1437754620,7/24/2015 9:17
5132,20150517110524-251,2,7/23/2015 11:38,1437676680,C5,74340,1437751020,7/24/2015 8:17
1661,20150217080254-664,2,7/20/2015 20:06,1437447960,C4,302640,1437750600,7/24/2015 8:10
639,20153712013720-181,3,7/21/2015 22:46,1437543960,C6,205800,1437749760,7/24/2015 7:56
5511,20154519034526-395,1,7/23/2015 3:33,1437647580,C3,100560,1437748140,7/24/2015 7:29
866,20155822125820-486,1,7/16/2015 8:43,1437061380,C0,686100,1437747480,7/24/2015 7:18
3877,20153218123229-36,2,7/15/2015 8:20,1436973600,C5,772560,1437746160,7/24/2015 6:56
4186,20152120042149-770,2,7/20/2015 13:01,1437422460,C2,322500,1437744960,7/24/2015 6:36
3412,20155517115552-543,1,7/22/2015 0:01,1437548460,C5,194580,1437743040,7/24/2015 6:04
2729,20154821024843-807,2,7/23/2015 8:48,1437666480,C8,75600,1437742080,7/24/2015 5:48
1512,20151315121354-235,1,7/19/2015 20:37,1437363420,C6,375840,1437739260,7/24/2015 5:01
1648,20150305030327-986,1,7/12/2015 1:18,1436689080,C3,1049100,1437738180,7/24/2015 4:43
4520,20151816061843-103,1,7/21/2015 13:14,1437509640,C5,228480,1437738120,7/24/2015 4:42
2872,20150010080038-54,2,7/19/2015 7:04,1437314640,C2,420780,1437735420,7/24/2015 3:57
4586,20151709091702-944,1,7/15/2015 17:01,1437004860,C4,727080,1437731940,7/24/2015 2:59
2359,20152113062104-747,2,7/20/2015 11:57,1437418620,C8,312480,1437731100,7/24/2015 2:45
5344,20155605125654-111,1,7/21/2015 18:43,1437529380,C8,200460,1437729840,7/24/2015 2:24
4286,20153012103050-559,1,7/20/2015 4:34,1437392040,C7,334920,1437726960,7/24/2015 1:36
3343,20150320010324-914,2,7/22/2015 7:15,1437574500,C2,151920,1437726420,7/24/2015 1:27
5539,20151514111514-132,3,7/20/2015 20:27,1437449220,C5,275760,1437724980,7/24/2015 1:03
2915,20154018024000-428,1,7/21/2015 7:26,1437488760,C4,233160,1437721920,7/24/2015 0:12
4722,20150315040346-314,1,7/21/2015 5:13,1437480780,C8,239700,1437720480,7/23/2015 23:48
6067,20154617064600-936,1,7/21/2015 17:50,1437526200,C7,192720,1437718920,7/23/2015 23:22
1491,20150115100135-182,2,7/19/2015 16:30,1437348600,C2,368940,1437717540,7/23/2015 22:59
6411,20155417045444-36,1,7/20/2015 19:37,1437446220,C2,268980,1437715200,7/23/2015 22:20
1323,20153801073845-972,1,7/21/2015 9:22,1437495720,C2,216780,1437712500,7/23/2015 21:35
882,20154706044718-338,3,7/18/2015 3:31,1437215460,C5,494520,1437709980,7/23/2015 20:53
6034,20152112022147-274,2,7/20/2015 2:29,1437384540,C8,324240,1437708780,7/23/2015 20:33
2535,20151717121704-659,3,7/21/2015 17:17,1437524220,C0,181800,1437706020,7/23/2015 19:47
3057,20150303080344-262,1,7/21/2015 5:37,1437482220,C7,220920,1437703140,7/23/2015 18:59
900,20150008010023-545,3,7/21/2015 21:08,1437538080,C2,164640,1437702720,7/23/2015 18:52
5208,20153519103528-888,2,7/22/2015 7:55,1437576900,C0,124800,1437701700,7/23/2015 18:35
3716,20150716100718-333,1,7/22/2015 13:07,1437595620,C8,105840,1437701460,7/23/2015 18:31
6069,20150908080915-434,3,7/21/2015 4:29,1437478140,C8,222000,1437700140,7/23/2015 18:09
4396,20154511114515-568,1,7/21/2015 16:40,1437522000,C8,176340,1437698340,7/23/2015 17:39
1013,20152808032826-116,3,7/18/2015 15:38,1437259080,C5,432300,1437691380,7/23/2015 15:43
4447,20154722034718-115,2,7/15/2015 21:26,1437020760,C2,669180,1437689940,7/23/2015 15:19
3508,20151315091329-68,1,7/22/2015 17:13,1437610380,C2,79200,1437689580,7/23/2015 15:13
5312,20150105010142-777,3,7/21/2015 8:53,1437493980,C2,195360,1437689340,7/23/2015 15:09
4013,20151520101518-94,3,7/22/2015 13:27,1437596820,C8,92160,1437688980,7/23/2015 15:03
669,20155218085232-407,3,7/22/2015 7:19,1437574740,C2,113340,1437688080,7/23/2015 14:48
2880,20153719053715-589,3,7/22/2015 15:01,1437602460,C0,83280,1437685740,7/23/2015 14:09
5125,20155629125653-788,2,7/16/2015 16:45,1437090300,C4,594420,1437684720,7/23/2015 13:52
1533,20153412063404-685,2,7/22/2015 3:31,1437561060,C5,121860,1437682920,7/23/2015 13:22
2665,20155319035337-279,1,7/22/2015 13:35,1437597300,C4,83640,1437680940,7/23/2015 12:49
4712,20153717083746-738,1,7/20/2015 10:26,1437413160,C2,265740,1437678900,7/23/2015 12:15
3096,20150708030735-179,1,7/19/2015 18:31,1437355860,C2,320880,1437676740,7/23/2015 11:39
4117,20150319020304-688,1,7/22/2015 4:27,1437564420,C0,112320,1437676740,7/23/2015 11:39
1521,20155414025452-910,1,7/20/2015 12:42,1437421320,C5,255240,1437676560,7/23/2015 11:36
2369,20150820090811-228,2,7/21/2015 22:11,1437541860,C0,133380,1437675240,7/23/2015 11:14
1231,20150103100107-497,1,7/21/2015 5:45,1437482700,C6,192480,1437675180,7/23/2015 11:13
1437,20153019043019-743,2,7/22/2015 4:28,1437564480,C8,107940,1437672420,7/23/2015 10:27
5324,20152814012834-417,2,7/18/2015 13:33,1437251580,C3,419700,1437671280,7/23/2015 10:08
3568,20154021044054-397,2,7/22/2015 20:14,1437621240,C5,49620,1437670860,7/23/2015 10:01
3445,20153618113644-795,1,7/22/2015 4:12,1437563520,C2,106320,1437669840,7/23/2015 9:44
3999,20154519084549-54,1,7/18/2015 12:39,1437248340,C6,419940,1437668280,7/23/2015 9:18
4135,20155112125144-954,2,7/21/2015 23:46,1437547560,C7,116700,1437664260,7/23/2015 8:11
3234,20155108075139-964,2,7/20/2015 20:06,1437447960,C8,216180,1437664140,7/23/2015 8:09
6491,20150119010140-843,3,7/22/2015 1:41,1437554460,C4,109200,1437663660,7/23/2015 8:01
5052,20151620101652-108,1,7/22/2015 8:36,1437579360,C7,83400,1437662760,7/23/2015 7:46
5492,20151314051327-38,1,7/20/2015 10:51,1437414660,C7,247740,1437662400,7/23/2015 7:40
2396,20155221025244-122,1,7/15/2015 9:22,1436977320,C4,684600,1437661920,7/23/2015 7:32
5938,20154114054132-501,2,7/22/2015 5:35,1437568500,C4,92520,1437661020,7/23/2015 7:17
4363,20151305041331-383,1,7/15/2015 7:33,1436970780,C8,684960,1437655740,7/23/2015 5:49
147,20150027120012-20,3,7/20/2015 0:31,1437377460,C4,277980,1437655440,7/23/2015 5:44
2983,20155405055416-800,1,7/17/2015 9:38,1437151080,C5,503520,1437654600,7/23/2015 5:30
1039,20151612031639-61,1,7/21/2015 10:11,1437498660,C8,151860,1437650520,7/23/2015 4:22
4079,20151707051702-432,1,7/20/2015 13:12,1437423120,C8,221700,1437644820,7/23/2015 2:47
2751,20150105040155-8,1,7/17/2015 7:09,1437142140,C8,502440,1437644580,7/23/2015 2:43
1009,20152703072701-166,2,7/18/2015 3:24,1437215040,C5,427140,1437642180,7/23/2015 2:03
4797,20151413081417-823,1,7/21/2015 23:58,1437548280,C0,93480,1437641760,7/23/2015 1:56
2267,20154021014001-277,2,7/19/2015 3:17,1437301020,C2,340260,1437641280,7/23/2015 1:48
4535,20153125123107-117,2,7/16/2015 4:25,1437045900,C2,595080,1437640980,7/23/2015 1:43
2135,20152507052543-844,2,7/17/2015 22:57,1437199020,C8,441960,1437640980,7/23/2015 1:43
2898,20153407043429-914,1,7/21/2015 3:16,1437473760,C7,165960,1437639720,7/23/2015 1:22
1561,20150817120835-419,3,7/22/2015 3:08,1437559680,C8,79920,1437639600,7/23/2015 1:20
5527,20153404113438-674,2,7/16/2015 20:24,1437103440,C2,534300,1437637740,7/23/2015 0:49
4380,20155004015003-341,3,7/20/2015 17:24,1437438240,C7,199320,1437637560,7/23/2015 0:46
1610,20150920090915-26,2,7/22/2015 3:31,1437561060,C8,76260,1437637320,7/23/2015 0:42
2814,20151820101849-472,2,7/21/2015 17:19,1437524340,C4,111660,1437636000,7/23/2015 0:20
5700,20153716053741-328,1,7/20/2015 21:27,1437452820,C8,179700,1437632520,7/22/2015 23:22
1221,20155415105401-84,2,7/22/2015 3:18,1437560280,C6,72180,1437632460,7/22/2015 23:21
2461,20150518090500-717,3,7/20/2015 16:00,1437433200,C4,197700,1437630900,7/22/2015 22:55
613,20155420065446-200,3,7/18/2015 20:26,1437276360,C5,352560,1437628920,7/22/2015 22:22
1502,20150605120608-125,3,7/20/2015 0:21,1437376860,C8,250740,1437627600,7/22/2015 22:00
3564,20153516073525-833,2,7/21/2015 23:17,1437545820,C6,81420,1437627240,7/22/2015 21:54
4031,20153917063943-246,1,7/16/2015 23:09,1437113340,C8,513000,1437626340,7/22/2015 21:39
5692,20153507043529-286,1,7/15/2015 7:01,1436968860,C3,656760,1437625620,7/22/2015 21:27
5886,20154206094218-555,1,7/14/2015 15:28,1436912880,C2,711960,1437624840,7/22/2015 21:14
3616,20154210014220-695,3,7/19/2015 18:24,1437355440,C5,264840,1437620280,7/22/2015 19:58
2188,20152826032848-662,1,7/19/2015 1:58,1437296280,C6,323100,1437619380,7/22/2015 19:43
4680,20153518113501-500,1,7/21/2015 17:26,1437524760,C3,93420,1437618180,7/22/2015 19:23
4007,20153916033930-668,3,7/20/2015 18:01,1437440460,C4,177060,1437617520,7/22/2015 19:12
2844,20150517010500-796,2,7/21/2015 0:55,1437465300,C0,150900,1437616200,7/22/2015 18:50
5884,20152909082925-700,1,7/18/2015 6:59,1437227940,C5,386100,1437614040,7/22/2015 18:14
542,20153313043332-986,1,7/12/2015 23:48,1436770080,C0,843900,1437613980,7/22/2015 18:13
692,20154112094107-810,3,7/17/2015 13:39,1437165540,C6,446280,1437611820,7/22/2015 17:37
3845,20150319090314-498,2,7/21/2015 14:21,1437513660,C3,95940,1437609600,7/22/2015 17:00
3058,20152413042403-986,3,7/21/2015 13:24,1437510240,C8,97200,1437607440,7/22/2015 16:24
2324,20151420041437-875,1,7/21/2015 16:18,1437520680,C2,86640,1437607320,7/22/2015 16:22
4916,20155002015002-492,1,7/17/2015 15:38,1437172680,C5,434160,1437606840,7/22/2015 16:14
6496,20153318113337-404,3,7/21/2015 6:09,1437484140,C7,119880,1437604020,7/22/2015 15:27
6017,20153719063729-533,1,7/21/2015 12:21,1437506460,C5,96720,1437603180,7/22/2015 15:13
3018,20152614112602-965,3,7/21/2015 13:53,1437511980,C5,87660,1437599640,7/22/2015 14:14
4327,20153314043314-37,1,7/17/2015 20:27,1437190020,C2,409320,1437599340,7/22/2015 14:09
2603,20151001041004-853,3,7/15/2015 14:40,1436996400,C8,602100,1437598500,7/22/2015 13:55
4295,20154710114715-117,1,7/18/2015 12:39,1437248340,C5,347160,1437595500,7/22/2015 13:05
5479,20155817085808-370,1,7/21/2015 5:22,1437481320,C5,110880,1437592200,7/22/2015 12:10
962,20153428103417-553,2,7/16/2015 11:40,1437072000,C2,519720,1437591720,7/22/2015 12:02
6446,20155304065358-506,3,7/16/2015 10:09,1437066540,C7,524280,1437590820,7/22/2015 11:47
664,20155915055956-404,3,7/20/2015 19:17,1437445020,C0,145560,1437590580,7/22/2015 11:43
2677,20150524110507-879,2,7/15/2015 11:14,1436984040,C3,604980,1437589020,7/22/2015 11:17
3519,20152114062143-72,1,7/18/2015 8:44,1437234240,C6,354180,1437588420,7/22/2015 11:07
4632,20154923014909-680,3,7/15/2015 5:34,1436963640,C5,623700,1437587340,7/22/2015 10:49
3934,20153718113750-118,2,7/21/2015 10:55,1437501300,C4,85560,1437586860,7/22/2015 10:41
5543,20150405100402-510,1,7/13/2015 22:06,1436850360,C0,734520,1437584880,7/22/2015 10:08
4160,20154405074442-509,2,7/20/2015 12:16,1437419760,C4,164040,1437583800,7/22/2015 9:50
2142,20155415015401-576,1,7/20/2015 16:06,1437433560,C4,146640,1437580200,7/22/2015 8:50
5974,20150616070612-761,2,7/20/2015 8:10,1437405000,C5,174720,1437579720,7/22/2015 8:42
4685,20151618021648-198,2,7/21/2015 2:28,1437470880,C8,108360,1437579240,7/22/2015 8:34
158,20151817011850-621,1,7/19/2015 22:49,1437371340,C4,207060,1437578400,7/22/2015 8:20
5971,20150005110029-714,3,7/19/2015 12:40,1437334800,C8,243120,1437577920,7/22/2015 8:12
2513,20152012012031-178,2,7/21/2015 2:47,1437472020,C4,105660,1437577680,7/22/2015 8:08
4141,20154219094203-849,2,7/21/2015 8:38,1437493080,C8,84480,1437577560,7/22/2015 8:06
5872,20155118115127-143,1,7/21/2015 9:00,1437494400,C3,82980,1437577380,7/22/2015 8:03
4836,20151418111432-774,3,7/21/2015 0:46,1437464760,C7,110760,1437575520,7/22/2015 7:32
3642,20153312063341-591,3,7/21/2015 4:41,1437478860,C4,96360,1437575220,7/22/2015 7:27
4464,20154117054141-402,1,7/20/2015 18:25,1437441900,C5,130920,1437572820,7/22/2015 6:47
3083,20154718034701-35,1,7/18/2015 1:23,1437207780,C7,362880,1437570660,7/22/2015 6:11
3289,20152518042537-745,2,7/21/2015 1:33,1437467580,C0,102840,1437570420,7/22/2015 6:07
5055,20153616023658-518,2,7/20/2015 8:48,1437407280,C2,162360,1437569640,7/22/2015 5:54
4709,20151202011253-62,3,7/20/2015 0:48,1437378480,C4,188820,1437567300,7/22/2015 5:15
1926,20155517085542-741,3,7/19/2015 18:50,1437357000,C0,208500,1437565500,7/22/2015 4:45
4497,20155625025639-594,1,7/19/2015 5:44,1437309840,C3,255060,1437564900,7/22/2015 4:35
13,20151510121543-670,3,7/19/2015 6:21,1437312060,C2,252120,1437564180,7/22/2015 4:23
120,20155603075643-430,1,7/19/2015 19:47,1437360420,C2,203580,1437564000,7/22/2015 4:20
5432,20154411064440-435,1,7/20/2015 23:16,1437459360,C2,104640,1437564000,7/22/2015 4:20
5412,20155315015313-84,1,7/21/2015 1:53,1437468780,C8,95040,1437563820,7/22/2015 4:17
6081,20151919061928-62,3,7/21/2015 4:57,1437479820,C3,83940,1437563760,7/22/2015 4:16
4180,20153512063509-117,1,7/20/2015 22:29,1437456540,C2,106920,1437563460,7/22/2015 4:11
4719,20151906061932-564,3,7/20/2015 4:20,1437391200,C7,171780,1437562980,7/22/2015 4:03
6181,20155709095715-337,3,7/18/2015 23:30,1437287400,C4,275460,1437562860,7/22/2015 4:01
4461,20153612073632-445,1,7/18/2015 20:56,1437278160,C8,283200,1437561360,7/22/2015 3:36
1563,20154108114121-535,1,7/15/2015 21:05,1437019500,C6,538440,1437557940,7/22/2015 2:39
3467,20152117022136-22,1,7/20/2015 23:21,1437459660,C4,97200,1437556860,7/22/2015 2:21
6352,20153712063756-502,2,7/20/2015 23:25,1437459900,C3,93960,1437553860,7/22/2015 1:31
1568,20153012083039-675,1,7/20/2015 16:06,1437433560,C6,119760,1437553320,7/22/2015 1:22
5222,20154715074737-500,2,7/18/2015 16:29,1437262140,C6,290520,1437552660,7/22/2015 1:11
6475,20155219035228-248,1,7/21/2015 5:52,1437483120,C8,68400,1437551520,7/22/2015 0:52
3377,20151020031037-765,2,7/21/2015 7:26,1437488760,C3,58560,1437547320,7/21/2015 23:42
3956,20152211042210-394,2,7/20/2015 6:27,1437398820,C8,148380,1437547200,7/21/2015 23:40
5000,20153905083900-16,3,7/17/2015 19:51,1437187860,C4,359040,1437546900,7/21/2015 23:35
1165,20151911051900-484,1,7/19/2015 9:58,1437325080,C2,221580,1437546660,7/21/2015 23:31
4705,20154703104742-613,1,7/19/2015 15:17,1437344220,C3,199800,1437544020,7/21/2015 22:47
1804,20155423105427-757,1,7/14/2015 19:18,1436926680,C3,614880,1437541560,7/21/2015 22:06
1102,20150207050259-178,1,7/20/2015 3:07,1437386820,C4,153300,1437540120,7/21/2015 21:42
861,20153623073655-303,2,7/18/2015 16:24,1437261840,C5,273960,1437535800,7/21/2015 20:30
2279,20154107114151-839,2,7/20/2015 1:23,1437380580,C8,155160,1437535740,7/21/2015 20:29
1933,20154516034505-603,1,7/20/2015 23:35,1437460500,C8,74760,1437535260,7/21/2015 20:21
3216,20152020062041-92,3,7/17/2015 21:21,1437193260,C2,340980,1437534240,7/21/2015 20:04
562,20153910123921-997,1,7/20/2015 13:03,1437422580,C4,108180,1437530760,7/21/2015 19:06
4851,20153311113332-277,2,7/20/2015 14:53,1437429180,C2,98700,1437527880,7/21/2015 18:18
1356,20153015053016-75,1,7/20/2015 6:00,1437397200,C4,130200,1437527400,7/21/2015 18:10
923,20154229014226-973,1,7/18/2015 1:17,1437207420,C8,319380,1437526800,7/21/2015 18:00
3893,20152309092303-862,2,7/19/2015 16:28,1437348480,C8,177900,1437526380,7/21/2015 17:53
577,20154303074351-681,1,7/16/2015 8:31,1437060660,C3,464760,1437525420,7/21/2015 17:37
6488,20153906123907-891,1,7/19/2015 13:27,1437337620,C6,187680,1437525300,7/21/2015 17:35
4256,20154201084214-252,1,7/16/2015 15:21,1437085260,C5,439980,1437525240,7/21/2015 17:34
609,20151614071608-934,1,7/20/2015 19:15,1437444900,C7,80220,1437525120,7/21/2015 17:32
2260,20150427020450-544,2,7/13/2015 15:46,1436827560,C2,694260,1437521820,7/21/2015 16:37
1925,20154205064237-776,2,7/16/2015 5:10,1437048600,C8,472440,1437521040,7/21/2015 16:24
1650,20150903090936-932,1,7/19/2015 14:53,1437342780,C0,175380,1437518160,7/21/2015 15:36
2736,20152411032440-684,1,7/16/2015 15:20,1437085200,C3,431760,1437516960,7/21/2015 15:16
1717,20155318095346-528,1,7/10/2015 12:27,1436556420,C4,955020,1437511440,7/21/2015 13:44
3256,20150305030356-98,2,7/18/2015 21:18,1437279480,C8,229140,1437508620,7/21/2015 12:57
2269,20152517032501-916,1,7/20/2015 5:23,1437394980,C5,111540,1437506520,7/21/2015 12:22
6514,20151212121250-641,1,7/20/2015 11:24,1437416640,C5,86040,1437502680,7/21/2015 11:18
1988,20153015053056-910,2,7/20/2015 18:01,1437440460,C2,61980,1437502440,7/21/2015 11:14
1474,20154919034934-127,2,7/20/2015 20:41,1437450060,C8,51960,1437502020,7/21/2015 11:07
4728,20154204034234-400,3,7/19/2015 13:42,1437338520,C4,161100,1437499620,7/21/2015 10:27
3613,20151212021252-485,3,7/20/2015 10:20,1437412800,C6,84660,1437497460,7/21/2015 9:51
1562,20152909082901-932,1,7/19/2015 9:29,1437323340,C8,173520,1437496860,7/21/2015 9:41
227,20154212114201-175,2,7/20/2015 9:50,1437411000,C5,85560,1437496560,7/21/2015 9:36
5273,20151502111546-232,1,7/19/2015 6:59,1437314340,C4,181680,1437496020,7/21/2015 9:27
2029,20150827020823-652,2,7/18/2015 17:04,1437264240,C0,228120,1437492360,7/21/2015 8:26
479,20155909075954-808,1,7/18/2015 8:02,1437231720,C4,259260,1437490980,7/21/2015 8:03
1099,20154417114443-51,1,7/20/2015 1:10,1437379800,C8,110580,1437490380,7/21/2015 7:53
5727,20155824105804-483,2,7/16/2015 20:08,1437102480,C8,386760,1437489240,7/21/2015 7:34
3802,20151114021156-85,1,7/16/2015 1:11,1437034260,C6,453000,1437487260,7/21/2015 7:01
3292,20153407083404-718,2,7/19/2015 21:01,1437364860,C7,120180,1437485040,7/21/2015 6:24
411,20155303055334-250,2,7/19/2015 7:21,1437315660,C0,168060,1437483720,7/21/2015 6:02
934,20155916065950-407,1,7/19/2015 14:21,1437340860,C8,142860,1437483720,7/21/2015 6:02
772,20151106061100-410,1,7/16/2015 5:23,1437049380,C0,431640,1437481020,7/21/2015 5:17
1995,20154911054914-248,1,7/16/2015 11:31,1437071460,C2,409320,1437480780,7/21/2015 5:13
4588,20153401073437-826,3,7/18/2015 16:04,1437260640,C5,214200,1437474840,7/21/2015 3:34
1036,20154809104801-644,3,7/19/2015 20:16,1437362160,C5,112260,1437474420,7/21/2015 3:27
387,20151412051446-871,1,7/20/2015 1:59,1437382740,C2,90900,1437473640,7/21/2015 3:14
6205,20151610051648-803,2,7/18/2015 11:28,1437244080,C4,223440,1437467520,7/21/2015 1:32
6046,20150415090454-392,1,7/19/2015 14:58,1437343080,C4,122280,1437465360,7/21/2015 0:56
5717,20150823040809-813,2,7/11/2015 21:50,1436676600,C8,787860,1437464460,7/21/2015 0:41
6454,20150214070205-409,2,7/17/2015 15:48,1437173280,C4,290760,1437464040,7/21/2015 0:34
469,20153310033332-410,2,7/19/2015 20:29,1437362940,C4,99420,1437462360,7/21/2015 0:06
4847,20154711064739-979,1,7/18/2015 13:38,1437251880,C0,209820,1437461700,7/20/2015 23:55
6047,20150024090008-901,1,7/16/2015 13:20,1437078000,C8,383280,1437461280,7/20/2015 23:48
2245,20152109052153-334,1,7/19/2015 2:31,1437298260,C8,162120,1437460380,7/20/2015 23:33
3208,20153708073726-600,2,7/16/2015 17:43,1437093780,C7,363780,1437457560,7/20/2015 22:46
4199,20150213020216-787,3,7/17/2015 6:18,1437139080,C2,317760,1437456840,7/20/2015 22:34
3610,20150901060931-375,3,7/18/2015 17:53,1437267180,C4,188880,1437456060,7/20/2015 22:21
1407,20155014125011-81,1,7/18/2015 19:04,1437271440,C4,184020,1437455460,7/20/2015 22:11
2864,20152408102406-549,2,7/17/2015 18:45,1437183900,C5,269220,1437453120,7/20/2015 21:32
4190,20154520074540-882,3,7/10/2015 16:51,1436572260,C8,880380,1437452640,7/20/2015 21:24
329,20152509102521-374,1,7/19/2015 14:49,1437342540,C2,109980,1437452520,7/20/2015 21:22
4687,20150629060651-645,3,7/15/2015 10:48,1436982480,C5,466440,1437448920,7/20/2015 20:22
3990,20154813094806-514,2,7/19/2015 21:47,1437367620,C4,80220,1437447840,7/20/2015 20:04
6350,20154712084755-402,1,7/18/2015 16:50,1437263400,C2,182460,1437445860,7/20/2015 19:31
2542,20151506091506-255,2,7/14/2015 10:57,1436896620,C1,548220,1437444840,7/20/2015 19:14
1730,20152818092849-712,1,7/19/2015 14:06,1437339960,C2,103080,1437443040,7/20/2015 18:44
4499,20155516115547-576,2,7/19/2015 8:15,1437318900,C8,123000,1437441900,7/20/2015 18:25
2332,20153701113704-354,1,7/14/2015 8:03,1436886180,C4,555180,1437441360,7/20/2015 18:16
645,20154312014352-916,1,7/19/2015 17:06,1437350760,C8,88140,1437438900,7/20/2015 17:35
6539,20153914123913-490,3,7/18/2015 15:45,1437259500,C7,178380,1437437880,7/20/2015 17:18
346,20150716030750-947,1,7/16/2015 10:52,1437069120,C7,368100,1437437220,7/20/2015 17:07
2577,20153816113806-724,1,7/19/2015 7:08,1437314880,C5,121500,1437436380,7/20/2015 16:53
5196,20153316063306-527,3,7/19/2015 5:15,1437308100,C7,127260,1437435360,7/20/2015 16:36
5010,20153018013026-319,2,7/19/2015 14:34,1437341640,C2,90240,1437431880,7/20/2015 15:38
2020,20155112105111-296,3,7/18/2015 14:15,1437254100,C0,176880,1437430980,7/20/2015 15:23
5954,20152008092020-195,3,7/16/2015 12:32,1437075120,C2,351360,1437426480,7/20/2015 14:08
5172,20152605062636-836,1,7/15/2015 10:58,1436983080,C8,440160,1437423240,7/20/2015 13:14
377,20154913124955-986,3,7/19/2015 16:10,1437347400,C4,75780,1437423180,7/20/2015 13:13
556,20154111024150-826,1,7/19/2015 10:17,1437326220,C7,96480,1437422700,7/20/2015 13:05
1946,20153914023918-636,1,7/17/2015 13:47,1437166020,C0,256080,1437422100,7/20/2015 12:55
2739,20150818050836-609,2,7/19/2015 22:04,1437368640,C5,52080,1437420720,7/20/2015 12:32
3631,20150903100903-596,2,7/18/2015 8:40,1437234000,C4,184380,1437418380,7/20/2015 11:53
2859,20154410024451-978,3,7/19/2015 6:03,1437310980,C5,106620,1437417600,7/20/2015 11:40
4826,20153903123902-205,1,7/18/2015 8:43,1437234180,C5,183120,1437417300,7/20/2015 11:35
2757,20155121035116-274,1,7/16/2015 21:00,1437105600,C4,311220,1437416820,7/20/2015 11:27
3267,20153414073455-915,3,7/17/2015 9:30,1437150600,C4,266160,1437416760,7/20/2015 11:26
4865,20151006071021-877,2,7/18/2015 21:34,1437280440,C3,136080,1437416520,7/20/2015 11:22
297,20154306054321-56,1,7/18/2015 21:51,1437281460,C2,131460,1437412920,7/20/2015 10:22
1719,20150811050843-334,2,7/19/2015 11:00,1437328800,C2,83640,1437412440,7/20/2015 10:14
1977,20151210031224-723,2,7/17/2015 3:46,1437129960,C5,281820,1437411780,7/20/2015 10:03
1684,20150517090518-811,3,7/19/2015 9:25,1437323100,C7,87000,1437410100,7/20/2015 9:35
4945,20154401034422-998,2,7/15/2015 16:53,1437004380,C5,404580,1437408960,7/20/2015 9:16
3773,20152004062054-876,1,7/12/2015 7:39,1436711940,C4,695940,1437407880,7/20/2015 8:58
6246,20155324015326-739,2,7/17/2015 3:27,1437128820,C8,278520,1437407340,7/20/2015 8:49
4811,20155922015952-462,1,7/15/2015 17:39,1437007140,C8,400080,1437407220,7/20/2015 8:47
3593,20155617035626-878,3,7/16/2015 16:44,1437090240,C4,313560,1437403800,7/20/2015 7:50
4541,20154004024021-315,2,7/18/2015 13:44,1437252240,C5,150780,1437403020,7/20/2015 7:37
2556,20155617085640-226,2,7/19/2015 7:12,1437315120,C8,83280,1437398400,7/20/2015 6:20
1894,20154111114145-439,2,7/19/2015 3:54,1437303240,C7,94740,1437397980,7/20/2015 6:13
332,20151504021557-531,2,7/18/2015 7:08,1437228480,C0,169140,1437397620,7/20/2015 6:07
4841,20154423124442-224,2,7/13/2015 0:33,1436772780,C7,623220,1437396000,7/20/2015 5:40
4239,20154417114443-748,1,7/19/2015 7:36,1437316560,C8,78960,1437395520,7/20/2015 5:32
5079,20150508050523-569,1,7/16/2015 9:11,1437063060,C7,331380,1437394440,7/20/2015 5:14
5482,20150024010014-301,2,7/17/2015 0:00,1437116400,C4,277200,1437393600,7/20/2015 5:00
1843,20154612124636-207,2,7/18/2015 6:55,1437227700,C5,165780,1437393480,7/20/2015 4:58
3908,20150816060849-742,3,7/19/2015 4:53,1437306780,C5,84900,1437391680,7/20/2015 4:28
6351,20150704050743-697,1,7/15/2015 0:35,1436945700,C7,445440,1437391140,7/20/2015 4:19
1329,20150112060145-428,1,7/19/2015 4:09,1437304140,C7,85440,1437389580,7/20/2015 3:53
4674,20151306121351-539,1,7/13/2015 7:41,1436798460,C4,588480,1437386940,7/20/2015 3:09
3240,20152018102004-940,1,7/19/2015 6:36,1437312960,C0,72960,1437385920,7/20/2015 2:52
2477,20153229033240-417,1,7/17/2015 20:04,1437188640,C5,196440,1437385080,7/20/2015 2:38
6393,20152008092051-845,2,7/16/2015 4:50,1437047400,C5,337500,1437384900,7/20/2015 2:35
4493,20151517081557-258,2,7/19/2015 4:19,1437304740,C2,79320,1437384060,7/20/2015 2:21
5228,20153213013210-111,1,7/17/2015 20:34,1437190440,C4,185460,1437375900,7/20/2015 0:05
3416,20153502063540-65,1,7/15/2015 13:32,1436992320,C4,382740,1437375060,7/19/2015 23:51
1749,20154112014114-381,1,7/17/2015 15:02,1437170520,C6,202380,1437372900,7/19/2015 23:15
4073,20151510081555-297,2,7/18/2015 18:19,1437268740,C3,103920,1437372660,7/19/2015 23:11
4410,20155809045856-713,2,7/18/2015 19:38,1437273480,C3,98400,1437371880,7/19/2015 22:58
5915,20150811030814-454,2,7/17/2015 4:08,1437131280,C5,239400,1437370680,7/19/2015 22:38
6176,20150810010834-148,2,7/16/2015 19:04,1437098640,C5,269880,1437368520,7/19/2015 22:02
4664,20154416054424-28,1,7/18/2015 7:52,1437231120,C4,137280,1437368400,7/19/2015 22:00
5993,20153001073008-682,3,7/13/2015 16:54,1436831640,C7,535320,1437366960,7/19/2015 21:36
3994,20152729042736-714,2,7/14/2015 19:54,1436928840,C0,436140,1437364980,7/19/2015 21:03
660,20150810060851-257,1,7/18/2015 18:48,1437270480,C4,92100,1437362580,7/19/2015 20:23
6007,20155617115643-257,1,7/19/2015 1:06,1437293160,C5,66900,1437360060,7/19/2015 19:41
2331,20151409111433-68,2,7/16/2015 8:50,1437061800,C3,298080,1437359880,7/19/2015 19:38
3754,20150301040355-981,1,7/13/2015 17:59,1436835540,C5,521880,1437357420,7/19/2015 18:57
520,20154007094039-158,1,7/14/2015 10:19,1436894340,C4,457020,1437351360,7/19/2015 17:16
2319,20151210101225-79,2,7/18/2015 16:28,1437262080,C4,89220,1437351300,7/19/2015 17:15
6097,20150106080113-871,1,7/18/2015 4:49,1437220140,C2,128160,1437348300,7/19/2015 16:25
2273,20155205015233-851,3,7/12/2015 15:07,1436738820,C2,609300,1437348120,7/19/2015 16:22
1353,20151911031933-491,1,7/17/2015 0:01,1437116460,C3,231660,1437348120,7/19/2015 16:22
1907,20151009041023-63,1,7/18/2015 12:50,1437249000,C2,95700,1437344700,7/19/2015 15:25
2927,20152907052915-532,2,7/18/2015 3:09,1437214140,C0,128400,1437342540,7/19/2015 14:49
5804,20152811092825-833,1,7/15/2015 12:05,1436987100,C2,355020,1437342120,7/19/2015 14:42
6313,20154404024426-337,2,7/17/2015 22:36,1437197760,C4,143940,1437341700,7/19/2015 14:35
290,20152612122652-844,1,7/18/2015 17:04,1437264240,C5,76440,1437340680,7/19/2015 14:18
5682,20153817023845-593,1,7/18/2015 22:14,1437282840,C5,56880,1437339720,7/19/2015 14:02
1160,20154507034519-6,2,7/17/2015 14:15,1437167700,C8,171720,1437339420,7/19/2015 13:57
740,20153814073818-418,1,7/16/2015 22:30,1437111000,C4,226320,1437337320,7/19/2015 13:22
6129,20150603060632-383,2,7/14/2015 2:40,1436866800,C5,469020,1437335820,7/19/2015 12:57
1838,20151617051603-789,1,7/16/2015 8:34,1437060840,C7,274920,1437335760,7/19/2015 12:56
2894,20155715075716-596,2,7/18/2015 11:30,1437244200,C2,90660,1437334860,7/19/2015 12:41
369,20155604125644-698,2,7/14/2015 12:44,1436903040,C5,431640,1437334680,7/19/2015 12:38
6054,20155710075750-214,1,7/18/2015 8:48,1437234480,C8,99180,1437333660,7/19/2015 12:21
306,20150207110213-868,3,7/18/2015 7:08,1437228480,C7,104040,1437332520,7/19/2015 12:02
2514,20152312092334-13,3,7/15/2015 22:28,1437024480,C6,306300,1437330780,7/19/2015 11:33
143,20155817085846-463,1,7/11/2015 10:22,1436635320,C5,692880,1437328200,7/19/2015 10:50
1690,20152215022221-833,1,7/8/2015 3:18,1436350680,C7,973680,1437324360,7/19/2015 9:46
9,20151710051755-835,3,7/18/2015 7:17,1437229020,C5,93600,1437322620,7/19/2015 9:17
1943,20153914043938-754,2,7/18/2015 18:46,1437270360,C8,50460,1437320820,7/19/2015 8:47
5778,20155721085718-188,2,7/10/2015 0:41,1436514060,C8,805920,1437319980,7/19/2015 8:33
4694,20152616032618-514,2,7/18/2015 10:24,1437240240,C4,77340,1437317580,7/19/2015 7:53
4682,20150810080815-587,2,7/18/2015 7:44,1437230640,C5,86220,1437316860,7/19/2015 7:41
680,20154310054327-591,1,7/16/2015 10:47,1437068820,C8,246720,1437315540,7/19/2015 7:19
5377,20155705085712-420,1,7/16/2015 23:02,1437112920,C8,200220,1437313140,7/19/2015 6:39
599,20155003015007-18,1,7/14/2015 1:00,1436860800,C8,452100,1437312900,7/19/2015 6:35
5476,20151109071101-943,1,7/15/2015 22:39,1437025140,C5,287040,1437312180,7/19/2015 6:23
5601,20155209015212-409,3,7/14/2015 9:56,1436892960,C2,417840,1437310800,7/19/2015 6:00
610,20152411082436-105,3,7/15/2015 7:06,1436969160,C0,340920,1437310080,7/19/2015 5:48
368,20152712012712-669,2,7/18/2015 11:59,1437245940,C5,64140,1437310080,7/19/2015 5:48
863,20153415093431-204,2,7/17/2015 22:06,1437195960,C0,108960,1437304920,7/19/2015 4:22
4109,20152303042327-304,1,7/17/2015 4:50,1437133800,C8,166860,1437300660,7/19/2015 3:11
4952,20152614052641-115,1,7/18/2015 0:44,1437205440,C2,95160,1437300600,7/19/2015 3:10
1886,20151209031242-452,1,7/14/2015 9:09,1436890140,C6,410220,1437300360,7/19/2015 3:06
1150,20154030104055-168,3,7/12/2015 21:34,1436762040,C2,538020,1437300060,7/19/2015 3:01
529,20154710124711-907,3,7/14/2015 7:09,1436882940,C3,416760,1437299700,7/19/2015 2:55
4055,20150830110807-384,1,7/16/2015 18:54,1437098040,C8,201480,1437299520,7/19/2015 2:52
590,20153617013645-103,3,7/18/2015 7:54,1437231240,C2,65880,1437297120,7/19/2015 2:12
4108,20153410073455-798,1,7/16/2015 21:07,1437106020,C5,189060,1437295080,7/19/2015 1:38
312,20154821034852-404,1,7/9/2015 22:12,1436505120,C0,789120,1437294240,7/19/2015 1:24
903,20151405111428-942,2,7/17/2015 2:20,1437124800,C6,167460,1437292260,7/19/2015 0:51
2403,20155009075029-871,2,7/15/2015 18:48,1437011280,C7,278940,1437290220,7/19/2015 0:17
229,20154113074143-823,1,7/17/2015 13:32,1437165120,C3,122220,1437287340,7/18/2015 23:29
2244,20153317013317-798,2,7/15/2015 0:36,1436945760,C4,338940,1437284700,7/18/2015 22:45
4917,20153010023059-654,1,7/16/2015 3:54,1437044040,C8,240120,1437284160,7/18/2015 22:36
908,20153502053554-349,2,7/16/2015 5:30,1437049800,C8,233220,1437283020,7/18/2015 22:17
1508,20150605080621-713,3,7/16/2015 15:51,1437087060,C8,195660,1437282720,7/18/2015 22:12
1072,20155228015245-135,2,7/13/2015 19:55,1436842500,C3,439260,1437281760,7/18/2015 21:56
2635,20152516122531-638,1,7/18/2015 2:05,1437210300,C5,67800,1437278100,7/18/2015 20:55
1611,20152730022758-606,1,7/16/2015 13:49,1437079740,C2,197160,1437276900,7/18/2015 20:35
1079,20152030062014-252,2,7/12/2015 14:58,1436738280,C4,533940,1437272220,7/18/2015 19:17
5656,20154405094402-820,1,7/14/2015 7:36,1436884560,C2,384960,1437269520,7/18/2015 18:32
4159,20153209073227-817,1,7/17/2015 13:59,1437166740,C4,102060,1437268800,7/18/2015 18:20
2628,20154408014459-479,2,7/17/2015 1:19,1437121140,C8,146580,1437267720,7/18/2015 18:02
6216,20152226122251-984,3,7/15/2015 23:09,1437026940,C5,240060,1437267000,7/18/2015 17:50
5112,20150413050412-329,2,7/18/2015 4:00,1437217200,C3,48120,1437265320,7/18/2015 17:22
5440,20153016063038-967,2,7/14/2015 2:00,1436864400,C6,400500,1437264900,7/18/2015 17:15
5840,20151206051246-156,1,7/17/2015 5:05,1437134700,C3,129540,1437264240,7/18/2015 17:04
1991,20151004061009-733,2,7/11/2015 11:02,1436637720,C0,622320,1437260040,7/18/2015 15:54
2752,20151601031635-401,3,7/16/2015 11:27,1437071220,C7,183180,1437254400,7/18/2015 14:20
3708,20152716022735-871,1,7/17/2015 22:15,1437196500,C8,57240,1437253740,7/18/2015 14:09
3140,20155908035956-424,2,7/17/2015 11:03,1437156180,C2,94980,1437251160,7/18/2015 13:26
3440,20150905070939-279,1,7/15/2015 5:39,1436963940,C3,286200,1437250140,7/18/2015 13:09
5859,20152212112239-676,2,7/17/2015 18:53,1437184380,C4,65580,1437249960,7/18/2015 13:06
4625,20152612032640-395,1,7/17/2015 21:10,1437192600,C2,56580,1437249180,7/18/2015 12:53
4796,20150502120548-840,2,7/13/2015 4:31,1436787060,C4,461580,1437248640,7/18/2015 12:44
1019,20152322112332-133,1,7/15/2015 6:26,1436966760,C3,281340,1437248100,7/18/2015 12:35
1240,20150108100110-534,2,7/15/2015 3:31,1436956260,C8,290700,1437246960,7/18/2015 12:16
2317,20155012085048-766,2,7/16/2015 11:02,1437069720,C5,176760,1437246480,7/18/2015 12:08
348,20153013023021-720,1,7/16/2015 20:36,1437104160,C4,140580,1437244740,7/18/2015 11:39
6546,20154829104840-718,1,7/12/2015 3:20,1436696400,C8,548160,1437244560,7/18/2015 11:36
666,20155514095514-716,1,7/17/2015 2:49,1437126540,C5,116820,1437243360,7/18/2015 11:16
1935,20155915035951-998,2,7/10/2015 6:20,1436534400,C5,708420,1437242820,7/18/2015 11:07
3461,20150827070855-530,3,7/14/2015 22:23,1436937780,C8,304740,1437242520,7/18/2015 11:02
6200,20150320020348-641,2,7/9/2015 3:53,1436439180,C5,802500,1437241680,7/18/2015 10:48
4870,20154209054227-699,1,7/15/2015 12:44,1436989440,C5,250260,1437239700,7/18/2015 10:15
5625,20154010034018-964,3,7/14/2015 12:43,1436902980,C2,334980,1437237960,7/18/2015 9:46
3549,20154409044439-912,3,7/15/2015 11:58,1436986680,C5,250620,1437237300,7/18/2015 9:35
4386,20151115041148-836,2,7/17/2015 11:43,1437158580,C8,78360,1437236940,7/18/2015 9:29
1629,20152712122737-855,1,7/13/2015 6:21,1436793660,C6,442740,1437236400,7/18/2015 9:20
5510,20153013023047-224,2,7/14/2015 12:14,1436901240,C6,333780,1437235020,7/18/2015 8:57
4306,20151709081703-888,2,7/15/2015 8:41,1436974860,C8,259920,1437234780,7/18/2015 8:53
5851,20155101075136-111,1,7/16/2015 10:15,1437066900,C5,163080,1437229980,7/18/2015 7:33
1810,20155911125954-688,1,7/17/2015 11:12,1437156720,C7,73140,1437229860,7/18/2015 7:31
1755,20152816082835-10,1,7/17/2015 7:45,1437144300,C4,83820,1437228120,7/18/2015 7:02
5238,20152014052009-210,2,7/16/2015 11:46,1437072360,C4,152760,1437225120,7/18/2015 6:12
557,20150810090808-3,2,7/14/2015 7:35,1436884500,C3,340020,1437224520,7/18/2015 6:02
2694,20150730080701-11,2,7/12/2015 6:37,1436708220,C5,515700,1437223920,7/18/2015 5:52
183,20154615084621-811,3,7/17/2015 6:14,1437138840,C5,81840,1437220680,7/18/2015 4:58
428,20151908071935-977,1,7/14/2015 20:47,1436932020,C8,283440,1437215460,7/18/2015 3:31
3407,20150220040211-856,1,7/15/2015 2:10,1436951400,C4,263760,1437215160,7/18/2015 3:26
3799,20155602045653-926,1,7/13/2015 2:00,1436778000,C5,436080,1437214080,7/18/2015 3:08
1298,20150011120023-724,1,7/15/2015 21:32,1437021120,C5,189960,1437211080,7/18/2015 2:18
4345,20152506042511-712,2,7/13/2015 11:37,1436812620,C2,397440,1437210060,7/18/2015 2:01
235,20155302055357-472,1,7/14/2015 5:56,1436878560,C5,331260,1437209820,7/18/2015 1:57
4404,20152811072856-634,1,7/15/2015 19:24,1437013440,C4,194280,1437207720,7/18/2015 1:22
3432,20154811104853-331,3,7/14/2015 17:57,1436921820,C4,284940,1437206760,7/18/2015 1:06
1394,20155503025536-107,3,7/10/2015 19:49,1436582940,C4,622440,1437205380,7/18/2015 0:43
6210,20153302013336-618,1,7/16/2015 2:14,1437038040,C2,166980,1437205020,7/18/2015 0:37
217,20151005071024-452,1,7/13/2015 18:44,1436838240,C5,366420,1437204660,7/18/2015 0:31
2187,20152010022051-412,2,7/16/2015 3:41,1437043260,C3,160020,1437203280,7/18/2015 0:08
2792,20150503040507-176,1,7/14/2015 8:59,1436889540,C0,308280,1437197820,7/17/2015 22:37
113,20150620070638-960,1,7/8/2015 17:18,1436401080,C3,795960,1437197040,7/17/2015 22:24
1980,20151214101217-551,1,7/16/2015 17:54,1437094440,C5,100260,1437194700,7/17/2015 21:45
2942,20154630124651-529,1,7/15/2015 23:18,1437027480,C3,166740,1437194220,7/17/2015 21:37
3405,20151501021548-648,1,7/15/2015 20:26,1437017160,C4,175980,1437193140,7/17/2015 21:19
3692,20155311035305-535,1,7/15/2015 19:11,1437012660,C4,178740,1437191400,7/17/2015 20:50
979,20155309065327-597,1,7/13/2015 13:40,1436820000,C4,370020,1437190020,7/17/2015 20:27
5505,20153214083255-828,2,7/16/2015 16:28,1437089280,C8,100680,1437189960,7/17/2015 20:26
6001,20155115055126-836,3,7/17/2015 2:27,1437125220,C8,58680,1437183900,7/17/2015 18:45
3397,20154712014753-800,1,7/16/2015 21:52,1437108720,C8,74940,1437183660,7/17/2015 18:41
2811,20155515045550-909,1,7/17/2015 2:05,1437123900,C2,59700,1437183600,7/17/2015 18:40
2997,20153111043103-266,3,7/17/2015 2:23,1437124980,C3,58440,1437183420,7/17/2015 18:37
4559,20153908063905-670,3,7/14/2015 14:23,1436908980,C4,273120,1437182100,7/17/2015 18:15
3310,20153208073235-389,2,7/16/2015 18:47,1437097620,C7,81300,1437178920,7/17/2015 17:22
6075,20153909013957-769,1,7/14/2015 23:59,1436943540,C8,234600,1437178140,7/17/2015 17:09
4947,20153010083042-172,2,7/15/2015 6:14,1436966040,C4,211920,1437177960,7/17/2015 17:06
5890,20154520014506-55,1,7/8/2015 15:43,1436395380,C0,781140,1437176520,7/17/2015 16:42
6187,20155002125000-291,1,7/15/2015 23:54,1437029640,C0,145380,1437175020,7/17/2015 16:17
2607,20153320043334-346,1,7/8/2015 15:45,1436395500,C8,776160,1437171660,7/17/2015 15:21
5882,20153310023320-488,1,7/16/2015 22:03,1437109380,C7,60600,1437169980,7/17/2015 14:53
1173,20152511102520-964,3,7/15/2015 13:09,1436990940,C7,177720,1437168660,7/17/2015 14:31
4257,20152004102015-754,1,7/13/2015 5:00,1436788800,C5,379200,1437168000,7/17/2015 14:20
4603,20154519024544-322,2,7/15/2015 6:09,1436965740,C4,201300,1437167040,7/17/2015 14:04
499,20153508083547-956,1,7/14/2015 11:39,1436899140,C0,264720,1437163860,7/17/2015 13:11
1234,20151301111308-417,1,7/15/2015 12:44,1436989440,C2,173580,1437163020,7/17/2015 12:57
5988,20150407090456-983,1,7/16/2015 6:13,1437052380,C3,109620,1437162000,7/17/2015 12:40
305,20154705114743-724,2,7/14/2015 12:14,1436901240,C4,259740,1437160980,7/17/2015 12:23
4769,20152929022956-198,1,7/15/2015 6:30,1436967000,C0,193380,1437160380,7/17/2015 12:13
4,20153111063125-468,2,7/15/2015 10:13,1436980380,C5,179460,1437159840,7/17/2015 12:04
5917,20152405052406-500,3,7/13/2015 13:12,1436818320,C5,338040,1437156360,7/17/2015 11:06
286,20153504103503-465,1,7/13/2015 2:53,1436781180,C5,374940,1437156120,7/17/2015 11:02
6250,20154011124049-78,1,7/8/2015 11:25,1436379900,C2,776100,1437156000,7/17/2015 11:00
988,20152921092953-210,2,7/14/2015 13:05,1436904300,C2,250020,1437154320,7/17/2015 10:32
3954,20153311033321-730,1,7/16/2015 17:00,1437091200,C4,62460,1437153660,7/17/2015 10:21
2551,20152805062805-519,1,7/13/2015 9:02,1436803320,C2,350220,1437153540,7/17/2015 10:19
1232,20154506054509-852,2,7/16/2015 8:09,1437059340,C7,92160,1437151500,7/17/2015 9:45
2483,20150215110234-930,2,7/14/2015 4:17,1436872620,C7,275700,1437148320,7/17/2015 8:52
801,20152408032428-524,1,7/16/2015 6:27,1437053220,C0,94140,1437147360,7/17/2015 8:36
5369,20154704074710-516,2,7/10/2015 3:42,1436524920,C8,619140,1437144060,7/17/2015 7:41
4877,20151414021427-933,1,7/15/2015 22:52,1437025920,C2,117480,1437143400,7/17/2015 7:30
638,20153712013720-181,3,7/14/2015 22:20,1436937600,C6,204180,1437141780,7/17/2015 7:03
4734,20155809065829-220,2,7/16/2015 6:51,1437054660,C2,86340,1437141000,7/17/2015 6:50
3825,20155304095308-767,1,7/12/2015 23:45,1436769900,C0,370560,1437140460,7/17/2015 6:41
5677,20153230053236-758,2,7/15/2015 10:04,1436979840,C5,158640,1437138480,7/17/2015 6:08
1307,20153705123714-935,3,7/11/2015 9:22,1436631720,C4,506700,1437138420,7/17/2015 6:07
4914,20154521094550-685,1,7/10/2015 18:15,1436577300,C4,557400,1437134700,7/17/2015 5:05
4432,20155708025739-913,1,7/16/2015 3:19,1437041940,C5,92760,1437134700,7/17/2015 5:05
3532,20154926014915-775,2,7/10/2015 7:13,1436537580,C0,592920,1437130500,7/17/2015 3:55
6241,20150201020251-919,2,7/11/2015 22:32,1436679120,C2,447300,1437126420,7/17/2015 2:47
1103,20155820025849-226,2,7/10/2015 11:49,1436554140,C4,572220,1437126360,7/17/2015 2:46
5786,20150514010523-466,1,7/16/2015 6:09,1437052140,C2,73920,1437126060,7/17/2015 2:41
4548,20155428065442-400,3,7/7/2015 16:33,1436311980,C4,812340,1437124320,7/17/2015 2:12
3860,20152810052855-807,1,7/13/2015 21:47,1436849220,C3,274740,1437123960,7/17/2015 2:06
6249,20151911091902-88,3,7/15/2015 15:43,1437000180,C4,122880,1437123060,7/17/2015 1:51
5924,20155904075953-519,2,7/12/2015 19:47,1436755620,C8,366840,1437122460,7/17/2015 1:41
322,20150315030313-186,1,7/16/2015 7:54,1437058440,C3,60660,1437119100,7/17/2015 0:45
6172,20151611111649-796,1,7/15/2015 4:00,1436958000,C8,159720,1437117720,7/17/2015 0:22
296,20152514102555-759,3,7/16/2015 3:37,1437043020,C8,74160,1437117180,7/17/2015 0:13
4800,20150926090945-943,3,7/14/2015 16:13,1436915580,C5,197580,1437113160,7/16/2015 23:06
6053,20154430034436-879,2,7/14/2015 21:41,1436935260,C7,175860,1437111120,7/16/2015 22:32
5463,20152518112549-926,2,7/9/2015 18:43,1436492580,C2,613560,1437106140,7/16/2015 21:09
108,20151104121158-643,2,7/12/2015 2:51,1436694660,C2,406200,1437100860,7/16/2015 19:41
1442,20152908092908-702,1,7/15/2015 18:14,1437009240,C5,90900,1437100140,7/16/2015 19:29
2307,20152401082424-321,1,7/14/2015 4:09,1436872140,C8,221580,1437093720,7/16/2015 17:42
5143,20153805053836-382,1,7/13/2015 0:56,1436774160,C4,315540,1437089700,7/16/2015 16:35
5448,20154801044816-267,2,7/11/2015 16:08,1436656080,C5,430800,1437086880,7/16/2015 15:48
5562,20150418070414-573,2,7/13/2015 2:11,1436778660,C7,306060,1437084720,7/16/2015 15:12
3940,20153410103418-726,2,7/14/2015 13:36,1436906160,C0,178260,1437084420,7/16/2015 15:07
1433,20154613064658-613,1,7/15/2015 12:08,1436987280,C7,96060,1437083340,7/16/2015 14:49
2170,20152703112748-47,2,7/13/2015 7:57,1436799420,C5,283800,1437083220,7/16/2015 14:47
5813,20155918055936-835,1,7/13/2015 2:50,1436781000,C5,300780,1437081780,7/16/2015 14:23
1872,20151511041558-368,1,7/14/2015 22:55,1436939700,C8,141600,1437081300,7/16/2015 14:15
2774,20152705112730-412,3,7/15/2015 8:15,1436973300,C2,106560,1437079860,7/16/2015 13:51
4942,20155307085318-512,3,7/15/2015 13:09,1436990940,C0,88320,1437079260,7/16/2015 13:41
4600,20151909021907-531,2,7/15/2015 9:24,1436977440,C8,100140,1437077580,7/16/2015 13:13
836,20152613022643-189,1,7/15/2015 13:28,1436992080,C0,84660,1437076740,7/16/2015 12:59
4777,20150515020535-533,1,7/12/2015 16:02,1436742120,C2,334260,1437076380,7/16/2015 12:53
3790,20152104072145-815,1,7/14/2015 23:47,1436942820,C0,131880,1437074700,7/16/2015 12:25
2363,20154521024518-105,2,7/10/2015 6:57,1436536620,C4,537840,1437074460,7/16/2015 12:21
2200,20154603024631-872,3,7/13/2015 6:46,1436795160,C4,278400,1437073560,7/16/2015 12:06
1642,20152009022052-994,2,7/15/2015 8:15,1436973300,C8,99300,1437072600,7/16/2015 11:50
1178,20154611044614-561,2,7/15/2015 22:54,1437026040,C3,45960,1437072000,7/16/2015 11:40
2016,20152705092735-661,1,7/15/2015 2:12,1436951520,C4,119700,1437071220,7/16/2015 11:27
6062,20152404072411-614,1,7/15/2015 2:44,1436953440,C2,116700,1437070140,7/16/2015 11:09
865,20150110090142-745,2,7/14/2015 9:51,1436892660,C0,174300,1437066960,7/16/2015 10:16
2746,20155510025531-344,2,7/13/2015 12:24,1436815440,C2,250140,1437065580,7/16/2015 9:53
16,20152614052608-658,1,7/15/2015 13:30,1436992200,C4,72240,1437064440,7/16/2015 9:34
1430,20152804012816-125,2,7/12/2015 10:14,1436721240,C8,339780,1437061020,7/16/2015 8:37
5493,20153807083832-588,3,7/14/2015 2:26,1436865960,C2,194160,1437060120,7/16/2015 8:22
731,20152813082850-252,1,7/14/2015 20:21,1436930460,C6,129180,1437059640,7/16/2015 8:14
5627,20150003090030-424,3,7/12/2015 0:18,1436685480,C4,373140,1437058620,7/16/2015 7:57
1815,20153006063005-968,2,7/15/2015 1:33,1436949180,C4,108540,1437057720,7/16/2015 7:42
1125,20150509110512-403,2,7/11/2015 1:05,1436601900,C6,454800,1437056700,7/16/2015 7:25
3640,20153112063157-147,3,7/15/2015 6:40,1436967600,C5,86580,1437054180,7/16/2015 6:43
3291,20153514073546-814,3,7/15/2015 7:04,1436969040,C0,84540,1437053580,7/16/2015 6:33
849,20155107125107-821,1,7/14/2015 0:00,1436857200,C5,186180,1437043380,7/16/2015 3:43
3255,20152424062452-330,2,7/10/2015 15:57,1436569020,C5,472260,1437041280,7/16/2015 3:08
4915,20154430064432-451,2,7/13/2015 10:54,1436810040,C8,227640,1437037680,7/16/2015 2:08
2101,20153312053318-51,2,7/14/2015 9:36,1436891760,C4,144180,1437035940,7/16/2015 1:39
4649,20155405015448-33,2,7/10/2015 19:45,1436582700,C4,453060,1437035760,7/16/2015 1:36
6434,20150408120450-64,1,7/14/2015 23:22,1436941320,C6,93180,1437034500,7/16/2015 1:15
2428,20150911080900-458,3,7/13/2015 16:33,1436830380,C3,203040,1437033420,7/16/2015 0:57
378,20151008091058-366,1,7/14/2015 22:28,1436938080,C6,94380,1437032460,7/16/2015 0:41
5320,20151110091107-217,1,7/14/2015 2:55,1436867700,C5,161520,1437029220,7/15/2015 23:47
5912,20152313032302-271,2,7/15/2015 4:47,1436960820,C4,67320,1437028140,7/15/2015 23:29
2544,20153805103821-658,3,7/14/2015 15:43,1436913780,C5,113700,1437027480,7/15/2015 23:18
335,20152408122403-570,1,7/14/2015 23:20,1436941200,C5,79680,1437020880,7/15/2015 21:28
4316,20150203060230-10,1,7/14/2015 7:06,1436882760,C7,136320,1437019080,7/15/2015 20:58
3011,20150713020758-120,2,7/15/2015 2:33,1436952780,C5,65580,1437018360,7/15/2015 20:46
3464,20155713045735-33,1,7/14/2015 18:50,1436925000,C2,93180,1437018180,7/15/2015 20:43
1040,20150005020044-437,1,7/14/2015 13:50,1436907000,C4,111000,1437018000,7/15/2015 20:40
6057,20150807090832-325,3,7/14/2015 18:21,1436923260,C8,91140,1437014400,7/15/2015 19:40
1016,20155315115319-974,3,7/5/2015 16:45,1436139900,C8,872760,1437012660,7/15/2015 19:11
4924,20153403063427-228,3,7/12/2015 15:31,1436740260,C4,269940,1437010200,7/15/2015 18:30
1142,20153613013647-912,3,7/15/2015 0:06,1436943960,C5,62100,1437006060,7/15/2015 17:21
3548,20151527081514-392,1,7/13/2015 9:22,1436804520,C7,198060,1437002580,7/15/2015 16:23
683,20150211080249-753,2,7/13/2015 12:06,1436814360,C6,187440,1437001800,7/15/2015 16:10
5297,20155517095518-749,1,7/12/2015 12:27,1436729220,C3,271140,1437000360,7/15/2015 15:46
5083,20154912054955-518,1,7/14/2015 15:59,1436914740,C3,83100,1436997840,7/15/2015 15:04
2711,20152508032527-438,1,7/14/2015 14:43,1436910180,C6,85980,1436996160,7/15/2015 14:36
5394,20155313105324-362,1,7/7/2015 13:38,1436301480,C4,694500,1436995980,7/15/2015 14:33
5838,20150510050547-65,1,7/13/2015 23:09,1436854140,C8,140520,1436994660,7/15/2015 14:11
2888,20152827092833-950,2,7/13/2015 6:58,1436795880,C4,196200,1436992080,7/15/2015 13:28
3834,20151308011359-158,2,7/13/2015 5:09,1436789340,C8,201480,1436990820,7/15/2015 13:07
1135,20153224073256-73,1,7/8/2015 11:10,1436379000,C5,611340,1436990340,7/15/2015 12:59
3263,20152711082701-441,1,7/14/2015 3:15,1436868900,C8,120240,1436989140,7/15/2015 12:39
1376,20155418045455-317,2,7/6/2015 14:02,1436216520,C0,772440,1436988960,7/15/2015 12:36
1797,20155811085816-277,2,7/14/2015 3:12,1436868720,C4,119220,1436987940,7/15/2015 12:19
4592,20154608064621-71,1,7/13/2015 2:10,1436778600,C5,207720,1436986320,7/15/2015 11:52
1726,20150904030958-830,1,7/14/2015 6:45,1436881500,C4,104220,1436985720,7/15/2015 11:42
374,20155713105709-55,2,7/14/2015 10:46,1436895960,C0,85740,1436981700,7/15/2015 10:35
644,20150202120211-959,3,7/11/2015 2:20,1436606400,C7,371340,1436977740,7/15/2015 9:29
6055,20150505110546-631,1,7/10/2015 8:45,1436543100,C2,430800,1436973900,7/15/2015 8:25
3573,20153910063929-445,1,7/12/2015 19:28,1436754480,C6,218940,1436973420,7/15/2015 8:17
4147,20155812125816-703,3,7/13/2015 22:37,1436852220,C0,121140,1436973360,7/15/2015 8:16
5819,20155810065842-768,2,7/14/2015 1:34,1436862840,C2,108720,1436971560,7/15/2015 7:46
1469,20152917082934-698,1,7/5/2015 23:57,1436165820,C5,805440,1436971260,7/15/2015 7:41
3771,20152206032259-605,2,7/12/2015 10:10,1436721000,C0,249840,1436970840,7/15/2015 7:34
2323,20155812065819-311,1,7/13/2015 19:06,1436839560,C6,130080,1436969640,7/15/2015 7:14
4572,20152927032921-834,1,7/13/2015 2:15,1436778900,C2,190680,1436969580,7/15/2015 7:13
5607,20150905010927-978,2,7/14/2015 1:40,1436863200,C5,105180,1436968380,7/15/2015 6:53
5620,20150808030815-401,1,7/14/2015 13:08,1436904480,C4,63900,1436968380,7/15/2015 6:53
3901,20154712124711-992,2,7/13/2015 21:49,1436849340,C6,118920,1436968260,7/15/2015 6:51
4411,20151525101516-848,2,7/13/2015 1:43,1436776980,C4,190560,1436967540,7/15/2015 6:39
328,20153606123639-984,3,7/14/2015 4:14,1436872440,C7,94440,1436966880,7/15/2015 6:28
5262,20150128070124-874,1,7/6/2015 18:16,1436231760,C4,731700,1436963460,7/15/2015 5:31
3657,20151326111319-353,1,7/12/2015 21:12,1436760720,C8,202620,1436963340,7/15/2015 5:29
4290,20153712053742-911,2,7/14/2015 7:57,1436885820,C5,69000,1436954820,7/15/2015 3:07
550,20151611051619-74,1,7/13/2015 23:40,1436856000,C4,97920,1436953920,7/15/2015 2:52
3690,20153711053702-226,3,7/13/2015 23:27,1436855220,C5,96900,1436952120,7/15/2015 2:22
3504,20150606110611-539,1,7/12/2015 4:58,1436702280,C7,248160,1436950440,7/15/2015 1:54
546,20155504075511-773,1,7/13/2015 17:33,1436833980,C8,116040,1436950020,7/15/2015 1:47
3755,20154925044945-414,1,7/13/2015 2:25,1436779500,C7,167040,1436946540,7/15/2015 0:49
6063,20155021125027-18,1,7/9/2015 3:44,1436438640,C0,507480,1436946120,7/15/2015 0:42
4831,20153115103103-717,1,7/10/2015 2:16,1436519760,C8,426060,1436945820,7/15/2015 0:37
1858,20155930095901-918,1,7/9/2015 22:55,1436507700,C2,437820,1436945520,7/15/2015 0:32
5048,20151319101312-156,3,7/11/2015 19:14,1436667240,C8,276180,1436943420,7/14/2015 23:57
4352,20152404042428-569,1,7/13/2015 5:14,1436789640,C8,147480,1436937120,7/14/2015 22:12
3661,20151106051115-506,3,7/13/2015 21:30,1436848200,C3,88620,1436936820,7/14/2015 22:07
3386,20155407095445-308,1,7/12/2015 9:54,1436720040,C7,216000,1436936040,7/14/2015 21:54
207,20155311125300-290,1,7/13/2015 18:27,1436837220,C8,96420,1436933640,7/14/2015 21:14
3587,20153013053056-41,1,7/14/2015 7:17,1436883420,C0,49620,1436933040,7/14/2015 21:04
4701,20151008091003-541,1,7/11/2015 15:00,1436652000,C2,280200,1436932200,7/14/2015 20:50
1208,20155712055713-620,1,7/14/2015 3:39,1436870340,C4,60660,1436931000,7/14/2015 20:30
3644,20152514072525-135,1,7/4/2015 15:45,1436049900,C8,879000,1436928900,7/14/2015 19:55
360,20155811045827-264,3,7/13/2015 6:24,1436793840,C3,134760,1436928600,7/14/2015 19:50
1335,20150313080324-835,1,7/4/2015 7:47,1436021220,C8,906720,1436927940,7/14/2015 19:39
4546,20155901015947-373,2,7/11/2015 11:53,1436640780,C0,285480,1436926260,7/14/2015 19:11
5296,20154827114820-401,1,7/12/2015 14:45,1436737500,C8,186660,1436924160,7/14/2015 18:36
6345,20152420122429-39,2,7/12/2015 1:52,1436691120,C6,232860,1436923980,7/14/2015 18:33
2583,20152902012912-255,3,7/11/2015 17:14,1436660040,C0,263700,1436923740,7/14/2015 18:29
1243,20153304063341-413,3,7/13/2015 14:17,1436822220,C4,100680,1436922900,7/14/2015 18:15
5500,20155019065024-371,2,7/10/2015 11:10,1436551800,C8,366000,1436917800,7/14/2015 16:50
2768,20154311084343-102,3,7/13/2015 13:29,1436819340,C5,94980,1436914320,7/14/2015 15:52
2339,20151808021841-200,2,7/12/2015 15:12,1436739120,C8,174420,1436913540,7/14/2015 15:39
6421,20152706122712-540,2,7/13/2015 17:55,1436835300,C3,78060,1436913360,7/14/2015 15:36
1724,20153811083856-28,1,7/13/2015 13:12,1436818320,C5,94620,1436912940,7/14/2015 15:29
2738,20150211030246-951,3,7/13/2015 14:58,1436824680,C8,86280,1436910960,7/14/2015 14:56
6536,20155614105606-280,2,7/10/2015 19:37,1436582220,C5,325380,1436907600,7/14/2015 14:00
5706,20153906043929-561,1,7/9/2015 19:44,1436496240,C8,408900,1436905140,7/14/2015 13:19
5323,20150905040910-240,3,7/11/2015 14:11,1436649060,C5,255660,1436904720,7/14/2015 13:12
2950,20153604113656-45,1,7/11/2015 4:34,1436614440,C5,289740,1436904180,7/14/2015 13:03
3785,20153605113620-487,1,7/12/2015 6:15,1436706900,C2,195180,1436902080,7/14/2015 12:28
5533,20154904124934-601,1,7/13/2015 9:29,1436804940,C4,95700,1436900640,7/14/2015 12:04
288,20150028030041-325,1,7/9/2015 6:52,1436449920,C6,449940,1436899860,7/14/2015 11:51
4338,20150311090356-344,3,7/13/2015 10:25,1436808300,C8,88860,1436897160,7/14/2015 11:06
3884,20151504091530-898,2,7/13/2015 8:11,1436800260,C4,96720,1436896980,7/14/2015 11:03
309,20154911124924-532,1,7/13/2015 16:13,1436829180,C3,61680,1436890860,7/14/2015 9:21
4578,20155902015910-865,1,7/8/2015 11:30,1436380200,C4,509460,1436889660,7/14/2015 9:01
6258,20151929051927-102,1,7/9/2015 11:31,1436466660,C8,421560,1436888220,7/14/2015 8:37
2813,20153707023747-858,1,7/12/2015 15:52,1436741520,C4,145500,1436887020,7/14/2015 8:17
4150,20154530114544-776,1,7/12/2015 14:22,1436736120,C4,149460,1436885580,7/14/2015 7:53
547,20153708023749-220,1,7/12/2015 9:53,1436719980,C7,164280,1436884260,7/14/2015 7:31
724,20154922024915-450,3,7/11/2015 14:17,1436649420,C4,234240,1436883660,7/14/2015 7:21
4185,20153110063138-887,2,7/12/2015 22:55,1436766900,C4,115920,1436882820,7/14/2015 7:07
2778,20155502115525-896,3,7/12/2015 23:07,1436767620,C3,113040,1436880660,7/14/2015 6:31
166,20151329011319-87,1,7/12/2015 9:48,1436719680,C5,158700,1436878380,7/14/2015 5:53
6407,20155605055620-608,3,7/11/2015 9:50,1436633400,C7,244620,1436878020,7/14/2015 5:47
3702,20154804094840-923,1,7/10/2015 22:44,1436593440,C2,282480,1436875920,7/14/2015 5:12
1332,20153926013940-342,1,7/8/2015 7:55,1436367300,C5,508080,1436875380,7/14/2015 5:03
2266,20154404064457-308,1,7/10/2015 20:46,1436586360,C2,284460,1436870820,7/14/2015 3:47
2118,20150611020620-822,3,7/13/2015 7:08,1436796480,C8,73860,1436870340,7/14/2015 3:39
1937,20152728082727-282,1,7/8/2015 20:47,1436413620,C4,454200,1436867820,7/14/2015 2:57
2238,20153316123340-662,1,7/11/2015 0:41,1436600460,C5,264660,1436865120,7/14/2015 2:12
2919,20151827081812-463,1,7/11/2015 23:42,1436683320,C4,180720,1436864040,7/14/2015 1:54
2159,20154504014517-802,2,7/13/2015 0:25,1436772300,C6,91200,1436863500,7/14/2015 1:45
1623,20151410081443-694,3,7/12/2015 19:42,1436755320,C5,107040,1436862360,7/14/2015 1:26
1778,20150209010259-697,1,7/13/2015 7:17,1436797020,C8,64980,1436862000,7/14/2015 1:20
6531,20150010040037-125,1,7/12/2015 21:38,1436762280,C5,96540,1436858820,7/14/2015 0:27
4754,20154605084600-982,3,7/11/2015 3:02,1436608920,C5,248880,1436857800,7/14/2015 0:10
6043,20152711092730-427,3,7/13/2015 3:03,1436781780,C8,74880,1436856660,7/13/2015 23:51
31,20152005102037-864,2,7/11/2015 3:10,1436609400,C5,246300,1436855700,7/13/2015 23:35
4672,20152009082025-752,1,7/12/2015 9:46,1436719560,C8,132180,1436851740,7/13/2015 22:29
5664,20152711112746-346,2,7/13/2015 2:11,1436778660,C7,69720,1436848380,7/13/2015 21:33
4427,20153222013237-308,1,7/8/2015 13:26,1436387160,C4,460680,1436847840,7/13/2015 21:24
1784,20152005092056-151,2,7/7/2015 11:05,1436292300,C8,554220,1436846520,7/13/2015 21:02
512,20150103040138-632,1,7/12/2015 4:06,1436699160,C8,146940,1436846100,7/13/2015 20:55
1282,20153005113023-61,2,7/12/2015 22:26,1436765160,C4,80520,1436845680,7/13/2015 20:48
3333,20153029033050-443,3,7/12/2015 1:56,1436691360,C3,153480,1436844840,7/13/2015 20:34
901,20151808051847-914,1,7/11/2015 6:40,1436622000,C2,220920,1436842920,7/13/2015 20:02
4069,20155803085804-911,3,7/12/2015 12:32,1436729520,C3,112920,1436842440,7/13/2015 19:54
27,20154602084650-633,1,7/6/2015 21:56,1436244960,C8,597000,1436841960,7/13/2015 19:46
2274,20152826092848-943,1,7/11/2015 7:46,1436625960,C6,214980,1436840940,7/13/2015 19:29
4310,20151008051030-28,1,7/12/2015 2:24,1436693040,C7,146220,1436839260,7/13/2015 19:01
3220,20150307030320-55,3,7/11/2015 17:11,1436659860,C8,176640,1436836500,7/13/2015 18:15
3454,20154121084107-952,3,7/6/2015 6:55,1436190900,C5,644820,1436835720,7/13/2015 18:02
5989,20153504013535-186,1,7/12/2015 17:11,1436746260,C6,88020,1436834280,7/13/2015 17:38
771,20151515021534-406,1,7/10/2015 14:31,1436563860,C2,270120,1436833980,7/13/2015 17:33
1771,20155511045543-118,2,7/13/2015 0:53,1436773980,C7,57540,1436831520,7/13/2015 16:52
2860,20155103015112-816,2,7/12/2015 0:16,1436685360,C8,145740,1436831100,7/13/2015 16:45
672,20151111041119-158,1,7/12/2015 16:09,1436742540,C0,86280,1436828820,7/13/2015 16:07
61,20154404114459-43,1,7/10/2015 14:26,1436563560,C8,264060,1436827620,7/13/2015 15:47
558,20150911050916-197,1,7/12/2015 16:25,1436743500,C2,83760,1436827260,7/13/2015 15:41
90,20153705093703-55,2,7/9/2015 9:05,1436457900,C2,366960,1436824860,7/13/2015 15:01
4989,20155708025745-242,1,7/12/2015 23:50,1436770200,C5,53940,1436824140,7/13/2015 14:49
987,20150603090639-155,3,7/10/2015 4:44,1436528640,C0,294540,1436823180,7/13/2015 14:33
3064,20153206103213-613,1,7/12/2015 18:48,1436752080,C4,68520,1436820600,7/13/2015 13:50
3200,20151511071529-602,2,7/12/2015 10:27,1436722020,C6,97920,1436819940,7/13/2015 13:39
3721,20154627024615-98,2,7/5/2015 13:43,1436128980,C6,687420,1436816400,7/13/2015 12:40
3872,20151807041826-31,1,7/11/2015 13:34,1436646840,C4,167880,1436814720,7/13/2015 12:12
5957,20153204053251-894,2,7/11/2015 7:11,1436623860,C0,189180,1436813040,7/13/2015 11:44
1857,20153130083112-439,2,7/9/2015 2:37,1436434620,C0,378180,1436812800,7/13/2015 11:40
995,20153406083403-509,2,7/11/2015 2:38,1436607480,C0,205320,1436812800,7/13/2015 11:40
4570,20153104043140-683,2,7/10/2015 12:45,1436557500,C5,252420,1436809920,7/13/2015 10:52
2017,20153505073536-429,1,7/9/2015 9:04,1436457840,C6,350940,1436808780,7/13/2015 10:33
3713,20155409015439-148,1,7/12/2015 2:26,1436693160,C3,108960,1436802120,7/13/2015 8:42
4378,20154304044326-805,2,7/11/2015 4:13,1436613180,C2,186600,1436799780,7/13/2015 8:03
6472,20151315031359-879,2,7/10/2015 6:09,1436533740,C0,265920,1436799660,7/13/2015 8:01
3347,20153025083001-968,3,7/10/2015 18:18,1436577480,C6,221880,1436799360,7/13/2015 7:56
2788,20155503095520-726,3,7/10/2015 0:25,1436513100,C8,285300,1436798400,7/13/2015 7:40
3221,20153307023326-161,2,7/1/2015 9:57,1435769820,C8,1028520,1436798340,7/13/2015 7:39
5849,20152308062330-627,3,7/12/2015 1:20,1436689200,C3,109140,1436798340,7/13/2015 7:39
1354,20154201074239-779,2,7/11/2015 23:26,1436682360,C5,115080,1436797440,7/13/2015 7:24
6163,20150209060238-306,3,7/11/2015 22:52,1436680320,C2,116700,1436797020,7/13/2015 7:17
5032,20153307063313-327,1,7/8/2015 19:01,1436407260,C5,389040,1436796300,7/13/2015 7:05
219,20155204105251-380,3,7/8/2015 20:47,1436413620,C4,381300,1436794920,7/13/2015 6:42
6395,20154002074029-503,1,7/12/2015 1:08,1436688480,C5,105060,1436793540,7/13/2015 6:19
326,20155805025842-634,1,7/8/2015 13:23,1436386980,C0,406500,1436793480,7/13/2015 6:18
4375,20154801124855-611,3,7/9/2015 8:08,1436454480,C5,337200,1436791680,7/13/2015 5:48
5308,20152730102714-620,1,7/6/2015 19:43,1436236980,C2,551760,1436788740,7/13/2015 4:59
3203,20150707090744-193,2,7/11/2015 16:52,1436658720,C4,124500,1436783220,7/13/2015 3:27
1748,20154112014114-381,1,7/10/2015 18:18,1436577480,C6,204480,1436781960,7/13/2015 3:06
5321,20150405040445-909,2,7/12/2015 6:28,1436707680,C5,71280,1436778960,7/13/2015 2:16
220,20155603015631-143,2,7/8/2015 7:54,1436367240,C4,410280,1436777520,7/13/2015 1:52
1014,20151602121624-797,1,7/7/2015 18:53,1436320380,C3,455820,1436776200,7/13/2015 1:30
4595,20153903043925-167,2,7/9/2015 22:21,1436505660,C2,269460,1436775120,7/13/2015 1:12
3520,20152509112544-291,1,7/11/2015 20:07,1436670420,C7,102060,1436772480,7/13/2015 0:28
2310,20155604055630-978,1,7/10/2015 22:41,1436593260,C5,178500,1436771760,7/13/2015 0:16
2490,20152608112631-387,3,7/10/2015 17:41,1436575260,C0,195300,1436770560,7/12/2015 23:56
4372,20151920091934-950,1,7/10/2015 2:59,1436522340,C2,243600,1436765940,7/12/2015 22:39
3330,20155003045027-887,1,7/8/2015 7:44,1436366640,C0,399240,1436765880,7/12/2015 22:38
1034,20155905045912-583,1,7/11/2015 20:53,1436673180,C6,88740,1436761920,7/12/2015 21:32
3571,20155309115300-960,1,7/12/2015 0:50,1436687400,C0,73140,1436760540,7/12/2015 21:09
1168,20153225063205-641,3,7/10/2015 22:08,1436591280,C5,169020,1436760300,7/12/2015 21:05
3277,20153513123506-982,1,7/9/2015 14:35,1436477700,C4,281700,1436759400,7/12/2015 20:50
1836,20151306101326-304,3,7/10/2015 17:03,1436572980,C5,185100,1436758080,7/12/2015 20:28
5814,20153606063624-577,3,7/11/2015 17:41,1436661660,C8,94380,1436756040,7/12/2015 19:54
1352,20151223091224-134,2,7/7/2015 23:03,1436335380,C2,419820,1436755200,7/12/2015 19:40
5759,20153830123835-677,1,7/11/2015 10:22,1436635320,C0,117780,1436753100,7/12/2015 19:05
601,20151103051148-977,3,7/9/2015 18:23,1436491380,C5,261360,1436752740,7/12/2015 18:59
449,20153028103038-731,3,7/5/2015 14:42,1436132520,C6,619920,1436752440,7/12/2015 18:54
729,20151203121253-478,3,7/11/2015 18:04,1436663040,C2,89040,1436752080,7/12/2015 18:48
5757,20153505113500-23,2,7/10/2015 8:23,1436541780,C5,210240,1436752020,7/12/2015 18:47
6424,20155328035310-746,2,7/5/2015 17:19,1436141940,C6,609960,1436751900,7/12/2015 18:45
104,20154708074757-401,1,7/10/2015 13:02,1436558520,C4,191700,1436750220,7/12/2015 18:17
4078,20154107044154-514,1,7/11/2015 1:31,1436603460,C4,145500,1436748960,7/12/2015 17:56
732,20151804041847-14,2,7/10/2015 1:20,1436516400,C8,232260,1436748660,7/12/2015 17:51
1196,20152403092454-380,2,7/9/2015 14:56,1436478960,C5,269160,1436748120,7/12/2015 17:42
6265,20153019073056-11,1,7/10/2015 2:58,1436522280,C5,224760,1436747040,7/12/2015 17:24
4129,20154510104522-927,1,7/11/2015 13:48,1436647680,C2,97380,1436745060,7/12/2015 16:51
5264,20155509105541-792,1,7/11/2015 14:31,1436650260,C7,92880,1436743140,7/12/2015 16:19
445,20154825064848-825,2,7/10/2015 12:05,1436555100,C7,187860,1436742960,7/12/2015 16:16
461,20154405034454-883,3,7/10/2015 22:05,1436591100,C2,151620,1436742720,7/12/2015 16:12
3381,20152105062125-369,2,7/10/2015 3:45,1436525100,C5,211320,1436736420,7/12/2015 14:27
1983,20153707073745-657,1,7/9/2015 22:49,1436507340,C2,227520,1436734860,7/12/2015 14:01
5639,20153908113930-121,1,7/11/2015 4:53,1436615580,C5,117420,1436733000,7/12/2015 13:30
2395,20150108080154-471,1,7/11/2015 2:51,1436608260,C7,120300,1436728560,7/12/2015 12:16
3415,20151905041959-420,2,7/11/2015 17:55,1436662500,C5,65520,1436728020,7/12/2015 12:07
1566,20154217034220-309,2,7/4/2015 4:44,1436010240,C5,714660,1436724900,7/12/2015 11:15
2232,20153601123633-561,1,7/9/2015 17:03,1436486580,C2,235740,1436722320,7/12/2015 10:32
5467,20152603072604-152,1,7/11/2015 3:14,1436609640,C6,112680,1436722320,7/12/2015 10:32
5418,20150523060517-30,1,7/11/2015 5:20,1436617200,C5,103500,1436720700,7/12/2015 10:05
1095,20154324084313-457,2,7/10/2015 3:25,1436523900,C5,194760,1436718660,7/12/2015 9:31
5004,20154520034536-573,2,7/9/2015 15:34,1436481240,C5,234420,1436715660,7/12/2015 8:41
634,20154412124411-6,1,7/2/2015 10:00,1435856400,C5,859080,1436715480,7/12/2015 8:38
1480,20155702065700-462,1,7/11/2015 8:00,1436626800,C7,86820,1436713620,7/12/2015 8:07
4878,20154408064412-833,3,7/11/2015 7:44,1436625840,C3,87600,1436713440,7/12/2015 8:04
11,20153705023701-460,1,7/11/2015 11:33,1436639580,C4,72480,1436712060,7/12/2015 7:41
4036,20153524123538-428,1,7/6/2015 8:09,1436195340,C4,510420,1436705760,7/12/2015 5:56
4343,20152025032033-74,1,7/8/2015 2:11,1436346660,C2,358620,1436705280,7/12/2015 5:48
5331,20153312103323-598,3,7/4/2015 18:12,1436058720,C5,642780,1436701500,7/12/2015 4:45
2640,20153905073902-613,3,7/9/2015 21:01,1436500860,C8,196860,1436697720,7/12/2015 3:42
2280,20154306044342-841,2,7/11/2015 12:27,1436642820,C5,52080,1436694900,7/12/2015 2:55
4976,20154803104834-431,2,7/11/2015 6:00,1436619600,C7,74880,1436694480,7/12/2015 2:48
4743,20153226093201-782,3,7/10/2015 3:28,1436524080,C5,169680,1436693760,7/12/2015 2:36
6076,20150801100813-808,1,7/10/2015 18:29,1436578140,C5,115380,1436693520,7/12/2015 2:32
3168,20151419121435-102,3,7/9/2015 6:08,1436447280,C8,243720,1436691000,7/12/2015 1:50
2918,20152305022313-514,1,7/5/2015 23:33,1436164380,C8,525000,1436689380,7/12/2015 1:23
5897,20154806014828-598,1,7/10/2015 4:34,1436528040,C3,156180,1436684220,7/11/2015 23:57
1466,20150419060418-689,1,7/4/2015 9:48,1436028480,C5,654720,1436683200,7/11/2015 23:40
3382,20150118110157-82,1,7/4/2015 3:13,1436004780,C8,677160,1436681940,7/11/2015 23:19
1525,20152303032328-493,1,7/9/2015 21:08,1436501280,C2,179700,1436680980,7/11/2015 23:03
2047,20152019082054-582,2,7/5/2015 22:44,1436161440,C4,514080,1436675520,7/11/2015 21:32
3098,20155001105054-534,1,7/10/2015 17:30,1436574600,C4,100200,1436674800,7/11/2015 21:20
2140,20152706102715-95,2,6/30/2015 1:33,1435653180,C5,1020780,1436673960,7/11/2015 21:06
5078,20151309041310-608,1,7/11/2015 3:01,1436608860,C5,62640,1436671500,7/11/2015 20:25
6257,20153104103154-685,1,7/10/2015 21:41,1436589660,C2,79800,1436669460,7/11/2015 19:51
2718,20150415110415-762,2,6/28/2015 15:21,1435530060,C2,1138620,1436668680,7/11/2015 19:38
733,20152116022122-905,1,7/8/2015 15:54,1436396040,C0,272340,1436668380,7/11/2015 19:33
125,20152109062104-583,2,7/8/2015 4:13,1436353980,C2,312240,1436666220,7/11/2015 18:57
2491,20150402120425-392,3,7/10/2015 14:12,1436562720,C2,99840,1436662560,7/11/2015 17:56
602,20154905014906-97,1,7/9/2015 16:17,1436483820,C5,177240,1436661060,7/11/2015 17:31
6135,20150503020544-302,1,7/9/2015 0:13,1436425980,C5,234240,1436660220,7/11/2015 17:17
510,20151604081612-669,1,7/9/2015 5:48,1436446080,C2,211560,1436657640,7/11/2015 16:34
891,20151705081717-385,1,7/9/2015 13:47,1436474820,C2,182700,1436657520,7/11/2015 16:32
1163,20152027112040-21,2,7/9/2015 6:50,1436449800,C8,204120,1436653920,7/11/2015 15:32
3588,20151619091658-670,1,7/9/2015 3:00,1436436000,C2,213180,1436649180,7/11/2015 14:13
525,20155525015513-235,2,7/7/2015 14:01,1436302860,C0,345720,1436648580,7/11/2015 14:03
3945,20155809095821-297,1,7/10/2015 11:41,1436553660,C3,92580,1436646240,7/11/2015 13:24
6537,20151001011026-433,1,7/10/2015 6:49,1436536140,C5,107820,1436643960,7/11/2015 12:46
5438,20155402055423-909,1,7/10/2015 8:57,1436543820,C8,94140,1436637960,7/11/2015 11:06
1341,20153004023033-371,2,7/9/2015 2:54,1436435640,C7,195120,1436630760,7/11/2015 9:06
3962,20154402124413-668,3,7/10/2015 6:21,1436534460,C8,95460,1436629920,7/11/2015 8:52
1343,20152504112551-431,2,7/9/2015 1:31,1436430660,C2,198180,1436628840,7/11/2015 8:34
5173,20150205080250-857,2,7/9/2015 8:02,1436454120,C8,172800,1436626920,7/11/2015 8:02
2012,20154602034646-21,1,7/9/2015 3:37,1436438220,C2,187020,1436625240,7/11/2015 7:34
6317,20154501124525-792,2,7/10/2015 1:37,1436517420,C3,105360,1436622780,7/11/2015 6:53
5177,20152605042639-261,2,7/10/2015 13:55,1436561700,C8,60420,1436622120,7/11/2015 6:42
4982,20153505123531-2,1,7/7/2015 7:15,1436278500,C3,343200,1436621700,7/11/2015 6:35
2730,20150705050702-651,1,7/9/2015 10:05,1436461500,C4,160140,1436621640,7/11/2015 6:34
5335,20153122113135-902,1,7/9/2015 9:07,1436458020,C7,162240,1436620260,7/11/2015 6:11
6194,20151202021203-963,1,7/6/2015 22:01,1436245260,C4,373740,1436619000,7/11/2015 5:50
3491,20150205010257-226,1,7/9/2015 8:00,1436454000,C5,163740,1436617740,7/11/2015 5:29
4260,20151002101014-792,3,7/9/2015 0:34,1436427240,C0,190080,1436617320,7/11/2015 5:22
1920,20153101023158-837,1,7/10/2015 0:21,1436512860,C3,103800,1436616660,7/11/2015 5:11
1608,20155204015210-595,2,7/9/2015 13:19,1436473140,C5,143340,1436616480,7/11/2015 5:08
470,20155808075842-527,3,7/9/2015 18:31,1436491860,C2,124380,1436616240,7/11/2015 5:04
3202,20152004072035-991,2,7/8/2015 21:28,1436416080,C8,198240,1436614320,7/11/2015 4:32
3857,20151727091758-4,3,7/8/2015 21:02,1436414520,C8,198540,1436613060,7/11/2015 4:11
2569,20151104091151-104,3,7/8/2015 21:47,1436417220,C8,195480,1436612700,7/11/2015 4:05
1831,20150729120752-754,2,7/7/2015 6:35,1436276100,C2,335640,1436611740,7/11/2015 3:49
4350,20150826020807-226,1,7/9/2015 7:27,1436452020,C8,157020,1436609040,7/11/2015 3:04
69,20151405011458-832,2,7/10/2015 10:08,1436548080,C5,60120,1436608200,7/11/2015 2:50
5600,20150828120844-852,1,7/9/2015 16:56,1436486160,C4,120960,1436607120,7/11/2015 2:32
1004,20153903103958-735,3,7/7/2015 6:30,1436275800,C6,330660,1436606460,7/11/2015 2:21
4325,20154009094029-596,2,7/7/2015 2:40,1436262000,C8,342000,1436604000,7/11/2015 1:40
1285,20151924091906-140,3,7/8/2015 22:58,1436421480,C7,179820,1436601300,7/11/2015 0:55
3321,20150326090329-717,2,7/8/2015 14:03,1436389380,C8,210960,1436600340,7/11/2015 0:39
5839,20153706113731-583,3,7/5/2015 6:22,1436102520,C8,497340,1436599860,7/11/2015 0:31
2823,20150921010943-734,2,7/7/2015 18:19,1436318340,C8,280200,1436598540,7/11/2015 0:09
2560,20151208091253-564,3,7/10/2015 2:56,1436522160,C2,75120,1436597280,7/10/2015 23:48
6329,20151928081935-515,2,7/7/2015 19:49,1436323740,C5,273000,1436596740,7/10/2015 23:39
5236,20150027100030-310,1,7/8/2015 15:45,1436395500,C8,194220,1436589720,7/10/2015 21:42
3953,20155019075059-941,3,7/5/2015 12:08,1436123280,C5,465960,1436589240,7/10/2015 21:34
5683,20150307100357-262,2,7/9/2015 17:41,1436488860,C5,100140,1436589000,7/10/2015 21:30
5693,20150523030511-17,2,7/8/2015 17:27,1436401620,C3,186360,1436587980,7/10/2015 21:13
1942,20154805014852-697,2,7/9/2015 23:43,1436510580,C8,76260,1436586840,7/10/2015 20:54
4429,20155307045325-414,2,7/9/2015 6:48,1436449680,C4,136500,1436586180,7/10/2015 20:43
3578,20153125023115-598,1,7/7/2015 0:43,1436254980,C0,329040,1436584020,7/10/2015 20:07
5008,20155418035415-502,1,7/7/2015 16:00,1436310000,C6,273660,1436583660,7/10/2015 20:01
5788,20151821121849-891,3,7/8/2015 16:10,1436397000,C4,185340,1436582340,7/10/2015 19:39
4174,20153003083030-321,3,7/8/2015 7:34,1436366040,C8,214320,1436580360,7/10/2015 19:06
4175,20154714024730-244,1,7/7/2015 11:56,1436295360,C7,282420,1436577780,7/10/2015 18:23
1996,20151626061648-946,3,7/7/2015 3:16,1436264160,C5,313200,1436577360,7/10/2015 18:16
1421,20153204073231-660,3,7/9/2015 15:52,1436482320,C8,92400,1436574720,7/10/2015 17:32
6203,20155405045446-551,1,7/9/2015 23:54,1436511240,C6,61800,1436573040,7/10/2015 17:04
83,20151207091211-916,2,7/9/2015 14:02,1436475720,C5,95100,1436570820,7/10/2015 16:27
5963,20154507074558-617,1,7/9/2015 12:51,1436471460,C5,95580,1436567040,7/10/2015 15:24
2003,20150330060312-987,1,7/9/2015 7:17,1436451420,C4,111720,1436563140,7/10/2015 14:19
3726,20152403102434-408,3,7/9/2015 9:04,1436457840,C8,102720,1436560560,7/10/2015 13:36
1348,20155030015058-336,1,7/7/2015 5:14,1436271240,C0,286920,1436558160,7/10/2015 12:56
5093,20152709052754-9,3,7/6/2015 16:22,1436224920,C4,332700,1436557620,7/10/2015 12:47
1372,20151205011253-317,2,7/6/2015 3:23,1436178180,C4,377580,1436555760,7/10/2015 12:16
3005,20152323072348-119,2,7/8/2015 14:19,1436390340,C2,165120,1436555460,7/10/2015 12:11
4886,20151704041709-562,1,7/9/2015 20:25,1436498700,C5,55860,1436554560,7/10/2015 11:56
2649,20154112084109-806,1,7/6/2015 22:54,1436248440,C8,303540,1436551980,7/10/2015 11:13
3777,20152707102716-827,3,7/9/2015 10:33,1436463180,C5,86580,1436549760,7/10/2015 10:36
704,20150025040004-379,2,7/8/2015 14:13,1436389980,C0,159540,1436549520,7/10/2015 10:32
3417,20155524085551-928,1,7/6/2015 9:58,1436201880,C4,346860,1436548740,7/10/2015 10:19
5437,20155830085850-481,1,7/5/2015 9:38,1436114280,C6,434400,1436548680,7/10/2015 10:18
2389,20150521090524-397,1,6/30/2015 21:39,1435725540,C6,822840,1436548380,7/10/2015 10:13
5309,20154404094430-924,3,7/8/2015 21:56,1436417760,C5,129840,1436547600,7/10/2015 10:00
985,20152704012705-41,1,7/8/2015 11:07,1436378820,C5,168600,1436547420,7/10/2015 9:57
3028,20152707122720-612,3,7/9/2015 9:59,1436461140,C8,81960,1436543100,7/10/2015 8:45
4184,20151020091049-173,1,7/5/2015 8:34,1436110440,C2,431280,1436541720,7/10/2015 8:22
1409,20151503011524-795,2,7/8/2015 15:24,1436394240,C5,146580,1436540820,7/10/2015 8:07
192,20154904034903-354,1,7/8/2015 10:35,1436376900,C4,163380,1436540280,7/10/2015 7:58
1635,20151710081754-167,2,7/6/2015 23:37,1436251020,C5,287700,1436538720,7/10/2015 7:32
1572,20150730070718-674,2,7/9/2015 4:27,1436441220,C3,96000,1436537220,7/10/2015 7:07
3563,20153029063054-508,1,7/6/2015 14:32,1436218320,C7,316860,1436535180,7/10/2015 6:33
118,20154701074721-510,2,7/8/2015 0:44,1436341440,C4,193140,1436534580,7/10/2015 6:23
3169,20150404120407-76,3,7/9/2015 12:21,1436469660,C4,61860,1436531520,7/10/2015 5:32
3002,20150122060128-25,2,7/7/2015 23:26,1436336760,C7,194100,1436530860,7/10/2015 5:21
755,20153805023838-887,1,7/9/2015 1:11,1436429460,C5,99060,1436528520,7/10/2015 4:42
4998,20150408040443-205,2,7/9/2015 10:13,1436461980,C2,65340,1436527320,7/10/2015 4:22
2611,20150001010009-284,3,7/8/2015 22:42,1436420520,C6,106620,1436527140,7/10/2015 4:19
3236,20153305123353-662,1,7/8/2015 23:57,1436425020,C5,100080,1436525100,7/10/2015 3:45
4210,20150029030057-969,2,7/4/2015 20:34,1436067240,C4,452040,1436519280,7/10/2015 2:08
2681,20155104055125-368,2,7/7/2015 9:52,1436287920,C6,230460,1436518380,7/10/2015 1:53
2129,20153324033312-407,3,7/4/2015 22:19,1436073540,C7,444180,1436517720,7/10/2015 1:42
4228,20151404021437-954,3,7/7/2015 7:44,1436280240,C0,235800,1436516040,7/10/2015 1:14
5384,20153205083252-86,1,7/7/2015 16:51,1436313060,C0,202740,1436515800,7/10/2015 1:10
2336,20150323040301-184,1,7/7/2015 23:31,1436337060,C7,176640,1436513700,7/10/2015 0:35
5302,20154127114129-6,1,7/7/2015 22:06,1436331960,C8,180300,1436512260,7/10/2015 0:11
295,20152923072910-395,2,7/4/2015 9:39,1436027940,C8,479100,1436507040,7/9/2015 22:44
3308,20152230122233-577,1,7/6/2015 18:26,1436232360,C4,270120,1436502480,7/9/2015 21:28
456,20151609011626-759,2,7/6/2015 11:16,1436206560,C5,290700,1436497260,7/9/2015 20:01
1097,20155416025450-542,3,7/6/2015 21:59,1436245140,C4,250500,1436495640,7/9/2015 19:34
5199,20151521121533-656,1,7/3/2015 17:07,1435968420,C3,527160,1436495580,7/9/2015 19:33
6399,20150929060957-709,1,7/8/2015 15:05,1436393100,C0,101220,1436494320,7/9/2015 19:12
4544,20151924061911-225,2,7/4/2015 14:43,1436046180,C2,447120,1436493300,7/9/2015 18:55
5992,20155802055814-251,2,7/8/2015 21:47,1436417220,C7,76020,1436493240,7/9/2015 18:54
2847,20155803045848-101,3,7/7/2015 17:38,1436315880,C2,174000,1436489880,7/9/2015 17:58
3585,20150201040231-215,1,7/7/2015 0:58,1436255880,C2,232080,1436487960,7/9/2015 17:26
6540,20150806040859-207,1,7/6/2015 0:56,1436169360,C2,317160,1436486520,7/9/2015 17:02
5833,20153808013814-745,1,7/1/2015 22:05,1435813500,C3,672540,1436486040,7/9/2015 16:54
3854,20154203064217-174,1,7/8/2015 1:36,1436344560,C5,137880,1436482440,7/9/2015 15:54
177,20150926110958-805,2,7/6/2015 8:42,1436197320,C0,285060,1436482380,7/9/2015 15:53
1413,20152828112812-119,1,7/8/2015 15:08,1436393280,C3,87720,1436481000,7/9/2015 15:30
4139,20150903090957-551,1,7/7/2015 13:17,1436300220,C5,180240,1436480460,7/9/2015 15:21
6190,20154303124314-941,1,7/7/2015 13:55,1436302500,C5,174960,1436477460,7/9/2015 14:31
4456,20152904032905-433,1,7/3/2015 18:29,1435973340,C8,503280,1436476620,7/9/2015 14:17
1278,20151106041146-807,1,7/8/2015 14:55,1436392500,C0,84120,1436476620,7/9/2015 14:17
3920,20154527024553-723,1,7/5/2015 14:05,1436130300,C5,344400,1436474700,7/9/2015 13:45
4495,20153416023407-833,1,7/3/2015 19:01,1435975260,C2,494940,1436470200,7/9/2015 12:30
3714,20152918052938-439,2,7/2/2015 14:05,1435871100,C8,598680,1436469780,7/9/2015 12:23
4475,20154426024411-840,2,7/6/2015 6:14,1436188440,C0,277800,1436466240,7/9/2015 11:24
1532,20150405010405-973,1,7/8/2015 3:56,1436352960,C5,113160,1436466120,7/9/2015 11:22
571,20152123012131-392,2,7/7/2015 16:33,1436311980,C6,152640,1436464620,7/9/2015 10:57
62,20150610040636-776,2,7/6/2015 13:42,1436215320,C7,248640,1436463960,7/9/2015 10:46
4048,20150801050802-446,2,7/6/2015 20:44,1436240640,C4,222480,1436463120,7/9/2015 10:32
3365,20155603015621-472,2,7/8/2015 16:19,1436397540,C0,62940,1436460480,7/9/2015 9:48
2160,20153907063955-529,2,7/8/2015 8:00,1436367600,C2,91260,1436458860,7/9/2015 9:21
6435,20150013020033-816,1,7/6/2015 3:55,1436180100,C8,278700,1436458800,7/9/2015 9:20
89,20151303071356-254,3,7/7/2015 7:59,1436281140,C5,174180,1436455320,7/9/2015 8:22
4041,20154821104859-297,2,7/7/2015 8:24,1436282640,C5,171720,1436454360,7/9/2015 8:06
5416,20150903040923-931,3,7/8/2015 14:20,1436390400,C5,60780,1436451180,7/9/2015 7:13
3926,20151430011409-669,1,7/6/2015 8:40,1436197200,C4,250980,1436448180,7/9/2015 6:23
323,20152703112735-711,1,7/7/2015 7:59,1436281140,C5,166560,1436447700,7/9/2015 6:15
1074,20152302012357-409,1,7/7/2015 0:11,1436253060,C7,192240,1436445300,7/9/2015 5:35
1133,20153204013239-640,1,7/8/2015 1:08,1436342880,C2,100320,1436443200,7/9/2015 5:00
3601,20151304121328-420,1,7/6/2015 20:35,1436240100,C3,202920,1436443020,7/9/2015 4:57
6310,20153629073622-752,2,7/5/2015 21:30,1436157000,C8,284220,1436441220,7/9/2015 4:27
131,20155801085847-425,1,7/5/2015 6:28,1436102880,C4,336600,1436439480,7/9/2015 3:58
3694,20155506035548-222,1,7/8/2015 7:57,1436367420,C3,72060,1436439480,7/9/2015 3:58
3607,20152222012249-468,3,7/7/2015 7:14,1436278440,C5,159240,1436437680,7/9/2015 3:28
3929,20151020081012-980,1,7/2/2015 18:44,1435887840,C0,537420,1436425260,7/9/2015 0:01
1631,20153906073935-24,2,7/7/2015 15:44,1436309040,C4,115500,1436424540,7/8/2015 23:49
3706,20155501035526-887,1,7/5/2015 7:05,1436105100,C2,313800,1436418900,7/8/2015 22:15
964,20153104023109-416,3,7/8/2015 3:46,1436352360,C8,61380,1436413740,7/8/2015 20:49
5415,20151004041028-27,1,7/6/2015 18:25,1436232300,C2,180900,1436413200,7/8/2015 20:40
3645,20151927101928-443,1,7/5/2015 23:52,1436165520,C0,246660,1436412180,7/8/2015 20:23
3973,20155826105805-860,1,7/5/2015 18:01,1436144460,C4,267660,1436412120,7/8/2015 20:22
1665,20154204124245-802,3,7/7/2015 18:27,1436318820,C2,93300,1436412120,7/8/2015 20:22
6377,20154005024056-186,3,6/27/2015 18:18,1435454280,C3,956940,1436411220,7/8/2015 20:07
6016,20150203060259-209,2,7/7/2015 10:26,1436289960,C5,120480,1436410440,7/8/2015 19:54
2673,20153507013548-133,3,6/30/2015 23:53,1435733580,C4,674760,1436408340,7/8/2015 19:19
5017,20153605033636-902,1,7/7/2015 17:56,1436316960,C8,90600,1436407560,7/8/2015 19:06
2578,20155904065927-209,1,7/7/2015 6:35,1436276100,C2,128880,1436404980,7/8/2015 18:23
2197,20152530052504-640,3,7/6/2015 1:47,1436172420,C8,231060,1436403480,7/8/2015 17:58
1451,20154421014437-375,1,7/6/2015 20:00,1436238000,C4,164820,1436402820,7/8/2015 17:47
5139,20153530093500-378,1,7/7/2015 18:47,1436320020,C2,79740,1436399760,7/8/2015 16:56
1551,20151403101418-295,2,7/4/2015 6:22,1436016120,C8,380640,1436396760,7/8/2015 16:06
2190,20154201114254-498,2,7/7/2015 10:57,1436291820,C8,103140,1436394960,7/8/2015 15:36
1768,20155420105422-518,3,7/6/2015 15:02,1436220120,C4,174660,1436394780,7/8/2015 15:33
1774,20152601122623-54,1,7/6/2015 6:18,1436188680,C3,204960,1436393640,7/8/2015 15:14
611,20153301123341-61,2,7/7/2015 17:11,1436314260,C5,76440,1436390700,7/8/2015 14:25
3621,20151103101135-993,1,7/7/2015 7:11,1436278260,C5,111600,1436389860,7/8/2015 14:11
459,20155630015659-740,1,7/7/2015 6:01,1436274060,C8,115260,1436389320,7/8/2015 14:02
241,20152303052305-443,1,7/7/2015 22:04,1436331840,C5,51780,1436383620,7/8/2015 12:27
426,20150723050745-341,1,7/6/2015 15:55,1436223300,C8,159840,1436383140,7/8/2015 12:19
3295,20151805071821-119,3,7/6/2015 21:39,1436243940,C6,138060,1436382000,7/8/2015 12:00
3878,20153224063221-780,1,7/4/2015 22:11,1436073060,C4,306780,1436379840,7/8/2015 11:24
5565,20151423051449-551,1,7/6/2015 20:02,1436238120,C3,141660,1436379780,7/8/2015 11:23
1720,20153906013912-384,2,6/17/2015 12:05,1434567900,C8,1811580,1436379480,7/8/2015 11:18
2210,20155502125507-435,1,7/7/2015 16:56,1436313360,C2,63780,1436377140,7/8/2015 10:39
5368,20151927041904-297,3,7/4/2015 20:15,1436066100,C0,309480,1436375580,7/8/2015 10:13
3189,20153830123858-160,1,7/7/2015 8:54,1436284440,C4,84480,1436368920,7/8/2015 8:22
2060,20150325020345-881,3,7/6/2015 5:03,1436184180,C8,183600,1436367780,7/8/2015 8:03
2442,20155501115549-423,2,7/7/2015 11:04,1436292240,C4,73620,1436365860,7/8/2015 7:31
5956,20152404052454-43,1,7/3/2015 11:42,1435948920,C6,414180,1436363100,7/8/2015 6:45
6270,20153505093535-456,2,7/6/2015 20:05,1436238300,C0,124200,1436362500,7/8/2015 6:35
1176,20151403031412-911,1,7/7/2015 2:23,1436260980,C3,99780,1436360760,7/8/2015 6:06
3355,20155814045802-471,2,7/2/2015 8:43,1435851780,C2,508500,1436360280,7/8/2015 5:58
1246,20153917033947-416,3,7/5/2015 15:26,1436135160,C8,222060,1436357220,7/8/2015 5:07
944,20151203041231-943,1,7/7/2015 1:48,1436258880,C2,97920,1436356800,7/8/2015 5:00
1899,20155304025306-399,1,7/7/2015 0:03,1436252580,C2,102900,1436355480,7/8/2015 4:38
5003,20154406044427-579,1,7/4/2015 6:00,1436014800,C3,340080,1436354880,7/8/2015 4:28
1242,20152201102241-597,3,7/5/2015 22:26,1436160360,C7,194520,1436354880,7/8/2015 4:28
4488,20150404050454-793,1,7/4/2015 11:04,1436033040,C6,321300,1436354340,7/8/2015 4:19
3361,20154730124723-254,3,7/4/2015 8:28,1436023680,C0,330060,1436353740,7/8/2015 4:09
1691,20154501084530-202,2,7/7/2015 7:40,1436280000,C8,73500,1436353500,7/8/2015 4:05
6188,20153120103108-805,2,7/6/2015 4:47,1436183220,C2,170220,1436353440,7/8/2015 4:04
5350,20151722101732-165,2,7/5/2015 20:29,1436153340,C6,193320,1436346660,7/8/2015 2:11
1043,20155501105513-756,2,7/7/2015 5:59,1436273940,C4,71520,1436345460,7/8/2015 1:51
5651,20152226032253-445,1,7/5/2015 5:13,1436098380,C4,247020,1436345400,7/8/2015 1:50
259,20151001031016-663,1,7/6/2015 10:58,1436205480,C2,138960,1436344440,7/8/2015 1:34
5593,20150501060550-176,3,7/3/2015 23:17,1435990620,C6,353340,1436343960,7/8/2015 1:26
5761,20150924070945-953,1,7/3/2015 11:09,1435946940,C7,396000,1436342940,7/8/2015 1:09
4046,20154121124110-292,1,6/29/2015 18:44,1435628640,C4,712980,1436341620,7/8/2015 0:47
6505,20151304011310-154,1,7/6/2015 6:57,1436191020,C3,150240,1436341260,7/8/2015 0:41
2377,20154525084548-607,2,7/4/2015 20:24,1436066640,C2,273180,1436339820,7/8/2015 0:17
2710,20153504013504-269,1,7/7/2015 3:35,1436265300,C5,74400,1436339700,7/8/2015 0:15
1583,20153526093522-53,1,7/4/2015 3:13,1436004780,C5,334140,1436338920,7/8/2015 0:02
5655,20155805015836-890,1,7/6/2015 18:51,1436233860,C3,103980,1436337840,7/7/2015 23:44
6221,20150420110457-500,2,7/6/2015 0:56,1436169360,C4,168240,1436337600,7/7/2015 23:40
464,20151823051805-597,1,6/30/2015 19:55,1435719300,C2,614220,1436333520,7/7/2015 22:32
548,20153617093653-526,2,7/5/2015 21:09,1436155740,C7,177420,1436333160,7/7/2015 22:26
3687,20152513102549-213,3,7/4/2015 20:55,1436068500,C5,264600,1436333100,7/7/2015 22:25
1553,20152529092504-987,2,7/5/2015 2:05,1436087100,C0,246000,1436333100,7/7/2015 22:25
3489,20154804044802-635,2,7/6/2015 20:24,1436239440,C5,92880,1436332320,7/7/2015 22:12
1045,20155124045148-189,1,7/1/2015 7:19,1435760340,C2,570480,1436330820,7/7/2015 21:47
699,20154501044554-839,2,7/7/2015 2:57,1436263020,C8,66960,1436329980,7/7/2015 21:33
2745,20150225120206-4,1,7/1/2015 16:35,1435793700,C2,534780,1436328480,7/7/2015 21:08
4702,20151506031509-899,2,7/7/2015 5:50,1436273400,C3,52500,1436325900,7/7/2015 20:25
679,20154304044323-645,1,7/6/2015 19:09,1436234940,C3,90780,1436325720,7/7/2015 20:22
3210,20152301032339-982,2,7/5/2015 17:35,1436142900,C7,176760,1436319660,7/7/2015 18:41
4646,20155503085502-843,1,7/6/2015 16:13,1436224380,C3,95160,1436319540,7/7/2015 18:39
261,20150702040704-305,1,7/6/2015 21:47,1436244420,C8,73200,1436317620,7/7/2015 18:07
58,20151422021453-376,2,7/5/2015 20:16,1436152560,C7,163560,1436316120,7/7/2015 17:42
1713,20153904043911-814,3,7/6/2015 16:57,1436227020,C3,86940,1436313960,7/7/2015 17:06
4154,20151701091730-48,3,7/5/2015 14:13,1436130780,C5,181680,1436312460,7/7/2015 16:41
2337,20150614120640-492,1,7/4/2015 19:04,1436061840,C0,250440,1436312280,7/7/2015 16:38
4818,20150701040708-313,3,7/5/2015 15:57,1436137020,C5,172500,1436309520,7/7/2015 15:52
2082,20154703044705-734,1,7/5/2015 16:18,1436138280,C3,171060,1436309340,7/7/2015 15:49
3341,20151603051629-978,1,7/6/2015 14:49,1436219340,C5,83460,1436302800,7/7/2015 14:00
3667,20153907123907-228,1,7/4/2015 5:27,1436012820,C3,288360,1436301180,7/7/2015 13:33
112,20150105040107-528,2,7/6/2015 14:29,1436218140,C3,80880,1436299020,7/7/2015 12:57
4038,20151302081321-676,3,7/6/2015 4:19,1436181540,C4,110520,1436292060,7/7/2015 11:01
779,20153902093914-109,1,7/6/2015 4:27,1436182020,C4,108960,1436290980,7/7/2015 10:43
750,20150206110209-450,2,7/3/2015 13:27,1435955220,C3,334500,1436289720,7/7/2015 10:22
3978,20154904104947-550,2,7/6/2015 10:13,1436202780,C3,85320,1436288100,7/7/2015 9:55
6103,20150605070642-510,1,7/6/2015 7:58,1436194680,C3,89520,1436284200,7/7/2015 8:50
790,20154201104250-936,2,7/5/2015 20:24,1436153040,C2,126840,1436279880,7/7/2015 7:38
4513,20155501035544-811,3,7/4/2015 11:31,1436034660,C6,243360,1436278020,7/7/2015 7:07
1728,20154725104717-951,2,7/3/2015 8:17,1435936620,C7,341100,1436277720,7/7/2015 7:02
1923,20152201042213-827,1,7/3/2015 7:58,1435935480,C5,341820,1436277300,7/7/2015 6:55
4984,20153521043512-619,2,7/3/2015 8:32,1435937520,C4,335940,1436273460,7/7/2015 5:51
959,20154003114038-680,2,7/6/2015 7:13,1436191980,C3,81060,1436273040,7/7/2015 5:44
3914,20154325044303-21,2,7/3/2015 8:53,1435938780,C5,331500,1436270280,7/7/2015 4:58
776,20155217105219-132,2,7/2/2015 5:40,1435840800,C2,425760,1436266560,7/7/2015 3:56
6544,20151028011029-820,3,7/6/2015 4:54,1436183640,C0,82680,1436266320,7/7/2015 3:52
6330,20154422114404-501,1,7/2/2015 6:26,1435843560,C5,422460,1436266020,7/7/2015 3:47
668,20154801084800-755,1,7/6/2015 4:13,1436181180,C8,83100,1436264280,7/7/2015 3:18
1443,20154001124007-163,1,7/5/2015 17:37,1436143020,C2,121140,1436264160,7/7/2015 3:16
109,20153026033020-755,3,7/1/2015 21:02,1435809720,C6,451920,1436261640,7/7/2015 2:34
3049,20150801020830-440,1,7/5/2015 6:02,1436101320,C4,158220,1436259540,7/7/2015 1:59
4039,20154129084132-74,1,7/6/2015 1:13,1436170380,C3,82560,1436252940,7/7/2015 0:09
4737,20153126063149-265,1,7/1/2015 15:02,1435788120,C6,462660,1436250780,7/6/2015 23:33
5230,20155404065421-768,1,7/5/2015 14:31,1436131860,C4,113820,1436245680,7/6/2015 22:08
1385,20150930010911-718,1,7/3/2015 17:20,1435969200,C4,274260,1436243460,7/6/2015 21:31
4949,20154603024647-48,2,7/5/2015 19:12,1436148720,C8,94380,1436243100,7/6/2015 21:25
6040,20153123023120-949,2,7/3/2015 12:55,1435953300,C4,286080,1436239380,7/6/2015 20:23
1086,20151221041237-821,1,7/1/2015 18:40,1435801200,C5,436440,1436237640,7/6/2015 19:54
4355,20153730123713-648,1,7/5/2015 18:27,1436146020,C8,90600,1436236620,7/6/2015 19:37
725,20150103100100-923,2,7/5/2015 15:57,1436137020,C5,97080,1436234100,7/6/2015 18:55
5801,20152219012207-18,3,7/2/2015 11:19,1435861140,C5,371940,1436233080,7/6/2015 18:38
5650,20152524082502-366,1,7/3/2015 15:58,1435964280,C5,268260,1436232540,7/6/2015 18:29
568,20155328035326-113,2,7/2/2015 17:09,1435882140,C6,350160,1436232300,7/6/2015 18:25
5076,20155412025439-711,2,7/4/2015 1:18,1435997880,C0,231480,1436229360,7/6/2015 17:36
530,20150030050049-156,2,7/3/2015 16:52,1435967520,C3,258720,1436226240,7/6/2015 16:44
4956,20154630044606-595,3,7/4/2015 16:34,1436052840,C8,172440,1436225280,7/6/2015 16:28
5578,20151330051300-634,1,7/3/2015 16:22,1435965720,C0,256140,1436221860,7/6/2015 15:31
2239,20154830104827-205,1,7/4/2015 13:02,1436040120,C0,176820,1436216940,7/6/2015 14:09
6440,20153730013733-766,3,7/5/2015 19:58,1436151480,C0,64980,1436216460,7/6/2015 14:01
5212,20150127030110-863,1,7/5/2015 16:22,1436138520,C7,77340,1436215860,7/6/2015 13:51
1463,20154303024324-525,2,7/5/2015 14:07,1436130420,C5,85320,1436215740,7/6/2015 13:49
5568,20154623074640-436,3,7/3/2015 5:46,1435927560,C5,285600,1436213160,7/6/2015 13:06
5488,20151726071747-488,1,7/1/2015 9:45,1435769100,C0,440880,1436209980,7/6/2015 12:13
3739,20153914093936-718,1,6/30/2015 23:27,1435732020,C3,477360,1436209380,7/6/2015 12:03
3164,20154128104144-208,2,7/5/2015 14:09,1436130540,C6,77160,1436207700,7/6/2015 11:35
3590,20152326082325-308,1,7/5/2015 4:43,1436096580,C7,109200,1436205780,7/6/2015 11:03
628,20154606074613-942,2,7/3/2015 2:26,1435915560,C5,289200,1436204760,7/6/2015 10:46
6079,20154620114644-698,2,7/1/2015 2:22,1435742520,C5,458280,1436200800,7/6/2015 9:40
2291,20151801111852-365,1,7/3/2015 20:52,1435981920,C6,207240,1436189160,7/6/2015 6:26
6502,20155828095857-94,2,7/5/2015 6:00,1436101200,C2,84360,1436185560,7/6/2015 5:26
2623,20152329052335-690,1,7/4/2015 0:53,1435996380,C5,186300,1436182680,7/6/2015 4:38
3065,20155024045031-794,3,7/2/2015 8:28,1435850880,C5,330540,1436181420,7/6/2015 4:17
467,20153902073935-578,2,7/4/2015 20:35,1436067300,C8,109680,1436176980,7/6/2015 3:03
2344,20155230035222-748,2,7/4/2015 7:06,1436018760,C8,157020,1436175780,7/6/2015 2:43
3146,20153330113330-512,2,7/4/2015 4:45,1436010300,C5,160560,1436170860,7/6/2015 1:21
2624,20151322121351-809,1,7/3/2015 18:43,1435974180,C8,194760,1436168940,7/6/2015 0:49
893,20154702124720-238,3,7/5/2015 3:35,1436092500,C5,75360,1436167860,7/6/2015 0:31
3738,20153126113104-616,1,7/3/2015 15:13,1435961580,C5,206040,1436167620,7/6/2015 0:27
1747,20154112014114-381,1,7/3/2015 16:00,1435964400,C6,202980,1436167380,7/6/2015 0:23
2148,20151613111653-93,1,6/30/2015 13:58,1435697880,C7,461880,1436159760,7/5/2015 22:16
2525,20151323091336-516,1,7/1/2015 16:55,1435794900,C5,359460,1436154360,7/5/2015 20:46
2518,20152302052353-71,1,7/5/2015 1:47,1436086020,C5,67680,1436153700,7/5/2015 20:35
2725,20153326103309-465,2,7/2/2015 16:39,1435880340,C7,270180,1436150520,7/5/2015 19:42
3897,20152003112040-99,1,7/4/2015 15:01,1436047260,C2,99660,1436146920,7/5/2015 18:42
4089,20153120113117-670,2,6/29/2015 23:42,1435646520,C4,499980,1436146500,7/5/2015 18:35
5023,20153808083849-175,1,7/1/2015 4:08,1435748880,C8,394200,1436143080,7/5/2015 17:38
5866,20150517080508-420,2,7/3/2015 10:15,1435943700,C2,198600,1436142300,7/5/2015 17:25
6074,20153721073751-968,1,6/28/2015 12:22,1435519320,C6,621900,1436141220,7/5/2015 17:07
1067,20153620053622-72,1,7/3/2015 19:26,1435976760,C0,161400,1436138160,7/5/2015 16:16
4453,20153003023020-726,1,7/4/2015 15:01,1436047260,C3,88260,1436135520,7/5/2015 15:32
3044,20150104040106-481,1,6/27/2015 21:31,1435465860,C4,669000,1436134860,7/5/2015 15:21
3917,20155601025658-508,1,7/3/2015 15:06,1435961160,C6,173400,1436134560,7/5/2015 15:16
2084,20150229050210-638,1,7/3/2015 15:38,1435963080,C5,170280,1436133360,7/5/2015 14:56
3562,20150628010613-142,1,7/4/2015 20:02,1436065320,C2,67920,1436133240,7/5/2015 14:54
2293,20155919015912-624,1,7/3/2015 14:13,1435957980,C8,172920,1436130900,7/5/2015 14:15
5160,20151913091934-158,1,7/1/2015 3:35,1435746900,C8,383640,1436130540,7/5/2015 14:09
2507,20151429091426-986,2,7/3/2015 12:08,1435950480,C5,178020,1436128500,7/5/2015 13:35
3353,20152017012017-5,1,7/3/2015 6:52,1435931520,C8,194160,1436125680,7/5/2015 12:48
3894,20152726042728-687,2,7/2/2015 13:09,1435867740,C5,253260,1436121000,7/5/2015 11:30
6098,20152103042134-429,2,7/4/2015 20:37,1436067420,C7,50880,1436118300,7/5/2015 10:45
4739,20151701121746-803,1,7/1/2015 16:09,1435792140,C6,325740,1436117880,7/5/2015 10:38
170,20150801120859-136,2,7/3/2015 11:23,1435947780,C6,170100,1436117880,7/5/2015 10:38
5688,20155608015646-673,1,7/2/2015 17:14,1435882440,C7,231720,1436114160,7/5/2015 9:36
3368,20150008060003-21,1,7/2/2015 0:02,1435820520,C7,293160,1436113680,7/5/2015 9:28
6226,20151212011241-763,3,7/1/2015 12:47,1435780020,C8,328020,1436108040,7/5/2015 7:54
867,20152828012807-551,2,7/1/2015 22:31,1435815060,C6,291780,1436106840,7/5/2015 7:34
3326,20154820114822-453,2,7/3/2015 10:15,1435943700,C4,159660,1436103360,7/5/2015 6:36
968,20151211051259-166,1,6/29/2015 8:48,1435592880,C4,508320,1436101200,7/5/2015 6:00
4747,20154513064520-256,2,7/2/2015 17:57,1435885020,C5,210240,1436095260,7/5/2015 4:21
5918,20154213024208-839,2,6/24/2015 9:15,1435162500,C2,930780,1436093280,7/5/2015 3:48
1287,20152702082701-295,1,7/3/2015 17:38,1435970280,C6,119460,1436089740,7/5/2015 2:49
3634,20155829095814-906,3,7/3/2015 5:10,1435925400,C7,164160,1436089560,7/5/2015 2:46
6478,20153813043802-884,2,7/2/2015 9:20,1435854000,C8,230760,1436084760,7/5/2015 1:26
2688,20153216013237-980,2,6/25/2015 19:23,1435285380,C6,798660,1436084040,7/5/2015 1:14
4839,20150430120449-822,2,7/2/2015 17:58,1435885080,C6,194040,1436079120,7/4/2015 23:52
879,20151929101959-58,3,7/3/2015 2:41,1435916460,C8,159060,1436075520,7/4/2015 22:52
5269,20155115055136-775,1,6/29/2015 8:55,1435593300,C6,481980,1436075280,7/4/2015 22:48
3998,20154019124057-626,1,7/1/2015 1:49,1435740540,C5,332580,1436073120,7/4/2015 22:12
5961,20155006035017-391,3,6/27/2015 20:17,1435461420,C5,610140,1436071560,7/4/2015 21:46
3155,20152325012334-763,1,7/1/2015 17:51,1435798260,C5,267240,1436065500,7/4/2015 20:05
4095,20152730062720-372,1,7/3/2015 15:57,1435964220,C0,97800,1436062020,7/4/2015 19:07
4768,20150222020245-78,1,6/30/2015 17:18,1435709880,C8,351480,1436061360,7/4/2015 18:56
1170,20152619052643-277,3,7/3/2015 2:14,1435914840,C3,144360,1436059200,7/4/2015 18:20
1327,20153626023632-111,1,7/2/2015 0:32,1435822320,C0,233880,1436056200,7/4/2015 17:30
2968,20154726114701-192,1,7/1/2015 23:33,1435818780,C5,237180,1436055960,7/4/2015 17:26
283,20154316104341-889,3,7/2/2015 15:47,1435877220,C4,175080,1436052300,7/4/2015 16:25
4128,20150312050331-531,3,6/23/2015 16:43,1435102980,C3,949200,1436052180,7/4/2015 16:23
287,20154428064410-192,3,7/3/2015 11:34,1435948440,C8,89880,1436038320,7/4/2015 12:32
2609,20151802061810-813,1,7/3/2015 9:21,1435940460,C0,97380,1436037840,7/4/2015 12:24
5300,20151701071741-626,3,7/2/2015 21:19,1435897140,C2,136920,1436034060,7/4/2015 11:21
2833,20153921093922-779,2,6/30/2015 2:17,1435655820,C5,375540,1436031360,7/4/2015 10:36
1186,20155826045826-106,2,6/30/2015 13:38,1435696680,C6,333600,1436030280,7/4/2015 10:18
2305,20153722033750-276,1,7/1/2015 11:34,1435775640,C5,254340,1436029980,7/4/2015 10:13
1237,20152827042814-470,2,7/2/2015 17:46,1435884360,C4,145560,1436029920,7/4/2015 10:12
4164,20153101083156-266,2,7/2/2015 20:55,1435895700,C0,131040,1436026740,7/4/2015 9:19
4317,20153601083632-281,3,7/2/2015 19:52,1435891920,C2,126960,1436018880,7/4/2015 7:08
5478,20152730062723-66,2,7/3/2015 6:33,1435930380,C0,86520,1436016900,7/4/2015 6:35
2450,20150820070819-746,2,7/2/2015 16:04,1435878240,C0,133620,1436011860,7/4/2015 5:11
5880,20153029033048-921,2,7/3/2015 10:40,1435945200,C8,65640,1436010840,7/4/2015 4:54
5352,20151614091646-956,1,7/1/2015 17:04,1435795440,C0,213840,1436009280,7/4/2015 4:28
4654,20152727032726-130,1,7/2/2015 12:39,1435865940,C4,140640,1436006580,7/4/2015 3:43
5973,20150806110818-449,1,6/24/2015 21:40,1435207200,C2,796560,1436003760,7/4/2015 2:56
1082,20151728101733-413,3,7/2/2015 4:51,1435837860,C5,163020,1436000880,7/4/2015 2:08
2856,20151711011732-63,3,6/22/2015 19:40,1435027200,C0,973380,1436000580,7/4/2015 2:03
6372,20153028123046-38,3,7/2/2015 5:14,1435839240,C8,159720,1435998960,7/4/2015 1:36
759,20152522072551-380,2,7/2/2015 14:17,1435871820,C4,126960,1435998780,7/4/2015 1:33
2908,20155826125821-822,3,7/3/2015 5:14,1435925640,C3,72120,1435997760,7/4/2015 1:16
3226,20155515095508-771,2,6/24/2015 17:07,1435190820,C0,803520,1435994340,7/4/2015 0:19
5515,20155811055815-517,1,6/28/2015 9:28,1435508880,C5,479400,1435988280,7/3/2015 22:38
2326,20150527020511-685,1,7/1/2015 19:29,1435804140,C8,182520,1435986660,7/3/2015 22:11
4333,20155425085422-138,1,6/29/2015 15:20,1435616400,C2,368760,1435985160,7/3/2015 21:46
41,20153419063412-632,1,7/2/2015 6:42,1435844520,C0,140460,1435984980,7/3/2015 21:43
4222,20150416030444-791,3,6/28/2015 2:32,1435483920,C8,495840,1435979760,7/3/2015 20:16
1175,20150417100406-907,3,6/28/2015 8:34,1435505640,C7,472500,1435978140,7/3/2015 19:49
3724,20150529110523-979,2,7/2/2015 8:51,1435852260,C4,125580,1435977840,7/3/2015 19:44
6375,20150231050204-372,2,6/29/2015 16:15,1435619700,C8,357540,1435977240,7/3/2015 19:34
1373,20154729104715-725,1,7/1/2015 14:37,1435786620,C4,186600,1435973220,7/3/2015 18:27
2444,20150203060210-288,1,6/28/2015 16:12,1435533120,C8,439320,1435972440,7/3/2015 18:14
2387,20155914095952-732,2,6/30/2015 11:14,1435688040,C8,277380,1435965420,7/3/2015 16:17
5657,20150621010643-875,2,7/2/2015 9:12,1435853520,C7,104040,1435957560,7/3/2015 14:06
5618,20153521043509-287,2,6/29/2015 14:11,1435612260,C5,341280,1435953540,7/3/2015 12:59
713,20154317064310-833,1,7/1/2015 10:55,1435773300,C8,174960,1435948260,7/3/2015 11:31
1657,20154530034515-528,1,7/2/2015 12:25,1435865100,C3,80400,1435945500,7/3/2015 10:45
1511,20151121121107-368,1,7/2/2015 2:43,1435830180,C2,114540,1435944720,7/3/2015 10:32
6468,20151325051319-382,3,6/30/2015 20:21,1435720860,C5,221640,1435942500,7/3/2015 9:55
4244,20151012091054-963,2,6/26/2015 9:16,1435335360,C7,604980,1435940340,7/3/2015 9:19
2166,20151805061831-133,1,6/26/2015 19:22,1435371720,C0,567480,1435939200,7/3/2015 9:00
5105,20153026023048-941,1,7/1/2015 2:48,1435744080,C5,194940,1435939020,7/3/2015 8:57
339,20150129090159-131,2,7/2/2015 8:31,1435851060,C0,85800,1435936860,7/3/2015 8:21
627,20154923074927-301,2,7/1/2015 21:55,1435812900,C6,123660,1435936560,7/3/2015 8:16
5426,20151417011439-309,2,6/28/2015 1:02,1435478520,C5,453240,1435931760,7/3/2015 6:56
4931,20154228054230-169,1,7/2/2015 3:03,1435831380,C5,97620,1435929000,7/3/2015 6:10
3870,20154629044625-977,2,7/2/2015 8:01,1435849260,C3,75900,1435925160,7/3/2015 5:06
1758,20155402085412-825,1,6/29/2015 17:42,1435624920,C6,295560,1435920480,7/3/2015 3:48
3658,20155009035012-229,2,6/30/2015 3:42,1435660920,C3,252960,1435913880,7/3/2015 1:58
517,20155430055405-608,3,7/2/2015 6:32,1435843920,C5,65940,1435909860,7/3/2015 0:51
2469,20152830022847-358,3,7/1/2015 19:14,1435803240,C3,103560,1435906800,7/3/2015 0:00
1866,20151122031145-815,2,7/1/2015 20:15,1435806900,C6,99480,1435906380,7/2/2015 23:53
4899,20151101051151-134,1,7/2/2015 8:28,1435850880,C4,55020,1435905900,7/2/2015 23:45
1153,20151823081833-359,1,7/1/2015 18:29,1435800540,C0,103980,1435904520,7/2/2015 23:22
1697,20152712102715-951,2,6/30/2015 16:11,1435705860,C5,196980,1435902840,7/2/2015 22:54
4879,20152317012346-970,1,7/1/2015 0:33,1435735980,C7,166200,1435902180,7/2/2015 22:43
5089,20151015061023-821,1,6/27/2015 12:26,1435433160,C4,467220,1435900380,7/2/2015 22:13
3245,20151305081322-814,1,6/29/2015 19:33,1435631580,C4,264300,1435895880,7/2/2015 20:58
425,20153826053837-25,2,6/29/2015 18:48,1435628880,C4,263400,1435892280,7/2/2015 19:58
1108,20151026081006-92,2,6/30/2015 15:40,1435704000,C5,186300,1435890300,7/2/2015 19:25
1087,20154909034948-631,1,6/27/2015 0:07,1435388820,C4,499560,1435888380,7/2/2015 18:53
5150,20150616060652-850,3,6/30/2015 17:04,1435709040,C5,178440,1435887480,7/2/2015 18:38
4441,20154430014454-721,1,7/2/2015 0:16,1435821360,C7,62160,1435883520,7/2/2015 17:32
396,20151128091155-501,1,7/1/2015 15:11,1435788660,C5,93600,1435882260,7/2/2015 17:11
3617,20155816045813-135,3,6/24/2015 16:36,1435188960,C2,689880,1435878840,7/2/2015 16:14
1632,20150907080945-381,1,6/28/2015 9:54,1435510440,C8,364140,1435874580,7/2/2015 15:03
1257,20152426012444-553,1,7/1/2015 20:48,1435808880,C5,65520,1435874400,7/2/2015 15:00
1476,20154618094619-43,2,6/25/2015 12:20,1435260000,C2,614040,1435874040,7/2/2015 14:54
3048,20154212104244-750,1,6/29/2015 5:57,1435582620,C8,290340,1435872960,7/2/2015 14:36
1434,20151223091254-664,1,7/1/2015 14:00,1435784400,C3,88560,1435872960,7/2/2015 14:36
5349,20155324075301-513,3,6/30/2015 12:32,1435692720,C4,178380,1435871100,7/2/2015 14:05
573,20150627070602-460,2,7/1/2015 5:21,1435753260,C5,113100,1435866360,7/2/2015 12:46
4757,20155026035048-916,1,7/1/2015 18:27,1435800420,C0,63060,1435863480,7/2/2015 11:58
1898,20155122015143-390,2,6/27/2015 12:37,1435433820,C6,427560,1435861380,7/2/2015 11:23
3542,20153221093222-957,2,7/1/2015 2:03,1435741380,C8,119580,1435860960,7/2/2015 11:16
3767,20154919094921-666,2,6/28/2015 2:39,1435484340,C8,375900,1435860240,7/2/2015 11:04
3981,20152128062123-84,3,7/1/2015 8:48,1435765680,C4,89340,1435855020,7/2/2015 9:37
3627,20154220084208-864,2,6/30/2015 8:47,1435679220,C8,172860,1435852080,7/2/2015 8:48
298,20151710121709-837,1,6/25/2015 1:33,1435221180,C5,628680,1435849860,7/2/2015 8:11
4422,20155919085937-643,3,6/27/2015 23:39,1435473540,C5,372000,1435845540,7/2/2015 6:59
3492,20155612055615-47,3,6/26/2015 15:40,1435358400,C5,484980,1435843380,7/2/2015 6:23
1798,20151314081340-101,1,6/29/2015 23:53,1435647180,C5,193200,1435840380,7/2/2015 5:33
2174,20151310041329-620,1,6/25/2015 0:07,1435216020,C5,619020,1435835040,7/2/2015 4:04
5661,20152729032736-810,2,6/30/2015 21:43,1435725780,C2,108960,1435834740,7/2/2015 3:59
492,20153729063729-602,1,7/1/2015 4:35,1435750500,C5,82740,1435833240,7/2/2015 3:34
2250,20155020095009-169,3,6/28/2015 5:08,1435493280,C7,337140,1435830420,7/2/2015 2:47
422,20153422113416-107,1,6/27/2015 0:17,1435389420,C3,438540,1435827960,7/2/2015 2:06
195,20150123040140-843,3,6/29/2015 23:28,1435645680,C4,181740,1435827420,7/2/2015 1:57
5820,20155908075949-522,2,6/26/2015 2:56,1435312560,C3,512340,1435824900,7/2/2015 1:15
3173,20155124095131-809,1,6/30/2015 3:15,1435659300,C2,164880,1435824180,7/2/2015 1:03
5552,20155626105649-404,1,6/30/2015 15:17,1435702620,C0,120420,1435823040,7/2/2015 0:44
4795,20150815040821-280,1,6/29/2015 21:58,1435640280,C4,175800,1435816080,7/1/2015 22:48
5815,20153801063806-347,1,6/16/2015 14:04,1434488640,C2,1322760,1435811400,7/1/2015 21:30
5066,20150607010649-553,2,6/29/2015 3:46,1435574760,C2,233400,1435808160,7/1/2015 20:36
4725,20153727053754-806,1,6/30/2015 19:37,1435718220,C4,88800,1435807020,7/1/2015 20:17
18,20155529015507-923,1,7/1/2015 2:07,1435741620,C5,65160,1435806780,7/1/2015 20:13
4727,20153021073045-85,1,6/28/2015 7:54,1435503240,C8,303120,1435806360,7/1/2015 20:06
4689,20152213052248-272,2,6/22/2015 18:24,1435022640,C3,781320,1435803960,7/1/2015 19:26
5453,20154612074618-947,3,6/29/2015 15:22,1435616520,C5,187020,1435803540,7/1/2015 19:19
5154,20152729032750-703,2,7/1/2015 1:37,1435739820,C0,61500,1435801320,7/1/2015 18:42
3101,20155318075334-519,2,6/28/2015 9:41,1435509660,C3,290160,1435799820,7/1/2015 18:17
4466,20154127084141-786,3,6/30/2015 6:57,1435672620,C5,126480,1435799100,7/1/2015 18:05
2537,20153626023634-935,1,7/1/2015 2:03,1435741380,C2,55260,1435796640,7/1/2015 17:24
4125,20155129025110-549,2,7/1/2015 0:25,1435735500,C2,60420,1435795920,7/1/2015 17:12
3408,20153808123846-946,2,6/28/2015 19:36,1435545360,C7,250440,1435795800,7/1/2015 17:10
4388,20151127061106-88,3,6/30/2015 12:56,1435694160,C0,94500,1435788660,7/1/2015 15:11
1199,20154627094625-389,2,6/30/2015 5:12,1435666320,C4,121380,1435787700,7/1/2015 14:55
6438,20155324075339-328,1,6/29/2015 4:27,1435577220,C8,209820,1435787040,7/1/2015 14:44
116,20152620042635-437,3,6/27/2015 23:16,1435472160,C5,314700,1435786860,7/1/2015 14:41
997,20154701124730-552,1,6/27/2015 19:50,1435459800,C4,324540,1435784340,7/1/2015 13:59
5227,20155725095739-361,2,6/29/2015 11:49,1435603740,C4,176160,1435779900,7/1/2015 12:45
5541,20154522074550-726,3,6/28/2015 9:27,1435508820,C0,262260,1435771080,7/1/2015 10:18
2524,20155229035239-568,3,6/30/2015 19:42,1435718520,C7,50100,1435768620,7/1/2015 9:37
5939,20152113112111-474,1,6/25/2015 10:05,1435251900,C5,516120,1435768020,7/1/2015 9:27
3309,20150720110747-627,1,6/30/2015 0:01,1435647660,C3,117720,1435765380,7/1/2015 8:43
4871,20153407083404-897,1,6/19/2015 8:37,1434728220,C2,1036980,1435765200,7/1/2015 8:40
4255,20155023065026-661,1,6/30/2015 8:07,1435676820,C5,87060,1435763880,7/1/2015 8:18
5943,20152925072930-684,3,6/29/2015 20:02,1435633320,C5,130260,1435763580,7/1/2015 8:13
6276,20155827045831-194,1,6/30/2015 3:04,1435658640,C4,104580,1435763220,7/1/2015 8:07
3666,20154627094652-597,1,6/30/2015 8:22,1435677720,C2,84720,1435762440,7/1/2015 7:54
1230,20153529083516-535,1,6/30/2015 8:14,1435677240,C0,85140,1435762380,7/1/2015 7:53
2255,20155721075705-83,1,6/27/2015 22:29,1435469340,C8,285360,1435754700,7/1/2015 5:45
1537,20153624093618-492,1,6/30/2015 7:56,1435676160,C7,73200,1435749360,7/1/2015 4:16
4146,20150016010039-314,3,6/29/2015 7:01,1435586460,C2,157380,1435743840,7/1/2015 2:44
2156,20151021041005-169,1,6/29/2015 21:41,1435639260,C8,101580,1435740840,7/1/2015 1:54
5690,20151109091155-536,3,6/25/2015 14:26,1435267560,C2,467100,1435734660,7/1/2015 0:11
2285,20155228125210-442,3,6/29/2015 17:54,1435625640,C0,104520,1435730160,6/30/2015 22:56
209,20152528092511-140,3,6/30/2015 2:25,1435656300,C8,73800,1435730100,6/30/2015 22:55
1948,20153627113639-711,1,6/29/2015 19:08,1435630080,C3,99960,1435730040,6/30/2015 22:54
2687,20151826091818-219,1,6/29/2015 19:27,1435631220,C5,98580,1435729800,6/30/2015 22:50
5779,20153121113129-538,2,6/28/2015 12:46,1435520760,C2,203100,1435723860,6/30/2015 21:11
3154,20154928124919-762,2,6/30/2015 1:59,1435654740,C4,66900,1435721640,6/30/2015 20:34
4798,20154227114255-944,1,6/29/2015 17:34,1435624440,C2,96960,1435721400,6/30/2015 20:30
3963,20153428023417-311,3,6/30/2015 2:26,1435656360,C8,64560,1435720920,6/30/2015 20:22
2110,20153525043522-499,1,6/30/2015 4:44,1435664640,C3,55620,1435720260,6/30/2015 20:11
179,20154824124835-785,1,6/28/2015 17:26,1435537560,C0,181140,1435718700,6/30/2015 19:45
5067,20150227070202-589,2,6/29/2015 15:28,1435616880,C5,101580,1435718460,6/30/2015 19:41
2896,20151801061858-931,1,6/27/2015 12:42,1435434120,C3,283680,1435717800,6/30/2015 19:30
4158,20152328112340-523,1,6/30/2015 0:47,1435650420,C8,67320,1435717740,6/30/2015 19:29
6412,20154920054923-830,2,6/29/2015 1:49,1435567740,C8,144000,1435711740,6/30/2015 17:49
5314,20154612114650-326,1,6/24/2015 14:52,1435182720,C7,523980,1435706700,6/30/2015 16:25
2621,20150827070822-694,3,6/29/2015 13:04,1435608240,C5,97080,1435705320,6/30/2015 16:02
3056,20152126092144-384,2,6/29/2015 14:18,1435612680,C5,92340,1435705020,6/30/2015 15:57
3691,20152507042535-456,1,6/22/2015 23:07,1435039620,C5,660060,1435699680,6/30/2015 14:28
6449,20151120071106-120,1,6/29/2015 7:22,1435587720,C5,111180,1435698900,6/30/2015 14:15
2080,20154227054240-936,1,6/29/2015 20:42,1435635720,C5,61200,1435696920,6/30/2015 13:42
1217,20154928064939-570,2,6/29/2015 10:01,1435597260,C3,97920,1435695180,6/30/2015 13:13
458,20150426010442-203,1,6/29/2015 5:04,1435579440,C5,115200,1435694640,6/30/2015 13:04
199,20152118072137-646,2,6/29/2015 4:25,1435577100,C3,117480,1435694580,6/30/2015 13:03
4844,20150503080543-310,1,6/27/2015 11:49,1435430940,C2,260880,1435691820,6/30/2015 12:17
5475,20152905032910-293,1,6/22/2015 4:57,1434974220,C7,715440,1435689660,6/30/2015 11:41
6264,20154414124412-684,1,6/25/2015 6:12,1435237920,C6,450660,1435688580,6/30/2015 11:23
6165,20151927081907-93,1,6/28/2015 21:42,1435552920,C6,134580,1435687500,6/30/2015 11:05
5282,20155528055512-788,2,6/29/2015 20:37,1435635420,C8,48060,1435683480,6/30/2015 9:58
1419,20155523085557-121,2,6/28/2015 1:31,1435480260,C5,202680,1435682940,6/30/2015 9:49
2555,20154527104510-24,1,6/28/2015 20:50,1435549800,C4,122700,1435672500,6/30/2015 6:55
5257,20153309043302-556,2,6/25/2015 3:12,1435227120,C4,444780,1435671900,6/30/2015 6:45
5444,20153514073548-195,2,6/26/2015 6:56,1435326960,C5,344820,1435671780,6/30/2015 6:43
898,20152515082556-333,2,6/28/2015 9:40,1435509600,C7,161100,1435670700,6/30/2015 6:25
1868,20154023044047-684,1,6/28/2015 14:40,1435527600,C5,141600,1435669200,6/30/2015 6:00
4937,20151623051636-911,2,6/29/2015 10:21,1435598460,C2,70500,1435668960,6/30/2015 5:56
2340,20151113071127-855,3,6/26/2015 0:11,1435302660,C3,366000,1435668660,6/30/2015 5:51
963,20153128113151-636,1,6/29/2015 8:31,1435591860,C2,75600,1435667460,6/30/2015 5:31
4658,20152220112252-143,1,6/26/2015 23:04,1435385040,C2,280260,1435665300,6/30/2015 4:55
2053,20153821073821-483,1,6/28/2015 17:13,1435536780,C8,127860,1435664640,6/30/2015 4:44
2233,20154026034051-679,2,6/29/2015 0:22,1435562520,C8,102060,1435664580,6/30/2015 4:43
4867,20154115024109-180,2,6/25/2015 7:59,1435244340,C5,419940,1435664280,6/30/2015 4:38
3142,20150318040329-875,1,6/29/2015 0:00,1435561200,C7,99180,1435660380,6/30/2015 3:33
5731,20155826045853-500,1,6/29/2015 6:46,1435585560,C4,74160,1435659720,6/30/2015 3:22
5168,20150224040251-670,1,6/28/2015 7:20,1435501200,C2,157140,1435658340,6/30/2015 2:59
626,20153516053542-376,2,6/28/2015 10:45,1435513500,C2,144600,1435658100,6/30/2015 2:55
2924,20151009091020-539,2,6/23/2015 3:44,1435056240,C4,595020,1435651260,6/30/2015 1:01
67,20152523032526-775,1,6/28/2015 10:13,1435511580,C3,137760,1435649340,6/30/2015 0:29
3394,20150112050156-642,1,6/27/2015 20:26,1435461960,C8,186900,1435648860,6/30/2015 0:21
2434,20154514124545-947,1,6/24/2015 4:05,1435143900,C5,501600,1435645500,6/29/2015 23:25
5958,20151303111300-96,1,6/26/2015 15:22,1435357320,C7,286020,1435643340,6/29/2015 22:49
3003,20152127122100-117,1,6/29/2015 3:13,1435572780,C5,69960,1435642740,6/29/2015 22:39
5197,20155021095034-253,3,6/28/2015 20:48,1435549680,C7,92040,1435641720,6/29/2015 22:22
3538,20153723103701-496,3,6/27/2015 18:17,1435454220,C5,186600,1435640820,6/29/2015 22:07
5752,20154617044627-301,1,6/28/2015 8:30,1435505400,C3,131520,1435636920,6/29/2015 21:02
6104,20152414012455-891,1,6/24/2015 18:26,1435195560,C7,441060,1435636620,6/29/2015 20:57
1692,20153814023849-856,1,6/27/2015 23:00,1435471200,C8,164760,1435635960,6/29/2015 20:46
5854,20152517072506-105,3,6/26/2015 17:25,1435364700,C3,271200,1435635900,6/29/2015 20:45
4557,20151025051035-258,1,6/28/2015 19:40,1435545600,C4,89400,1435635000,6/29/2015 20:30
5540,20151919051903-993,3,6/28/2015 16:39,1435534740,C0,96900,1435631640,6/29/2015 19:34
3315,20151823061853-546,1,6/28/2015 3:33,1435487580,C3,140700,1435628280,6/29/2015 18:38
3873,20151924051922-114,2,6/28/2015 1:51,1435481460,C8,144960,1435626420,6/29/2015 18:07
5144,20155620035613-395,1,6/28/2015 16:04,1435532640,C2,86460,1435619100,6/29/2015 16:05
5999,20155417035454-444,3,6/27/2015 22:30,1435469400,C6,147960,1435617360,6/29/2015 15:36
3709,20152012102044-576,3,6/25/2015 7:29,1435242540,C5,370980,1435613520,6/29/2015 14:32
2995,20151914081957-769,1,6/24/2015 11:55,1435172100,C4,438480,1435610580,6/29/2015 13:43
2194,20152619062611-689,3,6/26/2015 3:14,1435313640,C4,296640,1435610280,6/29/2015 13:38
4019,20152421022448-172,1,6/28/2015 16:08,1435532880,C3,76380,1435609260,6/29/2015 13:21
651,20153927033926-724,3,6/28/2015 21:39,1435552740,C5,54000,1435606740,6/29/2015 12:39
4303,20155327055311-62,3,6/28/2015 14:50,1435528200,C6,75420,1435603620,6/29/2015 11:47
4262,20152124032130-189,1,6/28/2015 4:51,1435492260,C3,102600,1435594860,6/29/2015 9:21
507,20155522115544-987,2,6/28/2015 12:28,1435519680,C4,74340,1435594020,6/29/2015 9:07
1816,20150408060458-999,1,6/26/2015 8:10,1435331400,C6,260460,1435591860,6/29/2015 8:31
5451,20150907070951-183,1,6/26/2015 21:17,1435378620,C6,211560,1435590180,6/29/2015 8:03
6397,20152314062321-228,2,6/21/2015 19:10,1434939000,C6,650820,1435589820,6/29/2015 7:57
3529,20153322053325-204,3,6/27/2015 2:59,1435399140,C5,189780,1435588920,6/29/2015 7:42
379,20150822090837-736,2,6/28/2015 2:53,1435485180,C8,99180,1435584360,6/29/2015 6:26
1597,20154117024144-496,3,6/25/2015 8:57,1435247820,C5,335280,1435583100,6/29/2015 6:05
180,20152725032725-88,1,6/27/2015 10:26,1435425960,C2,154740,1435580700,6/29/2015 5:25
2457,20151816031811-238,1,6/25/2015 0:26,1435217160,C0,362040,1435579200,6/29/2015 5:00
1301,20151619071622-794,1,6/25/2015 20:54,1435290840,C5,283740,1435574580,6/29/2015 3:43
5697,20152521082543-773,2,6/28/2015 6:41,1435498860,C2,74820,1435573680,6/29/2015 3:28
6383,20150717030756-157,1,6/25/2015 7:17,1435241820,C8,331500,1435573320,6/29/2015 3:22
3035,20153524063556-760,1,6/27/2015 11:07,1435428420,C5,137760,1435566180,6/29/2015 1:23
3527,20150120020159-683,1,6/28/2015 2:41,1435484460,C4,81300,1435565760,6/29/2015 1:16
6279,20152912072922-999,1,6/23/2015 10:51,1435081860,C0,481260,1435563120,6/29/2015 0:32
949,20155011095054-239,1,6/24/2015 14:23,1435180980,C2,379860,1435560840,6/28/2015 23:54
1746,20154112014114-381,1,6/26/2015 15:05,1435356300,C6,202440,1435558740,6/28/2015 23:19
2485,20154024034035-259,2,6/28/2015 5:50,1435495800,C8,62040,1435557840,6/28/2015 23:04
5991,20150522030548-312,1,6/26/2015 19:31,1435372260,C7,180780,1435553040,6/28/2015 21:44
5612,20155926125931-19,1,6/27/2015 16:59,1435449540,C2,100800,1435550340,6/28/2015 20:59
2580,20154802114807-830,1,6/25/2015 13:23,1435263780,C4,284700,1435548480,6/28/2015 20:28
157,20153906123947-442,1,6/26/2015 1:11,1435306260,C7,240960,1435547220,6/28/2015 20:07
1402,20152815102844-133,2,6/24/2015 8:28,1435159680,C4,385200,1435544880,6/28/2015 19:28
4094,20154210104209-855,1,6/26/2015 10:46,1435340760,C7,197520,1435538280,6/28/2015 17:38
2202,20155022075038-528,1,6/26/2015 14:08,1435352880,C2,184140,1435537020,6/28/2015 17:17
1498,20151924051901-835,2,6/26/2015 16:45,1435362300,C0,170760,1435533060,6/28/2015 16:11
2468,20154713064720-448,3,6/26/2015 1:47,1435308420,C8,221040,1435529460,6/28/2015 15:11
918,20155324085325-903,3,6/27/2015 4:33,1435404780,C3,121800,1435526580,6/28/2015 14:23
560,20152108052101-440,1,6/23/2015 14:21,1435094460,C5,428400,1435522860,6/28/2015 13:21
6161,20153924103929-927,3,6/27/2015 4:19,1435403940,C7,118200,1435522140,6/28/2015 13:09
1048,20151116081119-191,1,6/27/2015 6:05,1435410300,C7,104760,1435515060,6/28/2015 11:11
516,20152120062126-798,2,6/27/2015 9:16,1435421760,C0,87900,1435509660,6/28/2015 9:41
238,20154623084625-271,2,6/27/2015 3:10,1435399800,C4,108480,1435508280,6/28/2015 9:18
1455,20150510020551-789,3,6/26/2015 3:04,1435313040,C8,191820,1435504860,6/28/2015 8:21
3115,20154126064136-539,3,6/27/2015 7:15,1435414500,C0,88440,1435502940,6/28/2015 7:49
1981,20151818071851-924,2,6/24/2015 23:28,1435213680,C5,288300,1435501980,6/28/2015 7:33
3484,20150723090724-2,1,6/25/2015 19:06,1435284360,C0,208740,1435493100,6/28/2015 5:05
3370,20154512054518-584,2,6/23/2015 1:01,1435046460,C8,445080,1435491540,6/28/2015 4:39
2193,20154308034359-236,1,6/18/2015 10:00,1434646800,C4,843420,1435490220,6/28/2015 4:17
749,20155216125240-140,1,6/26/2015 5:37,1435322220,C8,167580,1435489800,6/28/2015 4:10
6362,20153621033624-514,3,6/24/2015 21:41,1435207260,C3,281100,1435488360,6/28/2015 3:46
4898,20151224041202-651,2,6/26/2015 23:30,1435386600,C4,99540,1435486140,6/28/2015 3:09
4858,20155720065732-452,1,6/26/2015 3:30,1435314600,C3,168660,1435483260,6/28/2015 2:21
2179,20155118105146-971,1,6/24/2015 21:07,1435205220,C4,277680,1435482900,6/28/2015 2:15
5931,20151604031616-721,3,6/24/2015 4:06,1435143960,C8,337560,1435481520,6/28/2015 1:52
3469,20153604113610-711,3,6/21/2015 5:09,1434888540,C8,589140,1435477680,6/28/2015 0:48
380,20155725075744-903,1,6/26/2015 16:22,1435360920,C6,116700,1435477620,6/28/2015 0:47
3859,20152311102311-455,2,6/25/2015 15:29,1435271340,C6,204660,1435476000,6/28/2015 0:20
917,20151813031843-852,1,6/26/2015 9:26,1435335960,C3,137760,1435473720,6/27/2015 23:42
5121,20154625034642-17,3,6/23/2015 19:32,1435113120,C2,359880,1435473000,6/27/2015 23:30
4430,20152319082350-281,1,6/26/2015 12:58,1435348680,C8,124260,1435472940,6/27/2015 23:29
4983,20150422040421-938,1,6/27/2015 2:09,1435396140,C8,76380,1435472520,6/27/2015 23:22
1190,20152218122205-541,1,6/24/2015 19:34,1435199640,C5,272160,1435471800,6/27/2015 23:10
2165,20155720095752-177,1,6/25/2015 10:41,1435254060,C2,217320,1435471380,6/27/2015 23:03
1931,20155823075842-421,2,6/25/2015 14:03,1435266180,C6,194700,1435460880,6/27/2015 20:08
5209,20154926084915-416,2,6/22/2015 10:04,1434992640,C8,467460,1435460100,6/27/2015 19:55
4838,20150425010456-10,1,6/27/2015 1:26,1435393560,C7,65460,1435459020,6/27/2015 19:37
3218,20153719123745-647,3,6/25/2015 0:57,1435219020,C5,238200,1435457220,6/27/2015 19:07
1515,20151720081740-125,3,6/26/2015 13:07,1435349220,C8,107160,1435456380,6/27/2015 18:53
4971,20153709073753-995,3,6/18/2015 13:05,1434657900,C6,797280,1435455180,6/27/2015 18:33
3253,20154521074546-272,2,6/26/2015 2:27,1435310820,C5,137640,1435448460,6/27/2015 16:41
2863,20154420054455-558,2,6/25/2015 22:41,1435297260,C0,149940,1435447200,6/27/2015 16:20
3270,20152424062413-508,1,6/26/2015 12:32,1435347120,C5,97440,1435444560,6/27/2015 15:36
3237,20153721043746-702,3,6/25/2015 15:53,1435272780,C0,171480,1435444260,6/27/2015 15:31
5095,20150422080420-314,3,6/26/2015 7:10,1435327800,C0,114120,1435441920,6/27/2015 14:52
2626,20154825054846-818,1,6/26/2015 23:30,1435386600,C8,53460,1435440060,6/27/2015 14:21
5171,20152016062004-516,2,6/26/2015 4:13,1435317180,C8,122340,1435439520,6/27/2015 14:12
272,20152509072520-737,1,6/25/2015 6:54,1435240440,C3,197220,1435437660,6/27/2015 13:41
1569,20151307091345-782,1,6/17/2015 11:26,1434565560,C3,871980,1435437540,6/27/2015 13:39
6516,20155319035359-974,1,6/24/2015 21:35,1435206900,C8,226260,1435433160,6/27/2015 12:26
3580,20150910020919-2,3,6/23/2015 6:51,1435067460,C5,365640,1435433100,6/27/2015 12:25
1112,20152515012542-655,1,6/25/2015 9:40,1435250400,C8,170100,1435420500,6/27/2015 8:55
2760,20152224092219-261,1,6/26/2015 9:02,1435334520,C5,85800,1435420320,6/27/2015 8:52
5827,20151411091404-225,1,6/22/2015 0:26,1434957960,C8,459360,1435417320,6/27/2015 8:02
36,20152115032120-829,1,6/24/2015 9:51,1435164660,C2,252600,1435417260,6/27/2015 8:01
3734,20150804030847-490,1,6/24/2015 11:36,1435170960,C7,245040,1435416000,6/27/2015 7:40
890,20155711125712-255,1,6/22/2015 1:09,1434960540,C5,453960,1435414500,6/27/2015 7:15
4848,20152915032948-543,1,6/23/2015 9:39,1435077540,C3,335100,1435412640,6/27/2015 6:44
5671,20150603100608-37,3,6/19/2015 6:58,1434722280,C5,685560,1435407840,6/27/2015 5:24
6359,20154021124002-193,3,6/24/2015 8:44,1435160640,C2,245040,1435405680,6/27/2015 4:48
1088,20151414071412-997,1,6/22/2015 21:36,1435034160,C8,371460,1435405620,6/27/2015 4:47
5338,20153419023448-961,1,6/25/2015 21:14,1435292040,C8,108480,1435400520,6/27/2015 3:22
1478,20152005072047-527,2,6/19/2015 20:22,1434770520,C8,628260,1435398780,6/27/2015 2:53
5375,20151921121956-754,3,6/24/2015 7:27,1435156020,C6,241680,1435397700,6/27/2015 2:35
4399,20154412114408-299,2,6/19/2015 17:38,1434760680,C2,626040,1435386720,6/26/2015 23:32
5857,20153818043830-284,2,6/22/2015 20:05,1435028700,C2,358020,1435386720,6/26/2015 23:32
2072,20155618085648-561,1,6/24/2015 2:24,1435137840,C8,247440,1435385280,6/26/2015 23:08
3212,20152113072113-341,2,6/24/2015 14:46,1435182360,C8,195420,1435377780,6/26/2015 21:03
3693,20151821051837-55,1,6/25/2015 3:36,1435228560,C3,148140,1435376700,6/26/2015 20:45
873,20150623020640-155,1,6/25/2015 18:14,1435281240,C5,93840,1435375080,6/26/2015 20:18
5059,20153624063634-720,2,6/25/2015 13:15,1435263300,C4,110340,1435373640,6/26/2015 19:54
2865,20154623064643-371,1,6/25/2015 15:04,1435269840,C2,101340,1435371180,6/26/2015 19:13
6423,20153723043748-531,2,6/25/2015 18:17,1435281420,C3,89400,1435370820,6/26/2015 19:07
4846,20153114083105-937,1,6/23/2015 15:10,1435097400,C2,267180,1435364580,6/26/2015 17:23
4663,20152124122113-381,3,6/25/2015 22:59,1435298340,C5,62340,1435360680,6/26/2015 16:18
3847,20155514115559-607,1,6/20/2015 14:03,1434834180,C0,526080,1435360260,6/26/2015 16:11
4068,20151515051521-888,1,6/23/2015 0:13,1435043580,C8,314940,1435358520,6/26/2015 15:42
2375,20152920042942-140,1,6/24/2015 14:27,1435181220,C4,169140,1435350360,6/26/2015 13:26
1656,20155023115047-443,1,6/25/2015 12:06,1435259160,C5,86880,1435346040,6/26/2015 12:14
5576,20151219081235-39,1,6/22/2015 21:44,1435034640,C4,307920,1435342560,6/26/2015 11:16
154,20155417085454-80,3,6/24/2015 22:44,1435211040,C8,130920,1435341960,6/26/2015 11:06
5534,20154914084953-37,3,6/23/2015 9:16,1435076160,C4,259740,1435335900,6/26/2015 9:25
6078,20154019104036-155,2,6/22/2015 21:44,1435034640,C0,299040,1435333680,6/26/2015 8:48
2522,20150108040111-888,1,6/24/2015 3:08,1435140480,C4,190860,1435331340,6/26/2015 8:09
1390,20154502084556-629,2,6/23/2015 7:21,1435069260,C4,258480,1435327740,6/26/2015 7:09
608,20154810044808-531,1,6/22/2015 8:45,1434987900,C2,335940,1435323840,6/26/2015 6:04
440,20153704113707-880,1,6/18/2015 23:51,1434696660,C4,626820,1435323480,6/26/2015 5:58
4075,20154508054512-557,1,6/20/2015 8:41,1434814860,C7,502080,1435316940,6/26/2015 4:09
2882,20152319092320-59,1,6/22/2015 18:40,1435023600,C4,292620,1435316220,6/26/2015 3:57
4967,20151222031241-371,1,6/24/2015 23:18,1435213080,C2,100980,1435314060,6/26/2015 3:21
408,20155923075941-191,3,6/24/2015 17:16,1435191360,C2,119820,1435311180,6/26/2015 2:33
4047,20155122015113-891,1,6/24/2015 22:17,1435209420,C5,101580,1435311000,6/26/2015 2:30
1704,20154118104113-978,3,6/25/2015 1:42,1435221720,C0,81780,1435303500,6/26/2015 0:25
5013,20152909122903-721,3,6/23/2015 22:38,1435124280,C4,178020,1435302300,6/26/2015 0:05
1628,20154821044849-587,3,6/23/2015 19:58,1435114680,C6,184200,1435298880,6/25/2015 23:08
6175,20152823032800-166,3,6/24/2015 19:11,1435198260,C6,99780,1435298040,6/25/2015 22:54
5563,20152218012209-123,1,6/24/2015 17:12,1435191120,C8,106440,1435297560,6/25/2015 22:46
1889,20153123053127-918,1,6/25/2015 4:57,1435233420,C0,63780,1435297200,6/25/2015 22:40
5902,20153319103352-70,2,6/25/2015 2:56,1435226160,C5,70140,1435296300,6/25/2015 22:25
5507,20150312020332-263,1,6/23/2015 16:53,1435103580,C8,192120,1435295700,6/25/2015 22:15
999,20150722100759-856,3,6/24/2015 18:11,1435194660,C5,100920,1435295580,6/25/2015 22:13
2281,20155121065100-589,1,6/24/2015 17:57,1435193820,C4,99720,1435293540,6/25/2015 21:39
6095,20154824104802-646,3,6/21/2015 20:08,1434942480,C7,350400,1435292880,6/25/2015 21:28
786,20150019050058-11,2,6/23/2015 18:36,1435109760,C5,175680,1435285440,6/25/2015 19:24
2763,20152519052551-298,1,6/22/2015 18:21,1435022460,C0,262560,1435285020,6/25/2015 19:17
5824,20155919085948-945,3,6/23/2015 14:05,1435093500,C3,181980,1435275480,6/25/2015 16:38
2328,20150221080255-974,3,6/24/2015 14:11,1435180260,C5,93780,1435274040,6/25/2015 16:14
198,20153717123759-246,1,6/22/2015 22:57,1435039020,C7,234600,1435273620,6/25/2015 16:07
4402,20152721012702-519,2,6/24/2015 14:42,1435182120,C2,87900,1435270020,6/25/2015 15:07
1258,20150420120432-763,3,6/24/2015 16:59,1435190340,C8,72660,1435263000,6/25/2015 13:10
5783,20153002123026-8,3,6/22/2015 15:30,1435012200,C7,248400,1435260600,6/25/2015 12:30
1184,20151809111800-66,1,6/20/2015 3:08,1434794880,C5,460500,1435255380,6/25/2015 11:03
26,20153622043643-625,1,6/24/2015 12:14,1435173240,C5,78540,1435251780,6/25/2015 10:03
278,20151712051721-6,1,6/22/2015 5:26,1434975960,C0,273780,1435249740,6/25/2015 9:29
828,20154713014720-385,1,6/23/2015 10:02,1435078920,C8,170100,1435249020,6/25/2015 9:17
2177,20151520041535-563,2,6/23/2015 19:25,1435112700,C4,135300,1435248000,6/25/2015 9:00
3126,20150518020503-955,1,6/24/2015 9:17,1435162620,C6,83520,1435246140,6/25/2015 8:29
4647,20151317101348-437,1,6/24/2015 7:04,1435154640,C8,84780,1435239420,6/25/2015 6:37
539,20152417062433-543,1,6/22/2015 14:12,1435007520,C8,230040,1435237560,6/25/2015 6:06
6157,20151515081555-958,3,6/24/2015 2:55,1435139700,C4,94800,1435234500,6/25/2015 5:15
4014,20155815085831-779,1,6/23/2015 18:46,1435110360,C6,121080,1435231440,6/25/2015 4:24
4948,20151121111157-61,3,6/23/2015 22:03,1435122180,C8,105960,1435228140,6/25/2015 3:29
671,20151006101058-57,1,6/23/2015 1:14,1435047240,C4,179580,1435226820,6/25/2015 3:07
3781,20151717071728-569,1,6/22/2015 12:09,1435000140,C4,224760,1435224900,6/25/2015 2:35
4996,20152422092440-277,1,6/24/2015 2:06,1435136760,C8,73260,1435210020,6/24/2015 22:27
6432,20151820051846-474,2,6/24/2015 4:33,1435145580,C8,59940,1435205520,6/24/2015 21:12
3787,20150420100412-238,2,6/23/2015 9:20,1435076400,C2,128280,1435204680,6/24/2015 20:58
1609,20151416011455-25,2,6/22/2015 2:20,1434964800,C4,239580,1435204380,6/24/2015 20:53
268,20153320113340-933,1,6/23/2015 9:33,1435077180,C8,126000,1435203180,6/24/2015 20:33
4880,20155507095534-53,3,6/22/2015 14:16,1435007760,C7,187380,1435195140,6/24/2015 18:19
2579,20155228125229-86,3,6/21/2015 17:08,1434931680,C0,261120,1435192800,6/24/2015 17:40
5226,20155021055038-706,3,6/23/2015 16:14,1435101240,C7,83520,1435184760,6/24/2015 15:26
2451,20152206102254-44,2,6/18/2015 11:24,1434651840,C7,520260,1435172100,6/24/2015 11:55
6296,20153121123116-781,3,6/23/2015 12:05,1435086300,C4,85620,1435171920,6/24/2015 11:52
6291,20153016033036-967,1,6/23/2015 7:42,1435070520,C6,96120,1435166640,6/24/2015 10:24
5486,20151115031100-780,1,6/22/2015 5:26,1434975960,C4,189900,1435165860,6/24/2015 10:11
4660,20154920094954-832,3,6/23/2015 1:21,1435047660,C5,114360,1435162020,6/24/2015 9:07
4602,20154519024544-322,2,6/21/2015 23:37,1434955020,C4,204720,1435159740,6/24/2015 8:29
1788,20151320091309-87,1,6/23/2015 8:19,1435072740,C4,85320,1435158060,6/24/2015 8:01
3655,20155620025615-452,1,6/23/2015 1:40,1435048800,C5,105720,1435154520,6/24/2015 7:02
2870,20151118091136-43,3,6/22/2015 7:31,1434983460,C8,169800,1435153260,6/24/2015 6:41
4346,20150517050533-767,3,6/22/2015 0:49,1434959340,C5,186720,1435146060,6/24/2015 4:41
6031,20152914062905-376,1,6/23/2015 1:17,1435047420,C5,94860,1435142280,6/24/2015 3:38
2176,20153601093619-939,1,6/21/2015 6:32,1434893520,C8,245280,1435138800,6/24/2015 2:40
6513,20155911095900-214,2,6/19/2015 20:35,1434771300,C5,364680,1435135980,6/24/2015 1:53
65,20154918074910-267,1,6/22/2015 3:25,1434968700,C8,164880,1435133580,6/24/2015 1:13
5263,20153606073656-187,1,6/19/2015 14:48,1434750480,C3,383040,1435133520,6/24/2015 1:12
1388,20152312032319-646,2,6/21/2015 4:41,1434886860,C4,246360,1435133220,6/24/2015 1:07
2164,20153315043301-166,3,6/21/2015 22:18,1434950280,C2,179700,1435129980,6/24/2015 0:13
1358,20153520033505-60,1,6/22/2015 7:23,1434982980,C4,143280,1435126260,6/23/2015 23:11
3718,20154017114049-331,1,6/23/2015 3:14,1435054440,C4,69720,1435124160,6/23/2015 22:36
1806,20153202123219-728,3,6/21/2015 13:28,1434918480,C0,205620,1435124100,6/23/2015 22:35
2633,20153813093827-417,1,6/22/2015 14:15,1435007700,C3,113460,1435121160,6/23/2015 21:46
6414,20155721095721-40,1,6/23/2015 1:43,1435048980,C5,71580,1435120560,6/23/2015 21:36
5585,20151201081219-907,2,6/21/2015 8:52,1434901920,C6,216300,1435118220,6/23/2015 20:57
5096,20151522051555-293,3,6/23/2015 6:43,1435066980,C2,48480,1435115460,6/23/2015 20:11
2374,20150329010340-772,2,6/20/2015 15:18,1434838680,C3,272700,1435111380,6/23/2015 19:03
4373,20153513013506-980,3,6/18/2015 15:40,1434667200,C3,439500,1435106700,6/23/2015 17:45
5381,20153514073524-157,3,6/21/2015 7:50,1434898200,C5,201900,1435100100,6/23/2015 15:55
2679,20154907054902-752,2,6/21/2015 20:37,1434944220,C5,152460,1435096680,6/23/2015 14:58
2322,20153414023451-770,3,6/22/2015 13:14,1435004040,C3,85800,1435089840,6/23/2015 13:04
156,20150305060300-527,1,6/17/2015 10:17,1434561420,C5,526020,1435087440,6/23/2015 12:24
1337,20155520125548-491,1,6/22/2015 11:49,1434998940,C8,84420,1435083360,6/23/2015 11:16
2184,20150624080656-470,1,6/13/2015 8:20,1434208800,C8,864420,1435073220,6/23/2015 8:27
2881,20152919012937-798,1,6/21/2015 10:41,1434908460,C6,162720,1435071180,6/23/2015 7:53
136,20151308081312-606,1,6/20/2015 10:43,1434822180,C2,248280,1435070460,6/23/2015 7:41
1018,20153416013418-86,2,6/21/2015 1:32,1434875520,C8,194340,1435069860,6/23/2015 7:31
4297,20152012032058-382,2,6/22/2015 2:56,1434966960,C4,102420,1435069380,6/23/2015 7:23
460,20152307102329-186,1,6/18/2015 0:11,1434611460,C5,456840,1435068300,6/23/2015 7:05
4414,20152420022419-264,2,6/22/2015 14:48,1435009680,C3,58080,1435067760,6/23/2015 6:56
3983,20151619061642-149,2,6/21/2015 22:38,1434951480,C0,115860,1435067340,6/23/2015 6:49
2486,20151815041843-802,1,6/19/2015 11:18,1434737880,C4,327600,1435065480,6/23/2015 6:18
2787,20154119094154-19,2,6/22/2015 6:35,1434980100,C0,82680,1435062780,6/23/2015 5:33
3400,20154914124917-488,1,6/22/2015 3:03,1434967380,C8,93720,1435061100,6/23/2015 5:05
3015,20152908102913-779,1,6/20/2015 17:54,1434848040,C8,212700,1435060740,6/23/2015 4:59
4104,20152513092510-818,2,6/21/2015 18:25,1434936300,C6,120600,1435056900,6/23/2015 3:55
77,20153619123625-792,3,6/21/2015 8:00,1434898800,C3,156240,1435055040,6/23/2015 3:24
3853,20154211054209-984,2,6/18/2015 9:18,1434644280,C0,406620,1435050900,6/23/2015 2:15
5640,20152215122235-485,1,6/19/2015 7:15,1434723300,C6,327180,1435050480,6/23/2015 2:08
3515,20155616035629-355,1,6/20/2015 22:34,1434864840,C8,184740,1435049580,6/23/2015 1:53
4196,20155720025749-383,1,6/22/2015 10:54,1434995640,C0,52740,1435048380,6/23/2015 1:33
294,20152215082242-794,1,6/21/2015 3:07,1434881220,C3,166500,1435047720,6/23/2015 1:22
561,20150116050129-415,2,6/19/2015 20:45,1434771900,C6,272640,1435044540,6/23/2015 0:29
880,20155519105547-921,1,6/21/2015 19:19,1434939540,C5,101520,1435041060,6/22/2015 23:31
697,20154111084119-363,1,6/21/2015 12:03,1434913380,C2,125160,1435038540,6/22/2015 22:49
1058,20153213083242-735,1,6/19/2015 17:04,1434758640,C2,274560,1435033200,6/22/2015 21:20
2900,20153007083052-124,1,6/18/2015 23:03,1434693780,C0,334260,1435028040,6/22/2015 19:54
4067,20154729084718-7,2,6/20/2015 8:11,1434813060,C7,210960,1435024020,6/22/2015 18:47
1213,20155613065614-139,1,6/20/2015 9:26,1434817560,C2,204600,1435022160,6/22/2015 18:16
502,20155605125623-741,3,6/20/2015 14:15,1434834900,C5,185820,1435020720,6/22/2015 17:52
5450,20153719113733-632,1,6/21/2015 21:52,1434948720,C4,69900,1435018620,6/22/2015 17:17
6042,20155712085725-362,1,6/19/2015 6:05,1434719100,C4,297240,1435016340,6/22/2015 16:39
2057,20153020053014-949,1,6/22/2015 0:50,1434959400,C7,56400,1435015800,6/22/2015 16:30
3678,20151807121828-117,2,6/17/2015 14:42,1434577320,C2,436320,1435013640,6/22/2015 15:54
2128,20150201080212-913,2,6/20/2015 6:58,1434808680,C5,204720,1435013400,6/22/2015 15:50
2613,20155307025311-47,1,6/20/2015 18:28,1434850080,C2,162300,1435012380,6/22/2015 15:33
3497,20154309114329-296,2,6/18/2015 5:53,1434631980,C5,378300,1435010280,6/22/2015 14:58
1076,20153419053450-999,1,6/21/2015 21:37,1434947820,C4,62460,1435010280,6/22/2015 14:58
2647,20154210124201-733,1,6/18/2015 13:56,1434660960,C4,347820,1435008780,6/22/2015 14:33
4515,20150803060828-975,3,6/20/2015 3:05,1434794700,C5,208260,1435002960,6/22/2015 12:56
5516,20155517025520-359,1,6/20/2015 21:35,1434861300,C2,141600,1435002900,6/22/2015 12:55
2806,20150018050050-556,2,6/20/2015 14:40,1434836400,C4,164400,1435000800,6/22/2015 12:20
1737,20150612090614-805,1,6/21/2015 5:40,1434890400,C2,109320,1434999720,6/22/2015 12:02
111,20155212055238-204,1,6/20/2015 20:57,1434859020,C8,140460,1434999480,6/22/2015 11:58
1396,20151210121248-239,1,6/21/2015 3:00,1434880800,C1,114660,1434995460,6/22/2015 10:51
6096,20150914090940-696,1,6/21/2015 1:54,1434876840,C8,115740,1434992580,6/22/2015 10:03
3144,20155418045458-340,1,6/20/2015 12:46,1434829560,C0,157920,1434987480,6/22/2015 8:38
1456,20151218051211-725,3,6/20/2015 12:49,1434829740,C6,157020,1434986760,6/22/2015 8:26
2742,20153118023112-598,3,6/21/2015 9:25,1434903900,C2,80280,1434984180,6/22/2015 7:43
3112,20153317123351-161,1,6/21/2015 12:13,1434913980,C8,68880,1434982860,6/22/2015 7:21
1849,20152415102404-680,2,6/18/2015 20:49,1434685740,C4,296700,1434982440,6/22/2015 7:14
4802,20150613070629-561,2,6/19/2015 6:04,1434719040,C8,257340,1434976380,6/22/2015 5:33
712,20153203093248-618,1,6/15/2015 22:46,1434433560,C5,542220,1434975780,6/22/2015 5:23
4648,20154404074423-76,1,6/19/2015 5:39,1434717540,C8,257700,1434975240,6/22/2015 5:14
5142,20153013013015-228,1,6/17/2015 21:19,1434601140,C2,373740,1434974880,6/22/2015 5:08
3414,20150616120616-647,1,6/20/2015 7:20,1434810000,C4,164220,1434974220,6/22/2015 4:57
1993,20153307123351-488,1,6/20/2015 8:47,1434815220,C8,158520,1434973740,6/22/2015 4:49
4710,20153217103218-546,1,6/19/2015 19:19,1434766740,C4,204420,1434971160,6/22/2015 4:06
2676,20152917022939-684,2,6/19/2015 21:16,1434773760,C4,197220,1434970980,6/22/2015 4:03
3020,20153919063918-509,1,6/20/2015 17:12,1434845520,C3,124380,1434969900,6/22/2015 3:45
2443,20151215021211-822,1,6/19/2015 22:02,1434776520,C7,186900,1434963420,6/22/2015 1:57
6212,20155412045446-0,1,6/18/2015 22:36,1434692160,C8,269460,1434961620,6/22/2015 1:27
663,20155922025905-519,2,6/14/2015 10:26,1434302760,C4,656940,1434959700,6/22/2015 0:55
3647,20155511075557-246,2,6/18/2015 9:29,1434644940,C3,305220,1434950160,6/21/2015 22:16
4833,20152004092005-697,2,6/19/2015 17:32,1434760320,C8,189360,1434949680,6/21/2015 22:08
5245,20153919023921-5,2,6/21/2015 3:29,1434882540,C5,66300,1434948840,6/21/2015 21:54
5086,20155516055530-619,3,6/20/2015 4:29,1434799740,C5,148620,1434948360,6/21/2015 21:46
5922,20155417055404-842,2,6/20/2015 19:03,1434852180,C5,87780,1434939960,6/21/2015 19:26
2480,20152119122102-412,1,6/21/2015 0:47,1434872820,C5,65580,1434938400,6/21/2015 19:00
2304,20151201071206-107,3,6/19/2015 5:14,1434716040,C8,221160,1434937200,6/21/2015 18:40
1318,20154213024216-561,1,6/19/2015 17:33,1434760380,C4,176220,1434936600,6/21/2015 18:30
5241,20151017081005-686,1,6/20/2015 6:52,1434808320,C8,127260,1434935580,6/21/2015 18:13
2904,20155213115254-355,1,6/20/2015 16:32,1434843120,C2,88800,1434931920,6/21/2015 17:12
3422,20152010012044-386,1,6/20/2015 10:56,1434822960,C4,106920,1434929880,6/21/2015 16:38
10,20152119012112-241,1,6/20/2015 14:45,1434836700,C4,91440,1434928140,6/21/2015 16:09
4336,20153912053941-227,1,6/18/2015 15:29,1434666540,C4,255300,1434921840,6/21/2015 14:24
5898,20152917022938-308,2,6/20/2015 3:53,1434797580,C2,110520,1434908100,6/21/2015 10:35
1930,20155417075442-571,1,6/20/2015 1:28,1434788880,C3,118020,1434906900,6/21/2015 10:15
3312,20152313102357-845,2,6/17/2015 10:11,1434561060,C0,344880,1434905940,6/21/2015 9:59
6433,20153619103622-151,1,6/20/2015 9:05,1434816300,C4,80940,1434897240,6/21/2015 7:34
400,20150017100000-961,2,6/19/2015 8:41,1434728460,C4,168060,1434896520,6/21/2015 7:22
2262,20152614112619-98,2,6/19/2015 0:26,1434698760,C3,196200,1434894960,6/21/2015 6:56
1181,20155909075931-597,3,6/17/2015 7:09,1434550140,C2,344100,1434894240,6/21/2015 6:44
4308,20154507074526-430,1,6/19/2015 17:21,1434759660,C2,133920,1434893580,6/21/2015 6:33
839,20152507042512-111,1,6/19/2015 13:19,1434745140,C3,146520,1434891660,6/21/2015 6:01
6461,20150409100452-47,1,6/18/2015 6:40,1434634800,C0,255120,1434889920,6/21/2015 5:32
6533,20151014091022-504,1,6/20/2015 5:52,1434804720,C6,84420,1434889140,6/21/2015 5:19
395,20155106085152-545,1,6/19/2015 7:18,1434723480,C2,159660,1434883140,6/21/2015 3:39
5748,20153417073443-887,3,6/20/2015 2:58,1434794280,C0,80880,1434875160,6/21/2015 1:26
5724,20153411023411-472,1,6/19/2015 20:47,1434772020,C4,101940,1434873960,6/21/2015 1:06
4708,20155312015304-1,1,6/20/2015 2:17,1434791820,C2,81180,1434873000,6/21/2015 0:50
4761,20155222025248-836,1,6/16/2015 3:07,1434449220,C8,423540,1434872760,6/21/2015 0:46
6515,20151506031529-885,3,6/19/2015 5:04,1434715440,C7,155220,1434870660,6/21/2015 0:11
3192,20155311045315-402,1,6/17/2015 21:19,1434601140,C4,267180,1434868320,6/20/2015 23:32
4780,20155308075334-739,1,6/18/2015 11:52,1434653520,C4,209220,1434862740,6/20/2015 21:59
5674,20155004085057-252,3,6/18/2015 19:48,1434682080,C0,178440,1434860520,6/20/2015 21:22
3288,20152104052130-587,2,6/18/2015 19:55,1434682500,C2,174120,1434856620,6/20/2015 20:17
4142,20153514023510-367,1,6/20/2015 2:59,1434794340,C5,59580,1434853920,6/20/2015 19:32
3204,20152517042527-36,1,6/19/2015 17:15,1434759300,C2,87900,1434847200,6/20/2015 17:40
2642,20155202065231-630,1,6/14/2015 13:20,1434313200,C7,530040,1434843240,6/20/2015 16:34
3765,20153708073703-436,2,6/16/2015 13:17,1434485820,C0,355800,1434841620,6/20/2015 16:07
2777,20154620024622-348,2,6/15/2015 11:41,1434393660,C8,447060,1434840720,6/20/2015 15:52
6305,20153704083744-741,3,6/18/2015 14:41,1434663660,C5,175920,1434839580,6/20/2015 15:33
4498,20155107105141-423,2,6/16/2015 5:23,1434457380,C2,378960,1434836340,6/20/2015 14:39
3641,20154916014913-150,3,6/19/2015 6:19,1434719940,C0,116100,1434836040,6/20/2015 14:34
3194,20155813105800-351,3,6/19/2015 18:42,1434764520,C5,68280,1434832800,6/20/2015 13:40
702,20155904055905-326,2,6/18/2015 12:37,1434656220,C7,170040,1434826260,6/20/2015 11:51
540,20154914054916-877,2,6/19/2015 17:45,1434761100,C0,61680,1434822780,6/20/2015 10:53
5572,20150218080215-880,3,6/19/2015 9:12,1434730320,C4,90600,1434820920,6/20/2015 10:22
2270,20154416074444-263,1,6/18/2015 8:47,1434642420,C4,176580,1434819000,6/20/2015 9:50
4137,20151816121814-878,1,6/19/2015 2:08,1434704880,C8,111300,1434816180,6/20/2015 9:03
3521,20152711112749-922,3,6/19/2015 6:00,1434718800,C2,95940,1434814740,6/20/2015 8:39
1277,20152311102347-770,1,6/19/2015 4:56,1434714960,C0,95940,1434810900,6/20/2015 7:35
2561,20154318074327-65,2,6/19/2015 7:02,1434722520,C3,83940,1434806460,6/20/2015 6:21
404,20154810034812-304,3,6/17/2015 1:28,1434529680,C4,276600,1434806280,6/20/2015 6:18
1871,20155711035748-460,3,6/19/2015 3:58,1434711480,C4,92580,1434804060,6/20/2015 5:41
6094,20151012111048-832,1,6/16/2015 7:15,1434464100,C4,331500,1434795600,6/20/2015 3:20
5034,20153915063929-257,1,6/18/2015 12:19,1434655140,C7,139800,1434794940,6/20/2015 3:09
129,20152603032638-774,1,6/18/2015 1:21,1434615660,C5,177900,1434793560,6/20/2015 2:46
4451,20154317014329-54,1,6/19/2015 5:57,1434718620,C5,72420,1434791040,6/20/2015 2:04
22,20155817095851-242,3,6/19/2015 4:40,1434714000,C4,76860,1434790860,6/20/2015 2:01
5556,20150007110022-413,2,6/13/2015 18:00,1434243600,C2,543600,1434787200,6/20/2015 1:00
2104,20153618123612-480,2,6/19/2015 6:31,1434720660,C6,64500,1434785160,6/20/2015 0:26
5026,20150816050850-701,1,6/18/2015 21:58,1434689880,C8,95100,1434784980,6/20/2015 0:23
5979,20151011011032-480,2,6/17/2015 4:36,1434540960,C8,243780,1434784740,6/20/2015 0:19
4273,20154213044221-384,1,6/19/2015 3:01,1434708060,C8,67020,1434775080,6/19/2015 21:38
2953,20152116052127-688,1,6/18/2015 19:57,1434682620,C2,91080,1434773700,6/19/2015 21:15
4864,20150918040902-934,1,6/19/2015 6:21,1434720060,C2,51120,1434771180,6/19/2015 20:33
4718,20153510023528-508,2,6/18/2015 19:39,1434681540,C4,88680,1434770220,6/19/2015 20:17
188,20151007061036-970,2,6/15/2015 15:12,1434406320,C5,361860,1434768180,6/19/2015 19:43
554,20154810074844-679,2,6/18/2015 5:43,1434631380,C8,136740,1434768120,6/19/2015 19:42
966,20155613125611-113,1,6/19/2015 2:56,1434707760,C5,60300,1434768060,6/19/2015 19:41
948,20152807062821-864,1,6/16/2015 14:58,1434491880,C5,269400,1434761280,6/19/2015 17:48
3975,20152913022938-375,3,6/17/2015 15:55,1434581700,C8,175380,1434757080,6/19/2015 16:38
3961,20155612075623-190,1,6/18/2015 9:31,1434645060,C8,104820,1434749880,6/19/2015 14:38
344,20151316021336-107,3,6/18/2015 13:35,1434659700,C2,85260,1434744960,6/19/2015 13:16
384,20151613031640-694,1,6/15/2015 9:48,1434386880,C5,353940,1434740820,6/19/2015 12:07
4821,20151515041526-196,1,6/18/2015 13:09,1434658140,C4,82680,1434740820,6/19/2015 12:07
3697,20152614032608-515,3,6/17/2015 21:12,1434600720,C8,139980,1434740700,6/19/2015 12:05
270,20153407123403-76,2,6/16/2015 11:52,1434480720,C2,258360,1434739080,6/19/2015 11:38
5250,20155809125823-570,1,6/18/2015 7:06,1434636360,C3,94560,1434730920,6/19/2015 9:22
6089,20153508053537-848,3,6/16/2015 16:50,1434498600,C2,229500,1434728100,6/19/2015 8:35
1619,20155417065430-542,1,6/13/2015 18:59,1434247140,C8,475260,1434722400,6/19/2015 7:00
5694,20150715100705-414,1,6/17/2015 23:59,1434610740,C5,111360,1434722100,6/19/2015 6:55
894,20153217103251-836,1,6/18/2015 8:34,1434641640,C2,79320,1434720960,6/19/2015 6:36
5716,20152004042018-896,3,6/17/2015 4:20,1434540000,C6,180000,1434720000,6/19/2015 6:20
6169,20152107072157-137,1,6/15/2015 6:39,1434375540,C8,344340,1434719880,6/19/2015 6:18
2641,20153716033726-119,2,6/17/2015 22:08,1434604080,C2,109860,1434713940,6/19/2015 4:39
2554,20155106065150-500,1,6/17/2015 13:52,1434574320,C5,139380,1434713700,6/19/2015 4:35
19,20151106121113-182,2,6/14/2015 22:55,1434347700,C8,364920,1434712620,6/19/2015 4:17
6353,20154913024913-440,2,6/18/2015 10:54,1434650040,C7,59700,1434709740,6/19/2015 3:29
4077,20152008082056-988,1,6/15/2015 12:50,1434397800,C7,310500,1434708300,6/19/2015 3:05
4901,20151813021824-408,2,6/16/2015 8:22,1434468120,C3,237840,1434705960,6/19/2015 2:26
2440,20155813115831-288,1,6/17/2015 5:32,1434544320,C0,161220,1434705540,6/19/2015 2:19
5604,20152305092355-533,2,6/14/2015 11:29,1434306540,C7,392580,1434699120,6/19/2015 0:32
506,20152923012904-916,3,6/10/2015 4:19,1433935140,C5,761100,1434696240,6/18/2015 23:44
2300,20151616021636-386,1,6/17/2015 18:52,1434592320,C6,102960,1434695280,6/18/2015 23:28
5345,20150907060938-780,2,6/17/2015 6:51,1434549060,C6,144420,1434693480,6/18/2015 22:58
1369,20154009054046-633,3,6/15/2015 21:10,1434427800,C5,265500,1434693300,6/18/2015 22:55
6020,20153603023614-793,1,6/13/2015 19:40,1434249600,C5,441120,1434690720,6/18/2015 22:12
6041,20150210020219-563,1,6/17/2015 23:54,1434610440,C4,80040,1434690480,6/18/2015 22:08
1101,20150309010348-628,1,6/15/2015 18:09,1434416940,C5,268380,1434685320,6/18/2015 20:42
6558,20154005024018-445,1,6/15/2015 11:58,1434394680,C0,284760,1434679440,6/18/2015 19:04
4278,20155409065419-204,3,6/15/2015 14:56,1434405360,C7,273660,1434679020,6/18/2015 18:57
1890,20151707051709-188,2,6/15/2015 23:56,1434437760,C4,238380,1434676140,6/18/2015 18:09
3858,20154407024412-194,1,6/15/2015 22:53,1434433980,C0,240180,1434674160,6/18/2015 17:36
2627,20152012032058-971,1,6/16/2015 15:22,1434493320,C5,172860,1434666180,6/18/2015 15:23
5204,20155706075734-63,2,6/14/2015 12:53,1434311580,C5,354480,1434666060,6/18/2015 15:21
4348,20150808020805-83,2,6/15/2015 6:46,1434375960,C5,289140,1434665100,6/18/2015 15:05
4144,20153015023037-512,1,6/17/2015 13:40,1434573600,C8,84900,1434658500,6/18/2015 13:15
3686,20155014015019-965,1,6/17/2015 12:08,1434568080,C3,84360,1434652440,6/18/2015 11:34
2902,20155314075350-327,1,6/17/2015 2:03,1434531780,C7,119100,1434650880,6/18/2015 11:08
646,20153512093552-508,1,6/15/2015 9:57,1434387420,C4,260520,1434647940,6/18/2015 10:19
4845,20151615011608-528,2,6/16/2015 22:48,1434520080,C6,120720,1434640800,6/18/2015 8:20
3972,20152603062609-710,2,6/13/2015 7:40,1434206400,C0,434220,1434640620,6/18/2015 8:17
3698,20150514090542-943,3,6/17/2015 8:26,1434554760,C5,85620,1434640380,6/18/2015 8:13
1869,20153815083827-733,2,6/17/2015 7:14,1434550440,C2,83880,1434634320,6/18/2015 6:32
1486,20153509013553-476,3,6/17/2015 4:10,1434539400,C7,93900,1434633300,6/18/2015 6:15
2820,20151403111404-688,2,6/16/2015 3:08,1434449280,C6,182340,1434631620,6/18/2015 5:47
4389,20150113030159-936,1,6/15/2015 21:28,1434428880,C4,196020,1434624900,6/18/2015 3:55
3434,20155409125422-39,2,6/17/2015 4:14,1434539640,C5,82500,1434622140,6/18/2015 3:09
700,20154207084222-772,1,6/16/2015 16:56,1434498960,C5,115320,1434614280,6/18/2015 0:58
1488,20155712125721-681,1,6/16/2015 14:57,1434491820,C2,117600,1434609420,6/17/2015 23:37
3299,20152310032340-322,1,6/17/2015 1:30,1434529800,C4,79260,1434609060,6/17/2015 23:31
2479,20153005093039-50,1,6/15/2015 20:50,1434426600,C8,180960,1434607560,6/17/2015 23:06
850,20153710103717-23,1,6/16/2015 1:58,1434445080,C4,162420,1434607500,6/17/2015 23:05
1031,20153831033841-860,1,6/12/2015 2:54,1434102840,C5,495480,1434598320,6/17/2015 20:32
1903,20150010050052-231,1,6/17/2015 1:24,1434529440,C2,68580,1434598020,6/17/2015 20:27
3313,20152308052334-841,3,6/16/2015 16:29,1434497340,C3,98280,1434595620,6/17/2015 19:47
4252,20155208125234-73,2,6/14/2015 16:20,1434324000,C8,265440,1434589440,6/17/2015 18:04
868,20155408015402-944,2,6/16/2015 11:43,1434480180,C4,97620,1434577800,6/17/2015 14:50
1046,20150608040651-249,2,6/7/2015 14:12,1433711520,C5,861720,1434573240,6/17/2015 13:34
3010,20152315102354-941,1,6/16/2015 11:48,1434480480,C4,91500,1434571980,6/17/2015 13:13
5365,20152729102731-508,1,6/14/2015 7:32,1434292320,C8,274380,1434566700,6/17/2015 11:45
4145,20153909123913-261,2,6/16/2015 11:43,1434480180,C0,85920,1434566100,6/17/2015 11:35
5342,20152315122321-162,3,6/16/2015 11:50,1434480600,C0,84420,1434565020,6/17/2015 11:17
5668,20151813091850-644,1,6/15/2015 10:11,1434388260,C6,175980,1434564240,6/17/2015 11:04
2489,20151413031402-190,3,6/16/2015 4:10,1434453000,C2,109680,1434562680,6/17/2015 10:38
2123,20150011020058-334,2,6/16/2015 14:10,1434489000,C2,61800,1434550800,6/17/2015 7:20
5410,20151002121039-700,1,6/12/2015 8:54,1434124440,C5,426120,1434550560,6/17/2015 7:16
3991,20152114012137-37,1,6/15/2015 20:59,1434427140,C4,113880,1434541020,6/17/2015 4:37
6060,20150013110026-797,1,6/15/2015 22:12,1434431520,C5,106560,1434538080,6/17/2015 3:48
1321,20151514091533-555,2,6/16/2015 5:13,1434456780,C4,79140,1434535920,6/17/2015 3:12
1571,20153213063205-982,1,6/15/2015 20:02,1434423720,C8,110700,1434534420,6/17/2015 2:47
4329,20152509072533-673,2,6/15/2015 3:10,1434363000,C5,167700,1434530700,6/17/2015 1:45
6495,20152607102647-573,1,6/15/2015 18:59,1434419940,C4,103140,1434523080,6/16/2015 23:38
1219,20150114030106-231,1,6/16/2015 3:57,1434452220,C2,66480,1434518700,6/16/2015 22:25
1295,20151406101448-508,2,6/15/2015 14:30,1434403800,C5,113280,1434517080,6/16/2015 21:58
4116,20153208033241-763,1,6/12/2015 18:39,1434159540,C2,356820,1434516360,6/16/2015 21:46
4080,20152913122916-642,2,6/15/2015 18:17,1434417420,C7,96840,1434514260,6/16/2015 21:11
1205,20155214125258-653,1,6/16/2015 1:34,1434443640,C7,66060,1434509700,6/16/2015 19:55
5364,20151905031957-601,1,6/13/2015 1:37,1434184620,C7,320940,1434505560,6/16/2015 18:46
1973,20151414041459-646,1,6/15/2015 17:29,1434414540,C6,90900,1434505440,6/16/2015 18:44
4027,20151403121420-600,2,6/13/2015 10:53,1434217980,C4,286380,1434504360,6/16/2015 18:26
4362,20154512124548-471,1,6/15/2015 16:39,1434411540,C4,91080,1434502620,6/16/2015 17:57
406,20155517035538-277,1,6/12/2015 22:16,1434172560,C0,324180,1434496740,6/16/2015 16:19
2801,20155413045417-828,2,6/15/2015 16:22,1434410520,C7,85440,1434495960,6/16/2015 16:06
4696,20154509014559-37,1,6/14/2015 7:09,1434290940,C7,204120,1434495060,6/16/2015 15:51
1548,20150124080152-145,1,6/13/2015 7:25,1434205500,C6,287640,1434493140,6/16/2015 15:19
6376,20152813042842-830,3,6/15/2015 15:10,1434406200,C2,84060,1434490260,6/16/2015 14:31
1,20152930032938-338,1,6/13/2015 17:54,1434243240,C8,243660,1434486900,6/16/2015 13:35
6482,20152924032915-517,1,6/13/2015 6:47,1434203220,C6,282780,1434486000,6/16/2015 13:20
2765,20154204024204-803,1,6/10/2015 13:54,1433969640,C2,515520,1434485160,6/16/2015 13:06
3084,20154913094911-76,1,6/15/2015 11:23,1434392580,C2,89220,1434481800,6/16/2015 12:10
5630,20150513030530-407,2,6/15/2015 12:43,1434397380,C8,82140,1434479520,6/16/2015 11:32
1593,20155407025401-645,1,6/15/2015 11:26,1434392760,C4,84840,1434477600,6/16/2015 11:00
1427,20150413110402-150,1,6/14/2015 22:05,1434344700,C4,126060,1434470760,6/16/2015 9:06
3197,20155802065857-168,2,6/13/2015 23:18,1434262680,C8,201840,1434464520,6/16/2015 7:22
3503,20151431071428-170,1,6/12/2015 6:59,1434117540,C2,345300,1434462840,6/16/2015 6:54
5465,20151813101843-73,1,6/15/2015 6:04,1434373440,C8,78780,1434452220,6/16/2015 3:57
616,20155007045010-724,2,6/13/2015 8:14,1434208440,C5,243720,1434452160,6/16/2015 3:56
1174,20152311062324-562,1,6/14/2015 12:05,1434308700,C5,139860,1434448560,6/16/2015 2:56
4314,20150606030611-107,2,6/14/2015 22:08,1434344880,C5,102360,1434447240,6/16/2015 2:34
6086,20153213033256-646,1,6/15/2015 6:34,1434375240,C5,70260,1434445500,6/16/2015 2:05
1134,20151212031240-621,1,6/14/2015 21:42,1434343320,C5,98100,1434441420,6/16/2015 0:57
5941,20155913025927-438,3,6/15/2015 5:21,1434370860,C7,69060,1434439920,6/16/2015 0:32
3078,20153606123604-841,1,6/14/2015 20:52,1434340320,C4,90120,1434430440,6/15/2015 21:54
5502,20151113011134-396,1,6/15/2015 2:49,1434361740,C4,67740,1434429480,6/15/2015 21:38
2448,20151511061503-898,1,6/14/2015 8:19,1434295140,C2,133320,1434428460,6/15/2015 21:21
2573,20152707102734-863,3,6/14/2015 19:33,1434335580,C4,91080,1434426660,6/15/2015 20:51
3707,20150106120154-473,2,6/14/2015 19:37,1434335820,C5,89820,1434425640,6/15/2015 20:34
472,20155412025458-760,1,6/14/2015 16:44,1434325440,C5,89700,1434415140,6/15/2015 17:39
3652,20152029102006-584,3,6/13/2015 5:38,1434199080,C6,213180,1434412260,6/15/2015 16:51
4681,20151711021720-756,2,6/13/2015 14:35,1434231300,C2,173880,1434405180,6/15/2015 14:53
4904,20150719050740-812,1,6/6/2015 15:23,1433629380,C2,774480,1434403860,6/15/2015 14:31
3272,20155501015552-358,1,6/10/2015 21:53,1433998380,C4,403140,1434401520,6/15/2015 13:52
5628,20150808020840-877,1,6/13/2015 5:56,1434200160,C8,201240,1434401400,6/15/2015 13:50
3132,20151811051833-890,2,6/14/2015 21:43,1434343380,C8,55020,1434398400,6/15/2015 13:00
955,20154706084700-54,2,6/14/2015 11:35,1434306900,C2,87660,1434394560,6/15/2015 11:56
2632,20152209122210-562,1,6/13/2015 10:58,1434218280,C7,170280,1434388560,6/15/2015 10:16
2854,20152031112006-199,3,6/10/2015 8:42,1433950920,C5,427260,1434378180,6/15/2015 7:23
2575,20154312124334-595,1,6/14/2015 8:05,1434294300,C5,78060,1434372360,6/15/2015 5:46
1262,20155205045211-58,1,6/14/2015 0:36,1434267360,C7,102720,1434370080,6/15/2015 5:08
6133,20150710010709-698,1,6/14/2015 10:12,1434301920,C8,67020,1434368940,6/15/2015 4:49
958,20152623092639-730,1,6/12/2015 6:57,1434117420,C2,245580,1434363000,6/15/2015 3:10
1151,20150108040141-642,1,6/12/2015 23:21,1434176460,C7,186000,1434362460,6/15/2015 3:01
3841,20151808071834-232,1,6/11/2015 16:38,1434065880,C3,292800,1434358680,6/15/2015 1:58
1377,20155606015608-991,3,6/10/2015 19:53,1433991180,C3,367020,1434358200,6/15/2015 1:50
5115,20154003064021-184,2,6/13/2015 16:48,1434239280,C0,112560,1434351840,6/15/2015 0:04
4428,20154212054245-458,1,6/13/2015 20:41,1434253260,C3,97140,1434350400,6/14/2015 23:40
3643,20154307024334-228,1,6/11/2015 6:47,1434030420,C3,317040,1434347460,6/14/2015 22:51
2078,20150802030830-611,1,6/11/2015 18:50,1434073800,C5,263640,1434337440,6/14/2015 20:04
1412,20155311065304-252,1,6/13/2015 14:39,1434231540,C2,100380,1434331920,6/14/2015 18:32
4516,20151807101827-295,2,6/12/2015 22:18,1434172680,C4,158400,1434331080,6/14/2015 18:18
4683,20152910022924-572,2,6/12/2015 15:37,1434148620,C3,176880,1434325500,6/14/2015 16:45
1633,20155824115842-88,2,6/11/2015 15:46,1434062760,C6,261480,1434324240,6/14/2015 16:24
6088,20154314114311-549,2,6/10/2015 18:06,1433984760,C2,336540,1434321300,6/14/2015 15:35
2430,20151004021051-72,1,6/13/2015 12:42,1434224520,C4,96540,1434321060,6/14/2015 15:31
1183,20150304080318-31,1,6/11/2015 4:55,1434023700,C2,296760,1434320460,6/14/2015 15:21
6179,20155301085317-34,1,6/12/2015 8:23,1434122580,C8,189720,1434312300,6/14/2015 13:05
3403,20154310114354-581,1,6/13/2015 3:13,1434190380,C8,114300,1434304680,6/14/2015 10:58
4300,20153227063240-542,1,6/8/2015 9:04,1433779440,C7,522960,1434302400,6/14/2015 10:20
5471,20155306125304-711,2,6/12/2015 9:53,1434127980,C0,169200,1434297180,6/14/2015 8:53
4597,20152112122156-641,2,6/13/2015 10:22,1434216120,C4,79260,1434295380,6/14/2015 8:23
990,20150508110558-558,1,6/12/2015 20:05,1434164700,C3,126000,1434290700,6/14/2015 7:05
1978,20150307120319-340,2,6/13/2015 12:35,1434224100,C3,65040,1434289140,6/14/2015 6:39
3380,20154310024344-489,3,6/12/2015 10:22,1434129720,C2,157140,1434286860,6/14/2015 6:01
4481,20150102100120-757,2,6/12/2015 18:24,1434158640,C5,127740,1434286380,6/14/2015 5:53
1790,20155804095839-242,3,6/13/2015 0:21,1434180060,C7,106140,1434286200,6/14/2015 5:50
2657,20152504102542-990,3,6/12/2015 23:17,1434176220,C5,105360,1434281580,6/14/2015 4:33
2744,20154711044729-817,2,6/13/2015 12:35,1434224100,C4,52560,1434276660,6/14/2015 3:11
769,20154405064401-508,2,6/12/2015 15:14,1434147240,C8,127080,1434274320,6/14/2015 2:32
632,20151910041931-214,3,6/12/2015 22:43,1434174180,C7,97920,1434272100,6/14/2015 1:55
1908,20152504072503-198,2,6/10/2015 19:19,1433989140,C7,280620,1434269760,6/14/2015 1:16
2175,20151808121849-986,2,6/13/2015 3:54,1434192840,C6,66960,1434259800,6/13/2015 22:30
1422,20150708030724-124,2,6/11/2015 6:42,1434030120,C6,228900,1434259020,6/13/2015 22:17
381,20153801053802-368,2,6/10/2015 20:23,1433992980,C4,262500,1434255480,6/13/2015 21:18
2999,20150003040042-47,1,6/12/2015 17:28,1434155280,C3,97860,1434253140,6/13/2015 20:39
5449,20152305052333-803,2,6/9/2015 18:51,1433901060,C3,350880,1434251940,6/13/2015 20:19
4644,20150509040535-12,2,6/12/2015 18:14,1434158040,C2,88980,1434247020,6/13/2015 18:57
4268,20155203125254-748,3,6/12/2015 0:37,1434094620,C8,146700,1434241320,6/13/2015 17:22
1367,20151009061043-83,1,6/12/2015 4:04,1434107040,C0,125820,1434232860,6/13/2015 15:01
2511,20153226123245-963,1,6/7/2015 13:42,1433709720,C7,520500,1434230220,6/13/2015 14:17
5267,20155707045718-181,2,6/11/2015 14:27,1434058020,C5,168300,1434226320,6/13/2015 13:12
6444,20152705112755-32,2,6/11/2015 12:27,1434050820,C2,174000,1434224820,6/13/2015 12:47
2227,20155301085312-76,1,6/9/2015 11:05,1433873100,C4,349560,1434222660,6/13/2015 12:11
6398,20154405034405-591,1,6/12/2015 15:04,1434146640,C3,75300,1434221940,6/13/2015 11:59
5785,20152102062100-389,2,6/9/2015 5:36,1433853360,C7,364500,1434217860,6/13/2015 10:51
5847,20154011114039-253,1,6/2/2015 11:06,1433268360,C5,949380,1434217740,6/13/2015 10:49
310,20152302082313-686,1,6/12/2015 4:55,1434110100,C2,106440,1434216540,6/13/2015 10:29
2236,20152202102255-946,1,6/7/2015 21:57,1433739420,C0,473700,1434213120,6/13/2015 9:32
1062,20151602031658-446,3,6/11/2015 13:21,1434054060,C8,154140,1434208200,6/13/2015 8:10
4596,20153504033551-486,1,6/11/2015 3:47,1434019620,C5,187440,1434207060,6/13/2015 7:51
4157,20151902111913-640,3,6/6/2015 7:59,1433602740,C8,602400,1434205140,6/13/2015 7:19
1071,20150823070821-824,2,6/8/2015 0:59,1433750340,C3,453420,1434203760,6/13/2015 6:56
4353,20152004012053-387,2,6/10/2015 8:14,1433949240,C7,250020,1434199260,6/13/2015 5:41
5755,20152607112632-973,2,6/10/2015 8:01,1433948460,C2,246900,1434195360,6/13/2015 4:36
1765,20154806044809-982,3,6/12/2015 8:15,1434122100,C4,69660,1434191760,6/13/2015 3:36
4264,20155815125820-398,1,6/5/2015 23:25,1433571900,C4,617340,1434189240,6/13/2015 2:54
3952,20153509123549-969,1,6/11/2015 20:59,1434081540,C5,101520,1434183060,6/13/2015 1:11
2658,20152026112029-817,1,6/11/2015 1:12,1434010320,C2,168240,1434178560,6/12/2015 23:56
2772,20152507042553-806,1,6/12/2015 9:45,1434127500,C4,51000,1434178500,6/12/2015 23:55
3495,20150808100805-344,1,6/11/2015 11:16,1434046560,C8,131640,1434178200,6/12/2015 23:50
473,20150404040434-742,3,6/8/2015 18:35,1433813700,C0,354660,1434168360,6/12/2015 21:06
2988,20150606010609-786,1,6/9/2015 16:29,1433892540,C2,271380,1434163920,6/12/2015 19:52
5456,20150002070024-376,2,6/9/2015 6:50,1433857800,C0,302100,1434159900,6/12/2015 18:45
1916,20152731112735-564,1,6/8/2015 14:19,1433798340,C7,350760,1434149100,6/12/2015 15:45
255,20152509092558-706,1,6/11/2015 12:57,1434052620,C5,92760,1434145380,6/12/2015 14:43
211,20153403093425-594,1,6/11/2015 7:58,1434034680,C7,97920,1434132600,6/12/2015 11:10
4446,20154126024152-89,1,6/8/2015 4:14,1433762040,C4,361860,1434123900,6/12/2015 8:45
5611,20151602021614-218,1,6/7/2015 11:18,1433701080,C6,421320,1434122400,6/12/2015 8:20
3583,20151309071349-323,1,6/11/2015 7:43,1434033780,C8,87300,1434121080,6/12/2015 7:58
3219,20152907062931-133,2,6/11/2015 1:08,1434010080,C5,108780,1434118860,6/12/2015 7:21
1667,20154910014900-520,1,6/11/2015 9:27,1434040020,C4,70680,1434110700,6/12/2015 5:05
2018,20151905081937-688,1,6/9/2015 21:31,1433910660,C4,196560,1434107220,6/12/2015 4:07
5070,20151708021738-621,1,6/10/2015 23:23,1434003780,C0,102780,1434106560,6/12/2015 3:56
3363,20151802021836-315,2,6/11/2015 2:18,1434014280,C2,91800,1434106080,6/12/2015 3:48
5855,20153906013936-263,3,6/9/2015 8:05,1433862300,C6,239160,1434101460,6/12/2015 2:31
4786,20150104060101-478,2,6/9/2015 11:25,1433874300,C8,225720,1434100020,6/12/2015 2:07
173,20153008023037-716,1,6/10/2015 22:14,1433999640,C5,100320,1434099960,6/12/2015 2:06
770,20155610035651-241,2,6/11/2015 8:12,1434035520,C6,58560,1434094080,6/12/2015 0:28
565,20155801095814-110,2,6/10/2015 16:34,1433979240,C4,114480,1434093720,6/12/2015 0:22
1710,20152815032843-542,3,6/2/2015 20:44,1433303040,C5,787080,1434090120,6/11/2015 23:22
4787,20151105121120-955,3,6/9/2015 19:05,1433901900,C5,185220,1434087120,6/11/2015 22:32
2341,20151404031404-378,2,6/8/2015 6:22,1433769720,C4,313680,1434083400,6/11/2015 21:30
2277,20152709072702-390,2,6/10/2015 14:13,1433970780,C3,110760,1434081540,6/11/2015 20:59
2920,20150805010805-339,1,6/9/2015 17:06,1433894760,C0,179940,1434074700,6/11/2015 19:05
1725,20150806040856-166,2,6/11/2015 3:42,1434019320,C5,55320,1434074640,6/11/2015 19:04
3856,20155907055958-889,2,6/9/2015 17:17,1433895420,C4,170280,1434065700,6/11/2015 16:35
3150,20151202071233-557,1,6/8/2015 12:38,1433792280,C4,268980,1434061260,6/11/2015 15:21
960,20151604011635-266,2,6/7/2015 1:56,1433667360,C3,362100,1434029460,6/11/2015 6:31
5422,20150308110346-628,1,6/9/2015 20:11,1433905860,C2,119280,1434025140,6/11/2015 5:19
6425,20151507051530-305,1,6/5/2015 10:35,1433525700,C8,496320,1434022020,6/11/2015 4:27
5424,20152603072628-94,1,6/10/2015 4:38,1433936280,C4,84960,1434021240,6/11/2015 4:14
4941,20152304102334-555,1,6/7/2015 19:04,1433729040,C4,290460,1434019500,6/11/2015 3:45
165,20151503071547-841,1,6/10/2015 3:45,1433933100,C8,84600,1434017700,6/11/2015 3:15
5542,20153504033505-27,3,6/8/2015 22:35,1433828100,C2,185400,1434013500,6/11/2015 2:05
4017,20152707062703-3,2,6/9/2015 18:55,1433901300,C0,108840,1434010140,6/11/2015 1:09
174,20153206033243-388,2,6/8/2015 19:05,1433815500,C4,185580,1434001080,6/10/2015 22:38
5137,20154607064650-344,3,6/9/2015 16:30,1433892600,C5,103920,1433996520,6/10/2015 21:22
3016,20150123020103-717,2,6/4/2015 18:25,1433467500,C8,526320,1433993820,6/10/2015 20:37
2022,20153107033139-406,3,6/9/2015 18:15,1433898900,C4,91320,1433990220,6/10/2015 19:37
783,20153203053218-362,3,6/9/2015 19:02,1433901720,C6,87300,1433989020,6/10/2015 19:17
5283,20152501032517-581,2,6/7/2015 16:53,1433721180,C5,261840,1433983020,6/10/2015 17:37
25,20152917072906-13,2,6/4/2015 14:29,1433453340,C3,526800,1433980140,6/10/2015 16:49
5274,20152919092946-526,1,5/30/2015 12:50,1433015400,C4,962460,1433977860,6/10/2015 16:11
4551,20153104043113-656,2,6/9/2015 23:52,1433919120,C7,50940,1433970060,6/10/2015 14:01
6289,20151401011424-950,1,6/7/2015 13:20,1433708400,C8,259380,1433967780,6/10/2015 13:23
3796,20152204012203-647,2,6/7/2015 13:10,1433707800,C3,258480,1433966280,6/10/2015 12:58
4191,20153907063953-451,2,6/9/2015 10:01,1433869260,C5,92460,1433961720,6/10/2015 11:42
4943,20154505074523-130,1,6/9/2015 4:12,1433848320,C5,110940,1433959260,6/10/2015 11:01
5371,20155004125004-492,1,6/9/2015 8:10,1433862600,C8,83040,1433945640,6/10/2015 7:14
841,20151102091154-662,2,6/6/2015 7:23,1433600580,C2,339120,1433939700,6/10/2015 5:35
2105,20152106092143-261,1,6/8/2015 7:24,1433773440,C2,165780,1433939220,6/10/2015 5:27
2109,20152207122235-665,2,6/9/2015 7:40,1433860800,C5,77940,1433938740,6/10/2015 5:19
5863,20155902105925-30,3,6/8/2015 6:11,1433769060,C5,167040,1433936100,6/10/2015 4:35
1917,20154106094112-225,1,6/8/2015 6:14,1433769240,C3,160380,1433929620,6/10/2015 2:47
5538,20153829013822-10,1,6/6/2015 5:54,1433595240,C2,331680,1433926920,6/10/2015 2:02
1602,20153730113759-10,3,6/8/2015 21:45,1433825100,C5,101760,1433926860,6/10/2015 2:01
1414,20150030060046-176,3,6/6/2015 8:58,1433606280,C5,307740,1433914020,6/9/2015 22:27
4034,20150707040715-238,1,6/9/2015 3:51,1433847060,C5,64320,1433911380,6/9/2015 21:43
1291,20151302111323-649,2,6/8/2015 15:23,1433802180,C8,106680,1433908860,6/9/2015 21:01
1581,20150820080854-186,1,6/4/2015 15:38,1433457480,C5,441000,1433898480,6/9/2015 18:08
3567,20151807041812-701,1,6/5/2015 14:28,1433539680,C3,357000,1433896680,6/9/2015 17:38
3477,20153504043512-341,3,6/7/2015 23:57,1433746620,C7,142860,1433889480,6/9/2015 15:38
21,20152923082949-398,1,6/7/2015 11:05,1433700300,C5,186480,1433886780,6/9/2015 14:53
2959,20153831123814-376,2,6/7/2015 8:11,1433689860,C2,196260,1433886120,6/9/2015 14:42
5178,20155803095829-960,3,6/7/2015 12:30,1433705400,C0,177360,1433882760,6/9/2015 13:46
1708,20154606094659-402,1,6/8/2015 10:44,1433785440,C7,88140,1433873580,6/9/2015 11:13
3178,20152005082009-82,2,6/8/2015 10:29,1433784540,C0,88980,1433873520,6/9/2015 11:12
1715,20152120032144-608,2,6/4/2015 10:45,1433439900,C5,426480,1433866380,6/9/2015 9:13
5430,20150605040618-478,1,6/5/2015 12:06,1433531160,C4,333000,1433864160,6/9/2015 8:36
3344,20152801112857-221,3,6/7/2015 6:58,1433685480,C3,167400,1433852880,6/9/2015 5:28
5793,20150706080728-516,3,6/8/2015 5:45,1433767500,C2,82140,1433849640,6/9/2015 4:34
2370,20153402063455-599,1,6/6/2015 20:14,1433646840,C2,197400,1433844240,6/9/2015 3:04
1314,20155304065335-775,1,6/7/2015 11:21,1433701260,C2,137640,1433838900,6/9/2015 1:35
2599,20154005074031-234,1,6/8/2015 1:49,1433753340,C0,79380,1433832720,6/8/2015 23:52
6429,20150006010020-419,1,6/7/2015 18:23,1433726580,C4,105780,1433832360,6/8/2015 23:46
851,20154906014956-369,1,6/7/2015 18:28,1433726880,C2,103140,1433830020,6/8/2015 23:07
463,20150205070257-697,2,6/7/2015 17:36,1433723760,C8,105420,1433829180,6/8/2015 22:53
4539,20154506114531-504,3,6/8/2015 2:57,1433757420,C7,70560,1433827980,6/8/2015 22:33
2225,20154102124124-992,2,6/8/2015 2:58,1433757480,C5,69060,1433826540,6/8/2015 22:09
496,20153620073655-119,1,6/5/2015 15:36,1433543760,C8,282240,1433826000,6/8/2015 22:00
205,20155927065901-324,1,6/5/2015 17:59,1433552340,C4,272400,1433824740,6/8/2015 21:39
1526,20155305035315-90,3,6/7/2015 6:25,1433683500,C3,138720,1433822220,6/8/2015 20:57
5701,20153031113006-452,1,6/7/2015 19:40,1433731200,C8,90600,1433821800,6/8/2015 20:50
2669,20154102064127-486,2,6/7/2015 4:50,1433677800,C3,141780,1433819580,6/8/2015 20:13
5967,20153622113653-407,1,6/5/2015 22:26,1433568360,C8,249720,1433818080,6/8/2015 19:48
4383,20152805102823-890,1,6/7/2015 15:34,1433716440,C8,95580,1433812020,6/8/2015 18:07
247,20152703062723-570,1,6/7/2015 8:12,1433689920,C2,117300,1433807220,6/8/2015 16:47
654,20154705124714-48,2,6/7/2015 14:55,1433714100,C3,90240,1433804340,6/8/2015 15:59
1169,20151422031406-22,1,6/2/2015 22:38,1433309880,C5,488520,1433798400,6/8/2015 14:20
2205,20151022041004-148,1,6/6/2015 11:04,1433613840,C5,182520,1433796360,6/8/2015 13:46
4296,20152704012752-116,3,6/7/2015 3:51,1433674260,C0,112320,1433786580,6/8/2015 11:03
5330,20153008103024-792,1,6/4/2015 23:10,1433484600,C4,297300,1433781900,6/8/2015 9:45
1702,20155501085548-717,2,6/5/2015 23:39,1433572740,C2,199320,1433772060,6/8/2015 7:01
1586,20153804023854-460,2,6/6/2015 10:17,1433611020,C4,157140,1433768160,6/8/2015 5:56
3036,20154102114109-572,2,6/6/2015 7:37,1433601420,C8,165480,1433766900,6/8/2015 5:35
5980,20152625012610-60,1,6/1/2015 9:20,1433175600,C0,590040,1433765640,6/8/2015 5:14
3684,20155504125520-496,2,6/7/2015 5:37,1433680620,C4,77640,1433758260,6/8/2015 3:11
1223,20153002103029-92,2,6/6/2015 16:57,1433635020,C4,122940,1433757960,6/8/2015 3:06
1275,20150027100037-189,2,6/6/2015 15:49,1433630940,C5,126420,1433757360,6/8/2015 2:56
6193,20151329121310-651,2,6/6/2015 21:35,1433651700,C0,103560,1433755260,6/8/2015 2:21
4884,20152602112608-911,2,6/6/2015 4:04,1433588640,C3,159540,1433748180,6/8/2015 0:23
2981,20151304041354-441,1,6/7/2015 3:43,1433673780,C4,71400,1433745180,6/7/2015 23:33
5292,20152203012222-575,1,6/6/2015 20:55,1433649300,C0,95460,1433744760,6/7/2015 23:26
1675,20153024043021-679,1,6/5/2015 22:18,1433567880,C6,176280,1433744160,6/7/2015 23:16
4594,20154612054651-827,2,5/30/2015 2:30,1432978200,C5,750120,1433728320,6/7/2015 18:52
5357,20151412071422-498,1,6/4/2015 11:16,1433441760,C2,285960,1433727720,6/7/2015 18:42
5636,20151505041552-201,1,6/6/2015 16:34,1433633640,C0,87540,1433721180,6/7/2015 16:53
1411,20155203095227-377,2,6/6/2015 0:20,1433575200,C5,112440,1433687640,6/7/2015 7:34
1155,20153704013734-599,1,6/6/2015 8:53,1433605980,C0,77880,1433683860,6/7/2015 6:31
3145,20155622035604-568,2,6/5/2015 7:32,1433514720,C3,168480,1433683200,6/7/2015 6:20
742,20150204020258-450,2,6/3/2015 1:16,1433319360,C8,363720,1433683080,6/7/2015 6:18
2783,20151104091103-487,2,6/5/2015 19:25,1433557500,C2,123240,1433680740,6/7/2015 5:39
1822,20152823042801-343,1,5/30/2015 22:45,1433051100,C2,627420,1433678520,6/7/2015 5:02
1530,20154129084107-872,1,6/6/2015 5:05,1433592300,C0,84780,1433677080,6/7/2015 4:38
2106,20150905090932-101,2,6/2/2015 21:03,1433304180,C7,351720,1433655900,6/6/2015 22:45
982,20153502063548-280,1,6/5/2015 18:29,1433554140,C4,100680,1433654820,6/6/2015 22:27
2931,20155630025632-929,2,6/5/2015 0:47,1433490420,C2,155820,1433646240,6/6/2015 20:04
2456,20152404022405-329,3,6/6/2015 1:20,1433578800,C3,62880,1433641680,6/6/2015 18:48
2766,20151029121011-173,1,6/5/2015 17:53,1433551980,C2,89340,1433641320,6/6/2015 18:42
3301,20152703012746-542,1,6/5/2015 16:39,1433547540,C0,92160,1433639700,6/6/2015 18:15
196,20151627121622-355,1,6/5/2015 10:21,1433524860,C8,110100,1433634960,6/6/2015 16:56
4651,20151928041922-215,3,6/4/2015 9:52,1433436720,C4,193860,1433630580,6/6/2015 15:43
6331,20153903083921-101,1,6/5/2015 11:27,1433528820,C4,91440,1433620260,6/6/2015 12:51
3404,20155103035116-592,1,5/26/2015 2:51,1432633860,C4,970200,1433604060,6/6/2015 8:21
1895,20151126011144-948,2,6/4/2015 23:03,1433484180,C5,116160,1433600340,6/6/2015 7:19
1688,20150102120151-257,1,6/4/2015 8:57,1433433420,C2,161760,1433595180,6/6/2015 5:53
4585,20153002113049-336,2,6/4/2015 23:10,1433484600,C8,107400,1433592000,6/6/2015 5:00
3586,20155102095112-902,3,6/5/2015 3:48,1433501280,C0,79140,1433580420,6/6/2015 1:47
933,20155302045335-245,1,6/4/2015 22:11,1433481060,C5,63960,1433545020,6/5/2015 15:57
5225,20151328121327-774,1,6/4/2015 4:53,1433418780,C8,115680,1433534460,6/5/2015 13:01
535,20155023065015-612,3,6/4/2015 0:18,1433402280,C2,126660,1433528940,6/5/2015 11:29
1880,20152901032906-564,1,6/4/2015 18:44,1433468640,C8,54180,1433522820,6/5/2015 9:47
1787,20151812011836-943,1,6/2/2015 9:06,1433261160,C7,257040,1433518200,6/5/2015 8:30
2153,20150117010157-104,2,6/3/2015 5:01,1433332860,C4,180000,1433512860,6/5/2015 7:01
334,20152227022219-923,1,6/2/2015 9:22,1433262120,C5,250200,1433512320,6/5/2015 6:52
2824,20151026031053-559,1,6/4/2015 1:00,1433404800,C7,103800,1433508600,6/5/2015 5:50
2727,20155801025816-705,2,6/3/2015 22:44,1433396640,C5,100380,1433497020,6/5/2015 2:37
5559,20154302064319-564,2,6/3/2015 16:23,1433373780,C3,121200,1433494980,6/5/2015 2:03
710,20153029093029-8,2,6/1/2015 17:07,1433203620,C2,286620,1433490240,6/5/2015 0:44
4062,20154502014508-491,1,6/3/2015 18:30,1433381400,C6,103500,1433484900,6/4/2015 23:15
3399,20155130115135-673,1,6/3/2015 13:15,1433362500,C2,116880,1433479380,6/4/2015 21:43
97,20154130084155-739,2,6/3/2015 11:47,1433357220,C4,118920,1433476140,6/4/2015 20:49
4782,20151025101044-367,1,6/3/2015 9:46,1433349960,C5,110880,1433460840,6/4/2015 16:34
2685,20152802112850-57,1,6/3/2015 13:49,1433364540,C4,94860,1433459400,6/4/2015 16:10
4024,20150929070904-711,2,6/1/2015 11:09,1433182140,C3,273600,1433455740,6/4/2015 15:09
3725,20150617090658-734,1,6/2/2015 8:14,1433258040,C0,197040,1433455080,6/4/2015 14:58
1037,20151601031653-102,1,6/3/2015 14:50,1433368200,C7,85620,1433453820,6/4/2015 14:37
2707,20155102045121-443,1,6/3/2015 15:33,1433370780,C0,81720,1433452500,6/4/2015 14:15
5401,20155227105245-707,2,6/3/2015 1:37,1433320620,C8,114300,1433434920,6/4/2015 9:22
2006,20151202051249-156,3,6/3/2015 19:32,1433385120,C4,47400,1433432520,6/4/2015 8:42
172,20154026084019-504,1,6/1/2015 7:04,1433167440,C8,256320,1433423760,6/4/2015 6:16
2779,20151201031215-712,1,6/3/2015 8:16,1433344560,C7,73920,1433418480,6/4/2015 4:48
4121,20153725123729-641,1,5/31/2015 22:59,1433138340,C2,277860,1433416200,6/4/2015 4:10
5301,20152323032339-44,2,6/1/2015 2:32,1433151120,C2,243780,1433394900,6/3/2015 22:15
2181,20155020035009-541,3,5/27/2015 18:36,1432776960,C2,614760,1433391720,6/3/2015 21:22
213,20155724025730-431,1,5/29/2015 17:41,1432946460,C6,441840,1433388300,6/3/2015 20:25
4889,20150722110719-792,1,6/2/2015 10:59,1433267940,C2,118740,1433386680,6/3/2015 19:58
3362,20154321084329-326,3,6/1/2015 12:58,1433188680,C8,193140,1433381820,6/3/2015 18:37
4406,20154222064254-555,1,5/30/2015 11:40,1433011200,C3,354540,1433365740,6/3/2015 14:09
4751,20153601073650-751,3,5/30/2015 6:35,1432992900,C2,357420,1433350320,6/3/2015 9:52
82,20150526090547-123,3,5/30/2015 8:57,1433001420,C3,345120,1433346540,6/3/2015 8:49
2192,20151029071053-279,1,6/1/2015 23:37,1433227020,C5,106140,1433333160,6/3/2015 5:06
5359,20154230064213-204,3,6/2/2015 3:30,1433241000,C4,82560,1433323560,6/3/2015 2:26
1131,20152231072249-788,2,6/1/2015 14:44,1433195040,C6,112920,1433307960,6/2/2015 22:06
2154,20151431111405-813,1,6/2/2015 1:50,1433235000,C0,69480,1433304480,6/2/2015 21:08
4935,20150028040010-50,3,6/1/2015 2:54,1433152440,C4,149220,1433301660,6/2/2015 20:21
4193,20155926065906-435,1,5/31/2015 7:29,1433082540,C5,216900,1433299440,6/2/2015 19:44
5022,20154820094833-789,1,6/1/2015 1:24,1433147040,C5,125820,1433272860,6/2/2015 12:21
5560,20151822101852-375,3,5/27/2015 21:36,1432787760,C4,472680,1433260440,6/2/2015 8:54
6517,20155930075904-615,2,6/1/2015 6:49,1433166540,C7,84300,1433250840,6/2/2015 6:14
2849,20151521111559-556,2,5/30/2015 4:51,1432986660,C4,251520,1433238180,6/2/2015 2:43
2500,20153023033057-365,1,5/31/2015 18:34,1433122440,C2,87780,1433210220,6/1/2015 18:57
5337,20154105104122-644,2,5/29/2015 3:05,1432893900,C5,292320,1433186220,6/1/2015 12:17
260,20153719023744-10,1,5/28/2015 4:21,1432812060,C5,370320,1433182380,6/1/2015 11:13
3979,20151924061922-35,1,5/29/2015 11:19,1432923540,C7,225000,1433148540,6/1/2015 1:49
5728,20152523042522-538,3,5/30/2015 17:14,1433031240,C4,86820,1433118060,5/31/2015 17:21
3156,20152423082429-73,3,5/29/2015 13:21,1432930860,C4,178740,1433109600,5/31/2015 15:00
3740,20155329045346-171,1,5/30/2015 20:11,1433041860,C5,49140,1433091000,5/31/2015 9:50
2956,20154913014902-715,2,5/25/2015 6:55,1432562100,C0,505980,1433068080,5/31/2015 3:28
234,20150821090834-726,2,5/27/2015 17:06,1432771560,C8,273540,1433045100,5/30/2015 21:05
2512,20155812035804-861,1,5/24/2015 19:14,1432520040,C7,524280,1433044320,5/30/2015 20:52
5749,20153927083939-140,1,5/29/2015 16:31,1432942260,C8,100560,1433042820,5/30/2015 20:27
4704,20151121091142-55,2,5/27/2015 14:29,1432762140,C8,268740,1433030880,5/30/2015 17:08
3350,20155322125316-320,2,5/29/2015 18:29,1432949340,C2,78120,1433027460,5/30/2015 16:11
423,20153514093535-484,1,5/25/2015 4:49,1432554540,C8,466620,1433021160,5/30/2015 14:26
5383,20151006031050-832,1,5/22/2015 10:58,1432317480,C7,683640,1433001120,5/30/2015 8:52
795,20150911060947-468,3,5/27/2015 1:24,1432715040,C8,273060,1432988100,5/30/2015 5:15
4369,20150309080352-837,2,5/26/2015 17:18,1432685880,C8,300420,1432986300,5/30/2015 4:45
2446,20151415091432-219,2,5/28/2015 17:11,1432858260,C7,127980,1432986240,5/30/2015 4:44
6506,20152421032440-973,1,5/29/2015 0:37,1432885020,C5,91140,1432976160,5/30/2015 1:56
2976,20153024043032-864,1,5/29/2015 7:58,1432911480,C3,50160,1432961640,5/29/2015 21:54
4783,20154823064844-637,2,5/27/2015 12:16,1432754160,C0,182640,1432936800,5/29/2015 15:00
340,20153316033329-899,2,5/27/2015 6:13,1432732380,C8,183360,1432915740,5/29/2015 9:09
1652,20155911075946-694,2,5/27/2015 1:10,1432714200,C7,193980,1432908180,5/29/2015 7:03
3039,20153615103638-158,3,5/25/2015 19:24,1432607040,C2,298560,1432905600,5/29/2015 6:20
2874,20154023084059-267,2,5/27/2015 6:04,1432731840,C5,168120,1432899960,5/29/2015 4:46
1201,20150324080316-784,1,5/26/2015 17:44,1432687440,C4,207660,1432895100,5/29/2015 3:25
1573,20150621060618-266,3,5/26/2015 9:14,1432656840,C8,221640,1432878480,5/28/2015 22:48
5873,20153622123619-566,2,5/28/2015 3:14,1432808040,C0,69240,1432877280,5/28/2015 22:28
5179,20155522035520-589,2,5/27/2015 22:58,1432792680,C5,65340,1432858020,5/28/2015 17:07
6426,20153426063448-128,3,5/27/2015 11:37,1432751820,C0,104580,1432856400,5/28/2015 16:40
3061,20155417065446-3,3,5/27/2015 6:25,1432733100,C8,123180,1432856280,5/28/2015 16:38
3844,20154410124411-337,1,5/26/2015 11:16,1432664160,C0,172140,1432836300,5/28/2015 11:05
4703,20152009082046-820,1,5/26/2015 7:56,1432652160,C5,183420,1432835580,5/28/2015 10:53
4944,20150413050443-129,2,5/24/2015 15:28,1432506480,C5,314880,1432821360,5/28/2015 6:56
5899,20151324031316-217,1,5/26/2015 23:01,1432706460,C8,100440,1432806900,5/28/2015 2:55
1767,20152615072606-62,2,5/26/2015 8:23,1432653780,C5,136260,1432790040,5/27/2015 22:14
2015,20151521011559-569,2,5/24/2015 16:27,1432510020,C3,270720,1432780740,5/27/2015 19:39
2698,20155221085210-381,2,5/24/2015 13:11,1432498260,C4,274740,1432773000,5/27/2015 17:30
2290,20150516120527-450,2,5/26/2015 5:53,1432644780,C4,120240,1432765020,5/27/2015 15:17
1844,20150419110442-824,3,5/26/2015 13:45,1432673100,C3,87780,1432760880,5/27/2015 14:08
1431,20151503091545-22,1,5/19/2015 2:57,1432029420,C8,679860,1432709280,5/26/2015 23:48
1964,20155608095633-284,1,5/20/2015 18:04,1432170240,C5,533040,1432703280,5/26/2015 22:08
1440,20152025052053-433,2,5/26/2015 7:37,1432651020,C6,51420,1432702440,5/26/2015 21:54
3074,20151617071647-820,3,5/23/2015 16:22,1432423320,C2,275580,1432698900,5/26/2015 20:55
1204,20150115090150-109,2,5/25/2015 9:49,1432572540,C8,123840,1432696380,5/26/2015 20:13
4726,20155020055005-112,1,5/25/2015 17:26,1432599960,C0,53820,1432653780,5/26/2015 8:23
6119,20152016092004-862,2,5/22/2015 22:24,1432358640,C5,282720,1432641360,5/26/2015 4:56
4580,20151717101752-508,1,5/23/2015 6:17,1432387020,C5,252000,1432639020,5/26/2015 4:17
521,20153622093615-832,1,5/25/2015 3:15,1432548900,C2,78780,1432627680,5/26/2015 1:08
6037,20152503032527-873,1,5/23/2015 3:08,1432375680,C0,240540,1432616220,5/25/2015 21:57
5474,20153410023431-149,3,5/24/2015 4:42,1432467720,C6,146760,1432614480,5/25/2015 21:28
3179,20150817100809-138,2,5/24/2015 22:16,1432530960,C3,81060,1432612020,5/25/2015 20:47
3727,20155719035725-878,1,5/22/2015 13:33,1432326780,C4,250560,1432577340,5/25/2015 11:09
2721,20155422015444-143,2,5/24/2015 11:58,1432493880,C8,82920,1432576800,5/25/2015 11:00
1026,20155717055748-249,1,5/24/2015 12:29,1432495740,C4,73140,1432568880,5/25/2015 8:48
5141,20153618073639-900,1,5/22/2015 21:10,1432354200,C4,197220,1432551420,5/25/2015 3:57
5634,20152712012750-549,1,5/18/2015 20:19,1432005540,C6,543120,1432548660,5/25/2015 3:11
524,20152022032029-340,1,5/23/2015 19:59,1432436340,C6,103140,1432539480,5/25/2015 0:38
6382,20153417063456-447,3,5/23/2015 22:17,1432444620,C5,82140,1432526760,5/24/2015 21:06
5455,20150317010343-76,2,5/22/2015 23:39,1432363140,C4,156720,1432519860,5/24/2015 19:11
763,20154001044056-714,3,5/21/2015 21:25,1432268700,C0,249300,1432518000,5/24/2015 18:40
6025,20154820084851-636,3,5/23/2015 7:06,1432389960,C5,126540,1432516500,5/24/2015 18:15
6253,20154908114938-83,1,5/22/2015 1:13,1432282380,C6,195240,1432477620,5/24/2015 7:27
2482,20152011032039-149,1,5/22/2015 4:35,1432294500,C8,182340,1432476840,5/24/2015 7:14
3359,20151807111855-648,3,5/20/2015 1:57,1432112220,C5,363180,1432475400,5/24/2015 6:50
6554,20153215073237-222,3,5/21/2015 4:36,1432208160,C5,253920,1432462080,5/24/2015 3:08
3747,20152708012754-464,2,5/19/2015 21:36,1432096560,C2,326580,1432423140,5/23/2015 16:19
924,20155517095500-40,1,5/21/2015 12:13,1432235580,C8,176940,1432412520,5/23/2015 13:22
1143,20151319101335-59,2,5/22/2015 10:10,1432314600,C0,86340,1432400940,5/23/2015 10:09
1251,20154215074223-266,1,5/21/2015 23:02,1432274520,C8,114720,1432389240,5/23/2015 6:54
6091,20152114052147-25,2,5/21/2015 2:48,1432201680,C3,184140,1432385820,5/23/2015 5:57
3964,20151202021230-956,2,5/18/2015 1:09,1431936540,C4,445140,1432381680,5/23/2015 4:48
2714,20154707104714-7,1,5/17/2015 22:35,1431927300,C5,453240,1432380540,5/23/2015 4:29
1558,20151810071802-340,2,5/19/2015 22:09,1432098540,C4,277020,1432375560,5/23/2015 3:06
4270,20154002074031-133,1,5/20/2015 18:20,1432171200,C6,199200,1432370400,5/23/2015 1:40
4799,20155509125554-329,2,5/21/2015 8:04,1432220640,C8,145620,1432366260,5/23/2015 0:31
2117,20155313065344-641,1,5/21/2015 17:18,1432253880,C5,104100,1432357980,5/22/2015 22:13
5822,20150409050412-493,2,5/21/2015 6:23,1432214580,C2,142620,1432357200,5/22/2015 22:00
1371,20155411105423-23,2,5/20/2015 19:59,1432177140,C8,162060,1432339200,5/22/2015 17:00
1497,20150818010852-458,1,5/21/2015 7:08,1432217280,C3,118800,1432336080,5/22/2015 16:08
2619,20155016105014-878,2,5/19/2015 12:54,1432065240,C6,266640,1432331880,5/22/2015 14:58
2386,20150115010107-702,2,5/21/2015 14:37,1432244220,C2,74880,1432319100,5/22/2015 11:25
2094,20150416040445-103,1,5/19/2015 11:33,1432060380,C3,242940,1432303320,5/22/2015 7:02
2327,20152018052046-592,1,5/21/2015 2:02,1432198920,C4,102060,1432300980,5/22/2015 6:23
5035,20154407084406-55,3,5/17/2015 6:38,1431869880,C8,428220,1432298100,5/22/2015 5:35
3674,20150020030052-644,2,5/21/2015 9:34,1432226040,C4,66840,1432292880,5/22/2015 4:08
6002,20155809125852-460,2,5/17/2015 20:16,1431918960,C0,358740,1432277700,5/21/2015 23:55
1482,20152816052835-878,1,5/19/2015 23:06,1432101960,C5,139740,1432241700,5/21/2015 13:55
1438,20151903071934-939,1,5/12/2015 8:35,1431444900,C3,782160,1432227060,5/21/2015 9:51
5382,20151112051139-269,3,5/20/2015 4:37,1432121820,C4,92280,1432214100,5/21/2015 6:15
2545,20155519055512-566,1,5/20/2015 10:30,1432143000,C6,59700,1432202700,5/21/2015 3:05
6388,20151312041350-13,2,5/18/2015 5:49,1431953340,C5,240480,1432193820,5/21/2015 0:37
3411,20152813082845-836,1,5/19/2015 2:22,1432027320,C2,165480,1432192800,5/21/2015 0:20
1172,20153114093106-881,1,5/18/2015 13:55,1431982500,C5,180720,1432163220,5/20/2015 16:07
1687,20155604035654-479,2,5/18/2015 19:56,1432004160,C2,153000,1432157160,5/20/2015 14:26
6065,20155516015501-914,2,5/18/2015 12:56,1431978960,C2,169260,1432148220,5/20/2015 11:57
6039,20151017091042-992,1,5/18/2015 22:16,1432012560,C6,133560,1432146120,5/20/2015 11:22
3342,20155705125721-407,3,5/15/2015 8:05,1431702300,C5,423240,1432125540,5/20/2015 5:39
1769,20153817023856-742,2,5/19/2015 8:16,1432048560,C8,74940,1432123500,5/20/2015 5:05
6144,20152602012639-340,3,5/15/2015 11:47,1431715620,C0,372420,1432088040,5/19/2015 19:14
2040,20153311093300-612,1,5/15/2015 13:43,1431722580,C4,360600,1432083180,5/19/2015 17:53
4522,20155414015450-986,1,5/19/2015 0:11,1432019460,C3,54660,1432074120,5/19/2015 15:22
4508,20150412120454-71,1,5/18/2015 7:58,1431961080,C6,83940,1432045020,5/19/2015 7:17
2743,20152309042350-396,2,5/18/2015 0:07,1431932820,C7,102720,1432035540,5/19/2015 4:39
1630,20152209012245-920,2,5/15/2015 22:48,1431755280,C0,276180,1432031460,5/19/2015 3:31
5526,20154702084758-168,1,5/13/2015 10:33,1431538380,C5,478380,1432016760,5/18/2015 23:26
4376,20152608082640-6,1,5/17/2015 18:18,1431911880,C5,101640,1432013520,5/18/2015 22:32
2292,20153602023647-120,2,5/16/2015 17:24,1431822240,C3,174240,1431996480,5/18/2015 17:48
6124,20150104050128-43,2,5/11/2015 16:13,1431385980,C0,601920,1431987900,5/18/2015 15:25
201,20153108053146-433,1,5/17/2015 8:11,1431875460,C3,93000,1431968460,5/18/2015 10:01
4700,20154510064550-279,2,5/16/2015 8:45,1431791100,C3,175200,1431966300,5/18/2015 9:25
1139,20155009055024-626,2,5/13/2015 20:06,1431572760,C6,353760,1431926520,5/17/2015 22:22
5777,20150207050247-410,3,5/12/2015 18:34,1431480840,C6,437520,1431918360,5/17/2015 20:06
2168,20150910080953-624,2,5/14/2015 22:29,1431667740,C5,198600,1431866340,5/17/2015 5:39
5251,20152606062618-786,1,5/13/2015 13:22,1431548520,C5,314880,1431863400,5/17/2015 4:50
931,20153912113932-996,2,5/15/2015 8:21,1431703260,C7,123660,1431826920,5/16/2015 18:42
122,20154911084948-971,3,5/15/2015 7:46,1431701160,C0,113940,1431815100,5/16/2015 15:25
6448,20153014023000-132,2,5/15/2015 22:50,1431755400,C5,58200,1431813600,5/16/2015 15:00
1940,20153314113313-788,3,5/15/2015 7:09,1431698940,C2,70560,1431769500,5/16/2015 2:45
6512,20154506074517-446,1,5/12/2015 18:23,1431480180,C5,278340,1431758520,5/15/2015 23:42
3948,20151312051315-26,2,5/14/2015 18:59,1431655140,C8,89580,1431744720,5/15/2015 19:52
941,20150309100312-290,1,5/13/2015 12:57,1431547020,C4,178020,1431725040,5/15/2015 14:24
4673,20153010103013-306,2,5/14/2015 6:51,1431611460,C2,110820,1431722280,5/15/2015 13:38
2732,20155801105820-248,2,5/13/2015 17:33,1431563580,C5,151500,1431715080,5/15/2015 11:38
3460,20154713054724-651,1,5/14/2015 21:13,1431663180,C2,49380,1431712560,5/15/2015 10:56
5615,20150410110411-548,1,5/12/2015 17:24,1431476640,C6,195600,1431672240,5/14/2015 23:44
2991,20153109123109-53,1,5/13/2015 9:25,1431534300,C2,111480,1431645780,5/14/2015 16:23
1161,20150703110736-237,1,5/11/2015 20:43,1431402180,C5,241920,1431644100,5/14/2015 15:55
1801,20153507023544-222,1,5/11/2015 22:23,1431408180,C7,186840,1431595020,5/14/2015 2:17
2868,20155910065938-444,1,5/12/2015 15:29,1431469740,C8,101700,1431571440,5/13/2015 19:44
3401,20152908012941-964,2,5/12/2015 0:15,1431414900,C5,148980,1431563880,5/13/2015 17:38
1990,20155701105733-580,1,5/9/2015 11:27,1431196020,C5,346500,1431542520,5/13/2015 11:42
1494,20152705082700-328,1,5/10/2015 7:27,1431268020,C8,214200,1431482220,5/12/2015 18:57
3135,20155803105858-900,2,5/10/2015 10:55,1431280500,C2,201540,1431482040,5/12/2015 18:54
3651,20152807082801-714,1,5/11/2015 3:37,1431340620,C2,109380,1431450000,5/12/2015 10:00
4921,20153003023054-91,3,5/11/2015 8:14,1431357240,C0,83580,1431440820,5/12/2015 7:27
5242,20153603073614-148,1,5/9/2015 6:50,1431179400,C5,257820,1431437220,5/12/2015 6:27
2357,20155201095259-137,1,5/8/2015 10:06,1431104760,C8,302820,1431407580,5/11/2015 22:13
4401,20154008114008-610,1,5/9/2015 20:27,1431228420,C3,118020,1431346440,5/11/2015 5:14
947,20152907112958-34,2,5/10/2015 1:23,1431246180,C2,74280,1431320460,5/10/2015 22:01
107,20155403055431-257,3,5/9/2015 18:34,1431221640,C7,74400,1431296040,5/10/2015 15:14
6332,20153203033255-977,1,5/8/2015 1:28,1431073680,C4,190680,1431264360,5/10/2015 6:26
6384,20155101065139-549,1,5/9/2015 0:19,1431155940,C0,83460,1431239400,5/9/2015 23:30
161,20154807104818-336,1,5/8/2015 13:06,1431115560,C2,94680,1431210240,5/9/2015 15:24
1987,20154401104416-538,3,5/7/2015 17:08,1431043680,C2,67680,1431111360,5/8/2015 11:56
3426,20155401045441-227,2,5/7/2015 13:26,1431030360,C3,63240,1431093600,5/8/2015 7:00
2724,20155003035017-260,1,5/6/2015 20:26,1430969160,C5,91920,1431061080,5/7/2015 21:58
5427,20153203033246-681,1,5/6/2015 6:14,1430918040,C0,75240,1430993280,5/7/2015 3:08
5307,20153601093644-33,1,5/5/2015 9:42,1430844120,C3,115320,1430959440,5/6/2015 17:44
6090,20153002013028-298,3,5/5/2015 4:30,1430825400,C4,75600,1430901000,5/6/2015 1:30
4698,20152002042015-193,3,5/4/2015 12:06,1430766360,C8,78780,1430845140,5/5/2015 9:59
