"","car.id","car.type","startDatetime","startTimestamp","gate.name","duration","endTimestamp","endDatetime"
"4698","20152002042015-193","3","2015-05-04 12:07:07",1430766427,"C8",78806,1430845233,"2015-05-05 10:00:33"
"6090","20153002013028-298","3","2015-05-05 04:29:49",1430825389,"C4",75587,1430900976,"2015-05-06 01:29:36"
"5307","20153601093644-33","1","2015-05-05 09:40:50",1430844050,"C3",115282,1430959332,"2015-05-06 17:42:12"
"5427","20153203033246-681","1","2015-05-06 06:12:25",1430917945,"C0",75193,1430993138,"2015-05-07 03:05:38"
"2724","20155003035017-260","1","2015-05-06 20:28:26",1430969306,"C5",91963,1431061269,"2015-05-07 22:01:09"
"3426","20155401045441-227","2","2015-05-07 13:24:41",1431030281,"C3",63225,1431093506,"2015-05-08 06:58:26"
"1987","20154401104416-538","3","2015-05-07 17:11:04",1431043864,"C2",67701,1431111565,"2015-05-08 11:59:25"
"6332","20153203033255-977","1","2015-05-08 01:28:15",1431073695,"C4",190660,1431264355,"2015-05-10 06:25:55"
"2357","20155201095259-137","1","2015-05-08 10:05:53",1431104753,"C8",302787,1431407540,"2015-05-11 22:12:20"
"161","20154807104818-336","1","2015-05-08 13:05:58",1431115558,"C2",94660,1431210218,"2015-05-09 15:23:38"
"6384","20155101065139-549","1","2015-05-09 00:18:59",1431155939,"C0",83455,1431239394,"2015-05-09 23:29:54"
"5242","20153603073614-148","1","2015-05-09 06:49:30",1431179370,"C5",257798,1431437168,"2015-05-12 06:26:08"
"1990","20155701105733-580","1","2015-05-09 11:28:19",1431196099,"C5",346523,1431542622,"2015-05-13 11:43:42"
"107","20155403055431-257","3","2015-05-09 18:31:57",1431221517,"C7",74378,1431295895,"2015-05-10 15:11:35"
"4401","20154008114008-610","1","2015-05-09 20:27:14",1431228434,"C3",118026,1431346460,"2015-05-11 05:14:20"
"947","20152907112958-34","2","2015-05-10 01:22:04",1431246124,"C2",74242,1431320366,"2015-05-10 21:59:26"
"1494","20152705082700-328","1","2015-05-10 07:25:46",1431267946,"C8",214163,1431482109,"2015-05-12 18:55:09"
"3135","20155803105858-900","2","2015-05-10 10:54:22",1431280462,"C2",201508,1431481970,"2015-05-12 18:52:50"
"3651","20152807082801-714","1","2015-05-11 03:35:40",1431340540,"C2",109353,1431449893,"2015-05-12 09:58:13"
"4921","20153003023054-91","3","2015-05-11 08:11:42",1431357102,"C0",83556,1431440658,"2015-05-12 07:24:18"
"6124","20150104050128-43","2","2015-05-11 16:13:04",1431385984,"C0",601896,1431987880,"2015-05-18 15:24:40"
"1161","20150703110736-237","1","2015-05-11 20:44:30",1431402270,"C5",241938,1431644208,"2015-05-14 15:56:48"
"1801","20153507023544-222","1","2015-05-11 22:24:36",1431408276,"C7",186866,1431595142,"2015-05-14 02:19:02"
"3401","20152908012941-964","2","2015-05-12 00:15:49",1431414949,"C5",148984,1431563933,"2015-05-13 17:38:53"
"1438","20151903071934-939","1","2015-05-12 08:36:16",1431444976,"C3",782202,1432227178,"2015-05-21 09:52:58"
"2868","20155910065938-444","1","2015-05-12 15:30:28",1431469828,"C8",101725,1431571553,"2015-05-13 19:45:53"
"5615","20150410110411-548","1","2015-05-12 17:24:32",1431476672,"C6",195621,1431672293,"2015-05-14 23:44:53"
"6512","20154506074517-446","1","2015-05-12 18:22:29",1431480149,"C5",278316,1431758465,"2015-05-15 23:41:05"
"5777","20150207050247-410","3","2015-05-12 18:33:57",1431480837,"C6",437470,1431918307,"2015-05-17 20:05:07"
"2991","20153109123109-53","1","2015-05-13 09:27:33",1431534453,"C2",111528,1431645981,"2015-05-14 16:26:21"
"5526","20154702084758-168","1","2015-05-13 10:34:50",1431538490,"C5",478406,1432016896,"2015-05-18 23:28:16"
"941","20150309100312-290","1","2015-05-13 12:57:06",1431547026,"C4",178017,1431725043,"2015-05-15 14:24:03"
"5251","20152606062618-786","1","2015-05-13 13:22:14",1431548534,"C5",314878,1431863412,"2015-05-17 04:50:12"
"2732","20155801105820-248","2","2015-05-13 17:34:23",1431563663,"C5",151509,1431715172,"2015-05-15 11:39:32"
"1139","20155009055024-626","2","2015-05-13 20:06:35",1431572795,"C6",353771,1431926566,"2015-05-17 22:22:46"
"4673","20153010103013-306","2","2015-05-14 06:50:55",1431611455,"C2",110814,1431722269,"2015-05-15 13:37:49"
"3948","20151312051315-26","2","2015-05-14 18:59:59",1431655199,"C8",89602,1431744801,"2015-05-15 19:53:21"
"3460","20154713054724-651","1","2015-05-14 21:13:36",1431663216,"C2",49386,1431712602,"2015-05-15 10:56:42"
"2168","20150910080953-624","2","2015-05-14 22:31:01",1431667861,"C5",198634,1431866495,"2015-05-17 05:41:35"
"1940","20153314113313-788","3","2015-05-15 07:08:56",1431698936,"C2",70543,1431769479,"2015-05-16 02:44:39"
"122","20154911084948-971","3","2015-05-15 07:47:21",1431701241,"C0",113951,1431815192,"2015-05-16 15:26:32"
"3342","20155705125721-407","3","2015-05-15 08:05:33",1431702333,"C5",423246,1432125579,"2015-05-20 05:39:39"
"931","20153912113932-996","2","2015-05-15 08:22:54",1431703374,"C7",123701,1431827075,"2015-05-16 18:44:35"
"6144","20152602012639-340","3","2015-05-15 11:47:57",1431715677,"C0",372426,1432088103,"2015-05-19 19:15:03"
"2040","20153311093300-612","1","2015-05-15 13:43:04",1431722584,"C4",360604,1432083188,"2015-05-19 17:53:08"
"1630","20152209012245-920","2","2015-05-15 22:48:27",1431755307,"C0",276171,1432031478,"2015-05-19 03:31:18"
"6448","20153014023000-132","2","2015-05-15 22:50:16",1431755416,"C5",58208,1431813624,"2015-05-16 15:00:24"
"4700","20154510064550-279","2","2015-05-16 08:47:23",1431791243,"C3",175231,1431966474,"2015-05-18 09:27:54"
"2292","20153602023647-120","2","2015-05-16 17:27:14",1431822434,"C3",174261,1431996695,"2015-05-18 17:51:35"
"5035","20154407084406-55","3","2015-05-17 06:38:16",1431869896,"C8",428225,1432298121,"2015-05-22 05:35:21"
"201","20153108053146-433","1","2015-05-17 08:14:10",1431875650,"C3",93018,1431968668,"2015-05-18 10:04:28"
"4376","20152608082640-6","1","2015-05-17 18:19:28",1431911968,"C5",101646,1432013614,"2015-05-18 22:33:34"
"6002","20155809125852-460","2","2015-05-17 20:17:06",1431919026,"C0",358747,1432277773,"2015-05-21 23:56:13"
"2714","20154707104714-7","1","2015-05-17 22:35:54",1431927354,"C5",453260,1432380614,"2015-05-23 04:30:14"
"2743","20152309042350-396","2","2015-05-18 00:11:06",1431933066,"C7",102748,1432035814,"2015-05-19 04:43:34"
"3964","20151202021230-956","2","2015-05-18 01:08:12",1431936492,"C4",445114,1432381606,"2015-05-23 04:46:46"
"6388","20151312041350-13","2","2015-05-18 05:48:56",1431953336,"C5",240453,1432193789,"2015-05-21 00:36:29"
"4508","20150412120454-71","1","2015-05-18 07:59:24",1431961164,"C6",83945,1432045109,"2015-05-19 07:18:29"
"6065","20155516015501-914","2","2015-05-18 12:56:15",1431978975,"C2",169274,1432148249,"2015-05-20 11:57:29"
"1172","20153114093106-881","1","2015-05-18 13:56:52",1431982612,"C5",180773,1432163385,"2015-05-20 16:09:45"
"1687","20155604035654-479","2","2015-05-18 20:01:10",1432004470,"C2",153032,1432157502,"2015-05-20 14:31:42"
"5634","20152712012750-549","1","2015-05-18 20:19:59",1432005599,"C6",543129,1432548728,"2015-05-25 03:12:08"
"6039","20151017091042-992","1","2015-05-18 22:16:41",1432012601,"C6",133559,1432146160,"2015-05-20 11:22:40"
"4522","20155414015450-986","1","2015-05-19 00:11:43",1432019503,"C3",54659,1432074162,"2015-05-19 15:22:42"
"3411","20152813082845-836","1","2015-05-19 02:23:45",1432027425,"C2",165500,1432192925,"2015-05-21 00:22:05"
"1431","20151503091545-22","1","2015-05-19 02:58:29",1432029509,"C8",679882,1432709391,"2015-05-26 23:49:51"
"1769","20153817023856-742","2","2015-05-19 08:16:08",1432048568,"C8",74916,1432123484,"2015-05-20 05:04:44"
"2094","20150416040445-103","1","2015-05-19 11:33:49",1432060429,"C3",242944,1432303373,"2015-05-22 07:02:53"
"2619","20155016105014-878","2","2015-05-19 12:53:55",1432065235,"C6",266621,1432331856,"2015-05-22 14:57:36"
"3747","20152708012754-464","2","2015-05-19 21:37:54",1432096674,"C2",326600,1432423274,"2015-05-23 16:21:14"
"1558","20151810071802-340","2","2015-05-19 22:10:08",1432098608,"C4",277042,1432375650,"2015-05-23 03:07:30"
"1482","20152816052835-878","1","2015-05-19 23:05:03",1432101903,"C5",139694,1432241597,"2015-05-21 13:53:17"
"3359","20151807111855-648","3","2015-05-20 01:56:07",1432112167,"C5",363144,1432475311,"2015-05-24 06:48:31"
"5382","20151112051139-269","3","2015-05-20 04:39:10",1432121950,"C4",92293,1432214243,"2015-05-21 06:17:23"
"2545","20155519055512-566","1","2015-05-20 10:30:07",1432143007,"C6",59695,1432202702,"2015-05-21 03:05:02"
"1964","20155608095633-284","1","2015-05-20 18:03:57",1432170237,"C5",533022,1432703259,"2015-05-26 22:07:39"
"4270","20154002074031-133","1","2015-05-20 18:15:43",1432170943,"C6",199164,1432370107,"2015-05-23 01:35:07"
"1371","20155411105423-23","2","2015-05-20 19:58:43",1432177123,"C8",162052,1432339175,"2015-05-22 16:59:35"
"2327","20152018052046-592","1","2015-05-21 02:02:36",1432198956,"C4",102055,1432301011,"2015-05-22 06:23:31"
"6091","20152114052147-25","2","2015-05-21 02:47:44",1432201664,"C3",184119,1432385783,"2015-05-23 05:56:23"
"6554","20153215073237-222","3","2015-05-21 04:35:57",1432208157,"C5",253900,1432462057,"2015-05-24 03:07:37"
"5822","20150409050412-493","2","2015-05-21 06:21:55",1432214515,"C2",142609,1432357124,"2015-05-22 21:58:44"
"1497","20150818010852-458","1","2015-05-21 07:09:06",1432217346,"C3",118807,1432336153,"2015-05-22 16:09:13"
"4799","20155509125554-329","2","2015-05-21 08:08:24",1432220904,"C8",145650,1432366554,"2015-05-23 00:35:54"
"3674","20150020030052-644","2","2015-05-21 09:35:02",1432226102,"C4",66850,1432292952,"2015-05-22 04:09:12"
"924","20155517095500-40","1","2015-05-21 12:12:42",1432235562,"C8",176931,1432412493,"2015-05-23 13:21:33"
"2386","20150115010107-702","2","2015-05-21 14:35:57",1432244157,"C2",74870,1432319027,"2015-05-22 11:23:47"
"2117","20155313065344-641","1","2015-05-21 17:17:34",1432253854,"C5",104090,1432357944,"2015-05-22 22:12:24"
"763","20154001044056-714","3","2015-05-21 21:23:57",1432268637,"C0",249283,1432517920,"2015-05-24 18:38:40"
"1251","20154215074223-266","1","2015-05-21 23:01:03",1432274463,"C8",114704,1432389167,"2015-05-23 06:52:47"
"6253","20154908114938-83","1","2015-05-22 01:09:14",1432282154,"C6",195196,1432477350,"2015-05-24 07:22:30"
"2482","20152011032039-149","1","2015-05-22 04:36:09",1432294569,"C8",182346,1432476915,"2015-05-24 07:15:15"
"1143","20151319101335-59","2","2015-05-22 10:11:41",1432314701,"C0",86362,1432401063,"2015-05-23 10:11:03"
"5383","20151006031050-832","1","2015-05-22 10:58:42",1432317522,"C7",683636,1433001158,"2015-05-30 08:52:38"
"3727","20155719035725-878","1","2015-05-22 13:33:24",1432326804,"C4",250559,1432577363,"2015-05-25 11:09:23"
"5141","20153618073639-900","1","2015-05-22 21:11:17",1432354277,"C4",197239,1432551516,"2015-05-25 03:58:36"
"6119","20152016092004-862","2","2015-05-22 22:22:42",1432358562,"C5",282679,1432641241,"2015-05-26 04:54:01"
"5455","20150317010343-76","2","2015-05-22 23:39:04",1432363144,"C4",156707,1432519851,"2015-05-24 19:10:51"
"6037","20152503032527-873","1","2015-05-23 03:09:44",1432375784,"C0",240551,1432616335,"2015-05-25 21:58:55"
"4580","20151717101752-508","1","2015-05-23 06:17:46",1432387066,"C5",251997,1432639063,"2015-05-26 04:17:43"
"6025","20154820084851-636","3","2015-05-23 07:06:31",1432389991,"C5",126530,1432516521,"2015-05-24 18:15:21"
"3074","20151617071647-820","3","2015-05-23 16:22:45",1432423365,"C2",275579,1432698944,"2015-05-26 20:55:44"
"524","20152022032029-340","1","2015-05-23 19:58:42",1432436322,"C6",103093,1432539415,"2015-05-25 00:36:55"
"6382","20153417063456-447","3","2015-05-23 22:18:52",1432444732,"C5",82148,1432526880,"2015-05-24 21:08:00"
"5474","20153410023431-149","3","2015-05-24 04:38:55",1432467535,"C6",146733,1432614268,"2015-05-25 21:24:28"
"2721","20155422015444-143","2","2015-05-24 11:58:26",1432493906,"C8",82911,1432576817,"2015-05-25 11:00:17"
"1026","20155717055748-249","1","2015-05-24 12:32:04",1432495924,"C4",73157,1432569081,"2015-05-25 08:51:21"
"2698","20155221085210-381","2","2015-05-24 13:11:11",1432498271,"C4",274741,1432773012,"2015-05-27 17:30:12"
"4944","20150413050443-129","2","2015-05-24 15:30:52",1432506652,"C5",314923,1432821575,"2015-05-28 06:59:35"
"2015","20151521011559-569","2","2015-05-24 16:27:46",1432510066,"C3",270707,1432780773,"2015-05-27 19:39:33"
"2512","20155812035804-861","1","2015-05-24 19:14:18",1432520058,"C7",524287,1433044345,"2015-05-30 20:52:25"
"3179","20150817100809-138","2","2015-05-24 22:10:41",1432530641,"C3",81019,1432611660,"2015-05-25 20:41:00"
"521","20153622093615-832","1","2015-05-25 03:15:24",1432548924,"C2",78783,1432627707,"2015-05-26 01:08:27"
"423","20153514093535-484","1","2015-05-25 04:49:55",1432554595,"C8",466630,1433021225,"2015-05-30 14:27:05"
"2956","20154913014902-715","2","2015-05-25 06:54:58",1432562098,"C0",505978,1433068076,"2015-05-31 03:27:56"
"1204","20150115090150-109","2","2015-05-25 09:52:17",1432572737,"C8",123861,1432696598,"2015-05-26 20:16:38"
"4726","20155020055005-112","1","2015-05-25 17:19:17",1432599557,"C0",53769,1432653326,"2015-05-26 08:15:26"
"3039","20153615103638-158","3","2015-05-25 19:24:05",1432607045,"C2",298549,1432905594,"2015-05-29 06:19:54"
"3404","20155103035116-592","1","2015-05-26 02:50:18",1432633818,"C4",970171,1433603989,"2015-06-06 08:19:49"
"2290","20150516120527-450","2","2015-05-26 05:50:39",1432644639,"C4",120216,1432764855,"2015-05-27 15:14:15"
"1440","20152025052053-433","2","2015-05-26 07:37:00",1432651020,"C6",51367,1432702387,"2015-05-26 21:53:07"
"4703","20152009082046-820","1","2015-05-26 08:00:38",1432652438,"C5",183449,1432835887,"2015-05-28 10:58:07"
"1767","20152615072606-62","2","2015-05-26 08:23:41",1432653821,"C5",136265,1432790086,"2015-05-27 22:14:46"
"1573","20150621060618-266","3","2015-05-26 09:15:26",1432656926,"C8",221674,1432878600,"2015-05-28 22:50:00"
"3844","20154410124411-337","1","2015-05-26 11:19:15",1432664355,"C0",172163,1432836518,"2015-05-28 11:08:38"
"1844","20150419110442-824","3","2015-05-26 13:46:38",1432673198,"C3",87788,1432760986,"2015-05-27 14:09:46"
"4369","20150309080352-837","2","2015-05-26 17:19:52",1432685992,"C8",300432,1432986424,"2015-05-30 04:47:04"
"1201","20150324080316-784","1","2015-05-26 17:44:27",1432687467,"C4",207671,1432895138,"2015-05-29 03:25:38"
"5899","20151324031316-217","1","2015-05-26 23:01:12",1432706472,"C8",100438,1432806910,"2015-05-28 02:55:10"
"1652","20155911075946-694","2","2015-05-27 01:09:36",1432714176,"C7",193970,1432908146,"2015-05-29 07:02:26"
"795","20150911060947-468","3","2015-05-27 01:24:52",1432715092,"C8",273061,1432988153,"2015-05-30 05:15:53"
"2874","20154023084059-267","2","2015-05-27 06:05:09",1432731909,"C5",168125,1432900034,"2015-05-29 04:47:14"
"340","20153316033329-899","2","2015-05-27 06:13:49",1432732429,"C8",183364,1432915793,"2015-05-29 09:09:53"
"3061","20155417065446-3","3","2015-05-27 06:26:14",1432733174,"C8",123184,1432856358,"2015-05-28 16:39:18"
"6426","20153426063448-128","3","2015-05-27 11:37:37",1432751857,"C0",104569,1432856426,"2015-05-28 16:40:26"
"4783","20154823064844-637","2","2015-05-27 12:16:32",1432754192,"C0",182634,1432936826,"2015-05-29 15:00:26"
"4704","20151121091142-55","2","2015-05-27 14:30:16",1432762216,"C8",268757,1433030973,"2015-05-30 17:09:33"
"234","20150821090834-726","2","2015-05-27 17:06:22",1432771582,"C8",273534,1433045116,"2015-05-30 21:05:16"
"2181","20155020035009-541","3","2015-05-27 18:36:06",1432776966,"C2",614757,1433391723,"2015-06-03 21:22:03"
"5560","20151822101852-375","3","2015-05-27 21:36:47",1432787807,"C4",472675,1433260482,"2015-06-02 08:54:42"
"5179","20155522035520-589","2","2015-05-27 22:54:50",1432792490,"C5",65310,1432857800,"2015-05-28 17:03:20"
"5873","20153622123619-566","2","2015-05-28 03:10:56",1432807856,"C0",69211,1432877067,"2015-05-28 22:24:27"
"260","20153719023744-10","1","2015-05-28 04:22:18",1432812138,"C5",370337,1433182475,"2015-06-01 11:14:35"
"2446","20151415091432-219","2","2015-05-28 17:17:23",1432858643,"C7",128019,1432986662,"2015-05-30 04:51:02"
"6506","20152421032440-973","1","2015-05-29 00:35:55",1432884955,"C5",91125,1432976080,"2015-05-30 01:54:40"
"5337","20154105104122-644","2","2015-05-29 03:04:19",1432893859,"C5",292311,1433186170,"2015-06-01 12:16:10"
"2976","20153024043032-864","1","2015-05-29 08:01:28",1432911688,"C3",50182,1432961870,"2015-05-29 21:57:50"
"3979","20151924061922-35","1","2015-05-29 11:18:56",1432923536,"C7",224987,1433148523,"2015-06-01 01:48:43"
"3156","20152423082429-73","3","2015-05-29 13:21:44",1432930904,"C4",178745,1433109649,"2015-05-31 15:00:49"
"5749","20153927083939-140","1","2015-05-29 16:30:43",1432942243,"C8",100532,1433042775,"2015-05-30 20:26:15"
"213","20155724025730-431","1","2015-05-29 17:41:41",1432946501,"C6",441851,1433388352,"2015-06-03 20:25:52"
"3350","20155322125316-320","2","2015-05-29 18:33:24",1432949604,"C2",78151,1433027755,"2015-05-30 16:15:55"
"4594","20154612054651-827","2","2015-05-30 02:32:13",1432978333,"C5",750161,1433728494,"2015-06-07 18:54:54"
"2849","20151521111559-556","2","2015-05-30 04:52:23",1432986743,"C4",251528,1433238271,"2015-06-02 02:44:31"
"4751","20153601073650-751","3","2015-05-30 06:30:14",1432992614,"C2",357372,1433349986,"2015-06-03 09:46:26"
"82","20150526090547-123","3","2015-05-30 08:57:47",1433001467,"C3",345120,1433346587,"2015-06-03 08:49:47"
"4406","20154222064254-555","1","2015-05-30 11:42:00",1433011320,"C3",354573,1433365893,"2015-06-03 14:11:33"
"5274","20152919092946-526","1","2015-05-30 12:50:38",1433015438,"C4",962452,1433977890,"2015-06-10 16:11:30"
"5728","20152523042522-538","3","2015-05-30 17:16:14",1433031374,"C4",86836,1433118210,"2015-05-31 17:23:30"
"3740","20155329045346-171","1","2015-05-30 20:12:20",1433041940,"C5",49157,1433091097,"2015-05-31 09:51:37"
"1822","20152823042801-343","1","2015-05-30 22:45:05",1433051105,"C2",627424,1433678529,"2015-06-07 05:02:09"
"4193","20155926065906-435","1","2015-05-31 07:29:12",1433082552,"C5",216903,1433299455,"2015-06-02 19:44:15"
"2500","20153023033057-365","1","2015-05-31 18:33:37",1433122417,"C2",87770,1433210187,"2015-06-01 18:56:27"
"4121","20153725123729-641","1","2015-05-31 23:00:05",1433138405,"C2",277878,1433416283,"2015-06-04 04:11:23"
"5022","20154820094833-789","1","2015-06-01 01:17:53",1433146673,"C5",125770,1433272443,"2015-06-02 12:14:03"
"5301","20152323032339-44","2","2015-06-01 02:34:09",1433151249,"C2",243810,1433395059,"2015-06-03 22:17:39"
"4935","20150028040010-50","3","2015-06-01 02:54:10",1433152450,"C4",149220,1433301670,"2015-06-02 20:21:10"
"6517","20155930075904-615","2","2015-06-01 06:47:54",1433166474,"C7",84265,1433250739,"2015-06-02 06:12:19"
"172","20154026084019-504","1","2015-06-01 07:03:41",1433167421,"C8",256301,1433423722,"2015-06-04 06:15:22"
"5980","20152625012610-60","1","2015-06-01 09:19:59",1433175599,"C0",590029,1433765628,"2015-06-08 05:13:48"
"4024","20150929070904-711","2","2015-06-01 11:09:24",1433182164,"C3",273620,1433455784,"2015-06-04 15:09:44"
"3362","20154321084329-326","3","2015-06-01 13:00:14",1433188814,"C8",193161,1433381975,"2015-06-03 18:39:35"
"1131","20152231072249-788","2","2015-06-01 14:44:35",1433195075,"C6",112906,1433307981,"2015-06-02 22:06:21"
"710","20153029093029-8","2","2015-06-01 17:06:44",1433203604,"C2",286575,1433490179,"2015-06-05 00:42:59"
"2192","20151029071053-279","1","2015-06-01 23:39:41",1433227181,"C5",106176,1433333357,"2015-06-03 05:09:17"
"2154","20151431111405-813","1","2015-06-02 01:49:03",1433234943,"C0",69449,1433304392,"2015-06-02 21:06:32"
"5359","20154230064213-204","3","2015-06-02 03:29:19",1433240959,"C4",82542,1433323501,"2015-06-03 02:25:01"
"3725","20150617090658-734","1","2015-06-02 08:15:33",1433258133,"C0",197045,1433455178,"2015-06-04 14:59:38"
"1787","20151812011836-943","1","2015-06-02 09:13:22",1433261602,"C7",257098,1433518700,"2015-06-05 08:38:20"
"334","20152227022219-923","1","2015-06-02 09:20:47",1433262047,"C5",250154,1433512201,"2015-06-05 06:50:01"
"4889","20150722110719-792","1","2015-06-02 10:57:59",1433267879,"C2",118730,1433386609,"2015-06-03 19:56:49"
"5847","20154011114039-253","1","2015-06-02 11:06:13",1433268373,"C5",949367,1434217740,"2015-06-13 10:49:00"
"1710","20152815032843-542","3","2015-06-02 20:45:37",1433303137,"C5",787107,1434090244,"2015-06-11 23:24:04"
"2106","20150905090932-101","2","2015-06-02 21:02:22",1433304142,"C7",351710,1433655852,"2015-06-06 22:44:12"
"1169","20151422031406-22","1","2015-06-02 22:38:46",1433309926,"C5",488540,1433798466,"2015-06-08 14:21:06"
"742","20150204020258-450","2","2015-06-03 01:16:23",1433319383,"C8",363715,1433683098,"2015-06-07 06:18:18"
"5401","20155227105245-707","2","2015-06-03 01:37:20",1433320640,"C8",114295,1433434935,"2015-06-04 09:22:15"
"2153","20150117010157-104","2","2015-06-03 04:55:57",1433332557,"C4",179955,1433512512,"2015-06-05 06:55:12"
"2779","20151201031215-712","1","2015-06-03 08:17:29",1433344649,"C7",73957,1433418606,"2015-06-04 04:50:06"
"4782","20151025101044-367","1","2015-06-03 09:41:01",1433349661,"C5",110831,1433460492,"2015-06-04 16:28:12"
"97","20154130084155-739","2","2015-06-03 11:49:01",1433357341,"C4",118942,1433476283,"2015-06-04 20:51:23"
"3399","20155130115135-673","1","2015-06-03 13:13:47",1433362427,"C2",116844,1433479271,"2015-06-04 21:41:11"
"2685","20152802112850-57","1","2015-06-03 13:49:57",1433364597,"C4",94867,1433459464,"2015-06-04 16:11:04"
"1037","20151601031653-102","1","2015-06-03 14:50:53",1433368253,"C7",85620,1433453873,"2015-06-04 14:37:53"
"2707","20155102045121-443","1","2015-06-03 15:32:38",1433370758,"C0",81677,1433452435,"2015-06-04 14:13:55"
"5559","20154302064319-564","2","2015-06-03 16:23:36",1433373816,"C3",121217,1433495033,"2015-06-05 02:03:53"
"4062","20154502014508-491","1","2015-06-03 18:29:44",1433381384,"C6",103476,1433484860,"2015-06-04 23:14:20"
"2006","20151202051249-156","3","2015-06-03 19:31:39",1433385099,"C4",47365,1433432464,"2015-06-04 08:41:04"
"2727","20155801025816-705","2","2015-06-03 22:45:08",1433396708,"C5",100406,1433497114,"2015-06-05 02:38:34"
"535","20155023065015-612","3","2015-06-04 00:18:23",1433402303,"C2",126661,1433528964,"2015-06-05 11:29:24"
"2824","20151026031053-559","1","2015-06-04 00:57:44",1433404664,"C7",103773,1433508437,"2015-06-05 05:47:17"
"5225","20151328121327-774","1","2015-06-04 04:53:32",1433418812,"C8",115681,1433534493,"2015-06-05 13:01:33"
"1688","20150102120151-257","1","2015-06-04 08:57:03",1433433423,"C2",161712,1433595135,"2015-06-06 05:52:15"
"4651","20151928041922-215","3","2015-06-04 09:53:13",1433436793,"C4",193877,1433630670,"2015-06-06 15:44:30"
"1715","20152120032144-608","2","2015-06-04 10:44:41",1433439881,"C5",426459,1433866340,"2015-06-09 09:12:20"
"5357","20151412071422-498","1","2015-06-04 11:16:15",1433441775,"C2",285959,1433727734,"2015-06-07 18:42:14"
"25","20152917072906-13","2","2015-06-04 14:29:24",1433453364,"C3",526806,1433980170,"2015-06-10 16:49:30"
"1581","20150820080854-186","1","2015-06-04 15:39:18",1433457558,"C5",441008,1433898566,"2015-06-09 18:09:26"
"3016","20150123020103-717","2","2015-06-04 18:26:11",1433467571,"C8",526354,1433993925,"2015-06-10 20:38:45"
"1880","20152901032906-564","1","2015-06-04 18:42:51",1433468571,"C8",54165,1433522736,"2015-06-05 09:45:36"
"933","20155302045335-245","1","2015-06-04 22:09:38",1433480978,"C5",63921,1433544899,"2015-06-05 15:54:59"
"1895","20151126011144-948","2","2015-06-04 23:04:40",1433484280,"C5",116168,1433600448,"2015-06-06 07:20:48"
"5330","20153008103024-792","1","2015-06-04 23:05:04",1433484304,"C4",297260,1433781564,"2015-06-08 09:39:24"
"4585","20153002113049-336","2","2015-06-04 23:10:37",1433484637,"C8",107394,1433592031,"2015-06-06 05:00:31"
"2931","20155630025632-929","2","2015-06-05 00:47:14",1433490434,"C2",155814,1433646248,"2015-06-06 20:04:08"
"3586","20155102095112-902","3","2015-06-05 03:50:03",1433501403,"C0",79177,1433580580,"2015-06-06 01:49:40"
"3145","20155622035604-568","2","2015-06-05 07:27:24",1433514444,"C3",168440,1433682884,"2015-06-07 06:14:44"
"196","20151627121622-355","1","2015-06-05 10:22:53",1433524973,"C8",110113,1433635086,"2015-06-06 16:58:06"
"6425","20151507051530-305","1","2015-06-05 10:37:00",1433525820,"C8",496338,1434022158,"2015-06-11 04:29:18"
"6331","20153903083921-101","1","2015-06-05 11:28:37",1433528917,"C4",91478,1433620395,"2015-06-06 12:53:15"
"5430","20150605040618-478","1","2015-06-05 12:01:06",1433530866,"C4",332961,1433863827,"2015-06-09 08:30:27"
"3567","20151807041812-701","1","2015-06-05 14:26:55",1433539615,"C3",356989,1433896604,"2015-06-09 17:36:44"
"496","20153620073655-119","1","2015-06-05 15:37:35",1433543855,"C8",282248,1433826103,"2015-06-08 22:01:43"
"3301","20152703012746-542","1","2015-06-05 16:39:58",1433547598,"C0",92166,1433639764,"2015-06-06 18:16:04"
"2766","20151029121011-173","1","2015-06-05 17:53:18",1433551998,"C2",89341,1433641339,"2015-06-06 18:42:19"
"205","20155927065901-324","1","2015-06-05 17:58:58",1433552338,"C4",272399,1433824737,"2015-06-08 21:38:57"
"982","20153502063548-280","1","2015-06-05 18:28:06",1433554086,"C4",100646,1433654732,"2015-06-06 22:25:32"
"2783","20151104091103-487","2","2015-06-05 19:25:06",1433557506,"C2",123243,1433680749,"2015-06-07 05:39:09"
"1675","20153024043021-679","1","2015-06-05 22:18:21",1433567901,"C6",176280,1433744181,"2015-06-07 23:16:21"
"5967","20153622113653-407","1","2015-06-05 22:27:53",1433568473,"C8",249732,1433818205,"2015-06-08 19:50:05"
"4264","20155815125820-398","1","2015-06-05 23:24:41",1433571881,"C4",617327,1434189208,"2015-06-13 02:53:28"
"1702","20155501085548-717","2","2015-06-05 23:39:26",1433572766,"C2",199309,1433772075,"2015-06-08 07:01:15"
"1411","20155203095227-377","2","2015-06-06 00:21:07",1433575267,"C5",112460,1433687727,"2015-06-07 07:35:27"
"2456","20152404022405-329","3","2015-06-06 01:19:21",1433578761,"C3",62858,1433641619,"2015-06-06 18:46:59"
"4884","20152602112608-911","2","2015-06-06 04:03:24",1433588604,"C3",159518,1433748122,"2015-06-08 00:22:02"
"1530","20154129084107-872","1","2015-06-06 05:10:11",1433592611,"C0",84818,1433677429,"2015-06-07 04:43:49"
"5538","20153829013822-10","1","2015-06-06 05:54:54",1433595294,"C2",331696,1433926990,"2015-06-10 02:03:10"
"841","20151102091154-662","2","2015-06-06 07:24:44",1433600684,"C2",339170,1433939854,"2015-06-10 05:37:34"
"3036","20154102114109-572","2","2015-06-06 07:36:31",1433601391,"C8",165461,1433766852,"2015-06-08 05:34:12"
"4157","20151902111913-640","3","2015-06-06 07:58:53",1433602733,"C8",602396,1434205129,"2015-06-13 07:18:49"
"1155","20153704013734-599","1","2015-06-06 08:53:22",1433606002,"C0",77874,1433683876,"2015-06-07 06:31:16"
"1414","20150030060046-176","3","2015-06-06 08:59:38",1433606378,"C5",307766,1433914144,"2015-06-09 22:29:04"
"1586","20153804023854-460","2","2015-06-06 10:17:28",1433611048,"C4",157114,1433768162,"2015-06-08 05:56:02"
"2205","20151022041004-148","1","2015-06-06 11:07:48",1433614068,"C5",182552,1433796620,"2015-06-08 13:50:20"
"4904","20150719050740-812","1","2015-06-06 15:25:00",1433629500,"C2",774520,1434404020,"2015-06-15 14:33:40"
"1275","20150027100037-189","2","2015-06-06 15:55:55",1433631355,"C5",126474,1433757829,"2015-06-08 03:03:49"
"5636","20151505041552-201","1","2015-06-06 16:35:48",1433633748,"C0",87596,1433721344,"2015-06-07 16:55:44"
"1223","20153002103029-92","2","2015-06-06 16:57:41",1433635061,"C4",122944,1433758005,"2015-06-08 03:06:45"
"2370","20153402063455-599","1","2015-06-06 20:15:35",1433646935,"C2",197420,1433844355,"2015-06-09 03:05:55"
"5292","20152203012222-575","1","2015-06-06 20:55:22",1433649322,"C0",95460,1433744782,"2015-06-07 23:26:22"
"6193","20151329121310-651","2","2015-06-06 21:37:51",1433651871,"C0",103583,1433755454,"2015-06-08 02:24:14"
"960","20151604011635-266","2","2015-06-07 01:49:07",1433666947,"C3",362044,1434028991,"2015-06-11 06:23:11"
"2981","20151304041354-441","1","2015-06-07 03:44:30",1433673870,"C4",71412,1433745282,"2015-06-07 23:34:42"
"4296","20152704012752-116","3","2015-06-07 03:50:20",1433674220,"C0",112274,1433786494,"2015-06-08 11:01:34"
"2669","20154102064127-486","2","2015-06-07 04:48:30",1433677710,"C3",141741,1433819451,"2015-06-08 20:10:51"
"3684","20155504125520-496","2","2015-06-07 05:37:17",1433680637,"C4",77639,1433758276,"2015-06-08 03:11:16"
"1526","20155305035315-90","3","2015-06-07 06:25:13",1433683513,"C3",138718,1433822231,"2015-06-08 20:57:11"
"3344","20152801112857-221","3","2015-06-07 06:59:36",1433685576,"C3",167413,1433852989,"2015-06-09 05:29:49"
"2959","20153831123814-376","2","2015-06-07 08:11:47",1433689907,"C2",196271,1433886178,"2015-06-09 14:42:58"
"247","20152703062723-570","1","2015-06-07 08:12:53",1433689973,"C2",117310,1433807283,"2015-06-08 16:48:03"
"21","20152923082949-398","1","2015-06-07 11:03:29",1433700209,"C5",186460,1433886669,"2015-06-09 14:51:09"
"5611","20151602021614-218","1","2015-06-07 11:18:05",1433701085,"C6",421311,1434122396,"2015-06-12 08:19:56"
"1314","20155304065335-775","1","2015-06-07 11:21:35",1433701295,"C2",137640,1433838935,"2015-06-09 01:35:35"
"5178","20155803095829-960","3","2015-06-07 12:29:15",1433705355,"C0",177323,1433882678,"2015-06-09 13:44:38"
"3796","20152204012203-647","2","2015-06-07 13:10:18",1433707818,"C3",258495,1433966313,"2015-06-10 12:58:33"
"6289","20151401011424-950","1","2015-06-07 13:20:06",1433708406,"C8",259371,1433967777,"2015-06-10 13:22:57"
"2511","20153226123245-963","1","2015-06-07 13:42:03",1433709723,"C7",520479,1434230202,"2015-06-13 14:16:42"
"1046","20150608040651-249","2","2015-06-07 14:12:42",1433711562,"C5",861717,1434573279,"2015-06-17 13:34:39"
"654","20154705124714-48","2","2015-06-07 14:55:06",1433714106,"C3",90236,1433804342,"2015-06-08 15:59:02"
"4383","20152805102823-890","1","2015-06-07 15:32:59",1433716379,"C8",95538,1433811917,"2015-06-08 18:05:17"
"5283","20152501032517-581","2","2015-06-07 16:52:57",1433721177,"C5",261830,1433983007,"2015-06-10 17:36:47"
"463","20150205070257-697","2","2015-06-07 17:35:05",1433723705,"C8",105364,1433829069,"2015-06-08 22:51:09"
"6429","20150006010020-419","1","2015-06-07 18:23:46",1433726626,"C4",105806,1433832432,"2015-06-08 23:47:12"
"851","20154906014956-369","1","2015-06-07 18:29:37",1433726977,"C2",103181,1433830158,"2015-06-08 23:09:18"
"4941","20152304102334-555","1","2015-06-07 19:04:30",1433729070,"C4",290456,1434019526,"2015-06-11 03:45:26"
"5701","20153031113006-452","1","2015-06-07 19:45:21",1433731521,"C8",90645,1433822166,"2015-06-08 20:56:06"
"2236","20152202102255-946","1","2015-06-07 21:58:28",1433739508,"C0",473733,1434213241,"2015-06-13 09:34:01"
"3477","20153504043512-341","3","2015-06-07 23:58:10",1433746690,"C7",142889,1433889579,"2015-06-09 15:39:39"
"1071","20150823070821-824","2","2015-06-08 00:57:18",1433750238,"C3",453379,1434203617,"2015-06-13 06:53:37"
"2599","20154005074031-234","1","2015-06-08 01:50:49",1433753449,"C0",79406,1433832855,"2015-06-08 23:54:15"
"2225","20154102124124-992","2","2015-06-08 02:58:10",1433757490,"C5",69058,1433826548,"2015-06-08 22:09:08"
"4539","20154506114531-504","3","2015-06-08 02:58:15",1433757495,"C7",70582,1433828077,"2015-06-08 22:34:37"
"4446","20154126024152-89","1","2015-06-08 04:13:49",1433762029,"C4",361839,1434123868,"2015-06-12 08:44:28"
"5793","20150706080728-516","3","2015-06-08 05:45:14",1433767514,"C2",82133,1433849647,"2015-06-09 04:34:07"
"5863","20155902105925-30","3","2015-06-08 06:10:10",1433769010,"C5",167015,1433936025,"2015-06-10 04:33:45"
"1917","20154106094112-225","1","2015-06-08 06:13:55",1433769235,"C3",160363,1433929598,"2015-06-10 02:46:38"
"2341","20151404031404-378","2","2015-06-08 06:21:40",1433769700,"C4",313656,1434083356,"2015-06-11 21:29:16"
"2105","20152106092143-261","1","2015-06-08 07:25:40",1433773540,"C2",165837,1433939377,"2015-06-10 05:29:37"
"4300","20153227063240-542","1","2015-06-08 09:04:38",1433779478,"C7",522959,1434302437,"2015-06-14 10:20:37"
"3178","20152005082009-82","2","2015-06-08 10:30:18",1433784618,"C0",89003,1433873621,"2015-06-09 11:13:41"
"1708","20154606094659-402","1","2015-06-08 10:44:21",1433785461,"C7",88121,1433873582,"2015-06-09 11:13:02"
"3150","20151202071233-557","1","2015-06-08 12:38:21",1433792301,"C4",268974,1434061275,"2015-06-11 15:21:15"
"1916","20152731112735-564","1","2015-06-08 14:18:19",1433798299,"C7",350722,1434149021,"2015-06-12 15:43:41"
"1291","20151302111323-649","2","2015-06-08 15:25:08",1433802308,"C8",106701,1433909009,"2015-06-09 21:03:29"
"473","20150404040434-742","3","2015-06-08 18:35:32",1433813732,"C0",354658,1434168390,"2015-06-12 21:06:30"
"174","20153206033243-388","2","2015-06-08 19:05:39",1433815539,"C4",185576,1434001115,"2015-06-10 22:38:35"
"1602","20153730113759-10","3","2015-06-08 21:48:15",1433825295,"C5",101777,1433927072,"2015-06-10 02:04:32"
"5542","20153504033505-27","3","2015-06-08 22:34:03",1433828043,"C2",185369,1434013412,"2015-06-11 02:03:32"
"4034","20150707040715-238","1","2015-06-09 03:52:11",1433847131,"C5",64348,1433911479,"2015-06-09 21:44:39"
"4943","20154505074523-130","1","2015-06-09 04:15:02",1433848502,"C5",110993,1433959495,"2015-06-10 11:04:55"
"5785","20152102062100-389","2","2015-06-09 05:28:39",1433852919,"C7",364451,1434217370,"2015-06-13 10:42:50"
"5456","20150002070024-376","2","2015-06-09 06:49:24",1433857764,"C0",302070,1434159834,"2015-06-12 18:43:54"
"2109","20152207122235-665","2","2015-06-09 07:41:17",1433860877,"C5",77961,1433938838,"2015-06-10 05:20:38"
"5855","20153906013936-263","3","2015-06-09 08:05:52",1433862352,"C6",239176,1434101528,"2015-06-12 02:32:08"
"5371","20155004125004-492","1","2015-06-09 08:13:44",1433862824,"C8",83084,1433945908,"2015-06-10 07:18:28"
"4191","20153907063953-451","2","2015-06-09 10:02:55",1433869375,"C5",92491,1433961866,"2015-06-10 11:44:26"
"2227","20155301085312-76","1","2015-06-09 11:05:12",1433873112,"C4",349560,1434222672,"2015-06-13 12:11:12"
"4786","20150104060101-478","2","2015-06-09 11:25:25",1433874325,"C8",225732,1434100057,"2015-06-12 02:07:37"
"2988","20150606010609-786","1","2015-06-09 16:28:56",1433892536,"C2",271367,1434163903,"2015-06-12 19:51:43"
"5137","20154607064650-344","3","2015-06-09 16:29:16",1433892556,"C5",103873,1433996429,"2015-06-10 21:20:29"
"2920","20150805010805-339","1","2015-06-09 17:05:51",1433894751,"C0",179933,1434074684,"2015-06-11 19:04:44"
"3856","20155907055958-889","2","2015-06-09 17:17:35",1433895455,"C4",170257,1434065712,"2015-06-11 16:35:12"
"2022","20153107033139-406","3","2015-06-09 18:15:53",1433898953,"C4",91327,1433990280,"2015-06-10 19:38:00"
"5449","20152305052333-803","2","2015-06-09 18:51:25",1433901085,"C3",350872,1434251957,"2015-06-13 20:19:17"
"4017","20152707062703-3","2","2015-06-09 18:56:09",1433901369,"C0",108873,1434010242,"2015-06-11 01:10:42"
"783","20153203053218-362","3","2015-06-09 19:02:48",1433901768,"C6",87305,1433989073,"2015-06-10 19:17:53"
"4787","20151105121120-955","3","2015-06-09 19:06:04",1433901964,"C5",185242,1434087206,"2015-06-11 22:33:26"
"5422","20150308110346-628","1","2015-06-09 20:11:28",1433905888,"C2",119262,1434025150,"2015-06-11 05:19:10"
"2018","20151905081937-688","1","2015-06-09 21:31:11",1433910671,"C4",196547,1434107218,"2015-06-12 04:06:58"
"4551","20153104043113-656","2","2015-06-09 23:48:55",1433918935,"C7",50918,1433969853,"2015-06-10 13:57:33"
"165","20151503071547-841","1","2015-06-10 03:47:11",1433933231,"C8",84612,1434017843,"2015-06-11 03:17:23"
"506","20152923012904-916","3","2015-06-10 04:19:58",1433935198,"C5",761127,1434696325,"2015-06-18 23:45:25"
"5424","20152603072628-94","1","2015-06-10 04:39:38",1433936378,"C4",84970,1434021348,"2015-06-11 04:15:48"
"5755","20152607112632-973","2","2015-06-10 08:01:56",1433948516,"C2",246924,1434195440,"2015-06-13 04:37:20"
"4353","20152004012053-387","2","2015-06-10 08:13:13",1433949193,"C7",249970,1434199163,"2015-06-13 05:39:23"
"2854","20152031112006-199","3","2015-06-10 08:42:14",1433950934,"C5",427264,1434378198,"2015-06-15 07:23:18"
"2765","20154204024204-803","1","2015-06-10 13:53:32",1433969612,"C2",515488,1434485100,"2015-06-16 13:05:00"
"2277","20152709072702-390","2","2015-06-10 14:13:28",1433970808,"C3",110786,1434081594,"2015-06-11 20:59:54"
"565","20155801095814-110","2","2015-06-10 16:28:31",1433978911,"C4",114431,1434093342,"2015-06-12 00:15:42"
"6088","20154314114311-549","2","2015-06-10 18:07:00",1433984820,"C2",336547,1434321367,"2015-06-14 15:36:07"
"1908","20152504072503-198","2","2015-06-10 19:18:53",1433989133,"C7",280615,1434269748,"2015-06-14 01:15:48"
"1377","20155606015608-991","3","2015-06-10 19:52:44",1433991164,"C3",366996,1434358160,"2015-06-15 01:49:20"
"381","20153801053802-368","2","2015-06-10 20:23:29",1433993009,"C4",262509,1434255518,"2015-06-13 21:18:38"
"3272","20155501015552-358","1","2015-06-10 21:54:32",1433998472,"C4",403160,1434401632,"2015-06-15 13:53:52"
"173","20153008023037-716","1","2015-06-10 22:14:49",1433999689,"C5",100326,1434100015,"2015-06-12 02:06:55"
"5070","20151708021738-621","1","2015-06-10 23:24:48",1434003888,"C0",102815,1434106703,"2015-06-12 03:58:23"
"3219","20152907062931-133","2","2015-06-11 01:08:28",1434010108,"C5",108779,1434118887,"2015-06-12 07:21:27"
"2658","20152026112029-817","1","2015-06-11 01:13:33",1434010413,"C2",168248,1434178661,"2015-06-12 23:57:41"
"3363","20151802021836-315","2","2015-06-11 02:17:56",1434014276,"C2",91795,1434106071,"2015-06-12 03:47:51"
"1725","20150806040856-166","2","2015-06-11 03:41:25",1434019285,"C5",55307,1434074592,"2015-06-11 19:03:12"
"4596","20153504033551-486","1","2015-06-11 03:47:24",1434019644,"C5",187431,1434207075,"2015-06-13 07:51:15"
"1183","20150304080318-31","1","2015-06-11 04:56:56",1434023816,"C2",296809,1434320625,"2015-06-14 15:23:45"
"1422","20150708030724-124","2","2015-06-11 06:43:05",1434030185,"C6",228941,1434259126,"2015-06-13 22:18:46"
"3643","20154307024334-228","1","2015-06-11 06:47:07",1434030427,"C3",317013,1434347440,"2015-06-14 22:50:40"
"3583","20151309071349-323","1","2015-06-11 07:43:15",1434033795,"C8",87283,1434121078,"2015-06-12 07:57:58"
"211","20153403093425-594","1","2015-06-11 07:56:54",1434034614,"C7",97907,1434132521,"2015-06-12 11:08:41"
"770","20155610035651-241","2","2015-06-11 08:13:33",1434035613,"C6",58602,1434094215,"2015-06-12 00:30:15"
"1667","20154910014900-520","1","2015-06-11 09:27:42",1434040062,"C4",70722,1434110784,"2015-06-12 05:06:24"
"3495","20150808100805-344","1","2015-06-11 11:16:31",1434046591,"C8",131653,1434178244,"2015-06-12 23:50:44"
"6444","20152705112755-32","2","2015-06-11 12:28:22",1434050902,"C2",174009,1434224911,"2015-06-13 12:48:31"
"255","20152509092558-706","1","2015-06-11 12:57:42",1434052662,"C5",92752,1434145414,"2015-06-12 14:43:34"
"1062","20151602031658-446","3","2015-06-11 13:18:53",1434053933,"C8",154103,1434208036,"2015-06-13 08:07:16"
"5267","20155707045718-181","2","2015-06-11 14:28:04",1434058084,"C5",168323,1434226407,"2015-06-13 13:13:27"
"1633","20155824115842-88","2","2015-06-11 15:46:24",1434062784,"C6",261477,1434324261,"2015-06-14 16:24:21"
"3841","20151808071834-232","1","2015-06-11 16:39:16",1434065956,"C3",292842,1434358798,"2015-06-15 01:59:58"
"2078","20150802030830-611","1","2015-06-11 18:53:06",1434073986,"C5",263692,1434337678,"2015-06-14 20:07:58"
"3952","20153509123549-969","1","2015-06-11 20:59:09",1434081549,"C5",101500,1434183049,"2015-06-13 01:10:49"
"4268","20155203125254-748","3","2015-06-12 00:37:19",1434094639,"C8",146693,1434241332,"2015-06-13 17:22:12"
"1031","20153831033841-860","1","2015-06-12 02:54:05",1434102845,"C5",495462,1434598307,"2015-06-17 20:31:47"
"1367","20151009061043-83","1","2015-06-12 04:03:37",1434107017,"C0",125787,1434232804,"2015-06-13 15:00:04"
"310","20152302082313-686","1","2015-06-12 04:50:17",1434109817,"C2",106403,1434216220,"2015-06-13 10:23:40"
"958","20152623092639-730","1","2015-06-12 06:56:57",1434117417,"C2",245574,1434362991,"2015-06-15 03:09:51"
"3503","20151431071428-170","1","2015-06-12 07:00:10",1434117610,"C2",345314,1434462924,"2015-06-16 06:55:24"
"1765","20154806044809-982","3","2015-06-12 08:13:31",1434122011,"C4",69646,1434191657,"2015-06-13 03:34:17"
"6179","20155301085317-34","1","2015-06-12 08:20:02",1434122402,"C8",189681,1434312083,"2015-06-14 13:01:23"
"5410","20151002121039-700","1","2015-06-12 08:53:11",1434124391,"C5",426076,1434550467,"2015-06-17 07:14:27"
"2772","20152507042553-806","1","2015-06-12 09:41:53",1434127313,"C4",50970,1434178283,"2015-06-12 23:51:23"
"5471","20155306125304-711","2","2015-06-12 09:53:55",1434128035,"C0",169217,1434297252,"2015-06-14 08:54:12"
"3380","20154310024344-489","3","2015-06-12 10:22:57",1434129777,"C2",157153,1434286930,"2015-06-14 06:02:10"
"6398","20154405034405-591","1","2015-06-12 15:06:53",1434146813,"C3",75321,1434222134,"2015-06-13 12:02:14"
"769","20154405064401-508","2","2015-06-12 15:14:06",1434147246,"C8",127081,1434274327,"2015-06-14 02:32:07"
"4683","20152910022924-572","2","2015-06-12 15:37:22",1434148642,"C3",176878,1434325520,"2015-06-14 16:45:20"
"2999","20150003040042-47","1","2015-06-12 17:26:34",1434155194,"C3",97844,1434253038,"2015-06-13 20:37:18"
"4644","20150509040535-12","2","2015-06-12 18:14:38",1434158078,"C2",88981,1434247059,"2015-06-13 18:57:39"
"4481","20150102100120-757","2","2015-06-12 18:29:14",1434158954,"C5",127782,1434286736,"2015-06-14 05:58:56"
"4116","20153208033241-763","1","2015-06-12 18:39:27",1434159567,"C2",356806,1434516373,"2015-06-16 21:46:13"
"990","20150508110558-558","1","2015-06-12 20:07:37",1434164857,"C3",126033,1434290890,"2015-06-14 07:08:10"
"406","20155517035538-277","1","2015-06-12 22:18:30",1434172710,"C0",324196,1434496906,"2015-06-16 16:21:46"
"4516","20151807101827-295","2","2015-06-12 22:19:03",1434172743,"C4",158412,1434331155,"2015-06-14 18:19:15"
"632","20151910041931-214","3","2015-06-12 22:41:39",1434174099,"C7",97864,1434271963,"2015-06-14 01:52:43"
"2657","20152504102542-990","3","2015-06-12 23:20:16",1434176416,"C5",105382,1434281798,"2015-06-14 04:36:38"
"1151","20150108040141-642","1","2015-06-12 23:23:05",1434176585,"C7",186042,1434362627,"2015-06-15 03:03:47"
"1790","20155804095839-242","3","2015-06-13 00:20:50",1434180050,"C7",106133,1434286183,"2015-06-14 05:49:43"
"5364","20151905031957-601","1","2015-06-13 01:37:47",1434184667,"C7",320935,1434505602,"2015-06-16 18:46:42"
"3403","20154310114354-581","1","2015-06-13 03:13:38",1434190418,"C8",114292,1434304710,"2015-06-14 10:58:30"
"2175","20151808121849-986","2","2015-06-13 03:57:13",1434193033,"C6",66984,1434260017,"2015-06-13 22:33:37"
"3652","20152029102006-584","3","2015-06-13 05:42:18",1434199338,"C6",213222,1434412560,"2015-06-15 16:56:00"
"5628","20150808020840-877","1","2015-06-13 05:58:14",1434200294,"C8",201287,1434401581,"2015-06-15 13:53:01"
"6482","20152924032915-517","1","2015-06-13 06:42:57",1434202977,"C6",282737,1434485714,"2015-06-16 13:15:14"
"1548","20150124080152-145","1","2015-06-13 07:25:16",1434205516,"C6",287634,1434493150,"2015-06-16 15:19:10"
"3972","20152603062609-710","2","2015-06-13 07:40:13",1434206413,"C0",434222,1434640635,"2015-06-18 08:17:15"
"616","20155007045010-724","2","2015-06-13 08:14:04",1434208444,"C5",243717,1434452161,"2015-06-16 03:56:01"
"2184","20150624080656-470","1","2015-06-13 08:22:18",1434208938,"C8",864461,1435073399,"2015-06-23 08:29:59"
"4597","20152112122156-641","2","2015-06-13 10:22:46",1434216166,"C4",79250,1434295416,"2015-06-14 08:23:36"
"4027","20151403121420-600","2","2015-06-13 10:53:20",1434218000,"C4",286380,1434504380,"2015-06-16 18:26:20"
"2632","20152209122210-562","1","2015-06-13 10:58:34",1434218314,"C7",170292,1434388606,"2015-06-15 10:16:46"
"2744","20154711044729-817","2","2015-06-13 12:33:53",1434224033,"C4",52528,1434276561,"2015-06-14 03:09:21"
"1978","20150307120319-340","2","2015-06-13 12:40:31",1434224431,"C3",65079,1434289510,"2015-06-14 06:45:10"
"2430","20151004021051-72","1","2015-06-13 12:47:07",1434224827,"C4",96572,1434321399,"2015-06-14 15:36:39"
"4681","20151711021720-756","2","2015-06-13 14:34:55",1434231295,"C2",173855,1434405150,"2015-06-15 14:52:30"
"1412","20155311065304-252","1","2015-06-13 14:38:50",1434231530,"C2",100373,1434331903,"2015-06-14 18:31:43"
"5115","20154003064021-184","2","2015-06-13 16:48:05",1434239285,"C0",112558,1434351843,"2015-06-15 00:04:03"
"1","20152930032938-338","1","2015-06-13 17:51:38",1434243098,"C8",243624,1434486722,"2015-06-16 13:32:02"
"5556","20150007110022-413","2","2015-06-13 17:59:59",1434243599,"C2",543577,1434787176,"2015-06-20 00:59:36"
"1619","20155417065430-542","1","2015-06-13 19:01:35",1434247295,"C8",475285,1434722580,"2015-06-19 07:03:00"
"6020","20153603023614-793","1","2015-06-13 19:38:36",1434249516,"C5",441071,1434690587,"2015-06-18 22:09:47"
"4428","20154212054245-458","1","2015-06-13 20:42:30",1434253350,"C3",97185,1434350535,"2015-06-14 23:42:15"
"3197","20155802065857-168","2","2015-06-13 23:17:47",1434262667,"C8",201826,1434464493,"2015-06-16 07:21:33"
"1262","20155205045211-58","1","2015-06-14 00:33:44",1434267224,"C7",102699,1434369923,"2015-06-15 05:05:23"
"4696","20154509014559-37","1","2015-06-14 07:10:37",1434291037,"C7",204139,1434495176,"2015-06-16 15:52:56"
"5365","20152729102731-508","1","2015-06-14 07:33:56",1434292436,"C8",274397,1434566833,"2015-06-17 11:47:13"
"2575","20154312124334-595","1","2015-06-14 08:05:08",1434294308,"C5",78047,1434372355,"2015-06-15 05:45:55"
"2448","20151511061503-898","1","2015-06-14 08:20:33",1434295233,"C2",133365,1434428598,"2015-06-15 21:23:18"
"6133","20150710010709-698","1","2015-06-14 10:08:14",1434301694,"C8",66973,1434368667,"2015-06-15 04:44:27"
"663","20155922025905-519","2","2015-06-14 10:25:59",1434302759,"C4",656938,1434959697,"2015-06-22 00:54:57"
"5604","20152305092355-533","2","2015-06-14 11:30:41",1434306641,"C7",392603,1434699244,"2015-06-19 00:34:04"
"955","20154706084700-54","2","2015-06-14 11:38:28",1434307108,"C2",87686,1434394794,"2015-06-15 11:59:54"
"1174","20152311062324-562","1","2015-06-14 12:06:16",1434308776,"C5",139886,1434448662,"2015-06-16 02:57:42"
"5204","20155706075734-63","2","2015-06-14 12:53:42",1434311622,"C5",354484,1434666106,"2015-06-18 15:21:46"
"2642","20155202065231-630","1","2015-06-14 13:19:05",1434313145,"C7",529997,1434843142,"2015-06-20 16:32:22"
"4252","20155208125234-73","2","2015-06-14 16:20:50",1434324050,"C8",265448,1434589498,"2015-06-17 18:04:58"
"472","20155412025458-760","1","2015-06-14 16:43:42",1434325422,"C5",89662,1434415084,"2015-06-15 17:38:04"
"2573","20152707102734-863","3","2015-06-14 19:32:38",1434335558,"C4",91072,1434426630,"2015-06-15 20:50:30"
"3707","20150106120154-473","2","2015-06-14 19:42:34",1434336154,"C5",89855,1434426009,"2015-06-15 20:40:09"
"3078","20153606123604-841","1","2015-06-14 20:52:36",1434340356,"C4",90124,1434430480,"2015-06-15 21:54:40"
"1134","20151212031240-621","1","2015-06-14 21:43:40",1434343420,"C5",98130,1434441550,"2015-06-16 00:59:10"
"3132","20151811051833-890","2","2015-06-14 21:44:33",1434343473,"C8",55032,1434398505,"2015-06-15 13:01:45"
"1427","20150413110402-150","1","2015-06-14 22:05:19",1434344719,"C4",126077,1434470796,"2015-06-16 09:06:36"
"4314","20150606030611-107","2","2015-06-14 22:09:07",1434344947,"C5",102368,1434447315,"2015-06-16 02:35:15"
"19","20151106121113-182","2","2015-06-14 22:54:43",1434347683,"C8",364905,1434712588,"2015-06-19 04:16:28"
"5502","20151113011134-396","1","2015-06-15 02:49:16",1434361756,"C4",67731,1434429487,"2015-06-15 21:38:07"
"4329","20152509072533-673","2","2015-06-15 03:11:54",1434363114,"C5",167727,1434530841,"2015-06-17 01:47:21"
"5941","20155913025927-438","3","2015-06-15 05:20:31",1434370831,"C7",69032,1434439863,"2015-06-16 00:31:03"
"5465","20151813101843-73","1","2015-06-15 06:03:03",1434373383,"C8",78730,1434452113,"2015-06-16 03:55:13"
"6086","20153213033256-646","1","2015-06-15 06:34:54",1434375294,"C5",70259,1434445553,"2015-06-16 02:05:53"
"6169","20152107072157-137","1","2015-06-15 06:39:41",1434375581,"C8",344332,1434719913,"2015-06-19 06:18:33"
"4348","20150808020805-83","2","2015-06-15 06:46:23",1434375983,"C5",289149,1434665132,"2015-06-18 15:05:32"
"384","20151613031640-694","1","2015-06-15 09:52:48",1434387168,"C5",353971,1434741139,"2015-06-19 12:12:19"
"646","20153512093552-508","1","2015-06-15 09:57:40",1434387460,"C4",260508,1434647968,"2015-06-18 10:19:28"
"5668","20151813091850-644","1","2015-06-15 10:11:42",1434388302,"C6",175972,1434564274,"2015-06-17 11:04:34"
"3084","20154913094911-76","1","2015-06-15 11:23:19",1434392599,"C2",89224,1434481823,"2015-06-16 12:10:23"
"1593","20155407025401-645","1","2015-06-15 11:24:17",1434392657,"C4",84827,1434477484,"2015-06-16 10:58:04"
"2777","20154620024622-348","2","2015-06-15 11:41:07",1434393667,"C8",447057,1434840724,"2015-06-20 15:52:04"
"6558","20154005024018-445","1","2015-06-15 11:58:57",1434394737,"C0",284773,1434679510,"2015-06-18 19:05:10"
"5630","20150513030530-407","2","2015-06-15 12:44:24",1434397464,"C8",82167,1434479631,"2015-06-16 11:33:51"
"4077","20152008082056-988","1","2015-06-15 12:51:08",1434397868,"C7",310506,1434708374,"2015-06-19 03:06:14"
"1295","20151406101448-508","2","2015-06-15 14:27:39",1434403659,"C5",113253,1434516912,"2015-06-16 21:55:12"
"4278","20155409065419-204","3","2015-06-15 14:57:19",1434405439,"C7",273690,1434679129,"2015-06-18 18:58:49"
"6376","20152813042842-830","3","2015-06-15 15:11:26",1434406286,"C2",84082,1434490368,"2015-06-16 14:32:48"
"188","20151007061036-970","2","2015-06-15 15:12:00",1434406320,"C5",361842,1434768162,"2015-06-19 19:42:42"
"2801","20155413045417-828","2","2015-06-15 16:20:55",1434410455,"C7",85399,1434495854,"2015-06-16 16:04:14"
"4362","20154512124548-471","1","2015-06-15 16:40:09",1434411609,"C4",91087,1434502696,"2015-06-16 17:58:16"
"1973","20151414041459-646","1","2015-06-15 17:29:49",1434414589,"C6",90890,1434505479,"2015-06-16 18:44:39"
"1101","20150309010348-628","1","2015-06-15 18:09:16",1434416956,"C5",268364,1434685320,"2015-06-18 20:42:00"
"4080","20152913122916-642","2","2015-06-15 18:17:08",1434417428,"C7",96836,1434514264,"2015-06-16 21:11:04"
"6495","20152607102647-573","1","2015-06-15 19:01:39",1434420099,"C4",103156,1434523255,"2015-06-16 23:40:55"
"1571","20153213063205-982","1","2015-06-15 20:03:03",1434423783,"C8",110729,1434534512,"2015-06-17 02:48:32"
"2479","20153005093039-50","1","2015-06-15 20:53:14",1434426794,"C8",180991,1434607785,"2015-06-17 23:09:45"
"3991","20152114012137-37","1","2015-06-15 20:59:44",1434427184,"C4",113887,1434541071,"2015-06-17 04:37:51"
"1369","20154009054046-633","3","2015-06-15 21:10:32",1434427832,"C5",265493,1434693325,"2015-06-18 22:55:25"
"4389","20150113030159-936","1","2015-06-15 21:29:22",1434428962,"C4",196043,1434625005,"2015-06-18 03:56:45"
"6060","20150013110026-797","1","2015-06-15 22:11:56",1434431516,"C5",106545,1434538061,"2015-06-17 03:47:41"
"712","20153203093248-618","1","2015-06-15 22:48:06",1434433686,"C5",542259,1434975945,"2015-06-22 05:25:45"
"3858","20154407024412-194","1","2015-06-15 22:51:30",1434433890,"C0",240146,1434674036,"2015-06-18 17:33:56"
"1890","20151707051709-188","2","2015-06-15 23:53:45",1434437625,"C4",238332,1434675957,"2015-06-18 18:05:57"
"1205","20155214125258-653","1","2015-06-16 01:34:52",1434443692,"C7",66057,1434509749,"2015-06-16 19:55:49"
"850","20153710103717-23","1","2015-06-16 01:56:50",1434445010,"C4",162391,1434607401,"2015-06-17 23:03:21"
"4761","20155222025248-836","1","2015-06-16 03:06:38",1434449198,"C8",423526,1434872724,"2015-06-21 00:45:24"
"2820","20151403111404-688","2","2015-06-16 03:10:34",1434449434,"C6",182365,1434631799,"2015-06-18 05:49:59"
"1219","20150114030106-231","1","2015-06-16 03:56:54",1434452214,"C2",66474,1434518688,"2015-06-16 22:24:48"
"2489","20151413031402-190","3","2015-06-16 04:09:14",1434452954,"C2",109656,1434562610,"2015-06-17 10:36:50"
"1321","20151514091533-555","2","2015-06-16 05:14:37",1434456877,"C4",79172,1434536049,"2015-06-17 03:14:09"
"4498","20155107105141-423","2","2015-06-16 05:22:27",1434457347,"C2",378923,1434836270,"2015-06-20 14:37:50"
"6094","20151012111048-832","1","2015-06-16 07:16:02",1434464162,"C4",331514,1434795676,"2015-06-20 03:21:16"
"4901","20151813021824-408","2","2015-06-16 08:22:29",1434468149,"C3",237845,1434705994,"2015-06-19 02:26:34"
"868","20155408015402-944","2","2015-06-16 11:42:41",1434480161,"C4",97617,1434577778,"2015-06-17 14:49:38"
"4145","20153909123913-261","2","2015-06-16 11:44:58",1434480298,"C0",85935,1434566233,"2015-06-17 11:37:13"
"3010","20152315102354-941","1","2015-06-16 11:49:14",1434480554,"C4",91520,1434572074,"2015-06-17 13:14:34"
"5342","20152315122321-162","3","2015-06-16 11:49:56",1434480596,"C0",84395,1434564991,"2015-06-17 11:16:31"
"270","20153407123403-76","2","2015-06-16 11:51:18",1434480678,"C2",258345,1434739023,"2015-06-19 11:37:03"
"3765","20153708073703-436","2","2015-06-16 13:16:01",1434485761,"C0",355769,1434841530,"2015-06-20 16:05:30"
"5815","20153801063806-347","1","2015-06-16 14:03:58",1434488638,"C2",1322752,1435811390,"2015-07-01 21:29:50"
"2123","20150011020058-334","2","2015-06-16 14:09:48",1434488988,"C2",61790,1434550778,"2015-06-17 07:19:38"
"948","20152807062821-864","1","2015-06-16 14:56:42",1434491802,"C5",269367,1434761169,"2015-06-19 17:46:09"
"1488","20155712125721-681","1","2015-06-16 14:57:09",1434491829,"C2",117596,1434609425,"2015-06-17 23:37:05"
"2627","20152012032058-971","1","2015-06-16 15:22:38",1434493358,"C5",172850,1434666208,"2015-06-18 15:23:28"
"3313","20152308052334-841","3","2015-06-16 16:28:59",1434497339,"C3",98275,1434595614,"2015-06-17 19:46:54"
"6089","20153508053537-848","3","2015-06-16 16:52:28",1434498748,"C2",229537,1434728285,"2015-06-19 08:38:05"
"700","20154207084222-772","1","2015-06-16 16:55:19",1434498919,"C5",115311,1434614230,"2015-06-18 00:57:10"
"4845","20151615011608-528","2","2015-06-16 22:47:56",1434520076,"C6",120708,1434640784,"2015-06-18 08:19:44"
"1903","20150010050052-231","1","2015-06-17 01:21:16",1434529276,"C2",68553,1434597829,"2015-06-17 20:23:49"
"404","20154810034812-304","3","2015-06-17 01:26:42",1434529602,"C4",276555,1434806157,"2015-06-20 06:15:57"
"3299","20152310032340-322","1","2015-06-17 01:33:14",1434529994,"C4",79282,1434609276,"2015-06-17 23:34:36"
"2902","20155314075350-327","1","2015-06-17 02:04:00",1434531840,"C7",119105,1434650945,"2015-06-18 11:09:05"
"3434","20155409125422-39","2","2015-06-17 04:09:58",1434539398,"C5",82467,1434621865,"2015-06-18 03:04:25"
"1486","20153509013553-476","3","2015-06-17 04:10:11",1434539411,"C7",93894,1434633305,"2015-06-18 06:15:05"
"5716","20152004042018-896","3","2015-06-17 04:17:12",1434539832,"C6",179969,1434719801,"2015-06-19 06:16:41"
"5979","20151011011032-480","2","2015-06-17 04:36:06",1434540966,"C8",243767,1434784733,"2015-06-20 00:18:53"
"2440","20155813115831-288","1","2015-06-17 05:33:55",1434544435,"C0",161262,1434705697,"2015-06-19 02:21:37"
"5345","20150907060938-780","2","2015-06-17 06:48:38",1434548918,"C6",144390,1434693308,"2015-06-18 22:55:08"
"1181","20155909075931-597","3","2015-06-17 07:10:19",1434550219,"C2",344124,1434894343,"2015-06-21 06:45:43"
"1869","20153815083827-733","2","2015-06-17 07:14:03",1434550443,"C2",83868,1434634311,"2015-06-18 06:31:51"
"3698","20150514090542-943","3","2015-06-17 08:27:18",1434554838,"C5",85632,1434640470,"2015-06-18 08:14:30"
"3312","20152313102357-845","2","2015-06-17 10:11:58",1434561118,"C0",344881,1434905999,"2015-06-21 09:59:59"
"156","20150305060300-527","1","2015-06-17 10:17:46",1434561466,"C5",526043,1435087509,"2015-06-23 12:25:09"
"1569","20151307091345-782","1","2015-06-17 11:27:02",1434565622,"C3",871997,1435437619,"2015-06-27 13:40:19"
"1720","20153906013912-384","2","2015-06-17 12:05:54",1434567954,"C8",1811601,1436379555,"2015-07-08 11:19:15"
"3686","20155014015019-965","1","2015-06-17 12:08:28",1434568108,"C3",84363,1434652471,"2015-06-18 11:34:31"
"4144","20153015023037-512","1","2015-06-17 13:41:23",1434573683,"C8",84923,1434658606,"2015-06-18 13:16:46"
"2554","20155106065150-500","1","2015-06-17 13:52:43",1434574363,"C5",139379,1434713742,"2015-06-19 04:35:42"
"3678","20151807121828-117","2","2015-06-17 14:43:44",1434577424,"C2",436358,1435013782,"2015-06-22 15:56:22"
"3975","20152913022938-375","3","2015-06-17 15:54:58",1434581698,"C8",175360,1434757058,"2015-06-19 16:37:38"
"2300","20151616021636-386","1","2015-06-17 18:52:51",1434592371,"C6",102975,1434695346,"2015-06-18 23:29:06"
"3697","20152614032608-515","3","2015-06-17 21:12:20",1434600740,"C8",139986,1434740726,"2015-06-19 12:05:26"
"5142","20153013013015-228","1","2015-06-17 21:19:09",1434601149,"C2",373734,1434974883,"2015-06-22 05:08:03"
"3192","20155311045315-402","1","2015-06-17 21:19:59",1434601199,"C4",267202,1434868401,"2015-06-20 23:33:21"
"2641","20153716033726-119","2","2015-06-17 22:08:57",1434604137,"C2",109891,1434714028,"2015-06-19 04:40:28"
"6041","20150210020219-563","1","2015-06-17 23:51:47",1434610307,"C4",80021,1434690328,"2015-06-18 22:05:28"
"5694","20150715100705-414","1","2015-06-17 23:59:25",1434610765,"C5",111370,1434722135,"2015-06-19 06:55:35"
"460","20152307102329-186","1","2015-06-18 00:10:59",1434611459,"C5",456825,1435068284,"2015-06-23 07:04:44"
"129","20152603032638-774","1","2015-06-18 01:22:41",1434615761,"C5",177909,1434793670,"2015-06-20 02:47:50"
"554","20154810074844-679","2","2015-06-18 05:47:04",1434631624,"C8",136780,1434768404,"2015-06-19 19:46:44"
"3497","20154309114329-296","2","2015-06-18 05:54:39",1434632079,"C5",378335,1435010414,"2015-06-22 15:00:14"
"6461","20150409100452-47","1","2015-06-18 06:40:37",1434634837,"C0",255115,1434889952,"2015-06-21 05:32:32"
"5250","20155809125823-570","1","2015-06-18 07:07:59",1434636479,"C3",94572,1434731051,"2015-06-19 09:24:11"
"894","20153217103251-836","1","2015-06-18 08:34:52",1434641692,"C2",79321,1434721013,"2015-06-19 06:36:53"
"2270","20154416074444-263","1","2015-06-18 08:47:18",1434642438,"C4",176554,1434818992,"2015-06-20 09:49:52"
"3853","20154211054209-984","2","2015-06-18 09:17:05",1434644225,"C0",406612,1435050837,"2015-06-23 02:13:57"
"3961","20155612075623-190","1","2015-06-18 09:30:58",1434645058,"C8",104815,1434749873,"2015-06-19 14:37:53"
"3647","20155511075557-246","2","2015-06-18 09:31:33",1434645093,"C3",305268,1434950361,"2015-06-21 22:19:21"
"2193","20154308034359-236","1","2015-06-18 10:01:15",1434646875,"C4",843436,1435490311,"2015-06-28 04:18:31"
"6353","20154913024913-440","2","2015-06-18 10:54:20",1434650060,"C7",59701,1434709761,"2015-06-19 03:29:21"
"2451","20152206102254-44","2","2015-06-18 11:24:56",1434651896,"C7",520261,1435172157,"2015-06-24 11:55:57"
"4780","20155308075334-739","1","2015-06-18 11:57:06",1434653826,"C4",209236,1434863062,"2015-06-20 22:04:22"
"5034","20153915063929-257","1","2015-06-18 12:18:43",1434655123,"C7",139777,1434794900,"2015-06-20 03:08:20"
"702","20155904055905-326","2","2015-06-18 12:32:39",1434655959,"C7",170002,1434825961,"2015-06-20 11:46:01"
"4971","20153709073753-995","3","2015-06-18 13:06:45",1434658005,"C6",797332,1435455337,"2015-06-27 18:35:37"
"4821","20151515041526-196","1","2015-06-18 13:09:35",1434658175,"C4",82683,1434740858,"2015-06-19 12:07:38"
"344","20151316021336-107","3","2015-06-18 13:35:16",1434659716,"C2",85250,1434744966,"2015-06-19 13:16:06"
"2647","20154210124201-733","1","2015-06-18 13:55:39",1434660939,"C4",347809,1435008748,"2015-06-22 14:32:28"
"6305","20153704083744-741","3","2015-06-18 14:42:47",1434663767,"C5",175929,1434839696,"2015-06-20 15:34:56"
"4336","20153912053941-227","1","2015-06-18 15:29:25",1434666565,"C4",255292,1434921857,"2015-06-21 14:24:17"
"4373","20153513013506-980","3","2015-06-18 15:39:54",1434667194,"C3",439488,1435106682,"2015-06-23 17:44:42"
"4718","20153510023528-508","2","2015-06-18 19:35:04",1434681304,"C4",88647,1434769951,"2015-06-19 20:12:31"
"5674","20155004085057-252","3","2015-06-18 19:48:29",1434682109,"C0",178436,1434860545,"2015-06-20 21:22:25"
"3288","20152104052130-587","2","2015-06-18 19:56:19",1434682579,"C2",174127,1434856706,"2015-06-20 20:18:26"
"2953","20152116052127-688","1","2015-06-18 19:57:01",1434682621,"C2",91067,1434773688,"2015-06-19 21:14:48"
"1849","20152415102404-680","2","2015-06-18 20:48:47",1434685727,"C4",296683,1434982410,"2015-06-22 07:13:30"
"5026","20150816050850-701","1","2015-06-18 21:58:18",1434689898,"C8",95084,1434784982,"2015-06-20 00:23:02"
"6212","20155412045446-0","1","2015-06-18 22:35:46",1434692146,"C8",269430,1434961576,"2015-06-22 01:26:16"
"2900","20153007083052-124","1","2015-06-18 23:03:31",1434693811,"C0",334253,1435028064,"2015-06-22 19:54:24"
"440","20153704113707-880","1","2015-06-18 23:50:01",1434696601,"C4",626787,1435323388,"2015-06-26 05:56:28"
"2262","20152614112619-98","2","2015-06-19 00:27:05",1434698825,"C3",196223,1434895048,"2015-06-21 06:57:28"
"4137","20151816121814-878","1","2015-06-19 02:07:24",1434704844,"C8",111275,1434816119,"2015-06-20 09:01:59"
"966","20155613125611-113","1","2015-06-19 02:53:39",1434707619,"C5",60281,1434767900,"2015-06-19 19:38:20"
"4273","20154213044221-384","1","2015-06-19 03:02:59",1434708179,"C8",67034,1434775213,"2015-06-19 21:40:13"
"1871","20155711035748-460","3","2015-06-19 03:56:14",1434711374,"C4",92558,1434803932,"2015-06-20 05:38:52"
"22","20155817095851-242","3","2015-06-19 04:42:15",1434714135,"C4",76902,1434791037,"2015-06-20 02:03:57"
"1277","20152311102347-770","1","2015-06-19 04:55:09",1434714909,"C0",95926,1434810835,"2015-06-20 07:33:55"
"6515","20151506031529-885","3","2015-06-19 05:05:04",1434715504,"C7",155225,1434870729,"2015-06-21 00:12:09"
"2304","20151201071206-107","3","2015-06-19 05:11:53",1434715913,"C8",221141,1434937054,"2015-06-21 18:37:34"
"4648","20154404074423-76","1","2015-06-19 05:39:08",1434717548,"C8",257697,1434975245,"2015-06-22 05:14:05"
"3521","20152711112749-922","3","2015-06-19 05:54:17",1434718457,"C2",95884,1434814341,"2015-06-20 08:32:21"
"4451","20154317014329-54","1","2015-06-19 05:58:39",1434718719,"C5",72455,1434791174,"2015-06-20 02:06:14"
"4802","20150613070629-561","2","2015-06-19 06:05:33",1434719133,"C8",257372,1434976505,"2015-06-22 05:35:05"
"6042","20155712085725-362","1","2015-06-19 06:06:29",1434719189,"C4",297272,1435016461,"2015-06-22 16:41:01"
"3641","20154916014913-150","3","2015-06-19 06:19:43",1434719983,"C0",116115,1434836098,"2015-06-20 14:34:58"
"4864","20150918040902-934","1","2015-06-19 06:20:55",1434720055,"C2",51113,1434771168,"2015-06-19 20:32:48"
"2104","20153618123612-480","2","2015-06-19 06:30:56",1434720656,"C6",64484,1434785140,"2015-06-20 00:25:40"
"5671","20150603100608-37","3","2015-06-19 06:58:06",1434722286,"C5",685559,1435407845,"2015-06-27 05:24:05"
"2561","20154318074327-65","2","2015-06-19 07:02:27",1434722547,"C3",83940,1434806487,"2015-06-20 06:21:27"
"395","20155106085152-545","1","2015-06-19 07:15:36",1434723336,"C2",159632,1434882968,"2015-06-21 03:36:08"
"5640","20152215122235-485","1","2015-06-19 07:16:18",1434723378,"C6",327223,1435050601,"2015-06-23 02:10:01"
"4871","20153407083404-897","1","2015-06-19 08:37:30",1434728250,"C2",1037006,1435765256,"2015-07-01 08:40:56"
"400","20150017100000-961","2","2015-06-19 08:41:08",1434728468,"C4",168068,1434896536,"2015-06-21 07:22:16"
"5572","20150218080215-880","3","2015-06-19 09:11:44",1434730304,"C4",90569,1434820873,"2015-06-20 10:21:13"
"2486","20151815041843-802","1","2015-06-19 11:19:18",1434737958,"C4",327635,1435065593,"2015-06-23 06:19:53"
"839","20152507042512-111","1","2015-06-19 13:16:59",1434745019,"C3",146501,1434891520,"2015-06-21 05:58:40"
"5263","20153606073656-187","1","2015-06-19 14:46:14",1434750374,"C3",382986,1435133360,"2015-06-24 01:09:20"
"1058","20153213083242-735","1","2015-06-19 17:04:10",1434758650,"C2",274544,1435033194,"2015-06-22 21:19:54"
"3204","20152517042527-36","1","2015-06-19 17:15:53",1434759353,"C2",87913,1434847266,"2015-06-20 17:41:06"
"4308","20154507074526-430","1","2015-06-19 17:21:34",1434759694,"C2",133921,1434893615,"2015-06-21 06:33:35"
"1318","20154213024216-561","1","2015-06-19 17:32:58",1434760378,"C4",176214,1434936592,"2015-06-21 18:29:52"
"4833","20152004092005-697","2","2015-06-19 17:34:32",1434760472,"C8",189381,1434949853,"2015-06-21 22:10:53"
"4399","20154412114408-299","2","2015-06-19 17:38:21",1434760701,"C2",626053,1435386754,"2015-06-26 23:32:34"
"540","20154914054916-877","2","2015-06-19 17:47:01",1434761221,"C0",61695,1434822916,"2015-06-20 10:55:16"
"3194","20155813105800-351","3","2015-06-19 18:41:12",1434764472,"C5",68274,1434832746,"2015-06-20 13:39:06"
"4710","20153217103218-546","1","2015-06-19 19:19:32",1434766772,"C4",204434,1434971206,"2015-06-22 04:06:46"
"1478","20152005072047-527","2","2015-06-19 20:22:09",1434770529,"C8",628241,1435398770,"2015-06-27 02:52:50"
"6513","20155911095900-214","2","2015-06-19 20:33:30",1434771210,"C5",364635,1435135845,"2015-06-24 01:50:45"
"561","20150116050129-415","2","2015-06-19 20:44:41",1434771881,"C6",272592,1435044473,"2015-06-23 00:27:53"
"5724","20153411023411-472","1","2015-06-19 20:52:19",1434772339,"C4",101984,1434874323,"2015-06-21 01:12:03"
"2676","20152917022939-684","2","2015-06-19 21:16:42",1434773802,"C4",197223,1434971025,"2015-06-22 04:03:45"
"2443","20151215021211-822","1","2015-06-19 22:02:15",1434776535,"C7",186902,1434963437,"2015-06-22 01:57:17"
"1930","20155417075442-571","1","2015-06-20 01:28:14",1434788894,"C3",118006,1434906900,"2015-06-21 10:15:00"
"4708","20155312015304-1","1","2015-06-20 02:16:48",1434791808,"C2",81178,1434872986,"2015-06-21 00:49:46"
"5748","20153417073443-887","3","2015-06-20 02:58:01",1434794281,"C0",80866,1434875147,"2015-06-21 01:25:47"
"4142","20153514023510-367","1","2015-06-20 02:59:50",1434794390,"C5",59585,1434853975,"2015-06-20 19:32:55"
"4515","20150803060828-975","3","2015-06-20 03:05:07",1434794707,"C5",208257,1435002964,"2015-06-22 12:56:04"
"1184","20151809111800-66","1","2015-06-20 03:08:54",1434794934,"C5",460527,1435255461,"2015-06-25 11:04:21"
"5898","20152917022938-308","2","2015-06-20 03:54:44",1434797684,"C2",110553,1434908237,"2015-06-21 10:37:17"
"5086","20155516055530-619","3","2015-06-20 04:30:16",1434799816,"C5",148643,1434948459,"2015-06-21 21:47:39"
"6533","20151014091022-504","1","2015-06-20 05:49:10",1434804550,"C6",84388,1434888938,"2015-06-21 05:15:38"
"5241","20151017081005-686","1","2015-06-20 06:52:37",1434808357,"C8",127276,1434935633,"2015-06-21 18:13:53"
"2128","20150201080212-913","2","2015-06-20 07:01:16",1434808876,"C5",204743,1435013619,"2015-06-22 15:53:39"
"3414","20150616120616-647","1","2015-06-20 07:18:46",1434809926,"C4",164175,1434974101,"2015-06-22 04:55:01"
"4067","20154729084718-7","2","2015-06-20 08:12:48",1434813168,"C7",210970,1435024138,"2015-06-22 18:48:58"
"4075","20154508054512-557","1","2015-06-20 08:40:26",1434814826,"C7",502057,1435316883,"2015-06-26 04:08:03"
"1993","20153307123351-488","1","2015-06-20 08:50:25",1434815425,"C8",158542,1434973967,"2015-06-22 04:52:47"
"6433","20153619103622-151","1","2015-06-20 09:05:08",1434816308,"C4",80926,1434897234,"2015-06-21 07:33:54"
"1213","20155613065614-139","1","2015-06-20 09:27:44",1434817664,"C2",204630,1435022294,"2015-06-22 18:18:14"
"136","20151308081312-606","1","2015-06-20 10:47:42",1434822462,"C2",248298,1435070760,"2015-06-23 07:46:00"
"3422","20152010012044-386","1","2015-06-20 10:54:36",1434822876,"C4",106904,1434929780,"2015-06-21 16:36:20"
"3144","20155418045458-340","1","2015-06-20 12:47:16",1434829636,"C0",157938,1434987574,"2015-06-22 08:39:34"
"1456","20151218051211-725","3","2015-06-20 12:49:09",1434829749,"C6",157018,1434986767,"2015-06-22 08:26:07"
"3847","20155514115559-607","1","2015-06-20 14:04:36",1434834276,"C0",526117,1435360393,"2015-06-26 16:13:13"
"502","20155605125623-741","3","2015-06-20 14:12:35",1434834755,"C5",185796,1435020551,"2015-06-22 17:49:11"
"2806","20150018050050-556","2","2015-06-20 14:40:40",1434836440,"C4",164390,1435000830,"2015-06-22 12:20:30"
"10","20152119012112-241","1","2015-06-20 14:44:51",1434836691,"C4",91419,1434928110,"2015-06-21 16:08:30"
"2374","20150329010340-772","2","2015-06-20 15:17:09",1434838629,"C3",272687,1435111316,"2015-06-23 19:01:56"
"2904","20155213115254-355","1","2015-06-20 16:30:20",1434843020,"C2",88778,1434931798,"2015-06-21 17:09:58"
"3020","20153919063918-509","1","2015-06-20 17:12:05",1434845525,"C3",124367,1434969892,"2015-06-22 03:44:52"
"3015","20152908102913-779","1","2015-06-20 17:58:03",1434848283,"C8",212746,1435061029,"2015-06-23 05:03:49"
"2613","20155307025311-47","1","2015-06-20 18:24:34",1434849874,"C2",162269,1435012143,"2015-06-22 15:29:03"
"5922","20155417055404-842","2","2015-06-20 19:04:04",1434852244,"C5",87800,1434940044,"2015-06-21 19:27:24"
"111","20155212055238-204","1","2015-06-20 20:59:38",1434859178,"C8",140484,1434999662,"2015-06-22 12:01:02"
"5516","20155517025520-359","1","2015-06-20 21:37:00",1434861420,"C2",141650,1435003070,"2015-06-22 12:57:50"
"3515","20155616035629-355","1","2015-06-20 22:34:53",1434864893,"C8",184752,1435049645,"2015-06-23 01:54:05"
"2480","20152119122102-412","1","2015-06-21 00:46:14",1434872774,"C5",65556,1434938330,"2015-06-21 18:58:50"
"1018","20153416013418-86","2","2015-06-21 01:31:52",1434875512,"C8",194327,1435069839,"2015-06-23 07:30:39"
"6096","20150914090940-696","1","2015-06-21 01:56:25",1434876985,"C8",115761,1434992746,"2015-06-22 10:05:46"
"1396","20151210121248-239","1","2015-06-21 03:03:44",1434881024,"C1",114682,1434995706,"2015-06-22 10:55:06"
"294","20152215082242-794","1","2015-06-21 03:08:21",1434881301,"C3",166513,1435047814,"2015-06-23 01:23:34"
"5245","20153919023921-5","2","2015-06-21 03:30:07",1434882607,"C5",66323,1434948930,"2015-06-21 21:55:30"
"1388","20152312032319-646","2","2015-06-21 04:41:49",1434886909,"C4",246370,1435133279,"2015-06-24 01:07:59"
"3469","20153604113610-711","3","2015-06-21 05:12:47",1434888767,"C8",589171,1435477938,"2015-06-28 00:52:18"
"1737","20150612090614-805","1","2015-06-21 05:40:56",1434890456,"C2",109326,1434999782,"2015-06-22 12:03:02"
"2176","20153601093619-939","1","2015-06-21 06:35:42",1434893742,"C8",245309,1435139051,"2015-06-24 02:44:11"
"5381","20153514073524-157","3","2015-06-21 07:50:39",1434898239,"C5",201905,1435100144,"2015-06-23 15:55:44"
"77","20153619123625-792","3","2015-06-21 08:00:38",1434898838,"C3",156253,1435055091,"2015-06-23 03:24:51"
"5585","20151201081219-907","2","2015-06-21 08:56:19",1434902179,"C6",216330,1435118509,"2015-06-23 21:01:49"
"2742","20153118023112-598","3","2015-06-21 09:24:57",1434903897,"C2",80275,1434984172,"2015-06-22 07:42:52"
"2881","20152919012937-798","1","2015-06-21 10:42:08",1434908528,"C6",162751,1435071279,"2015-06-23 07:54:39"
"697","20154111084119-363","1","2015-06-21 11:58:46",1434913126,"C2",125121,1435038247,"2015-06-22 22:44:07"
"3112","20153317123351-161","1","2015-06-21 12:10:36",1434913836,"C8",68841,1434982677,"2015-06-22 07:17:57"
"1806","20153202123219-728","3","2015-06-21 13:32:59",1434918779,"C0",205655,1435124434,"2015-06-23 22:40:34"
"2579","20155228125229-86","3","2015-06-21 17:09:25",1434931765,"C0",261127,1435192892,"2015-06-24 17:41:32"
"4104","20152513092510-818","2","2015-06-21 18:27:28",1434936448,"C6",120623,1435057071,"2015-06-23 03:57:51"
"6397","20152314062321-228","2","2015-06-21 19:10:27",1434939027,"C6",650826,1435589853,"2015-06-29 07:57:33"
"880","20155519105547-921","1","2015-06-21 19:18:19",1434939499,"C5",101476,1435040975,"2015-06-22 23:29:35"
"6095","20154824104802-646","3","2015-06-21 20:05:49",1434942349,"C7",350381,1435292730,"2015-06-25 21:25:30"
"2679","20154907054902-752","2","2015-06-21 20:42:46",1434944566,"C5",152503,1435097069,"2015-06-23 15:04:29"
"1076","20153419053450-999","1","2015-06-21 21:38:23",1434947903,"C4",62471,1435010374,"2015-06-22 14:59:34"
"5450","20153719113733-632","1","2015-06-21 21:53:03",1434948783,"C4",69910,1435018693,"2015-06-22 17:18:13"
"2164","20153315043301-166","3","2015-06-21 22:16:19",1434950179,"C2",179666,1435129845,"2015-06-24 00:10:45"
"3983","20151619061642-149","2","2015-06-21 22:39:46",1434951586,"C0",115892,1435067478,"2015-06-23 06:51:18"
"4602","20154519024544-322","2","2015-06-21 23:38:04",1434955084,"C4",204740,1435159824,"2015-06-24 08:30:24"
"5827","20151411091404-225","1","2015-06-22 00:25:54",1434957954,"C8",459355,1435417309,"2015-06-27 08:01:49"
"2057","20153020053014-949","1","2015-06-22 00:48:36",1434959316,"C7",56351,1435015667,"2015-06-22 16:27:47"
"4346","20150517050533-767","3","2015-06-22 00:49:57",1434959397,"C5",186732,1435146129,"2015-06-24 04:42:09"
"890","20155711125712-255","1","2015-06-22 01:09:10",1434960550,"C5",453959,1435414509,"2015-06-27 07:15:09"
"1609","20151416011455-25","2","2015-06-22 02:20:09",1434964809,"C4",239557,1435204366,"2015-06-24 20:52:46"
"4297","20152012032058-382","2","2015-06-22 03:00:02",1434967202,"C4",102443,1435069645,"2015-06-23 07:27:25"
"3400","20154914124917-488","1","2015-06-22 03:01:04",1434967264,"C8",93701,1435060965,"2015-06-23 05:02:45"
"65","20154918074910-267","1","2015-06-22 03:25:52",1434968752,"C8",164901,1435133653,"2015-06-24 01:14:13"
"5475","20152905032910-293","1","2015-06-22 04:55:36",1434974136,"C7",715393,1435689529,"2015-06-30 11:38:49"
"5486","20151115031100-780","1","2015-06-22 05:25:30",1434975930,"C4",189890,1435165820,"2015-06-24 10:10:20"
"278","20151712051721-6","1","2015-06-22 05:26:00",1434975960,"C0",273773,1435249733,"2015-06-25 09:28:53"
"2787","20154119094154-19","2","2015-06-22 06:35:21",1434980121,"C0",82669,1435062790,"2015-06-23 05:33:10"
"1358","20153520033505-60","1","2015-06-22 07:23:39",1434983019,"C4",143314,1435126333,"2015-06-23 23:12:13"
"2870","20151118091136-43","3","2015-06-22 07:32:06",1434983526,"C8",169815,1435153341,"2015-06-24 06:42:21"
"608","20154810044808-531","1","2015-06-22 08:45:44",1434987944,"C2",335952,1435323896,"2015-06-26 06:04:56"
"5209","20154926084915-416","2","2015-06-22 10:02:55",1434992575,"C8",467444,1435460019,"2015-06-27 19:53:39"
"4196","20155720025749-383","1","2015-06-22 10:54:25",1434995665,"C0",52732,1435048397,"2015-06-23 01:33:17"
"1337","20155520125548-491","1","2015-06-22 11:50:38",1434999038,"C8",84445,1435083483,"2015-06-23 11:18:03"
"3781","20151717071728-569","1","2015-06-22 12:08:44",1435000124,"C4",224738,1435224862,"2015-06-25 02:34:22"
"2322","20153414023451-770","3","2015-06-22 13:13:47",1435004027,"C3",85792,1435089819,"2015-06-23 13:03:39"
"539","20152417062433-543","1","2015-06-22 14:13:07",1435007587,"C8",230057,1435237644,"2015-06-25 06:07:24"
"4880","20155507095534-53","3","2015-06-22 14:13:32",1435007612,"C7",187354,1435194966,"2015-06-24 18:16:06"
"2633","20153813093827-417","1","2015-06-22 14:17:33",1435007853,"C3",113478,1435121331,"2015-06-23 21:48:51"
"4414","20152420022419-264","2","2015-06-22 14:48:04",1435009684,"C3",58075,1435067759,"2015-06-23 06:55:59"
"5783","20153002123026-8","3","2015-06-22 15:33:07",1435012387,"C7",248423,1435260810,"2015-06-25 12:33:30"
"2763","20152519052551-298","1","2015-06-22 18:21:36",1435022496,"C0",262545,1435285041,"2015-06-25 19:17:21"
"4689","20152213052248-272","2","2015-06-22 18:23:55",1435022635,"C3",781267,1435803902,"2015-07-01 19:25:02"
"2882","20152319092320-59","1","2015-06-22 18:40:33",1435023633,"C4",292633,1435316266,"2015-06-26 03:57:46"
"2856","20151711011732-63","3","2015-06-22 19:40:25",1435027225,"C0",973373,1436000598,"2015-07-04 02:03:18"
"5857","20153818043830-284","2","2015-06-22 20:05:27",1435028727,"C2",358017,1435386744,"2015-06-26 23:32:24"
"1088","20151414071412-997","1","2015-06-22 21:36:18",1435034178,"C8",371463,1435405641,"2015-06-27 04:47:21"
"6078","20154019104036-155","2","2015-06-22 21:44:50",1435034690,"C0",299054,1435333744,"2015-06-26 08:49:04"
"5576","20151219081235-39","1","2015-06-22 21:45:03",1435034703,"C4",307948,1435342651,"2015-06-26 11:17:31"
"198","20153717123759-246","1","2015-06-22 22:58:53",1435039133,"C7",234627,1435273760,"2015-06-25 16:09:20"
"3691","20152507042535-456","1","2015-06-22 23:09:09",1435039749,"C5",660107,1435699856,"2015-06-30 14:30:56"
"4068","20151515051521-888","1","2015-06-23 00:12:49",1435043569,"C8",314924,1435358493,"2015-06-26 15:41:33"
"3370","20154512054518-584","2","2015-06-23 01:01:02",1435046462,"C8",445072,1435491534,"2015-06-28 04:38:54"
"671","20151006101058-57","1","2015-06-23 01:13:06",1435047186,"C4",179566,1435226752,"2015-06-25 03:05:52"
"6031","20152914062905-376","1","2015-06-23 01:16:49",1435047409,"C5",94858,1435142267,"2015-06-24 03:37:47"
"4660","20154920094954-832","3","2015-06-23 01:21:56",1435047716,"C5",114361,1435162077,"2015-06-24 09:07:57"
"3655","20155620025615-452","1","2015-06-23 01:40:21",1435048821,"C5",105723,1435154544,"2015-06-24 07:02:24"
"6414","20155721095721-40","1","2015-06-23 01:44:33",1435049073,"C5",71616,1435120689,"2015-06-23 21:38:09"
"3718","20154017114049-331","1","2015-06-23 03:11:26",1435054286,"C4",69691,1435123977,"2015-06-23 22:32:57"
"2924","20151009091020-539","2","2015-06-23 03:44:20",1435056260,"C4",595020,1435651280,"2015-06-30 01:01:20"
"5096","20151522051555-293","3","2015-06-23 06:43:37",1435067017,"C2",48462,1435115479,"2015-06-23 20:11:19"
"3580","20150910020919-2","3","2015-06-23 06:49:49",1435067389,"C5",365610,1435432999,"2015-06-27 12:23:19"
"1390","20154502084556-629","2","2015-06-23 07:21:21",1435069281,"C4",258475,1435327756,"2015-06-26 07:09:16"
"6291","20153016033036-967","1","2015-06-23 07:42:24",1435070544,"C6",96118,1435166662,"2015-06-24 10:24:22"
"1788","20151320091309-87","1","2015-06-23 08:17:00",1435072620,"C4",85277,1435157897,"2015-06-24 07:58:17"
"5534","20154914084953-37","3","2015-06-23 09:18:11",1435076291,"C4",259766,1435336057,"2015-06-26 09:27:37"
"3787","20150420100412-238","2","2015-06-23 09:20:24",1435076424,"C2",128286,1435204710,"2015-06-24 20:58:30"
"268","20153320113340-933","1","2015-06-23 09:33:06",1435077186,"C8",125983,1435203169,"2015-06-24 20:32:49"
"4848","20152915032948-543","1","2015-06-23 09:38:26",1435077506,"C3",335059,1435412565,"2015-06-27 06:42:45"
"828","20154713014720-385","1","2015-06-23 10:06:00",1435079160,"C8",170144,1435249304,"2015-06-25 09:21:44"
"6279","20152912072922-999","1","2015-06-23 10:52:16",1435081936,"C0",481287,1435563223,"2015-06-29 00:33:43"
"6296","20153121123116-781","3","2015-06-23 12:05:26",1435086326,"C4",85625,1435171951,"2015-06-24 11:52:31"
"5824","20155919085948-945","3","2015-06-23 14:06:54",1435093614,"C3",182013,1435275627,"2015-06-25 16:40:27"
"560","20152108052101-440","1","2015-06-23 14:23:13",1435094593,"C5",428444,1435523037,"2015-06-28 13:23:57"
"4846","20153114083105-937","1","2015-06-23 15:10:53",1435097453,"C2",267196,1435364649,"2015-06-26 17:24:09"
"5226","20155021055038-706","3","2015-06-23 16:14:56",1435101296,"C7",83529,1435184825,"2015-06-24 15:27:05"
"4128","20150312050331-531","3","2015-06-23 16:43:07",1435102987,"C3",949176,1436052163,"2015-07-04 16:22:43"
"5507","20150312020332-263","1","2015-06-23 16:53:02",1435103582,"C8",192114,1435295696,"2015-06-25 22:14:56"
"786","20150019050058-11","2","2015-06-23 18:36:54",1435109814,"C5",175678,1435285492,"2015-06-25 19:24:52"
"4014","20155815085831-779","1","2015-06-23 18:48:13",1435110493,"C6",121097,1435231590,"2015-06-25 04:26:30"
"2177","20151520041535-563","2","2015-06-23 19:26:17",1435112777,"C4",135321,1435248098,"2015-06-25 09:01:38"
"5121","20154625034642-17","3","2015-06-23 19:28:09",1435112889,"C2",359841,1435472730,"2015-06-27 23:25:30"
"1628","20154821044849-587","3","2015-06-23 19:59:21",1435114761,"C6",184232,1435298993,"2015-06-25 23:09:53"
"4948","20151121111157-61","3","2015-06-23 22:04:01",1435122241,"C8",105962,1435228203,"2015-06-25 03:30:03"
"5013","20152909122903-721","3","2015-06-23 22:42:36",1435124556,"C4",178059,1435302615,"2015-06-26 00:10:15"
"4996","20152422092440-277","1","2015-06-24 02:05:10",1435136710,"C8",73215,1435209925,"2015-06-24 22:25:25"
"2072","20155618085648-561","1","2015-06-24 02:23:42",1435137822,"C8",247407,1435385229,"2015-06-26 23:07:09"
"6157","20151515081555-958","3","2015-06-24 02:57:23",1435139843,"C4",94811,1435234654,"2015-06-25 05:17:34"
"2522","20150108040111-888","1","2015-06-24 03:08:39",1435140519,"C4",190864,1435331383,"2015-06-26 08:09:43"
"2434","20154514124545-947","1","2015-06-24 04:06:41",1435144001,"C5",501608,1435645609,"2015-06-29 23:26:49"
"5931","20151604031616-721","3","2015-06-24 04:07:21",1435144041,"C8",337573,1435481614,"2015-06-28 01:53:34"
"6432","20151820051846-474","2","2015-06-24 04:35:11",1435145711,"C8",59957,1435205668,"2015-06-24 21:14:28"
"4647","20151317101348-437","1","2015-06-24 07:05:51",1435154751,"C8",84789,1435239540,"2015-06-25 06:39:00"
"5375","20151921121956-754","3","2015-06-24 07:28:05",1435156085,"C6",241689,1435397774,"2015-06-27 02:36:14"
"1402","20152815102844-133","2","2015-06-24 08:29:10",1435159750,"C4",385213,1435544963,"2015-06-28 19:29:23"
"6359","20154021124002-193","3","2015-06-24 08:43:40",1435160620,"C2",245018,1435405638,"2015-06-27 04:47:18"
"5918","20154213024208-839","2","2015-06-24 09:14:54",1435162494,"C2",930766,1436093260,"2015-07-05 03:47:40"
"3126","20150518020503-955","1","2015-06-24 09:21:39",1435162899,"C6",83566,1435246465,"2015-06-25 08:34:25"
"36","20152115032120-829","1","2015-06-24 09:49:38",1435164578,"C2",252566,1435417144,"2015-06-27 07:59:04"
"3734","20150804030847-490","1","2015-06-24 11:42:23",1435171343,"C7",245088,1435416431,"2015-06-27 07:47:11"
"2995","20151914081957-769","1","2015-06-24 11:54:59",1435172099,"C4",438451,1435610550,"2015-06-29 13:42:30"
"26","20153622043643-625","1","2015-06-24 12:14:11",1435173251,"C5",78524,1435251775,"2015-06-25 10:02:55"
"2328","20150221080255-974","3","2015-06-24 14:14:46",1435180486,"C5",93837,1435274323,"2015-06-25 16:18:43"
"949","20155011095054-239","1","2015-06-24 14:26:00",1435181160,"C2",379902,1435561062,"2015-06-28 23:57:42"
"2375","20152920042942-140","1","2015-06-24 14:27:38",1435181258,"C4",169138,1435350396,"2015-06-26 13:26:36"
"4402","20152721012702-519","2","2015-06-24 14:41:53",1435182113,"C2",87897,1435270010,"2015-06-25 15:06:50"
"3212","20152113072113-341","2","2015-06-24 14:47:08",1435182428,"C8",195431,1435377859,"2015-06-26 21:04:19"
"5314","20154612114650-326","1","2015-06-24 14:52:46",1435182766,"C7",523978,1435706744,"2015-06-30 16:25:44"
"3617","20155816045813-135","3","2015-06-24 16:36:21",1435188981,"C2",689888,1435878869,"2015-07-02 16:14:29"
"1258","20150420120432-763","3","2015-06-24 16:56:52",1435190212,"C8",72628,1435262840,"2015-06-25 13:07:20"
"3226","20155515095508-771","2","2015-06-24 17:07:26",1435190846,"C0",803538,1435994384,"2015-07-04 00:19:44"
"5563","20152218012209-123","1","2015-06-24 17:12:29",1435191149,"C8",106444,1435297593,"2015-06-25 22:46:33"
"408","20155923075941-191","3","2015-06-24 17:16:23",1435191383,"C2",119802,1435311185,"2015-06-26 02:33:05"
"2281","20155121065100-589","1","2015-06-24 17:58:18",1435193898,"C4",99746,1435293644,"2015-06-25 21:40:44"
"999","20150722100759-856","3","2015-06-24 18:10:25",1435194625,"C5",100873,1435295498,"2015-06-25 22:11:38"
"6104","20152414012455-891","1","2015-06-24 18:26:41",1435195601,"C7",441053,1435636654,"2015-06-29 20:57:34"
"6175","20152823032800-166","3","2015-06-24 19:10:52",1435198252,"C6",99772,1435298024,"2015-06-25 22:53:44"
"1190","20152218122205-541","1","2015-06-24 19:34:45",1435199685,"C5",272180,1435471865,"2015-06-27 23:11:05"
"2179","20155118105146-971","1","2015-06-24 21:07:48",1435205268,"C4",277681,1435482949,"2015-06-28 02:15:49"
"6516","20155319035359-974","1","2015-06-24 21:35:41",1435206941,"C8",226251,1435433192,"2015-06-27 12:26:32"
"5973","20150806110818-449","1","2015-06-24 21:40:16",1435207216,"C2",796559,1436003775,"2015-07-04 02:56:15"
"6362","20153621033624-514","3","2015-06-24 21:41:53",1435207313,"C3",281129,1435488442,"2015-06-28 03:47:22"
"4047","20155122015113-891","1","2015-06-24 22:18:19",1435209499,"C5",101613,1435311112,"2015-06-26 02:31:52"
"154","20155417085454-80","3","2015-06-24 22:44:59",1435211099,"C8",130921,1435342020,"2015-06-26 11:07:00"
"4967","20151222031241-371","1","2015-06-24 23:17:57",1435213077,"C2",100958,1435314035,"2015-06-26 03:20:35"
"1981","20151818071851-924","2","2015-06-24 23:29:15",1435213755,"C5",288312,1435502067,"2015-06-28 07:34:27"
"2174","20151310041329-620","1","2015-06-25 00:06:03",1435215963,"C5",618977,1435834940,"2015-07-02 04:02:20"
"2457","20151816031811-238","1","2015-06-25 00:26:57",1435217217,"C0",362063,1435579280,"2015-06-29 05:01:20"
"3218","20153719123745-647","3","2015-06-25 00:58:43",1435219123,"C5",238229,1435457352,"2015-06-27 19:09:12"
"298","20151710121709-837","1","2015-06-25 01:31:45",1435221105,"C5",628638,1435849743,"2015-07-02 08:09:03"
"1704","20154118104113-978","3","2015-06-25 01:39:39",1435221579,"C0",81758,1435303337,"2015-06-26 00:22:17"
"5902","20153319103352-70","2","2015-06-25 02:58:58",1435226338,"C5",70158,1435296496,"2015-06-25 22:28:16"
"5257","20153309043302-556","2","2015-06-25 03:12:08",1435227128,"C4",444782,1435671910,"2015-06-30 06:45:10"
"3693","20151821051837-55","1","2015-06-25 03:34:53",1435228493,"C3",148088,1435376581,"2015-06-26 20:43:01"
"1889","20153123053127-918","1","2015-06-25 04:58:37",1435233517,"C0",63815,1435297332,"2015-06-25 22:42:12"
"6264","20154414124412-684","1","2015-06-25 06:07:08",1435237628,"C6",450622,1435688250,"2015-06-30 11:17:30"
"272","20152509072520-737","1","2015-06-25 06:53:52",1435240432,"C3",197216,1435437648,"2015-06-27 13:40:48"
"6383","20150717030756-157","1","2015-06-25 07:18:12",1435241892,"C8",331508,1435573400,"2015-06-29 03:23:20"
"3709","20152012102044-576","3","2015-06-25 07:26:56",1435242416,"C5",370924,1435613340,"2015-06-29 14:29:00"
"4867","20154115024109-180","2","2015-06-25 07:58:45",1435244325,"C5",419928,1435664253,"2015-06-30 04:37:33"
"1597","20154117024144-496","3","2015-06-25 08:57:02",1435247822,"C5",335259,1435583081,"2015-06-29 06:04:41"
"1112","20152515012542-655","1","2015-06-25 09:38:07",1435250287,"C8",170069,1435420356,"2015-06-27 08:52:36"
"5939","20152113112111-474","1","2015-06-25 10:05:53",1435251953,"C5",516141,1435768094,"2015-07-01 09:28:14"
"2165","20155720095752-177","1","2015-06-25 10:41:14",1435254074,"C2",217301,1435471375,"2015-06-27 23:02:55"
"1656","20155023115047-443","1","2015-06-25 12:07:55",1435259275,"C5",86914,1435346189,"2015-06-26 12:16:29"
"1476","20154618094619-43","2","2015-06-25 12:20:21",1435260021,"C2",614042,1435874063,"2015-07-02 14:54:23"
"5059","20153624063634-720","2","2015-06-25 13:15:21",1435263321,"C4",110327,1435373648,"2015-06-26 19:54:08"
"2580","20154802114807-830","1","2015-06-25 13:21:15",1435263675,"C4",284684,1435548359,"2015-06-28 20:25:59"
"1931","20155823075842-421","2","2015-06-25 14:03:26",1435266206,"C6",194684,1435460890,"2015-06-27 20:08:10"
"5690","20151109091155-536","3","2015-06-25 14:27:37",1435267657,"C2",467114,1435734771,"2015-07-01 00:12:51"
"2865","20154623064643-371","1","2015-06-25 15:04:55",1435269895,"C2",101346,1435371241,"2015-06-26 19:14:01"
"3859","20152311102311-455","2","2015-06-25 15:28:35",1435271315,"C6",204654,1435475969,"2015-06-28 00:19:29"
"3237","20153721043746-702","3","2015-06-25 15:53:24",1435272804,"C0",171469,1435444273,"2015-06-27 15:31:13"
"873","20150623020640-155","1","2015-06-25 18:14:06",1435281246,"C5",93823,1435375069,"2015-06-26 20:17:49"
"6423","20153723043748-531","2","2015-06-25 18:17:28",1435281448,"C3",89390,1435370838,"2015-06-26 19:07:18"
"3484","20150723090724-2","1","2015-06-25 19:07:10",1435284430,"C0",208786,1435493216,"2015-06-28 05:06:56"
"2688","20153216013237-980","2","2015-06-25 19:24:15",1435285455,"C6",798698,1436084153,"2015-07-05 01:15:53"
"1301","20151619071622-794","1","2015-06-25 20:53:22",1435290802,"C5",283710,1435574512,"2015-06-29 03:41:52"
"5338","20153419023448-961","1","2015-06-25 21:10:28",1435291828,"C8",108428,1435400256,"2015-06-27 03:17:36"
"2863","20154420054455-558","2","2015-06-25 22:43:16",1435297396,"C0",149967,1435447363,"2015-06-27 16:22:43"
"4663","20152124122113-381","3","2015-06-25 22:58:57",1435298337,"C5",62332,1435360669,"2015-06-26 16:17:49"
"2340","20151113071127-855","3","2015-06-26 00:10:39",1435302639,"C3",365984,1435668623,"2015-06-30 05:50:23"
"157","20153906123947-442","1","2015-06-26 01:10:23",1435306223,"C7",240948,1435547171,"2015-06-28 20:06:11"
"2468","20154713064720-448","3","2015-06-26 01:44:30",1435308270,"C8",221006,1435529276,"2015-06-28 15:07:56"
"3253","20154521074546-272","2","2015-06-26 02:28:28",1435310908,"C5",137654,1435448562,"2015-06-27 16:42:42"
"5820","20155908075949-522","2","2015-06-26 02:57:16",1435312636,"C3",512349,1435824985,"2015-07-02 01:16:25"
"1455","20150510020551-789","3","2015-06-26 03:07:32",1435313252,"C8",191843,1435505095,"2015-06-28 08:24:55"
"2194","20152619062611-689","3","2015-06-26 03:12:31",1435313551,"C4",296590,1435610141,"2015-06-29 13:35:41"
"4858","20155720065732-452","1","2015-06-26 03:32:47",1435314767,"C3",168705,1435483472,"2015-06-28 02:24:32"
"5171","20152016062004-516","2","2015-06-26 04:15:52",1435317352,"C8",122364,1435439716,"2015-06-27 14:15:16"
"749","20155216125240-140","1","2015-06-26 05:36:30",1435322190,"C8",167566,1435489756,"2015-06-28 04:09:16"
"5444","20153514073548-195","2","2015-06-26 06:55:00",1435326900,"C5",344784,1435671684,"2015-06-30 06:41:24"
"5095","20150422080420-314","3","2015-06-26 07:08:35",1435327715,"C0",114085,1435441800,"2015-06-27 14:50:00"
"1816","20150408060458-999","1","2015-06-26 08:10:52",1435331452,"C6",260459,1435591911,"2015-06-29 08:31:51"
"2760","20152224092219-261","1","2015-06-26 09:03:57",1435334637,"C5",85849,1435420486,"2015-06-27 08:54:46"
"4244","20151012091054-963","2","2015-06-26 09:18:18",1435335498,"C7",605022,1435940520,"2015-07-03 09:22:00"
"917","20151813031843-852","1","2015-06-26 09:22:27",1435335747,"C3",137728,1435473475,"2015-06-27 23:37:55"
"4094","20154210104209-855","1","2015-06-26 10:50:49",1435341049,"C7",197560,1435538609,"2015-06-28 17:43:29"
"3270","20152424062413-508","1","2015-06-26 12:32:21",1435347141,"C5",97444,1435444585,"2015-06-27 15:36:25"
"4430","20152319082350-281","1","2015-06-26 12:58:15",1435348695,"C8",124253,1435472948,"2015-06-27 23:29:08"
"1515","20151720081740-125","3","2015-06-26 13:04:40",1435349080,"C8",107124,1435456204,"2015-06-27 18:50:04"
"2202","20155022075038-528","1","2015-06-26 14:07:56",1435352876,"C2",184119,1435536995,"2015-06-28 17:16:35"
"1746","20154112014114-381","1","2015-06-26 15:05:08",1435356308,"C6",202439,1435558747,"2015-06-28 23:19:07"
"5958","20151303111300-96","1","2015-06-26 15:19:12",1435357152,"C7",285996,1435643148,"2015-06-29 22:45:48"
"3492","20155612055615-47","3","2015-06-26 15:37:43",1435358263,"C5",484961,1435843224,"2015-07-02 06:20:24"
"380","20155725075744-903","1","2015-06-26 16:22:39",1435360959,"C6",116695,1435477654,"2015-06-28 00:47:34"
"1498","20151924051901-835","2","2015-06-26 16:45:45",1435362345,"C0",170804,1435533149,"2015-06-28 16:12:29"
"5854","20152517072506-105","3","2015-06-26 17:26:18",1435364778,"C3",271224,1435636002,"2015-06-29 20:46:42"
"2166","20151805061831-133","1","2015-06-26 19:21:35",1435371695,"C0",567473,1435939168,"2015-07-03 08:59:28"
"5991","20150522030548-312","1","2015-06-26 19:31:50",1435372310,"C7",180781,1435553091,"2015-06-28 21:44:51"
"5451","20150907070951-183","1","2015-06-26 21:19:19",1435378759,"C6",211571,1435590330,"2015-06-29 08:05:30"
"4658","20152220112252-143","1","2015-06-26 23:05:36",1435385136,"C2",280282,1435665418,"2015-06-30 04:56:58"
"4898","20151224041202-651","2","2015-06-26 23:28:34",1435386514,"C4",99496,1435486010,"2015-06-28 03:06:50"
"2626","20154825054846-818","1","2015-06-26 23:31:56",1435386716,"C8",53495,1435440211,"2015-06-27 14:23:31"
"1087","20154909034948-631","1","2015-06-27 00:07:27",1435388847,"C4",499553,1435888400,"2015-07-02 18:53:20"
"422","20153422113416-107","1","2015-06-27 00:22:45",1435389765,"C3",438587,1435828352,"2015-07-02 02:12:32"
"4838","20150425010456-10","1","2015-06-27 01:25:34",1435393534,"C7",65419,1435458953,"2015-06-27 19:35:53"
"4983","20150422040421-938","1","2015-06-27 02:11:06",1435396266,"C8",76401,1435472667,"2015-06-27 23:24:27"
"3529","20153322053325-204","3","2015-06-27 03:00:05",1435399205,"C5",189800,1435589005,"2015-06-29 07:43:25"
"238","20154623084625-271","2","2015-06-27 03:10:49",1435399849,"C4",108488,1435508337,"2015-06-28 09:18:57"
"6161","20153924103929-927","3","2015-06-27 04:19:15",1435403955,"C7",118193,1435522148,"2015-06-28 13:09:08"
"918","20155324085325-903","3","2015-06-27 04:33:39",1435404819,"C3",121807,1435526626,"2015-06-28 14:23:46"
"1048","20151116081119-191","1","2015-06-27 06:05:19",1435410319,"C7",104760,1435515079,"2015-06-28 11:11:19"
"3115","20154126064136-539","3","2015-06-27 07:15:37",1435414537,"C0",88441,1435502978,"2015-06-28 07:49:38"
"516","20152120062126-798","2","2015-06-27 09:20:38",1435422038,"C0",87936,1435509974,"2015-06-28 09:46:14"
"180","20152725032725-88","1","2015-06-27 10:26:02",1435425962,"C2",154717,1435580679,"2015-06-29 05:24:39"
"3035","20153524063556-760","1","2015-06-27 11:07:36",1435428456,"C5",137750,1435566206,"2015-06-29 01:23:26"
"4844","20150503080543-310","1","2015-06-27 11:52:23",1435431143,"C2",260900,1435692043,"2015-06-30 12:20:43"
"5089","20151015061023-821","1","2015-06-27 12:25:27",1435433127,"C4",467213,1435900340,"2015-07-02 22:12:20"
"2896","20151801061858-931","1","2015-06-27 12:36:42",1435433802,"C3",283633,1435717435,"2015-06-30 19:23:55"
"1898","20155122015143-390","2","2015-06-27 12:37:56",1435433876,"C6",427573,1435861449,"2015-07-02 11:24:09"
"5612","20155926125931-19","1","2015-06-27 16:58:55",1435449535,"C2",100764,1435550299,"2015-06-28 20:58:19"
"3538","20153723103701-496","3","2015-06-27 18:18:29",1435454309,"C5",186644,1435640953,"2015-06-29 22:09:13"
"6377","20154005024056-186","3","2015-06-27 18:19:30",1435454370,"C3",956957,1436411327,"2015-07-08 20:08:47"
"997","20154701124730-552","1","2015-06-27 19:46:32",1435459592,"C4",324506,1435784098,"2015-07-01 13:54:58"
"5961","20155006035017-391","3","2015-06-27 20:16:35",1435461395,"C5",610126,1436071521,"2015-07-04 21:45:21"
"3394","20150112050156-642","1","2015-06-27 20:25:11",1435461911,"C8",186885,1435648796,"2015-06-30 00:19:56"
"3044","20150104040106-481","1","2015-06-27 21:30:18",1435465818,"C4",668984,1436134802,"2015-07-05 15:20:02"
"2255","20155721075705-83","1","2015-06-27 22:28:33",1435469313,"C8",285344,1435754657,"2015-07-01 05:44:17"
"5999","20155417035454-444","3","2015-06-27 22:36:36",1435469796,"C6",148017,1435617813,"2015-06-29 15:43:33"
"1692","20153814023849-856","1","2015-06-27 22:56:44",1435471004,"C8",164725,1435635729,"2015-06-29 20:42:09"
"116","20152620042635-437","3","2015-06-27 23:15:51",1435472151,"C5",314678,1435786829,"2015-07-01 14:40:29"
"4422","20155919085937-643","3","2015-06-27 23:38:15",1435473495,"C5",371959,1435845454,"2015-07-02 06:57:34"
"5426","20151417011439-309","2","2015-06-28 01:02:01",1435478521,"C5",453221,1435931742,"2015-07-03 06:55:42"
"1419","20155523085557-121","2","2015-06-28 01:31:53",1435480313,"C5",202678,1435682991,"2015-06-30 09:49:51"
"3873","20151924051922-114","2","2015-06-28 01:50:18",1435481418,"C8",144928,1435626346,"2015-06-29 18:05:46"
"4222","20150416030444-791","3","2015-06-28 02:32:16",1435483936,"C8",495826,1435979762,"2015-07-03 20:16:02"
"3767","20154919094921-666","2","2015-06-28 02:38:53",1435484333,"C8",375886,1435860219,"2015-07-02 11:03:39"
"3527","20150120020159-683","1","2015-06-28 02:43:59",1435484639,"C4",81315,1435565954,"2015-06-29 01:19:14"
"379","20150822090837-736","2","2015-06-28 02:51:52",1435485112,"C8",99159,1435584271,"2015-06-29 06:24:31"
"3315","20151823061853-546","1","2015-06-28 03:34:11",1435487651,"C3",140706,1435628357,"2015-06-29 18:39:17"
"4262","20152124032130-189","1","2015-06-28 04:53:06",1435492386,"C3",102632,1435595018,"2015-06-29 09:23:38"
"2250","20155020095009-169","3","2015-06-28 05:06:55",1435493215,"C7",337103,1435830318,"2015-07-02 02:45:18"
"2485","20154024034035-259","2","2015-06-28 05:48:45",1435495725,"C8",62018,1435557743,"2015-06-28 23:02:23"
"5697","20152521082543-773","2","2015-06-28 06:40:47",1435498847,"C2",74813,1435573660,"2015-06-29 03:27:40"
"5168","20150224040251-670","1","2015-06-28 07:20:53",1435501253,"C2",157141,1435658394,"2015-06-30 02:59:54"
"4727","20153021073045-85","1","2015-06-28 07:54:57",1435503297,"C8",303126,1435806423,"2015-07-01 20:07:03"
"1175","20150417100406-907","3","2015-06-28 08:33:44",1435505624,"C7",472489,1435978113,"2015-07-03 19:48:33"
"5752","20154617044627-301","1","2015-06-28 08:34:04",1435505644,"C3",131551,1435637195,"2015-06-29 21:06:35"
"5541","20154522074550-726","3","2015-06-28 09:29:02",1435508942,"C0",262296,1435771238,"2015-07-01 10:20:38"
"5515","20155811055815-517","1","2015-06-28 09:29:33",1435508973,"C5",479426,1435988399,"2015-07-03 22:39:59"
"898","20152515082556-333","2","2015-06-28 09:40:07",1435509607,"C7",161093,1435670700,"2015-06-30 06:25:00"
"3101","20155318075334-519","2","2015-06-28 09:43:25",1435509805,"C3",290197,1435800002,"2015-07-01 18:20:02"
"1632","20150907080945-381","1","2015-06-28 09:58:40",1435510720,"C8",364187,1435874907,"2015-07-02 15:08:27"
"67","20152523032526-775","1","2015-06-28 10:14:47",1435511687,"C3",137787,1435649474,"2015-06-30 00:31:14"
"626","20153516053542-376","2","2015-06-28 10:47:13",1435513633,"C2",144613,1435658246,"2015-06-30 02:57:26"
"6074","20153721073751-968","1","2015-06-28 12:22:29",1435519349,"C6",621878,1436141227,"2015-07-05 17:07:07"
"507","20155522115544-987","2","2015-06-28 12:25:49",1435519549,"C4",74315,1435593864,"2015-06-29 09:04:24"
"5779","20153121113129-538","2","2015-06-28 12:47:41",1435520861,"C2",203124,1435723985,"2015-06-30 21:13:05"
"1868","20154023044047-684","1","2015-06-28 14:39:29",1435527569,"C5",141574,1435669143,"2015-06-30 05:59:03"
"4303","20155327055311-62","3","2015-06-28 14:50:56",1435528256,"C6",75465,1435603721,"2015-06-29 11:48:41"
"2718","20150415110415-762","2","2015-06-28 15:21:49",1435530109,"C2",1138654,1436668763,"2015-07-11 19:39:23"
"5144","20155620035613-395","1","2015-06-28 16:03:57",1435532637,"C2",86458,1435619095,"2015-06-29 16:04:55"
"2444","20150203060210-288","1","2015-06-28 16:10:30",1435533030,"C8",439300,1435972330,"2015-07-03 18:12:10"
"4019","20152421022448-172","1","2015-06-28 16:14:40",1435533280,"C3",76424,1435609704,"2015-06-29 13:28:24"
"5540","20151919051903-993","3","2015-06-28 16:40:15",1435534815,"C0",96909,1435631724,"2015-06-29 19:35:24"
"2053","20153821073821-483","1","2015-06-28 17:12:51",1435536771,"C8",127854,1435664625,"2015-06-30 04:43:45"
"179","20154824124835-785","1","2015-06-28 17:26:05",1435537565,"C0",181125,1435718690,"2015-06-30 19:44:50"
"3408","20153808123846-946","2","2015-06-28 19:39:13",1435545553,"C7",250461,1435796014,"2015-07-01 17:13:34"
"4557","20151025051035-258","1","2015-06-28 19:39:47",1435545587,"C4",89384,1435634971,"2015-06-29 20:29:31"
"5197","20155021095034-253","3","2015-06-28 20:43:47",1435549427,"C7",91999,1435641426,"2015-06-29 22:17:06"
"2555","20154527104510-24","1","2015-06-28 20:50:03",1435549803,"C4",122693,1435672496,"2015-06-30 06:54:56"
"651","20153927033926-724","3","2015-06-28 21:39:54",1435552794,"C5",54014,1435606808,"2015-06-29 12:40:08"
"6165","20151927081907-93","1","2015-06-28 21:41:49",1435552909,"C6",134562,1435687471,"2015-06-30 11:04:31"
"3142","20150318040329-875","1","2015-06-28 23:55:14",1435560914,"C7",99145,1435660059,"2015-06-30 03:27:39"
"2233","20154026034051-679","2","2015-06-29 00:22:21",1435562541,"C8",102045,1435664586,"2015-06-30 04:43:06"
"6412","20154920054923-830","2","2015-06-29 01:49:38",1435567778,"C8",144003,1435711781,"2015-06-30 17:49:41"
"3003","20152127122100-117","1","2015-06-29 03:11:40",1435572700,"C5",69920,1435642620,"2015-06-29 22:37:00"
"5066","20150607010649-553","2","2015-06-29 03:48:33",1435574913,"C2",233413,1435808326,"2015-07-01 20:38:46"
"6438","20155324075339-328","1","2015-06-29 04:28:51",1435577331,"C8",209856,1435787187,"2015-07-01 14:46:27"
"199","20152118072137-646","2","2015-06-29 04:29:53",1435577393,"C3",117512,1435694905,"2015-06-30 13:08:25"
"1795","20155909085910-596","1","2015-06-29 04:37:52",1435577872,"C4",2195361,1437773233,"2015-07-24 14:27:13"
"458","20150426010442-203","1","2015-06-29 05:04:16",1435579456,"C5",115187,1435694643,"2015-06-30 13:04:03"
"3048","20154212104244-750","1","2015-06-29 05:56:49",1435582609,"C8",290329,1435872938,"2015-07-02 14:35:38"
"5731","20155826045853-500","1","2015-06-29 06:45:50",1435585550,"C4",74139,1435659689,"2015-06-30 03:21:29"
"4146","20150016010039-314","3","2015-06-29 07:01:04",1435586464,"C2",157375,1435743839,"2015-07-01 02:43:59"
"6449","20151120071106-120","1","2015-06-29 07:23:09",1435587789,"C5",111189,1435698978,"2015-06-30 14:16:18"
"963","20153128113151-636","1","2015-06-29 08:32:07",1435591927,"C2",75616,1435667543,"2015-06-30 05:32:23"
"968","20151211051259-166","1","2015-06-29 08:47:56",1435592876,"C4",508299,1436101175,"2015-07-05 05:59:35"
"5269","20155115055136-775","1","2015-06-29 08:53:52",1435593232,"C6",481967,1436075199,"2015-07-04 22:46:39"
"1217","20154928064939-570","2","2015-06-29 10:01:00",1435597260,"C3",97881,1435695141,"2015-06-30 13:12:21"
"4937","20151623051636-911","2","2015-06-29 10:19:23",1435598363,"C2",70481,1435668844,"2015-06-30 05:54:04"
"5227","20155725095739-361","2","2015-06-29 11:50:25",1435603825,"C4",176183,1435780008,"2015-07-01 12:46:48"
"2621","20150827070822-694","3","2015-06-29 13:04:18",1435608258,"C5",97078,1435705336,"2015-06-30 16:02:16"
"5618","20153521043509-287","2","2015-06-29 14:11:43",1435612303,"C5",341297,1435953600,"2015-07-03 13:00:00"
"3056","20152126092144-384","2","2015-06-29 14:19:26",1435612766,"C5",92354,1435705120,"2015-06-30 15:58:40"
"4333","20155425085422-138","1","2015-06-29 15:20:49",1435616449,"C2",368787,1435985236,"2015-07-03 21:47:16"
"5453","20154612074618-947","3","2015-06-29 15:22:26",1435616546,"C5",187021,1435803567,"2015-07-01 19:19:27"
"5067","20150227070202-589","2","2015-06-29 15:26:56",1435616816,"C5",101547,1435718363,"2015-06-30 19:39:23"
"6375","20150231050204-372","2","2015-06-29 16:16:49",1435619809,"C8",357555,1435977364,"2015-07-03 19:36:04"
"4798","20154227114255-944","1","2015-06-29 17:34:31",1435624471,"C2",96948,1435721419,"2015-06-30 20:30:19"
"1758","20155402085412-825","1","2015-06-29 17:42:36",1435624956,"C6",295563,1435920519,"2015-07-03 03:48:39"
"2285","20155228125210-442","3","2015-06-29 17:54:20",1435625660,"C0",104530,1435730190,"2015-06-30 22:56:30"
"4046","20154121124110-292","1","2015-06-29 18:44:01",1435628641,"C4",712971,1436341612,"2015-07-08 00:46:52"
"425","20153826053837-25","2","2015-06-29 18:48:12",1435628892,"C4",263375,1435892267,"2015-07-02 19:57:47"
"1948","20153627113639-711","1","2015-06-29 19:08:43",1435630123,"C3",99962,1435730085,"2015-06-30 22:54:45"
"2687","20151826091818-219","1","2015-06-29 19:26:54",1435631214,"C5",98572,1435729786,"2015-06-30 22:49:46"
"3245","20151305081322-814","1","2015-06-29 19:30:58",1435631458,"C4",264282,1435895740,"2015-07-02 20:55:40"
"5943","20152925072930-684","3","2015-06-29 20:03:42",1435633422,"C5",130284,1435763706,"2015-07-01 08:15:06"
"5282","20155528055512-788","2","2015-06-29 20:36:44",1435635404,"C8",48046,1435683450,"2015-06-30 09:57:30"
"2080","20154227054240-936","1","2015-06-29 20:41:52",1435635712,"C5",61184,1435696896,"2015-06-30 13:41:36"
"2156","20151021041005-169","1","2015-06-29 21:37:28",1435639048,"C8",101549,1435740597,"2015-07-01 01:49:57"
"4795","20150815040821-280","1","2015-06-29 21:56:36",1435640196,"C4",175785,1435815981,"2015-07-01 22:46:21"
"195","20150123040140-843","3","2015-06-29 23:28:58",1435645738,"C4",181746,1435827484,"2015-07-02 01:58:04"
"4089","20153120113117-670","2","2015-06-29 23:40:18",1435646418,"C4",499963,1436146381,"2015-07-05 18:33:01"
"1798","20151314081340-101","1","2015-06-29 23:55:46",1435647346,"C5",193218,1435840564,"2015-07-02 05:36:04"
"3309","20150720110747-627","1","2015-06-30 00:02:57",1435647777,"C3",117730,1435765507,"2015-07-01 08:45:07"
"4158","20152328112340-523","1","2015-06-30 00:48:32",1435650512,"C8",67346,1435717858,"2015-06-30 19:30:58"
"2140","20152706102715-95","2","2015-06-30 01:33:49",1435653229,"C5",1020797,1436674026,"2015-07-11 21:07:06"
"3154","20154928124919-762","2","2015-06-30 01:59:45",1435654785,"C4",66913,1435721698,"2015-06-30 20:34:58"
"2833","20153921093922-779","2","2015-06-30 02:15:42",1435655742,"C5",375490,1436031232,"2015-07-04 10:33:52"
"3963","20153428023417-311","3","2015-06-30 02:25:33",1435656333,"C8",64538,1435720871,"2015-06-30 20:21:11"
"209","20152528092511-140","3","2015-06-30 02:25:51",1435656351,"C8",73820,1435730171,"2015-06-30 22:56:11"
"6276","20155827045831-194","1","2015-06-30 03:05:21",1435658721,"C4",104605,1435763326,"2015-07-01 08:08:46"
"3173","20155124095131-809","1","2015-06-30 03:14:37",1435659277,"C2",164862,1435824139,"2015-07-02 01:02:19"
"3658","20155009035012-229","2","2015-06-30 03:45:35",1435661135,"C3",252989,1435914124,"2015-07-03 02:02:04"
"2110","20153525043522-499","1","2015-06-30 04:46:35",1435664795,"C3",55639,1435720434,"2015-06-30 20:13:54"
"1199","20154627094625-389","2","2015-06-30 05:13:19",1435666399,"C4",121407,1435787806,"2015-07-01 14:56:46"
"4466","20154127084141-786","3","2015-06-30 06:58:41",1435672721,"C5",126510,1435799231,"2015-07-01 18:07:11"
"1537","20153624093618-492","1","2015-06-30 07:55:36",1435676136,"C7",73194,1435749330,"2015-07-01 04:15:30"
"4255","20155023065026-661","1","2015-06-30 08:09:18",1435676958,"C5",87076,1435764034,"2015-07-01 08:20:34"
"1230","20153529083516-535","1","2015-06-30 08:14:16",1435677256,"C0",85140,1435762396,"2015-07-01 07:53:16"
"3666","20154627094652-597","1","2015-06-30 08:23:01",1435677781,"C2",84723,1435762504,"2015-07-01 07:55:04"
"3627","20154220084208-864","2","2015-06-30 08:51:08",1435679468,"C8",172908,1435852376,"2015-07-02 08:52:56"
"2387","20155914095952-732","2","2015-06-30 11:16:52",1435688212,"C8",277404,1435965616,"2015-07-03 16:20:16"
"5349","20155324075301-513","3","2015-06-30 12:33:22",1435692802,"C4",178407,1435871209,"2015-07-02 14:06:49"
"4388","20151127061106-88","3","2015-06-30 12:57:00",1435694220,"C0",94518,1435788738,"2015-07-01 15:12:18"
"1186","20155826045826-106","2","2015-06-30 13:37:42",1435696662,"C6",333556,1436030218,"2015-07-04 10:16:58"
"2148","20151613111653-93","1","2015-06-30 14:02:56",1435698176,"C7",461907,1436160083,"2015-07-05 22:21:23"
"5552","20155626105649-404","1","2015-06-30 15:17:13",1435702633,"C0",120408,1435823041,"2015-07-02 00:44:01"
"1108","20151026081006-92","2","2015-06-30 15:40:34",1435704034,"C5",186314,1435890348,"2015-07-02 19:25:48"
"1697","20152712102715-951","2","2015-06-30 16:05:07",1435705507,"C5",196934,1435902441,"2015-07-02 22:47:21"
"5150","20150616060652-850","3","2015-06-30 17:06:16",1435709176,"C5",178452,1435887628,"2015-07-02 18:40:28"
"4768","20150222020245-78","1","2015-06-30 17:18:03",1435709883,"C8",351459,1436061342,"2015-07-04 18:55:42"
"4725","20153727053754-806","1","2015-06-30 19:37:39",1435718259,"C4",88795,1435807054,"2015-07-01 20:17:34"
"2524","20155229035239-568","3","2015-06-30 19:42:27",1435718547,"C7",50094,1435768641,"2015-07-01 09:37:21"
"464","20151823051805-597","1","2015-06-30 19:55:43",1435719343,"C2",614258,1436333601,"2015-07-07 22:33:21"
"6468","20151325051319-382","3","2015-06-30 20:22:39",1435720959,"C5",221680,1435942639,"2015-07-03 09:57:19"
"2389","20150521090524-397","1","2015-06-30 21:38:45",1435725525,"C6",822801,1436548326,"2015-07-10 10:12:06"
"5661","20152729032736-810","2","2015-06-30 21:42:50",1435725770,"C2",108914,1435834684,"2015-07-02 03:58:04"
"3739","20153914093936-718","1","2015-06-30 23:26:03",1435731963,"C3",477329,1436209292,"2015-07-06 12:01:32"
"2673","20153507013548-133","3","2015-06-30 23:55:18",1435733718,"C4",674790,1436408508,"2015-07-08 19:21:48"
"4125","20155129025110-549","2","2015-07-01 00:24:38",1435735478,"C2",60404,1435795882,"2015-07-01 17:11:22"
"4879","20152317012346-970","1","2015-07-01 00:32:08",1435735928,"C7",166186,1435902114,"2015-07-02 22:41:54"
"5154","20152729032750-703","2","2015-07-01 01:37:34",1435739854,"C0",61492,1435801346,"2015-07-01 18:42:26"
"3998","20154019124057-626","1","2015-07-01 01:49:36",1435740576,"C5",332573,1436073149,"2015-07-04 22:12:29"
"3542","20153221093222-957","2","2015-07-01 01:58:21",1435741101,"C8",119537,1435860638,"2015-07-02 11:10:38"
"2537","20153626023634-935","1","2015-07-01 02:04:51",1435741491,"C2",55271,1435796762,"2015-07-01 17:26:02"
"18","20155529015507-923","1","2015-07-01 02:07:19",1435741639,"C5",65166,1435806805,"2015-07-01 20:13:25"
"6079","20154620114644-698","2","2015-07-01 02:23:06",1435742586,"C5",458291,1436200877,"2015-07-06 09:41:17"
"5105","20153026023048-941","1","2015-07-01 02:49:12",1435744152,"C5",194952,1435939104,"2015-07-03 08:58:24"
"5160","20151913091934-158","1","2015-07-01 03:36:58",1435747018,"C8",383661,1436130679,"2015-07-05 14:11:19"
"5023","20153808083849-175","1","2015-07-01 04:08:44",1435748924,"C8",394199,1436143123,"2015-07-05 17:38:43"
"492","20153729063729-602","1","2015-07-01 04:35:35",1435750535,"C5",82743,1435833278,"2015-07-02 03:34:38"
"573","20150627070602-460","2","2015-07-01 05:20:20",1435753220,"C5",113086,1435866306,"2015-07-02 12:45:06"
"1045","20155124045148-189","1","2015-07-01 07:20:17",1435760417,"C2",570509,1436330926,"2015-07-07 21:48:46"
"3981","20152128062123-84","3","2015-07-01 08:48:35",1435765715,"C4",89344,1435855059,"2015-07-02 09:37:39"
"5488","20151726071747-488","1","2015-07-01 09:45:33",1435769133,"C0",440866,1436209999,"2015-07-06 12:13:19"
"3221","20153307023326-161","2","2015-07-01 09:56:16",1435769776,"C8",1028485,1436798261,"2015-07-13 07:37:41"
"713","20154317064310-833","1","2015-07-01 10:56:13",1435773373,"C8",174969,1435948342,"2015-07-03 11:32:22"
"2305","20153722033750-276","1","2015-07-01 11:34:50",1435775690,"C5",254340,1436030030,"2015-07-04 10:13:50"
"6226","20151212011241-763","3","2015-07-01 12:48:06",1435780086,"C8",328025,1436108111,"2015-07-05 07:55:11"
"1434","20151223091254-664","1","2015-07-01 13:59:10",1435784350,"C3",88547,1435872897,"2015-07-02 14:34:57"
"1373","20154729104715-725","1","2015-07-01 14:37:22",1435786642,"C4",186607,1435973249,"2015-07-03 18:27:29"
"4737","20153126063149-265","1","2015-07-01 15:03:17",1435788197,"C6",462688,1436250885,"2015-07-06 23:34:45"
"396","20151128091155-501","1","2015-07-01 15:13:25",1435788805,"C5",93630,1435882435,"2015-07-02 17:13:55"
"4739","20151701121746-803","1","2015-07-01 16:08:50",1435792130,"C6",325733,1436117863,"2015-07-05 10:37:43"
"2745","20150225120206-4","1","2015-07-01 16:35:41",1435793741,"C2",534815,1436328556,"2015-07-07 21:09:16"
"2525","20151323091336-516","1","2015-07-01 16:55:38",1435794938,"C5",359461,1436154399,"2015-07-05 20:46:39"
"5352","20151614091646-956","1","2015-07-01 17:05:42",1435795542,"C0",213848,1436009390,"2015-07-04 04:29:50"
"3155","20152325012334-763","1","2015-07-01 17:52:34",1435798354,"C5",267270,1436065624,"2015-07-04 20:07:04"
"4757","20155026035048-916","1","2015-07-01 18:23:57",1435800237,"C0",63027,1435863264,"2015-07-02 11:54:24"
"1153","20151823081833-359","1","2015-07-01 18:27:55",1435800475,"C0",103966,1435904441,"2015-07-02 23:20:41"
"1086","20151221041237-821","1","2015-07-01 18:40:29",1435801229,"C5",436436,1436237665,"2015-07-06 19:54:25"
"2469","20152830022847-358","3","2015-07-01 19:14:51",1435803291,"C3",103564,1435906855,"2015-07-03 00:00:55"
"2326","20150527020511-685","1","2015-07-01 19:30:39",1435804239,"C8",182564,1435986803,"2015-07-03 22:13:23"
"1866","20151122031145-815","2","2015-07-01 20:15:13",1435806913,"C6",99476,1435906389,"2015-07-02 23:53:09"
"1257","20152426012444-553","1","2015-07-01 20:47:13",1435808833,"C5",65507,1435874340,"2015-07-02 14:59:00"
"109","20153026033020-755","3","2015-07-01 21:02:20",1435809740,"C6",451920,1436261660,"2015-07-07 02:34:20"
"627","20154923074927-301","2","2015-07-01 21:56:33",1435812993,"C6",123671,1435936664,"2015-07-03 08:17:44"
"5833","20153808013814-745","1","2015-07-01 22:06:14",1435813574,"C3",672560,1436486134,"2015-07-09 16:55:34"
"867","20152828012807-551","2","2015-07-01 22:30:28",1435815028,"C6",291741,1436106769,"2015-07-05 07:32:49"
"2968","20154726114701-192","1","2015-07-01 23:34:35",1435818875,"C5",237227,1436056102,"2015-07-04 17:28:22"
"3368","20150008060003-21","1","2015-07-02 00:06:57",1435820817,"C7",293202,1436114019,"2015-07-05 09:33:39"
"4441","20154430014454-721","1","2015-07-02 00:17:40",1435821460,"C7",62183,1435883643,"2015-07-02 17:34:03"
"1327","20153626023632-111","1","2015-07-02 00:32:00",1435822320,"C0",233864,1436056184,"2015-07-04 17:29:44"
"1511","20151121121107-368","1","2015-07-02 02:45:39",1435830339,"C2",114559,1435944898,"2015-07-03 10:34:58"
"4931","20154228054230-169","1","2015-07-02 03:04:15",1435831455,"C5",97635,1435929090,"2015-07-03 06:11:30"
"1082","20151728101733-413","3","2015-07-02 04:49:55",1435837795,"C5",162971,1436000766,"2015-07-04 02:06:06"
"6372","20153028123046-38","3","2015-07-02 05:13:36",1435839216,"C8",159685,1435998901,"2015-07-04 01:35:01"
"776","20155217105219-132","2","2015-07-02 05:39:43",1435840783,"C2",425748,1436266531,"2015-07-07 03:55:31"
"6330","20154422114404-501","1","2015-07-02 06:26:18",1435843578,"C5",422467,1436266045,"2015-07-07 03:47:25"
"517","20155430055405-608","3","2015-07-02 06:32:35",1435843955,"C5",65955,1435909910,"2015-07-03 00:51:50"
"41","20153419063412-632","1","2015-07-02 06:44:36",1435844676,"C0",140478,1435985154,"2015-07-03 21:45:54"
"3870","20154629044625-977","2","2015-07-02 07:58:37",1435849117,"C3",75844,1435924961,"2015-07-03 05:02:41"
"4899","20151101051151-134","1","2015-07-02 08:28:16",1435850896,"C4",54985,1435905881,"2015-07-02 23:44:41"
"3065","20155024045031-794","3","2015-07-02 08:29:29",1435850969,"C5",330569,1436181538,"2015-07-06 04:18:58"
"339","20150129090159-131","2","2015-07-02 08:34:26",1435851266,"C0",85849,1435937115,"2015-07-03 08:25:15"
"3355","20155814045802-471","2","2015-07-02 08:43:23",1435851803,"C2",508507,1436360310,"2015-07-08 05:58:30"
"3724","20150529110523-979","2","2015-07-02 08:51:25",1435852285,"C4",125581,1435977866,"2015-07-03 19:44:26"
"5657","20150621010643-875","2","2015-07-02 09:11:04",1435853464,"C7",104029,1435957493,"2015-07-03 14:04:53"
"6478","20153813043802-884","2","2015-07-02 09:19:34",1435853974,"C8",230756,1436084730,"2015-07-05 01:25:30"
"634","20154412124411-6","1","2015-07-02 10:00:33",1435856433,"C5",859091,1436715524,"2015-07-12 08:38:44"
"5801","20152219012207-18","3","2015-07-02 11:18:37",1435861117,"C5",371930,1436233047,"2015-07-06 18:37:27"
"1657","20154530034515-528","1","2015-07-02 12:25:25",1435865125,"C3",80405,1435945530,"2015-07-03 10:45:30"
"4654","20152727032726-130","1","2015-07-02 12:39:23",1435865963,"C4",140639,1436006602,"2015-07-04 03:43:22"
"3894","20152726042728-687","2","2015-07-02 13:08:00",1435867680,"C5",253216,1436120896,"2015-07-05 11:28:16"
"3714","20152918052938-439","2","2015-07-02 14:06:52",1435871212,"C8",598717,1436469929,"2015-07-09 12:25:29"
"759","20152522072551-380","2","2015-07-02 14:18:19",1435871899,"C4",126964,1435998863,"2015-07-04 01:34:23"
"283","20154316104341-889","3","2015-07-02 15:51:09",1435877469,"C4",175106,1436052575,"2015-07-04 16:29:35"
"2450","20150820070819-746","2","2015-07-02 16:08:11",1435878491,"C0",133649,1436012140,"2015-07-04 05:15:40"
"2725","20153326103309-465","2","2015-07-02 16:38:29",1435880309,"C7",270160,1436150469,"2015-07-05 19:41:09"
"568","20155328035326-113","2","2015-07-02 17:09:52",1435882192,"C6",350186,1436232378,"2015-07-06 18:26:18"
"5688","20155608015646-673","1","2015-07-02 17:21:40",1435882900,"C7",231766,1436114666,"2015-07-05 09:44:26"
"1237","20152827042814-470","2","2015-07-02 17:47:11",1435884431,"C4",145579,1436030010,"2015-07-04 10:13:30"
"4747","20154513064520-256","2","2015-07-02 17:56:16",1435884976,"C5",210232,1436095208,"2015-07-05 04:20:08"
"4839","20150430120449-822","2","2015-07-02 17:59:06",1435885146,"C6",194057,1436079203,"2015-07-04 23:53:23"
"3929","20151020081012-980","1","2015-07-02 18:45:16",1435887916,"C0",537452,1436425368,"2015-07-09 00:02:48"
"4317","20153601083632-281","3","2015-07-02 19:52:00",1435891920,"C2",126928,1436018848,"2015-07-04 07:07:28"
"4164","20153101083156-266","2","2015-07-02 20:56:37",1435895797,"C0",131081,1436026878,"2015-07-04 09:21:18"
"5300","20151701071741-626","3","2015-07-02 21:19:06",1435897146,"C2",136885,1436034031,"2015-07-04 11:20:31"
"1170","20152619052643-277","3","2015-07-03 02:15:23",1435914923,"C3",144365,1436059288,"2015-07-04 18:21:28"
"628","20154606074613-942","2","2015-07-03 02:27:33",1435915653,"C5",289210,1436204863,"2015-07-06 10:47:43"
"879","20151929101959-58","3","2015-07-03 02:41:57",1435916517,"C8",159059,1436075576,"2015-07-04 22:52:56"
"3634","20155829095814-906","3","2015-07-03 05:11:18",1435925478,"C7",164192,1436089670,"2015-07-05 02:47:50"
"2908","20155826125821-822","3","2015-07-03 05:19:17",1435925957,"C3",72157,1435998114,"2015-07-04 01:21:54"
"5568","20154623074640-436","3","2015-07-03 05:46:37",1435927597,"C5",285599,1436213196,"2015-07-06 13:06:36"
"5478","20152730062723-66","2","2015-07-03 06:30:56",1435930256,"C0",86471,1436016727,"2015-07-04 06:32:07"
"3353","20152017012017-5","1","2015-07-03 06:53:13",1435931593,"C8",194168,1436125761,"2015-07-05 12:49:21"
"1923","20152201042213-827","1","2015-07-03 07:57:41",1435935461,"C5",341816,1436277277,"2015-07-07 06:54:37"
"1728","20154725104717-951","2","2015-07-03 08:17:53",1435936673,"C7",341118,1436277791,"2015-07-07 07:03:11"
"4984","20153521043512-619","2","2015-07-03 08:34:03",1435937643,"C4",335977,1436273620,"2015-07-07 05:53:40"
"3914","20154325044303-21","2","2015-07-03 08:53:13",1435938793,"C5",331505,1436270298,"2015-07-07 04:58:18"
"2609","20151802061810-813","1","2015-07-03 09:21:20",1435940480,"C0",97390,1436037870,"2015-07-04 12:24:30"
"3326","20154820114822-453","2","2015-07-03 10:17:21",1435943841,"C4",159677,1436103518,"2015-07-05 06:38:38"
"5866","20150517080508-420","2","2015-07-03 10:19:06",1435943946,"C2",198634,1436142580,"2015-07-05 17:29:40"
"5880","20153029033048-921","2","2015-07-03 10:40:08",1435945208,"C8",65632,1436010840,"2015-07-04 04:54:00"
"5761","20150924070945-953","1","2015-07-03 11:11:23",1435947083,"C7",396049,1436343132,"2015-07-08 01:12:12"
"170","20150801120859-136","2","2015-07-03 11:24:27",1435947867,"C6",170128,1436117995,"2015-07-05 10:39:55"
"287","20154428064410-192","3","2015-07-03 11:34:20",1435948460,"C8",89882,1436038342,"2015-07-04 12:32:22"
"5956","20152404052454-43","1","2015-07-03 11:42:24",1435948944,"C6",414175,1436363119,"2015-07-08 06:45:19"
"2507","20151429091426-986","2","2015-07-03 12:08:12",1435950492,"C5",178013,1436128505,"2015-07-05 13:35:05"
"6040","20153123023120-949","2","2015-07-03 12:57:02",1435953422,"C4",286114,1436239536,"2015-07-06 20:25:36"
"750","20150206110209-450","2","2015-07-03 13:27:37",1435955257,"C3",334504,1436289761,"2015-07-07 10:22:41"
"2293","20155919015912-624","1","2015-07-03 14:12:58",1435957978,"C8",172918,1436130896,"2015-07-05 14:14:56"
"3917","20155601025658-508","1","2015-07-03 15:06:04",1435961164,"C6",173346,1436134510,"2015-07-05 15:15:10"
"3738","20153126113104-616","1","2015-07-03 15:14:22",1435961662,"C5",206066,1436167728,"2015-07-06 00:28:48"
"2084","20150229050210-638","1","2015-07-03 15:37:26",1435963046,"C5",170258,1436133304,"2015-07-05 14:55:04"
"5650","20152524082502-366","1","2015-07-03 15:55:59",1435964159,"C5",268219,1436232378,"2015-07-06 18:26:18"
"1747","20154112014114-381","False","2015-07-03 15:56:51",1435964211,"C6",202939,1436167150,"2015-07-06 00:19:10"
"4095","20152730062720-372","1","2015-07-03 15:57:05",1435964225,"C0",97795,1436062020,"2015-07-04 19:07:00"
"5578","20151330051300-634","1","2015-07-03 16:21:35",1435965695,"C0",256115,1436221810,"2015-07-06 15:30:10"
"530","20150030050049-156","2","2015-07-03 16:52:44",1435967564,"C3",258715,1436226279,"2015-07-06 16:44:39"
"5199","20151521121533-656","1","2015-07-03 17:07:45",1435968465,"C3",527166,1436495631,"2015-07-09 19:33:51"
"1385","20150930010911-718","1","2015-07-03 17:20:31",1435969231,"C4",274280,1436243511,"2015-07-06 21:31:51"
"1287","20152702082701-295","1","2015-07-03 17:37:47",1435970267,"C6",119446,1436089713,"2015-07-05 02:48:33"
"4456","20152904032905-433","1","2015-07-03 18:29:25",1435973365,"C8",503284,1436476649,"2015-07-09 14:17:29"
"2624","20151322121351-809","1","2015-07-03 18:39:16",1435973956,"C8",194705,1436168661,"2015-07-06 00:44:21"
"4495","20153416023407-833","1","2015-07-03 19:00:28",1435975228,"C2",494927,1436470155,"2015-07-09 12:29:15"
"1067","20153620053622-72","1","2015-07-03 19:24:37",1435976677,"C0",161385,1436138062,"2015-07-05 16:14:22"
"2291","20151801111852-365","1","2015-07-03 20:53:31",1435982011,"C6",207279,1436189290,"2015-07-06 06:28:10"
"5593","20150501060550-176","3","2015-07-03 23:20:46",1435990846,"C6",353362,1436344208,"2015-07-08 01:30:08"
"2623","20152329052335-690","1","2015-07-04 00:54:31",1435996471,"C5",186328,1436182799,"2015-07-06 04:39:59"
"5076","20155412025439-711","2","2015-07-04 01:16:23",1435997783,"C0",231463,1436229246,"2015-07-06 17:34:06"
"1583","20153526093522-53","1","2015-07-04 03:13:14",1436004794,"C5",334136,1436338930,"2015-07-08 00:02:10"
"3382","20150118110157-82","1","2015-07-04 03:14:19",1436004859,"C8",677171,1436682030,"2015-07-11 23:20:30"
"1566","20154217034220-309","2","2015-07-04 04:44:24",1436010264,"C5",714662,1436724926,"2015-07-12 11:15:26"
"3146","20153330113330-512","2","2015-07-04 04:46:36",1436010396,"C5",160593,1436170989,"2015-07-06 01:23:09"
"3667","20153907123907-228","1","2015-07-04 05:32:11",1436013131,"C3",288398,1436301529,"2015-07-07 13:38:49"
"5003","20154406044427-579","1","2015-07-04 06:00:48",1436014848,"C3",340083,1436354931,"2015-07-08 04:28:51"
"1551","20151403101418-295","2","2015-07-04 06:23:42",1436016222,"C8",380652,1436396874,"2015-07-08 16:07:54"
"2344","20155230035222-748","2","2015-07-04 07:06:16",1436018776,"C8",157017,1436175793,"2015-07-06 02:43:13"
"1335","20150313080324-835","1","2015-07-04 07:46:38",1436021198,"C8",906697,1436927895,"2015-07-14 19:38:15"
"3361","20154730124723-254","3","2015-07-04 08:28:07",1436023687,"C0",330044,1436353731,"2015-07-08 04:08:51"
"295","20152923072910-395","2","2015-07-04 09:39:52",1436027992,"C8",479121,1436507113,"2015-07-09 22:45:13"
"1466","20150419060418-689","1","2015-07-04 09:47:16",1436028436,"C5",654689,1436683125,"2015-07-11 23:38:45"
"4488","20150404050454-793","1","2015-07-04 11:04:22",1436033062,"C6",321296,1436354358,"2015-07-08 04:19:18"
"4513","20155501035544-811","3","2015-07-04 11:31:30",1436034690,"C6",243346,1436278036,"2015-07-07 07:07:16"
"2239","20154830104827-205","1","2015-07-04 13:02:49",1436040169,"C0",176831,1436217000,"2015-07-06 14:10:00"
"4544","20151924061911-225","2","2015-07-04 14:43:07",1436046187,"C2",447118,1436493305,"2015-07-09 18:55:05"
"4453","20153003023020-726","1","2015-07-04 15:01:21",1436047281,"C3",88261,1436135542,"2015-07-05 15:32:22"
"3897","20152003112040-99","1","2015-07-04 15:01:32",1436047292,"C2",99652,1436146944,"2015-07-05 18:42:24"
"3644","20152514072525-135","1","2015-07-04 15:44:31",1436049871,"C8",878973,1436928844,"2015-07-14 19:54:04"
"4956","20154630044606-595","3","2015-07-04 16:35:14",1436052914,"C8",172474,1436225388,"2015-07-06 16:29:48"
"5331","20153312103323-598","3","2015-07-04 18:12:56",1436058776,"C5",642791,1436701567,"2015-07-12 04:46:07"
"2337","20150614120640-492","1","2015-07-04 19:02:34",1436061754,"C0",250422,1436312176,"2015-07-07 16:36:16"
"3562","20150628010613-142","1","2015-07-04 20:05:49",1436065549,"C2",67947,1436133496,"2015-07-05 14:58:16"
"5368","20151927041904-297","3","2015-07-04 20:14:44",1436066084,"C0",309470,1436375554,"2015-07-08 10:12:34"
"2377","20154525084548-607","2","2015-07-04 20:24:21",1436066661,"C2",273171,1436339832,"2015-07-08 00:17:12"
"467","20153902073935-578","2","2015-07-04 20:33:55",1436067235,"C8",109630,1436176865,"2015-07-06 03:01:05"
"4210","20150029030057-969","2","2015-07-04 20:35:01",1436067301,"C4",452044,1436519345,"2015-07-10 02:09:05"
"6098","20152103042134-429","2","2015-07-04 20:38:40",1436067520,"C7",50913,1436118433,"2015-07-05 10:47:13"
"3687","20152513102549-213","3","2015-07-04 20:53:29",1436068409,"C5",264580,1436332989,"2015-07-07 22:23:09"
"3878","20153224063221-780","1","2015-07-04 22:09:09",1436072949,"C4",306736,1436379685,"2015-07-08 11:21:25"
"2129","20153324033312-407","3","2015-07-04 22:19:00",1436073540,"C7",444174,1436517714,"2015-07-10 01:41:54"
"2518","20152302052353-71","1","2015-07-05 01:47:02",1436086022,"C5",67663,1436153685,"2015-07-05 20:34:45"
"1553","20152529092504-987","2","2015-07-05 02:04:34",1436087074,"C0",245985,1436333059,"2015-07-07 22:24:19"
"893","20154702124720-238","3","2015-07-05 03:35:38",1436092538,"C5",75366,1436167904,"2015-07-06 00:31:44"
"3590","20152326082325-308","1","2015-07-05 04:47:51",1436096871,"C7",109238,1436206109,"2015-07-06 11:08:29"
"5651","20152226032253-445","1","2015-07-05 05:14:08",1436098448,"C4",247025,1436345473,"2015-07-08 01:51:13"
"6502","20155828095857-94","2","2015-07-05 05:58:58",1436101138,"C2",84343,1436185481,"2015-07-06 05:24:41"
"3049","20150801020830-440","1","2015-07-05 06:01:24",1436101284,"C4",158187,1436259471,"2015-07-07 01:57:51"
"5839","20153706113731-583","3","2015-07-05 06:20:26",1436102426,"C8",497315,1436599741,"2015-07-11 00:29:01"
"131","20155801085847-425","1","2015-07-05 06:28:43",1436102923,"C4",336596,1436439519,"2015-07-09 03:58:39"
"3706","20155501035526-887","1","2015-07-05 07:05:48",1436105148,"C2",313822,1436418970,"2015-07-08 22:16:10"
"4184","20151020091049-173","1","2015-07-05 08:34:19",1436110459,"C2",431270,1436541729,"2015-07-10 08:22:09"
"5437","20155830085850-481","1","2015-07-05 09:39:00",1436114340,"C6",434410,1436548750,"2015-07-10 10:19:10"
"3953","20155019075059-941","3","2015-07-05 12:09:35",1436123375,"C5",465972,1436589347,"2015-07-10 21:35:47"
"3721","20154627024615-98","2","2015-07-05 13:43:30",1436129010,"C6",687435,1436816445,"2015-07-13 12:40:45"
"3920","20154527024553-723","1","2015-07-05 14:05:43",1436130343,"C5",344395,1436474738,"2015-07-09 13:45:38"
"3164","20154128104144-208","2","2015-07-05 14:06:16",1436130376,"C6",77134,1436207510,"2015-07-06 11:31:50"
"1463","20154303024324-525","2","2015-07-05 14:08:50",1436130530,"C5",85363,1436215893,"2015-07-06 13:51:33"
"4154","20151701091730-48","3","2015-07-05 14:13:50",1436130830,"C5",181690,1436312520,"2015-07-07 16:42:00"
"5230","20155404065421-768","1","2015-07-05 14:32:08",1436131928,"C4",113867,1436245795,"2015-07-06 22:09:55"
"449","20153028103038-731","3","2015-07-05 14:42:55",1436132575,"C6",619937,1436752512,"2015-07-12 18:55:12"
"1246","20153917033947-416","3","2015-07-05 15:24:48",1436135088,"C8",222043,1436357131,"2015-07-08 05:05:31"
"4818","20150701040708-313","3","2015-07-05 15:57:16",1436137036,"C5",172504,1436309540,"2015-07-07 15:52:20"
"725","20150103100100-923","2","2015-07-05 15:57:26",1436137046,"C5",97093,1436234139,"2015-07-06 18:55:39"
"2082","20154703044705-734","1","2015-07-05 16:18:06",1436138286,"C3",171061,1436309347,"2015-07-07 15:49:07"
"5212","20150127030110-863","1","2015-07-05 16:18:52",1436138332,"C7",77318,1436215650,"2015-07-06 13:47:30"
"1016","20155315115319-974","3","2015-07-05 16:45:27",1436139927,"C8",872764,1437012691,"2015-07-15 19:11:31"
"6424","20155328035310-746","2","2015-07-05 17:18:48",1436141928,"C6",609938,1436751866,"2015-07-12 18:44:26"
"3210","20152301032339-982","2","2015-07-05 17:36:15",1436142975,"C7",176778,1436319753,"2015-07-07 18:42:33"
"1443","20154001124007-163","1","2015-07-05 17:36:34",1436142994,"C2",121129,1436264123,"2015-07-07 03:15:23"
"3973","20155826105805-860","1","2015-07-05 17:58:59",1436144339,"C4",267618,1436411957,"2015-07-08 20:19:17"
"4355","20153730123713-648","1","2015-07-05 18:24:48",1436145888,"C8",90571,1436236459,"2015-07-06 19:34:19"
"4949","20154603024647-48","2","2015-07-05 19:13:49",1436148829,"C8",94411,1436243240,"2015-07-06 21:27:20"
"6440","20153730013733-766","3","2015-07-05 20:04:02",1436151842,"C0",65027,1436216869,"2015-07-06 14:07:49"
"58","20151422021453-376","2","2015-07-05 20:20:16",1436152816,"C7",163589,1436316405,"2015-07-07 17:46:45"
"790","20154201104250-936","2","2015-07-05 20:23:20",1436153000,"C2",126810,1436279810,"2015-07-07 07:36:50"
"5350","20151722101732-165","2","2015-07-05 20:30:44",1436153444,"C6",193332,1436346776,"2015-07-08 02:12:56"
"548","20153617093653-526","2","2015-07-05 21:06:35",1436155595,"C7",177398,1436332993,"2015-07-07 22:23:13"
"6310","20153629073622-752","2","2015-07-05 21:31:02",1436157062,"C8",284240,1436441302,"2015-07-09 04:28:22"
"1242","20152201102241-597","3","2015-07-05 22:26:43",1436160403,"C7",194521,1436354924,"2015-07-08 04:28:44"
"2047","20152019082054-582","2","2015-07-05 22:44:06",1436161446,"C4",514074,1436675520,"2015-07-11 21:32:00"
"2918","20152305022313-514","1","2015-07-05 23:32:58",1436164378,"C8",524997,1436689375,"2015-07-12 01:22:55"
"3645","20151927101928-443","1","2015-07-05 23:52:07",1436165527,"C0",246653,1436412180,"2015-07-08 20:23:00"
"1469","20152917082934-698","1","2015-07-05 23:58:30",1436165910,"C5",805468,1436971378,"2015-07-15 07:42:58"
"6540","20150806040859-207","1","2015-07-06 00:56:35",1436169395,"C2",317157,1436486552,"2015-07-09 17:02:32"
"6221","20150420110457-500","2","2015-07-06 00:56:49",1436169409,"C4",168239,1436337648,"2015-07-07 23:40:48"
"4039","20154129084132-74","1","2015-07-06 01:13:53",1436170433,"C3",82563,1436252996,"2015-07-07 00:09:56"
"2197","20152530052504-640","3","2015-07-06 01:47:02",1436172422,"C8",231059,1436403481,"2015-07-08 17:58:01"
"1372","20151205011253-317","2","2015-07-06 03:25:03",1436178303,"C4",377590,1436555893,"2015-07-10 12:18:13"
"6435","20150013020033-816","1","2015-07-06 03:56:01",1436180161,"C8",278704,1436458865,"2015-07-09 09:21:05"
"668","20154801084800-755","1","2015-07-06 04:12:15",1436181135,"C8",83091,1436264226,"2015-07-07 03:17:06"
"4038","20151302081321-676","3","2015-07-06 04:20:57",1436181657,"C4",110552,1436292209,"2015-07-07 11:03:29"
"779","20153902093914-109","1","2015-07-06 04:28:02",1436182082,"C4",108976,1436291058,"2015-07-07 10:44:18"
"6188","20153120103108-805","2","2015-07-06 04:48:20",1436183300,"C2",170229,1436353529,"2015-07-08 04:05:29"
"6544","20151028011029-820","3","2015-07-06 04:49:09",1436183349,"C0",82640,1436265989,"2015-07-07 03:46:29"
"2060","20150325020345-881","3","2015-07-06 05:03:45",1436184225,"C8",183600,1436367825,"2015-07-08 08:03:45"
"4475","20154426024411-840","2","2015-07-06 06:13:38",1436188418,"C0",277789,1436466207,"2015-07-09 11:23:27"
"1774","20152601122623-54","1","2015-07-06 06:18:09",1436188689,"C3",204953,1436393642,"2015-07-08 15:14:02"
"3454","20154121084107-952","3","2015-07-06 06:55:19",1436190919,"C5",644826,1436835745,"2015-07-13 18:02:25"
"6505","20151304011310-154","1","2015-07-06 06:57:04",1436191024,"C3",150234,1436341258,"2015-07-08 00:40:58"
"959","20154003114038-680","2","2015-07-06 07:13:38",1436192018,"C3",81060,1436273078,"2015-07-07 05:44:38"
"6103","20150605070642-510","1","2015-07-06 07:58:17",1436194697,"C3",89495,1436284192,"2015-07-07 08:49:52"
"4036","20153524123538-428","1","2015-07-06 08:07:42",1436195262,"C4",510362,1436705624,"2015-07-12 05:53:44"
"3926","20151430011409-669","1","2015-07-06 08:40:57",1436197257,"C4",251004,1436448261,"2015-07-09 06:24:21"
"177","20150926110958-805","2","2015-07-06 08:42:52",1436197372,"C0",285058,1436482430,"2015-07-09 15:53:50"
"3417","20155524085551-928","1","2015-07-06 09:56:09",1436201769,"C4",346806,1436548575,"2015-07-10 10:16:15"
"3978","20154904104947-550","2","2015-07-06 10:13:17",1436202797,"C3",85305,1436288102,"2015-07-07 09:55:02"
"259","20151001031016-663","1","2015-07-06 10:59:04",1436205544,"C2",138976,1436344520,"2015-07-08 01:35:20"
"456","20151609011626-759","2","2015-07-06 11:14:10",1436206450,"C5",290683,1436497133,"2015-07-09 19:58:53"
"62","20150610040636-776","2","2015-07-06 13:37:21",1436215041,"C7",248605,1436463646,"2015-07-09 10:40:46"
"1376","20155418045455-317","2","2015-07-06 14:02:51",1436216571,"C0",772438,1436989009,"2015-07-15 12:36:49"
"112","20150105040107-528","2","2015-07-06 14:28:44",1436218124,"C3",80857,1436298981,"2015-07-07 12:56:21"
"3563","20153029063054-508","1","2015-07-06 14:34:12",1436218452,"C7",316899,1436535351,"2015-07-10 06:35:51"
"3341","20151603051629-978","1","2015-07-06 14:49:41",1436219381,"C5",83464,1436302845,"2015-07-07 14:00:45"
"1768","20155420105422-518","3","2015-07-06 15:01:18",1436220078,"C4",174652,1436394730,"2015-07-08 15:32:10"
"426","20150723050745-341","1","2015-07-06 15:56:55",1436223415,"C8",159850,1436383265,"2015-07-08 12:21:05"
"4646","20155503085502-843","1","2015-07-06 16:13:35",1436224415,"C3",95171,1436319586,"2015-07-07 18:39:46"
"5093","20152709052754-9","3","2015-07-06 16:22:12",1436224932,"C4",332694,1436557626,"2015-07-10 12:47:06"
"1713","20153904043911-814","3","2015-07-06 16:57:33",1436227053,"C3",86951,1436314004,"2015-07-07 17:06:44"
"5262","20150128070124-874","1","2015-07-06 18:16:31",1436231791,"C4",731707,1436963498,"2015-07-15 05:31:38"
"5415","20151004041028-27","1","2015-07-06 18:25:20",1436232320,"C2",180892,1436413212,"2015-07-08 20:40:12"
"3308","20152230122233-577","1","2015-07-06 18:26:47",1436232407,"C4",270127,1436502534,"2015-07-09 21:28:54"
"5655","20155805015836-890","1","2015-07-06 18:51:29",1436233889,"C3",103973,1436337862,"2015-07-07 23:44:22"
"679","20154304044323-645","1","2015-07-06 19:08:21",1436234901,"C3",90749,1436325650,"2015-07-07 20:20:50"
"5308","20152730102714-620","1","2015-07-06 19:43:15",1436236995,"C2",551761,1436788756,"2015-07-13 04:59:16"
"1451","20154421014437-375","1","2015-07-06 19:57:33",1436237853,"C4",164797,1436402650,"2015-07-08 17:44:10"
"5565","20151423051449-551","1","2015-07-06 20:01:45",1436238105,"C3",141652,1436379757,"2015-07-08 11:22:37"
"6270","20153505093535-456","2","2015-07-06 20:05:56",1436238356,"C0",124221,1436362577,"2015-07-08 06:36:17"
"3489","20154804044802-635","2","2015-07-06 20:24:52",1436239492,"C5",92905,1436332397,"2015-07-07 22:13:17"
"3601","20151304121328-420","1","2015-07-06 20:35:24",1436240124,"C3",202916,1436443040,"2015-07-09 04:57:20"
"4048","20150801050802-446","2","2015-07-06 20:43:16",1436240596,"C4",222457,1436463053,"2015-07-09 10:30:53"
"3295","20151805071821-119","3","2015-07-06 21:38:58",1436243938,"C6",138037,1436381975,"2015-07-08 11:59:35"
"261","20150702040704-305","1","2015-07-06 21:42:59",1436244179,"C8",73151,1436317330,"2015-07-07 18:02:10"
"27","20154602084650-633","1","2015-07-06 21:55:55",1436244955,"C8",596989,1436841944,"2015-07-13 19:45:44"
"6194","20151202021203-963","1","2015-07-06 22:01:08",1436245268,"C4",373745,1436619013,"2015-07-11 05:50:13"
"1097","20155416025450-542","3","2015-07-06 22:01:42",1436245302,"C4",250516,1436495818,"2015-07-09 19:36:58"
"2649","20154112084109-806","1","2015-07-06 22:54:51",1436248491,"C8",303546,1436552037,"2015-07-10 11:13:57"
"1635","20151710081754-167","2","2015-07-06 23:36:26",1436250986,"C5",287689,1436538675,"2015-07-10 07:31:15"
"1899","20155304025306-399","1","2015-07-07 00:03:10",1436252590,"C2",102902,1436355492,"2015-07-08 04:38:12"
"1074","20152302012357-409","1","2015-07-07 00:11:37",1436253097,"C7",192230,1436445327,"2015-07-09 05:35:27"
"3578","20153125023115-598","1","2015-07-07 00:40:54",1436254854,"C0",328993,1436583847,"2015-07-10 20:04:07"
"3585","20150201040231-215","1","2015-07-07 00:57:31",1436255851,"C2",232050,1436487901,"2015-07-09 17:25:01"
"944","20151203041231-943","1","2015-07-07 01:47:34",1436258854,"C2",97901,1436356755,"2015-07-08 04:59:15"
"1176","20151403031412-911","1","2015-07-07 02:25:12",1436261112,"C3",99820,1436360932,"2015-07-08 06:08:52"
"4325","20154009094029-596","2","2015-07-07 02:39:12",1436261952,"C8",341989,1436603941,"2015-07-11 01:39:01"
"699","20154501044554-839","2","2015-07-07 02:56:23",1436262983,"C8",66947,1436329930,"2015-07-07 21:32:10"
"1996","20151626061648-946","3","2015-07-07 03:17:30",1436264250,"C5",313214,1436577464,"2015-07-10 18:17:44"
"2710","20153504013504-269","1","2015-07-07 03:35:34",1436265334,"C5",74410,1436339744,"2015-07-08 00:15:44"
"1348","20155030015058-336","1","2015-07-07 05:14:54",1436271294,"C0",286918,1436558212,"2015-07-10 12:56:52"
"4702","20151506031509-899","2","2015-07-07 05:50:29",1436273429,"C3",52520,1436325949,"2015-07-07 20:25:49"
"1043","20155501105513-756","2","2015-07-07 06:01:33",1436274093,"C4",71540,1436345633,"2015-07-08 01:53:53"
"459","20155630015659-740","1","2015-07-07 06:03:34",1436274214,"C8",115279,1436389493,"2015-07-08 14:04:53"
"1004","20153903103958-735","3","2015-07-07 06:31:25",1436275885,"C6",330687,1436606572,"2015-07-11 02:22:52"
"2578","20155904065927-209","1","2015-07-07 06:34:43",1436276083,"C2",128858,1436404941,"2015-07-08 18:22:21"
"1831","20150729120752-754","2","2015-07-07 06:35:36",1436276136,"C2",335632,1436611768,"2015-07-11 03:49:28"
"3621","20151103101135-993","1","2015-07-07 07:09:20",1436278160,"C5",111555,1436389715,"2015-07-08 14:08:35"
"3607","20152222012249-468","3","2015-07-07 07:14:09",1436278449,"C5",159235,1436437684,"2015-07-09 03:28:04"
"4982","20153505123531-2","1","2015-07-07 07:17:23",1436278643,"C3",343214,1436621857,"2015-07-11 06:37:37"
"1691","20154501084530-202","2","2015-07-07 07:43:32",1436280212,"C8",73526,1436353738,"2015-07-08 04:08:58"
"4228","20151404021437-954","3","2015-07-07 07:44:24",1436280264,"C0",235787,1436516051,"2015-07-10 01:14:11"
"89","20151303071356-254","3","2015-07-07 08:00:24",1436281224,"C5",174194,1436455418,"2015-07-09 08:23:38"
"323","20152703112735-711","1","2015-07-07 08:01:21",1436281281,"C5",166613,1436447894,"2015-07-09 06:18:14"
"4041","20154821104859-297","2","2015-07-07 08:22:43",1436282563,"C5",171703,1436454266,"2015-07-09 08:04:26"
"3189","20153830123858-160","1","2015-07-07 08:55:19",1436284519,"C4",84483,1436369002,"2015-07-08 08:23:22"
"2681","20155104055125-368","2","2015-07-07 09:52:15",1436287935,"C6",230450,1436518385,"2015-07-10 01:53:05"
"6016","20150203060259-209","2","2015-07-07 10:27:08",1436290028,"C5",120483,1436410511,"2015-07-08 19:55:11"
"2190","20154201114254-498","2","2015-07-07 10:59:14",1436291954,"C8",103156,1436395110,"2015-07-08 15:38:30"
"1784","20152005092056-151","2","2015-07-07 11:06:01",1436292361,"C8",554221,1436846582,"2015-07-13 21:03:02"
"2442","20155501115549-423","2","2015-07-07 11:07:51",1436292471,"C4",73646,1436366117,"2015-07-08 07:35:17"
"4175","20154714024730-244","1","2015-07-07 12:02:13",1436295733,"C7",282469,1436578202,"2015-07-10 18:30:02"
"4139","20150903090957-551","1","2015-07-07 13:18:19",1436300299,"C5",180251,1436480550,"2015-07-09 15:22:30"
"5394","20155313105324-362","1","2015-07-07 13:39:03",1436301543,"C4",694513,1436996056,"2015-07-15 14:34:16"
"6190","20154303124314-941","1","2015-07-07 13:56:00",1436302560,"C5",174983,1436477543,"2015-07-09 14:32:23"
"525","20155525015513-235","2","2015-07-07 14:01:37",1436302897,"C0",345728,1436648625,"2015-07-11 14:03:45"
"1631","20153906073935-24","2","2015-07-07 15:44:23",1436309063,"C4",115488,1436424551,"2015-07-08 23:49:11"
"5008","20155418035415-502","1","2015-07-07 15:59:51",1436309991,"C6",273656,1436583647,"2015-07-10 20:00:47"
"4548","20155428065442-400","3","2015-07-07 16:33:33",1436312013,"C4",812331,1437124344,"2015-07-17 02:12:24"
"571","20152123012131-392","2","2015-07-07 16:35:47",1436312147,"C6",152657,1436464804,"2015-07-09 11:00:04"
"5384","20153205083252-86","1","2015-07-07 16:52:25",1436313145,"C0",202773,1436515918,"2015-07-10 01:11:58"
"2210","20155502125507-435","1","2015-07-07 16:57:31",1436313451,"C2",63792,1436377243,"2015-07-08 10:40:43"
"611","20153301123341-61","2","2015-07-07 17:09:42",1436314182,"C5",76423,1436390605,"2015-07-08 14:23:25"
"2847","20155803045848-101","3","2015-07-07 17:39:30",1436315970,"C2",174021,1436489991,"2015-07-09 17:59:51"
"5017","20153605033636-902","1","2015-07-07 17:57:02",1436317022,"C8",90613,1436407635,"2015-07-08 19:07:15"
"2823","20150921010943-734","2","2015-07-07 18:19:58",1436318398,"C8",280203,1436598601,"2015-07-11 00:10:01"
"1665","20154204124245-802","3","2015-07-07 18:28:39",1436318919,"C2",93318,1436412237,"2015-07-08 20:23:57"
"5139","20153530093500-378","1","2015-07-07 18:47:08",1436320028,"C2",79741,1436399769,"2015-07-08 16:56:09"
"1014","20151602121624-797","1","2015-07-07 18:52:48",1436320368,"C3",455784,1436776152,"2015-07-13 01:29:12"
"6329","20151928081935-515","2","2015-07-07 19:51:44",1436323904,"C5",273043,1436596947,"2015-07-10 23:42:27"
"241","20152303052305-443","1","2015-07-07 22:03:09",1436331789,"C5",51772,1436383561,"2015-07-08 12:26:01"
"5302","20154127114129-6","1","2015-07-07 22:08:19",1436332099,"C8",180322,1436512421,"2015-07-10 00:13:41"
"1352","20151223091224-134","2","2015-07-07 23:03:27",1436335407,"C2",419821,1436755228,"2015-07-12 19:40:28"
"3002","20150122060128-25","2","2015-07-07 23:26:07",1436336767,"C7",194097,1436530864,"2015-07-10 05:21:04"
"2336","20150323040301-184","1","2015-07-07 23:34:31",1436337271,"C7",176670,1436513941,"2015-07-10 00:39:01"
"118","20154701074721-510","2","2015-07-08 00:43:42",1436341422,"C4",193127,1436534549,"2015-07-10 06:22:29"
"1133","20153204013239-640","1","2015-07-08 01:10:18",1436343018,"C2",100353,1436443371,"2015-07-09 05:02:51"
"3854","20154203064217-174","1","2015-07-08 01:34:53",1436344493,"C5",137852,1436482345,"2015-07-09 15:52:25"
"4343","20152025032033-74","1","2015-07-08 02:11:15",1436346675,"C2",358614,1436705289,"2015-07-12 05:48:09"
"1690","20152215022221-833","1","2015-07-08 03:18:17",1436350697,"C7",973678,1437324375,"2015-07-19 09:46:15"
"964","20153104023109-416","3","2015-07-08 03:47:34",1436352454,"C8",61397,1436413851,"2015-07-08 20:50:51"
"1532","20150405010405-973","1","2015-07-08 03:56:51",1436353011,"C5",113183,1436466194,"2015-07-09 11:23:14"
"125","20152109062104-583","2","2015-07-08 04:16:32",1436354192,"C2",312266,1436666458,"2015-07-11 19:00:58"
"4174","20153003083030-321","3","2015-07-08 07:33:54",1436366034,"C8",214302,1436580336,"2015-07-10 19:05:36"
"3330","20155003045027-887","1","2015-07-08 07:43:37",1436366617,"C0",399190,1436765807,"2015-07-12 22:36:47"
"220","20155603015631-143","2","2015-07-08 07:54:41",1436367281,"C4",410290,1436777571,"2015-07-13 01:52:51"
"1332","20153926013940-342","1","2015-07-08 07:56:30",1436367390,"C5",508105,1436875495,"2015-07-14 05:04:55"
"3694","20155506035548-222","1","2015-07-08 07:57:18",1436367438,"C3",72045,1436439483,"2015-07-09 03:58:03"
"2160","20153907063955-529","2","2015-07-08 08:00:40",1436367640,"C2",91245,1436458885,"2015-07-09 09:21:25"
"192","20154904034903-354","1","2015-07-08 10:33:23",1436376803,"C4",163330,1436540133,"2015-07-10 07:55:33"
"985","20152704012705-41","1","2015-07-08 11:07:55",1436378875,"C5",168625,1436547500,"2015-07-10 09:58:20"
"1135","20153224073256-73","1","2015-07-08 11:10:52",1436379052,"C5",611338,1436990390,"2015-07-15 12:59:50"
"6250","20154011124049-78","1","2015-07-08 11:27:37",1436380057,"C2",776136,1437156193,"2015-07-17 11:03:13"
"4578","20155902015910-865","1","2015-07-08 11:30:03",1436380203,"C4",509453,1436889656,"2015-07-14 09:00:56"
"326","20155805025842-634","1","2015-07-08 13:24:31",1436387071,"C0",406507,1436793578,"2015-07-13 06:19:38"
"4427","20153222013237-308","1","2015-07-08 13:28:40",1436387320,"C4",460721,1436848041,"2015-07-13 21:27:21"
"3321","20150326090329-717","2","2015-07-08 14:07:29",1436389649,"C8",211008,1436600657,"2015-07-11 00:44:17"
"704","20150025040004-379","2","2015-07-08 14:16:20",1436390180,"C0",159568,1436549748,"2015-07-10 10:35:48"
"5416","20150903040923-931","3","2015-07-08 14:25:24",1436390724,"C5",60823,1436451547,"2015-07-09 07:19:07"
"3005","20152323072348-119","2","2015-07-08 14:25:40",1436390740,"C2",165164,1436555904,"2015-07-10 12:18:24"
"1278","20151106041146-807","1","2015-07-08 14:55:08",1436392508,"C0",84101,1436476609,"2015-07-09 14:16:49"
"6399","20150929060957-709","1","2015-07-08 15:09:01",1436393341,"C0",101243,1436494584,"2015-07-09 19:16:24"
"1413","20152828112812-119","1","2015-07-08 15:12:02",1436393522,"C3",87743,1436481265,"2015-07-09 15:34:25"
"1409","20151503011524-795","2","2015-07-08 15:25:09",1436394309,"C5",146595,1436540904,"2015-07-10 08:08:24"
"5890","20154520014506-55","1","2015-07-08 15:43:10",1436395390,"C0",781142,1437176532,"2015-07-17 16:42:12"
"2607","20153320043334-346","1","2015-07-08 15:46:08",1436395568,"C8",776177,1437171745,"2015-07-17 15:22:25"
"5236","20150027100030-310","1","2015-07-08 15:48:00",1436395680,"C8",194250,1436589930,"2015-07-10 21:45:30"
"733","20152116022122-905","1","2015-07-08 15:58:06",1436396286,"C0",272372,1436668658,"2015-07-11 19:37:38"
"5788","20151821121849-891","3","2015-07-08 16:11:13",1436397073,"C4",185343,1436582416,"2015-07-10 19:40:16"
"3365","20155603015621-472","2","2015-07-08 16:24:15",1436397855,"C0",62982,1436460837,"2015-07-09 09:53:57"
"113","20150620070638-960","1","2015-07-08 17:18:44",1436401124,"C3",795963,1437197087,"2015-07-17 22:24:47"
"5693","20150523030511-17","2","2015-07-08 17:28:49",1436401729,"C3",186374,1436588103,"2015-07-10 21:15:03"
"5032","20153307063313-327","1","2015-07-08 18:56:19",1436406979,"C5",388998,1436795977,"2015-07-13 06:59:37"
"219","20155204105251-380","3","2015-07-08 20:48:09",1436413689,"C4",381318,1436795007,"2015-07-13 06:43:27"
"1937","20152728082727-282","1","2015-07-08 20:48:25",1436413705,"C4",454229,1436867934,"2015-07-14 02:58:54"
"3857","20151727091758-4","3","2015-07-08 20:58:38",1436414318,"C8",198488,1436612806,"2015-07-11 04:06:46"
"3202","20152004072035-991","2","2015-07-08 21:28:07",1436416087,"C8",198226,1436614313,"2015-07-11 04:31:53"
"2569","20151104091151-104","3","2015-07-08 21:47:03",1436417223,"C8",195456,1436612679,"2015-07-11 04:04:39"
"5992","20155802055814-251","2","2015-07-08 21:48:31",1436417311,"C7",76031,1436493342,"2015-07-09 18:55:42"
"5309","20154404094430-924","3","2015-07-08 21:56:30",1436417790,"C5",129840,1436547630,"2015-07-10 10:00:30"
"2611","20150001010009-284","3","2015-07-08 22:38:21",1436420301,"C6",106582,1436526883,"2015-07-10 04:14:43"
"1285","20151924091906-140","3","2015-07-08 22:59:30",1436421570,"C7",179832,1436601402,"2015-07-11 00:56:42"
"3236","20153305123353-662","1","2015-07-08 23:57:23",1436425043,"C5",100070,1436525113,"2015-07-10 03:45:13"
"6135","20150503020544-302","1","2015-07-09 00:13:26",1436426006,"C5",234231,1436660237,"2015-07-11 17:17:17"
"4260","20151002101014-792","3","2015-07-09 00:35:32",1436427332,"C0",190106,1436617438,"2015-07-11 05:23:58"
"755","20153805023838-887","1","2015-07-09 01:11:23",1436429483,"C5",99055,1436528538,"2015-07-10 04:42:18"
"1343","20152504112551-431","2","2015-07-09 01:33:17",1436430797,"C2",198223,1436629020,"2015-07-11 08:37:00"
"1857","20153130083112-439","2","2015-07-09 02:38:16",1436434696,"C0",378212,1436812908,"2015-07-13 11:41:48"
"1341","20153004023033-371","2","2015-07-09 02:54:49",1436435689,"C7",195128,1436630817,"2015-07-11 09:06:57"
"3588","20151619091658-670","1","2015-07-09 02:55:30",1436435730,"C2",213139,1436648869,"2015-07-11 14:07:49"
"2012","20154602034646-21","1","2015-07-09 03:38:07",1436438287,"C2",187027,1436625314,"2015-07-11 07:35:14"
"6063","20155021125027-18","1","2015-07-09 03:46:27",1436438787,"C0",507520,1436946307,"2015-07-15 00:45:07"
"6200","20150320020348-641","2","2015-07-09 03:52:22",1436439142,"C5",802457,1437241599,"2015-07-18 10:46:39"
"1572","20150730070718-674","2","2015-07-09 04:32:22",1436441542,"C3",96038,1436537580,"2015-07-10 07:13:00"
"510","20151604081612-669","1","2015-07-09 05:49:04",1436446144,"C2",211586,1436657730,"2015-07-11 16:35:30"
"3168","20151419121435-102","3","2015-07-09 06:03:20",1436447000,"C8",243675,1436690675,"2015-07-12 01:44:35"
"4429","20155307045325-414","2","2015-07-09 06:48:27",1436449707,"C4",136502,1436586209,"2015-07-10 20:43:29"
"288","20150028030041-325","1","2015-07-09 06:51:45",1436449905,"C6",449933,1436899838,"2015-07-14 11:50:38"
"1163","20152027112040-21","2","2015-07-09 06:51:50",1436449910,"C8",204134,1436654044,"2015-07-11 15:34:04"
"2003","20150330060312-987","1","2015-07-09 07:13:14",1436451194,"C4",111686,1436562880,"2015-07-10 14:14:40"
"4350","20150826020807-226","1","2015-07-09 07:28:17",1436452097,"C8",157030,1436609127,"2015-07-11 03:05:27"
"3491","20150205010257-226","1","2015-07-09 08:00:31",1436454031,"C5",163727,1436617758,"2015-07-11 05:29:18"
"5173","20150205080250-857","2","2015-07-09 08:01:26",1436454086,"C8",172758,1436626844,"2015-07-11 08:00:44"
"4375","20154801124855-611","3","2015-07-09 08:08:09",1436454489,"C5",337177,1436791666,"2015-07-13 05:47:46"
"90","20153705093703-55","2","2015-07-09 09:01:59",1436457719,"C2",366937,1436824656,"2015-07-13 14:57:36"
"3726","20152403102434-408","3","2015-07-09 09:04:34",1436457874,"C8",102720,1436560594,"2015-07-10 13:36:34"
"2017","20153505073536-429","1","2015-07-09 09:05:22",1436457922,"C6",350986,1436808908,"2015-07-13 10:35:08"
"5335","20153122113135-902","1","2015-07-09 09:14:47",1436458487,"C7",162288,1436620775,"2015-07-11 06:19:35"
"3028","20152707122720-612","3","2015-07-09 10:00:38",1436461238,"C8",81999,1436543237,"2015-07-10 08:47:17"
"2730","20150705050702-651","1","2015-07-09 10:04:16",1436461456,"C4",160117,1436621573,"2015-07-11 06:32:53"
"4998","20150408040443-205","2","2015-07-09 10:13:13",1436461993,"C2",65310,1436527303,"2015-07-10 04:21:43"
"3777","20152707102716-827","3","2015-07-09 10:33:38",1436463218,"C5",86591,1436549809,"2015-07-10 10:36:49"
"6258","20151929051927-102","1","2015-07-09 11:31:49",1436466709,"C8",421571,1436888280,"2015-07-14 08:38:00"
"3169","20150404120407-76","3","2015-07-09 12:22:24",1436469744,"C4",61871,1436531615,"2015-07-10 05:33:35"
"5963","20154507074558-617","1","2015-07-09 12:51:24",1436471484,"C5",95563,1436567047,"2015-07-10 15:24:07"
"1608","20155204015210-595","2","2015-07-09 13:18:43",1436473123,"C5",143331,1436616454,"2015-07-11 05:07:34"
"891","20151705081717-385","1","2015-07-09 13:48:45",1436474925,"C2",182744,1436657669,"2015-07-11 16:34:29"
"83","20151207091211-916","2","2015-07-09 14:02:49",1436475769,"C5",95119,1436570888,"2015-07-10 16:28:08"
"3277","20153513123506-982","1","2015-07-09 14:31:38",1436477498,"C4",281674,1436759172,"2015-07-12 20:46:12"
"1196","20152403092454-380","2","2015-07-09 14:57:24",1436479044,"C5",269175,1436748219,"2015-07-12 17:43:39"
"5004","20154520034536-573","2","2015-07-09 15:40:47",1436481647,"C5",234473,1436716120,"2015-07-12 08:48:40"
"1421","20153204073231-660","3","2015-07-09 15:51:46",1436482306,"C8",92391,1436574697,"2015-07-10 17:31:37"
"602","20154905014906-97","1","2015-07-09 16:17:28",1436483848,"C5",177251,1436661099,"2015-07-11 17:31:39"
"5600","20150828120844-852","1","2015-07-09 16:57:24",1436486244,"C4",120965,1436607209,"2015-07-11 02:33:29"
"2232","20153601123633-561","1","2015-07-09 17:03:09",1436486589,"C2",235732,1436722321,"2015-07-12 10:32:01"
"5683","20150307100357-262","2","2015-07-09 17:42:13",1436488933,"C5",100148,1436589081,"2015-07-10 21:31:21"
"601","20151103051148-977","3","2015-07-09 18:24:24",1436491464,"C5",261378,1436752842,"2015-07-12 19:00:42"
"470","20155808075842-527","3","2015-07-09 18:31:32",1436491892,"C2",124370,1436616262,"2015-07-11 05:04:22"
"5463","20152518112549-926","2","2015-07-09 18:45:37",1436492737,"C2",613596,1437106333,"2015-07-16 21:12:13"
"5706","20153906043929-561","1","2015-07-09 19:46:35",1436496395,"C8",408918,1436905313,"2015-07-14 13:21:53"
"4886","20151704041709-562","1","2015-07-09 20:24:53",1436498693,"C5",55858,1436554551,"2015-07-10 11:55:51"
"2640","20153905073902-613","3","2015-07-09 21:00:50",1436500850,"C8",196854,1436697704,"2015-07-12 03:41:44"
"1525","20152303032328-493","1","2015-07-09 21:09:10",1436501350,"C2",179714,1436681064,"2015-07-11 23:04:24"
"312","20154821034852-404","1","2015-07-09 22:12:28",1436505148,"C0",789108,1437294256,"2015-07-19 01:24:16"
"4595","20153903043925-167","2","2015-07-09 22:22:29",1436505749,"C2",269492,1436775241,"2015-07-13 01:14:01"
"1983","20153707073745-657","1","2015-07-09 22:49:34",1436507374,"C2",227509,1436734883,"2015-07-12 14:01:23"
"1858","20155930095901-918","1","2015-07-09 22:50:53",1436507453,"C2",437789,1436945242,"2015-07-15 00:27:22"
"1942","20154805014852-697","2","2015-07-09 23:44:07",1436510647,"C8",76263,1436586910,"2015-07-10 20:55:10"
"6203","20155405045446-551","1","2015-07-09 23:54:58",1436511298,"C6",61802,1436573100,"2015-07-10 17:05:00"
"2788","20155503095520-726","3","2015-07-10 00:25:12",1436513112,"C8",285296,1436798408,"2015-07-13 07:40:08"
"1920","20153101023158-837","1","2015-07-10 00:27:06",1436513226,"C3",103844,1436617070,"2015-07-11 05:17:50"
"5778","20155721085718-188","2","2015-07-10 00:41:30",1436514090,"C8",805926,1437320016,"2015-07-19 08:33:36"
"732","20151804041847-14","2","2015-07-10 01:21:05",1436516465,"C8",232269,1436748734,"2015-07-12 17:52:14"
"6317","20154501124525-792","2","2015-07-10 01:39:24",1436517564,"C3",105377,1436622941,"2015-07-11 06:55:41"
"4831","20153115103103-717","1","2015-07-10 02:17:23",1436519843,"C8",426076,1436945919,"2015-07-15 00:38:39"
"6265","20153019073056-11","1","2015-07-10 02:53:52",1436522032,"C5",224722,1436746754,"2015-07-12 17:19:14"
"2560","20151208091253-564","3","2015-07-10 02:57:07",1436522227,"C2",75127,1436597354,"2015-07-10 23:49:14"
"4372","20151920091934-950","1","2015-07-10 03:02:29",1436522549,"C2",243625,1436766174,"2015-07-12 22:42:54"
"1095","20154324084313-457","2","2015-07-10 03:27:40",1436524060,"C5",194781,1436718841,"2015-07-12 09:34:01"
"4743","20153226093201-782","3","2015-07-10 03:28:50",1436524130,"C5",169687,1436693817,"2015-07-12 02:36:57"
"5369","20154704074710-516","2","2015-07-10 03:38:40",1436524720,"C8",619098,1437143818,"2015-07-17 07:36:58"
"3381","20152105062125-369","2","2015-07-10 03:44:51",1436525091,"C5",211303,1436736394,"2015-07-12 14:26:34"
"5897","20154806014828-598","1","2015-07-10 04:34:34",1436528074,"C3",156183,1436684257,"2015-07-11 23:57:37"
"987","20150603090639-155","3","2015-07-10 04:45:05",1436528705,"C0",294553,1436823258,"2015-07-13 14:34:18"
"6472","20151315031359-879","2","2015-07-10 06:05:11",1436533511,"C0",265884,1436799395,"2015-07-13 07:56:35"
"1935","20155915035951-998","2","2015-07-10 06:19:33",1436534373,"C5",708394,1437242767,"2015-07-18 11:06:07"
"3962","20154402124413-668","3","2015-07-10 06:22:02",1436534522,"C8",95467,1436629989,"2015-07-11 08:53:09"
"6537","20151001011026-433","1","2015-07-10 06:48:44",1436536124,"C5",107814,1436643938,"2015-07-11 12:45:38"
"2363","20154521024518-105","2","2015-07-10 06:56:48",1436536608,"C4",537830,1437074438,"2015-07-16 12:20:38"
"3532","20154926014915-775","2","2015-07-10 07:12:19",1436537539,"C0",592892,1437130431,"2015-07-17 03:53:51"
"5757","20153505113500-23","2","2015-07-10 08:23:20",1436541800,"C5",210250,1436752050,"2015-07-12 18:47:30"
"6055","20150505110546-631","1","2015-07-10 08:42:44",1436542964,"C2",430774,1436973738,"2015-07-15 08:22:18"
"5438","20155402055423-909","1","2015-07-10 08:59:01",1436543941,"C8",94154,1436638095,"2015-07-11 11:08:15"
"69","20151405011458-832","2","2015-07-10 10:05:14",1436547914,"C5",60088,1436608002,"2015-07-11 02:46:42"
"5500","20155019065024-371","2","2015-07-10 11:11:29",1436551889,"C8",366013,1436917902,"2015-07-14 16:51:42"
"3945","20155809095821-297","1","2015-07-10 11:41:18",1436553678,"C3",92577,1436646255,"2015-07-11 13:24:15"
"1103","20155820025849-226","2","2015-07-10 11:49:55",1436554195,"C4",572222,1437126417,"2015-07-17 02:46:57"
"445","20154825064848-825","2","2015-07-10 12:02:04",1436554924,"C7",187828,1436742752,"2015-07-12 16:12:32"
"1717","20155318095346-528","1","2015-07-10 12:28:22",1436556502,"C4",955038,1437511540,"2015-07-21 13:45:40"
"4570","20153104043140-683","2","2015-07-10 12:47:18",1436557638,"C5",252469,1436810107,"2015-07-13 10:55:07"
"104","20154708074757-401","1","2015-07-10 13:02:51",1436558571,"C4",191694,1436750265,"2015-07-12 18:17:45"
"3736","20153008033000-100","1","2015-07-10 13:55:22",1436561722,"C5",1379561,1437941283,"2015-07-26 13:08:03"
"5177","20152605042639-261","2","2015-07-10 13:58:13",1436561893,"C8",60442,1436622335,"2015-07-11 06:45:35"
"2491","20150402120425-392","3","2015-07-10 14:05:53",1436562353,"C2",99784,1436662137,"2015-07-11 17:48:57"
"61","20154404114459-43","1","2015-07-10 14:26:39",1436563599,"C8",264050,1436827649,"2015-07-13 15:47:29"
"771","20151515021534-406","1","2015-07-10 14:36:46",1436564206,"C2",270159,1436834365,"2015-07-13 17:39:25"
"3255","20152424062452-330","2","2015-07-10 15:58:37",1436569117,"C5",472275,1437041392,"2015-07-16 03:09:52"
"4190","20154520074540-882","3","2015-07-10 16:50:44",1436572244,"C8",880352,1437452596,"2015-07-20 21:23:16"
"1836","20151306101326-304","3","2015-07-10 17:01:58",1436572918,"C5",185056,1436757974,"2015-07-12 20:26:14"
"3098","20155001105054-534","1","2015-07-10 17:30:06",1436574606,"C4",100194,1436674800,"2015-07-11 21:20:00"
"2490","20152608112631-387","3","2015-07-10 17:41:37",1436575297,"C0",195306,1436770603,"2015-07-12 23:56:43"
"3347","20153025083001-968","3","2015-07-10 18:13:31",1436577211,"C6",221835,1436799046,"2015-07-13 07:50:46"
"4914","20154521094550-685","1","2015-07-10 18:15:50",1436577350,"C4",557400,1437134750,"2015-07-17 05:05:50"
"1748","20154112014114-381","False","2015-07-10 18:17:04",1436577424,"C6",204463,1436781887,"2015-07-13 03:04:47"
"6076","20150801100813-808","1","2015-07-10 18:24:12",1436577852,"C5",115337,1436693189,"2015-07-12 02:26:29"
"6536","20155614105606-280","2","2015-07-10 19:37:41",1436582261,"C5",325385,1436907646,"2015-07-14 14:00:46"
"4649","20155405015448-33","2","2015-07-10 19:45:53",1436582753,"C4",453065,1437035818,"2015-07-16 01:36:58"
"1394","20155503025536-107","3","2015-07-10 19:49:38",1436582978,"C4",622442,1437205420,"2015-07-18 00:43:40"
"2266","20154404064457-308","1","2015-07-10 20:47:29",1436586449,"C2",284476,1436870925,"2015-07-14 03:48:45"
"6257","20153104103154-685","1","2015-07-10 21:44:56",1436589896,"C2",79826,1436669722,"2015-07-11 19:55:22"
"461","20154405034454-883","3","2015-07-10 22:04:24",1436591064,"C2",151590,1436742654,"2015-07-12 16:10:54"
"1168","20153225063205-641","3","2015-07-10 22:07:57",1436591277,"C5",169019,1436760296,"2015-07-12 21:04:56"
"2310","20155604055630-978","1","2015-07-10 22:40:51",1436593251,"C5",178487,1436771738,"2015-07-13 00:15:38"
"3702","20154804094840-923","1","2015-07-10 22:45:52",1436593552,"C2",282516,1436876068,"2015-07-14 05:14:28"
"2238","20153316123340-662","1","2015-07-11 00:43:00",1436600580,"C5",264670,1436865250,"2015-07-14 02:14:10"
"1125","20150509110512-403","2","2015-07-11 01:05:54",1436601954,"C6",454807,1437056761,"2015-07-16 07:26:01"
"4078","20154107044154-514","1","2015-07-11 01:33:18",1436603598,"C4",145542,1436749140,"2015-07-12 17:59:00"
"644","20150202120211-959","3","2015-07-11 02:21:17",1436606477,"C7",371373,1436977850,"2015-07-15 09:30:50"
"995","20153406083403-509","2","2015-07-11 02:39:13",1436607553,"C0",205355,1436812908,"2015-07-13 11:41:48"
"2395","20150108080154-471","1","2015-07-11 02:51:10",1436608270,"C7",120278,1436728548,"2015-07-12 12:15:48"
"5078","20151309041310-608","1","2015-07-11 03:00:46",1436608846,"C5",62628,1436671474,"2015-07-11 20:24:34"
"4754","20154605084600-982","3","2015-07-11 03:01:32",1436608892,"C5",248866,1436857758,"2015-07-14 00:09:18"
"31","20152005102037-864","2","2015-07-11 03:11:01",1436609461,"C5",246312,1436855773,"2015-07-13 23:36:13"
"5467","20152603072604-152","1","2015-07-11 03:13:22",1436609602,"C6",112673,1436722275,"2015-07-12 10:31:15"
"4378","20154304044326-805","2","2015-07-11 04:11:23",1436613083,"C2",186559,1436799642,"2015-07-13 08:00:42"
"2950","20153604113656-45","1","2015-07-11 04:35:46",1436614546,"C5",289765,1436904311,"2015-07-14 13:05:11"
"5639","20153908113930-121","1","2015-07-11 04:53:48",1436615628,"C5",117429,1436733057,"2015-07-12 13:30:57"
"5418","20150523060517-30","1","2015-07-11 05:09:17",1436616557,"C5",103456,1436720013,"2015-07-12 09:53:33"
"4976","20154803104834-431","2","2015-07-11 05:59:04",1436619544,"C7",74870,1436694414,"2015-07-12 02:46:54"
"901","20151808051847-914","1","2015-07-11 06:40:22",1436622022,"C2",220895,1436842917,"2015-07-13 20:01:57"
"5957","20153204053251-894","2","2015-07-11 07:09:48",1436623788,"C0",189139,1436812927,"2015-07-13 11:42:07"
"4878","20154408064412-833","3","2015-07-11 07:44:45",1436625885,"C3",87611,1436713496,"2015-07-12 08:04:56"
"2274","20152826092848-943","1","2015-07-11 07:49:06",1436626146,"C6",215003,1436841149,"2015-07-13 19:32:29"
"1480","20155702065700-462","1","2015-07-11 08:03:09",1436626989,"C7",86841,1436713830,"2015-07-12 08:10:30"
"1307","20153705123714-935","3","2015-07-11 09:22:20",1436631740,"C4",506706,1437138446,"2015-07-17 06:07:26"
"6407","20155605055620-608","3","2015-07-11 09:51:24",1436633484,"C7",244652,1436878136,"2015-07-14 05:48:56"
"5759","20153830123835-677","1","2015-07-11 10:22:27",1436635347,"C0",117779,1436753126,"2015-07-12 19:05:26"
"143","20155817085846-463","1","2015-07-11 10:23:10",1436635390,"C5",692888,1437328278,"2015-07-19 10:51:18"
"1991","20151004061009-733","2","2015-07-11 11:01:51",1436637711,"C0",622302,1437260013,"2015-07-18 15:53:33"
"11","20153705023701-460","1","2015-07-11 11:31:23",1436639483,"C4",72466,1436711949,"2015-07-12 07:39:09"
"4546","20155901015947-373","2","2015-07-11 11:53:23",1436640803,"C0",285472,1436926275,"2015-07-14 19:11:15"
"2280","20154306044342-841","2","2015-07-11 12:21:50",1436642510,"C5",52036,1436694546,"2015-07-12 02:49:06"
"3872","20151807041826-31","1","2015-07-11 13:35:44",1436646944,"C4",167919,1436814863,"2015-07-13 12:14:23"
"4129","20154510104522-927","1","2015-07-11 13:48:06",1436647686,"C2",97364,1436745050,"2015-07-12 16:50:50"
"5323","20150905040910-240","3","2015-07-11 14:11:40",1436649100,"C5",255675,1436904775,"2015-07-14 13:12:55"
"724","20154922024915-450","3","2015-07-11 14:17:15",1436649435,"C4",234240,1436883675,"2015-07-14 07:21:15"
"5264","20155509105541-792","1","2015-07-11 14:32:57",1436650377,"C7",92918,1436743295,"2015-07-12 16:21:35"
"4701","20151008091003-541","1","2015-07-11 15:00:17",1436652017,"C2",280214,1436932231,"2015-07-14 20:50:31"
"5448","20154801044816-267","2","2015-07-11 16:07:32",1436656052,"C5",430778,1437086830,"2015-07-16 15:47:10"
"3203","20150707090744-193","2","2015-07-11 16:52:02",1436658722,"C4",124486,1436783208,"2015-07-13 03:26:48"
"3220","20150307030320-55","3","2015-07-11 17:12:02",1436659922,"C8",176661,1436836583,"2015-07-13 18:16:23"
"2583","20152902012912-255","3","2015-07-11 17:13:21",1436660001,"C0",263683,1436923684,"2015-07-14 18:28:04"
"5814","20153606063624-577","3","2015-07-11 17:41:54",1436661714,"C8",94386,1436756100,"2015-07-12 19:55:00"
"3415","20151905041959-420","2","2015-07-11 18:01:03",1436662863,"C5",65558,1436728421,"2015-07-12 12:13:41"
"729","20151203121253-478","3","2015-07-11 18:01:33",1436662893,"C2",89015,1436751908,"2015-07-12 18:45:08"
"5048","20151319101312-156","3","2015-07-11 19:09:46",1436666986,"C8",276142,1436943128,"2015-07-14 23:52:08"
"3520","20152509112544-291","1","2015-07-11 20:06:10",1436670370,"C7",102013,1436772383,"2015-07-13 00:26:23"
"1034","20155905045912-583","1","2015-07-11 20:56:54",1436673414,"C6",88777,1436762191,"2015-07-12 21:36:31"
"5717","20150823040809-813","2","2015-07-11 21:48:35",1436676515,"C8",787813,1437464328,"2015-07-21 00:38:48"
"6241","20150201020251-919","2","2015-07-11 22:33:53",1436679233,"C2",447331,1437126564,"2015-07-17 02:49:24"
"6163","20150209060238-306","3","2015-07-11 22:52:48",1436680368,"C2",116705,1436797073,"2015-07-13 07:17:53"
"1354","20154201074239-779","2","2015-07-11 23:29:59",1436682599,"C5",115105,1436797704,"2015-07-13 07:28:24"
"2919","20151827081812-463","1","2015-07-11 23:39:59",1436683199,"C4",180701,1436863900,"2015-07-14 01:51:40"
"2860","20155103015112-816","2","2015-07-12 00:15:32",1436685332,"C8",145732,1436831064,"2015-07-13 16:44:24"
"5627","20150003090030-424","3","2015-07-12 00:18:10",1436685490,"C4",373130,1437058620,"2015-07-16 07:57:00"
"3571","20155309115300-960","1","2015-07-12 00:50:15",1436687415,"C0",73145,1436760560,"2015-07-12 21:09:20"
"6395","20154002074029-503","1","2015-07-12 01:01:41",1436688101,"C5",105009,1436793110,"2015-07-13 06:11:50"
"1648","20150305030327-986","1","2015-07-12 01:19:24",1436689164,"C3",1049119,1437738283,"2015-07-24 04:44:43"
"5849","20152308062330-627","3","2015-07-12 01:19:57",1436689197,"C3",109129,1436798326,"2015-07-13 07:38:46"
"6345","20152420122429-39","2","2015-07-12 01:56:45",1436691405,"C6",232892,1436924297,"2015-07-14 18:38:17"
"3333","20153029033050-443","3","2015-07-12 01:58:21",1436691501,"C3",153493,1436844994,"2015-07-13 20:36:34"
"4310","20151008051030-28","1","2015-07-12 02:24:02",1436693042,"C7",146206,1436839248,"2015-07-13 19:00:48"
"3713","20155409015439-148","1","2015-07-12 02:26:53",1436693213,"C3",108967,1436802180,"2015-07-13 08:43:00"
"108","20151104121158-643","2","2015-07-12 02:52:54",1436694774,"C2",406207,1437100981,"2015-07-16 19:43:01"
"6546","20154829104840-718","1","2015-07-12 03:21:18",1436696478,"C8",548179,1437244657,"2015-07-18 11:37:37"
"512","20150103040138-632","1","2015-07-12 04:07:48",1436699268,"C8",146954,1436846222,"2015-07-13 20:57:02"
"3504","20150606110611-539","1","2015-07-12 04:58:05",1436702285,"C7",248157,1436950442,"2015-07-15 01:54:02"
"3785","20153605113620-487","1","2015-07-12 06:15:44",1436706944,"C2",195188,1436902132,"2015-07-14 12:28:52"
"5321","20150405040445-909","2","2015-07-12 06:32:37",1436707957,"C5",71309,1436779266,"2015-07-13 02:21:06"
"2694","20150730080701-11","2","2015-07-12 06:37:33",1436708253,"C5",515716,1437223969,"2015-07-18 05:52:49"
"3773","20152004062054-876","1","2015-07-12 07:39:29",1436711969,"C4",695915,1437407884,"2015-07-20 08:58:04"
"4672","20152009082025-752","1","2015-07-12 09:47:33",1436719653,"C8",132214,1436851867,"2015-07-13 22:31:07"
"547","20153708023749-220","1","2015-07-12 09:54:21",1436720061,"C7",164296,1436884357,"2015-07-14 07:32:37"
"3386","20155407095445-308","1","2015-07-12 09:54:39",1436720079,"C7",215997,1436936076,"2015-07-14 21:54:36"
"166","20151329011319-87","1","2015-07-12 09:54:51",1436720091,"C5",158756,1436878847,"2015-07-14 06:00:47"
"3771","20152206032259-605","2","2015-07-12 10:12:17",1436721137,"C0",249879,1436971016,"2015-07-15 07:36:56"
"1430","20152804012816-125","2","2015-07-12 10:15:02",1436721302,"C8",339803,1437061105,"2015-07-16 08:38:25"
"3200","20151511071529-602","2","2015-07-12 10:26:46",1436722006,"C6",97877,1436819883,"2015-07-13 13:38:03"
"5297","20155517095518-749","1","2015-07-12 12:28:46",1436729326,"C3",271151,1437000477,"2015-07-15 15:47:57"
"4069","20155803085804-911","3","2015-07-12 12:34:59",1436729699,"C3",112945,1436842644,"2015-07-13 19:57:24"
"4150","20154530114544-776","1","2015-07-12 14:24:29",1436736269,"C4",149475,1436885744,"2015-07-14 07:55:44"
"5296","20154827114820-401","1","2015-07-12 14:50:28",1436737828,"C8",186704,1436924532,"2015-07-14 18:42:12"
"1079","20152030062014-252","2","2015-07-12 14:58:00",1436738280,"C4",533933,1437272213,"2015-07-18 19:16:53"
"2273","20155205015233-851","3","2015-07-12 15:08:05",1436738885,"C2",609332,1437348217,"2015-07-19 16:23:37"
"2339","20151808021841-200","2","2015-07-12 15:12:25",1436739145,"C8",174412,1436913557,"2015-07-14 15:39:17"
"4924","20153403063427-228","3","2015-07-12 15:32:15",1436740335,"C4",269956,1437010291,"2015-07-15 18:31:31"
"2813","20153707023747-858","1","2015-07-12 15:51:44",1436741504,"C4",145479,1436886983,"2015-07-14 08:16:23"
"4777","20150515020535-533","1","2015-07-12 15:58:02",1436741882,"C2",334221,1437076103,"2015-07-16 12:48:23"
"672","20151111041119-158","1","2015-07-12 16:09:09",1436742549,"C0",86270,1436828819,"2015-07-13 16:06:59"
"558","20150911050916-197","1","2015-07-12 16:25:39",1436743539,"C2",83783,1436827322,"2015-07-13 15:42:02"
"5989","20153504013535-186","1","2015-07-12 17:15:59",1436746559,"C6",88053,1436834612,"2015-07-13 17:43:32"
"4206","20153208083240-926","3","2015-07-12 17:57:44",1436749064,"C7",1485752,1438234816,"2015-07-29 22:40:16"
"3064","20153206103213-613","1","2015-07-12 18:49:09",1436752149,"C4",68527,1436820676,"2015-07-13 13:51:16"
"3573","20153910063929-445","1","2015-07-12 19:27:55",1436754475,"C6",218906,1436973381,"2015-07-15 08:16:21"
"1623","20151410081443-694","3","2015-07-12 19:43:01",1436755381,"C5",107049,1436862430,"2015-07-14 01:27:10"
"5924","20155904075953-519","2","2015-07-12 19:47:37",1436755657,"C8",366832,1437122489,"2015-07-17 01:41:29"
"3657","20151326111319-353","1","2015-07-12 21:10:55",1436760655,"C8",202608,1436963263,"2015-07-15 05:27:43"
"1150","20154030104055-168","3","2015-07-12 21:33:01",1436761981,"C2",537963,1437299944,"2015-07-19 02:59:04"
"6531","20150010040037-125","1","2015-07-12 21:37:31",1436762251,"C5",96507,1436858758,"2015-07-14 00:25:58"
"1282","20153005113023-61","2","2015-07-12 22:24:55",1436765095,"C4",80509,1436845604,"2015-07-13 20:46:44"
"4185","20153110063138-887","2","2015-07-12 22:55:00",1436766900,"C4",115901,1436882801,"2015-07-14 07:06:41"
"2778","20155502115525-896","3","2015-07-12 23:06:13",1436767573,"C3",113031,1436880604,"2015-07-14 06:30:04"
"3825","20155304095308-767","1","2015-07-12 23:46:14",1436769974,"C0",370593,1437140567,"2015-07-17 06:42:47"
"542","20153313043332-986","1","2015-07-12 23:49:14",1436770154,"C0",843914,1437614068,"2015-07-22 18:14:28"
"4989","20155708025745-242","1","2015-07-12 23:53:54",1436770434,"C5",53967,1436824401,"2015-07-13 14:53:21"
"2159","20154504014517-802","2","2015-07-13 00:18:53",1436771933,"C6",91152,1436863085,"2015-07-14 01:38:05"
"4841","20154423124442-224","2","2015-07-13 00:32:04",1436772724,"C7",623206,1437395930,"2015-07-20 05:38:50"
"1771","20155511045543-118","2","2015-07-13 00:54:53",1436774093,"C7",57575,1436831668,"2015-07-13 16:54:28"
"5143","20153805053836-382","1","2015-07-13 00:56:36",1436774196,"C4",315540,1437089736,"2015-07-16 16:35:36"
"4411","20151525101516-848","2","2015-07-13 01:47:56",1436777276,"C4",190595,1436967871,"2015-07-15 06:44:31"
"3799","20155602045653-926","1","2015-07-13 01:57:17",1436777837,"C5",436053,1437213890,"2015-07-18 03:04:50"
"5664","20152711112746-346","2","2015-07-13 02:10:30",1436778630,"C7",69682,1436848312,"2015-07-13 21:31:52"
"4592","20154608064621-71","1","2015-07-13 02:11:03",1436778663,"C5",207741,1436986404,"2015-07-15 11:53:24"
"4572","20152927032921-834","1","2015-07-13 02:14:39",1436778879,"C2",190674,1436969553,"2015-07-15 07:12:33"
"5562","20150418070414-573","2","2015-07-13 02:14:58",1436778898,"C7",306092,1437084990,"2015-07-16 15:16:30"
"3755","20154925044945-414","1","2015-07-13 02:26:12",1436779572,"C7",167043,1436946615,"2015-07-15 00:50:15"
"5813","20155918055936-835","1","2015-07-13 02:47:20",1436780840,"C5",300752,1437081592,"2015-07-16 14:19:52"
"286","20153504103503-465","1","2015-07-13 02:51:55",1436781115,"C5",374906,1437156021,"2015-07-17 11:00:21"
"6043","20152711092730-427","3","2015-07-13 03:03:36",1436781816,"C8",74883,1436856699,"2015-07-13 23:51:39"
"4796","20150502120548-840","2","2015-07-13 04:31:12",1436787072,"C4",461562,1437248634,"2015-07-18 12:43:54"
"4257","20152004102015-754","1","2015-07-13 05:00:19",1436788819,"C5",379202,1437168021,"2015-07-17 14:20:21"
"3834","20151308011359-158","2","2015-07-13 05:08:57",1436789337,"C8",201449,1436990786,"2015-07-15 13:06:26"
"4352","20152404042428-569","1","2015-07-13 05:12:23",1436789543,"C8",147455,1436936998,"2015-07-14 22:09:58"
"1629","20152712122737-855","1","2015-07-13 06:21:13",1436793673,"C6",442736,1437236409,"2015-07-18 09:20:09"
"360","20155811045827-264","3","2015-07-13 06:24:40",1436793880,"C3",134773,1436928653,"2015-07-14 19:50:53"
"2200","20154603024631-872","3","2015-07-13 06:45:55",1436795155,"C4",278388,1437073543,"2015-07-16 12:05:43"
"2888","20152827092833-950","2","2015-07-13 06:57:58",1436795878,"C4",196195,1436992073,"2015-07-15 13:27:53"
"2118","20150611020620-822","3","2015-07-13 07:08:28",1436796508,"C8",73864,1436870372,"2015-07-14 03:39:32"
"1778","20150209010259-697","1","2015-07-13 07:21:49",1436797309,"C8",65026,1436862335,"2015-07-14 01:25:35"
"4674","20151306121351-539","1","2015-07-13 07:41:31",1436798491,"C4",588460,1437386951,"2015-07-20 03:09:11"
"2170","20152703112748-47","2","2015-07-13 07:57:21",1436799441,"C5",283791,1437083232,"2015-07-16 14:47:12"
"3884","20151504091530-898","2","2015-07-13 08:11:14",1436800274,"C4",96718,1436896992,"2015-07-14 11:03:12"
"2551","20152805062805-519","1","2015-07-13 09:00:55",1436803255,"C2",350185,1437153440,"2015-07-17 10:17:20"
"3548","20151527081514-392","1","2015-07-13 09:24:13",1436804653,"C7",198077,1437002730,"2015-07-15 16:25:30"
"5533","20154904124934-601","1","2015-07-13 09:30:30",1436805030,"C4",95707,1436900737,"2015-07-14 12:05:37"
"4338","20150311090356-344","3","2015-07-13 10:27:04",1436808424,"C8",88894,1436897318,"2015-07-14 11:08:38"
"4915","20154430064432-451","2","2015-07-13 10:54:47",1436810087,"C8",227643,1437037730,"2015-07-16 02:08:50"
"4345","20152506042511-712","2","2015-07-13 11:41:11",1436812871,"C2",397470,1437210341,"2015-07-18 02:05:41"
"683","20150211080249-753","2","2015-07-13 12:06:17",1436814377,"C6",187408,1437001785,"2015-07-15 16:09:45"
"2746","20155510025531-344","2","2015-07-13 12:25:08",1436815508,"C2",250177,1437065685,"2015-07-16 09:54:45"
"5917","20152405052406-500","3","2015-07-13 13:12:16",1436818336,"C5",338045,1437156381,"2015-07-17 11:06:21"
"1724","20153811083856-28","1","2015-07-13 13:13:28",1436818408,"C5",94636,1436913044,"2015-07-14 15:30:44"
"2768","20154311084343-102","3","2015-07-13 13:28:51",1436819331,"C5",94954,1436914285,"2015-07-14 15:51:25"
"979","20155309065327-597","1","2015-07-13 13:40:39",1436820039,"C4",370032,1437190071,"2015-07-17 20:27:51"
"1243","20153304063341-413","3","2015-07-13 14:21:01",1436822461,"C4",100705,1436923166,"2015-07-14 18:19:26"
"2738","20150211030246-951","3","2015-07-13 14:59:42",1436824782,"C8",86308,1436911090,"2015-07-14 14:58:10"
"2260","20150427020450-544","2","2015-07-13 15:48:10",1436827690,"C2",694300,1437521990,"2015-07-21 16:39:50"
"309","20154911124924-532","1","2015-07-13 16:13:27",1436829207,"C3",61681,1436890888,"2015-07-14 09:21:28"
"2428","20150911080900-458","3","2015-07-13 16:33:30",1436830410,"C3",203070,1437033480,"2015-07-16 00:58:00"
"5993","20153001073008-682","3","2015-07-13 16:53:22",1436831602,"C7",535297,1437366899,"2015-07-19 21:34:59"
"546","20155504075511-773","1","2015-07-13 17:34:00",1436834040,"C8",116047,1436950087,"2015-07-15 01:48:07"
"3754","20150301040355-981","1","2015-07-13 17:58:03",1436835483,"C5",521824,1437357307,"2015-07-19 18:55:07"
"6421","20152706122712-540","2","2015-07-13 18:00:24",1436835624,"C3",78099,1436913723,"2015-07-14 15:42:03"
"207","20155311125300-290","1","2015-07-13 18:27:40",1436837260,"C8",96440,1436933700,"2015-07-14 21:15:00"
"217","20151005071024-452","1","2015-07-13 18:43:46",1436838226,"C5",366401,1437204627,"2015-07-18 00:30:27"
"2323","20155812065819-311","1","2015-07-13 19:06:40",1436839600,"C6",130101,1436969701,"2015-07-15 07:15:01"
"1072","20155228015245-135","2","2015-07-13 19:57:00",1436842620,"C3",439285,1437281905,"2015-07-18 21:58:25"
"3661","20151106051115-506","3","2015-07-13 21:28:44",1436848124,"C3",88607,1436936731,"2015-07-14 22:05:31"
"3860","20152810052855-807","1","2015-07-13 21:47:51",1436849271,"C3",274736,1437124007,"2015-07-17 02:06:47"
"3901","20154712124711-992","2","2015-07-13 21:49:15",1436849355,"C6",118924,1436968279,"2015-07-15 06:51:19"
"5543","20150405100402-510","1","2015-07-13 22:06:56",1436850416,"C0",734574,1437584990,"2015-07-22 10:09:50"
"4147","20155812125816-703","3","2015-07-13 22:36:43",1436852203,"C0",121107,1436973310,"2015-07-15 08:15:10"
"5838","20150510050547-65","1","2015-07-13 23:10:51",1436854251,"C8",140552,1436994803,"2015-07-15 14:13:23"
"3690","20153711053702-226","3","2015-07-13 23:26:16",1436855176,"C5",96877,1436952053,"2015-07-15 02:20:53"
"550","20151611051619-74","1","2015-07-13 23:41:11",1436856071,"C4",97946,1436954017,"2015-07-15 02:53:37"
"849","20155107125107-821","1","2015-07-13 23:58:49",1436857129,"C5",186154,1437043283,"2015-07-16 03:41:23"
"599","20155003015007-18","1","2015-07-14 00:59:39",1436860779,"C8",452086,1437312865,"2015-07-19 06:34:25"
"5819","20155810065842-768","2","2015-07-14 01:33:00",1436862780,"C2",108686,1436971466,"2015-07-15 07:44:26"
"5607","20150905010927-978","2","2015-07-14 01:37:25",1436863045,"C5",105154,1436968199,"2015-07-15 06:49:59"
"5440","20153016063038-967","2","2015-07-14 01:59:44",1436864384,"C6",400491,1437264875,"2015-07-18 17:14:35"
"5493","20153807083832-588","3","2015-07-14 02:25:02",1436865902,"C2",194130,1437060032,"2015-07-16 08:20:32"
"6129","20150603060632-383","2","2015-07-14 02:40:00",1436866800,"C5",469004,1437335804,"2015-07-19 12:56:44"
"5320","20151110091107-217","1","2015-07-14 02:55:15",1436867715,"C5",161524,1437029239,"2015-07-15 23:47:19"
"1797","20155811085816-277","2","2015-07-14 03:10:58",1436868658,"C4",119181,1436987839,"2015-07-15 12:17:19"
"3263","20152711082701-441","1","2015-07-14 03:14:53",1436868893,"C8",120236,1436989129,"2015-07-15 12:38:49"
"1208","20155712055713-620","1","2015-07-14 03:39:29",1436870369,"C4",60668,1436931037,"2015-07-14 20:30:37"
"2307","20152401082424-321","1","2015-07-14 04:10:04",1436872204,"C8",221588,1437093792,"2015-07-16 17:43:12"
"2483","20150215110234-930","2","2015-07-14 04:10:13",1436872213,"C7",275651,1437147864,"2015-07-17 08:44:24"
"328","20153606123639-984","3","2015-07-14 04:15:14",1436872514,"C7",94445,1436966959,"2015-07-15 06:29:19"
"235","20155302055357-472","1","2015-07-14 05:57:39",1436878659,"C5",331274,1437209933,"2015-07-18 01:58:53"
"1726","20150904030958-830","1","2015-07-14 06:47:34",1436881654,"C4",104232,1436985886,"2015-07-15 11:44:46"
"4316","20150203060230-10","1","2015-07-14 07:05:06",1436882706,"C7",136308,1437019014,"2015-07-15 20:56:54"
"529","20154710124711-907","3","2015-07-14 07:09:32",1436882972,"C3",416763,1437299735,"2015-07-19 02:55:35"
"3587","20153013053056-41","1","2015-07-14 07:18:30",1436883510,"C0",49654,1436933164,"2015-07-14 21:06:04"
"557","20150810090808-3","2","2015-07-14 07:35:18",1436884518,"C3",340030,1437224548,"2015-07-18 06:02:28"
"5656","20154405094402-820","1","2015-07-14 07:35:42",1436884542,"C2",384950,1437269492,"2015-07-18 18:31:32"
"4290","20153712053742-911","2","2015-07-14 07:57:32",1436885852,"C5",68995,1436954847,"2015-07-15 03:07:27"
"2332","20153701113704-354","1","2015-07-14 08:02:52",1436886172,"C4",555174,1437441346,"2015-07-20 18:15:46"
"4568","20153619073613-656","2","2015-07-14 08:07:07",1436886427,"C0",1080927,1437967354,"2015-07-26 20:22:34"
"2792","20150503040507-176","1","2015-07-14 08:58:10",1436889490,"C0",308261,1437197751,"2015-07-17 22:35:51"
"1886","20151209031242-452","1","2015-07-14 09:09:58",1436890198,"C6",410236,1437300434,"2015-07-19 03:07:14"
"2101","20153312053318-51","2","2015-07-14 09:36:36",1436891796,"C4",144198,1437035994,"2015-07-16 01:39:54"
"865","20150110090142-745","2","2015-07-14 09:51:34",1436892694,"C0",174296,1437066990,"2015-07-16 10:16:30"
"5601","20155209015212-409","3","2015-07-14 09:56:12",1436892972,"C2",417840,1437310812,"2015-07-19 06:00:12"
"677","20154306084336-628","2","2015-07-14 09:57:20",1436893040,"C3",1643812,1438536852,"2015-08-02 10:34:12"
"520","20154007094039-158","1","2015-07-14 10:19:25",1436894365,"C4",457018,1437351383,"2015-07-19 17:16:23"
"374","20155713105709-55","2","2015-07-14 10:45:51",1436895951,"C0",85722,1436981673,"2015-07-15 10:34:33"
"2542","20151506091506-255","2","2015-07-14 11:00:00",1436896800,"C1",548249,1437445049,"2015-07-20 19:17:29"
"499","20153508083547-956","1","2015-07-14 11:39:49",1436899189,"C0",264721,1437163910,"2015-07-17 13:11:50"
"305","20154705114743-724","2","2015-07-14 12:13:07",1436901187,"C4",259708,1437160895,"2015-07-17 12:21:35"
"5510","20153013023047-224","2","2015-07-14 12:17:27",1436901447,"C6",333800,1437235247,"2015-07-18 09:00:47"
"369","20155604125644-698","2","2015-07-14 12:43:40",1436903020,"C5",431608,1437334628,"2015-07-19 12:37:08"
"5625","20154010034018-964","3","2015-07-14 12:43:40",1436903020,"C2",335002,1437238022,"2015-07-18 09:47:02"
"5620","20150808030815-401","1","2015-07-14 13:01:19",1436904079,"C4",63848,1436967927,"2015-07-15 06:45:27"
"988","20152921092953-210","2","2015-07-14 13:10:25",1436904625,"C2",250054,1437154679,"2015-07-17 10:37:59"
"3940","20153410103418-726","2","2015-07-14 13:35:30",1436906130,"C0",178236,1437084366,"2015-07-16 15:06:06"
"1040","20150005020044-437","1","2015-07-14 13:56:27",1436907387,"C4",111049,1437018436,"2015-07-15 20:47:16"
"4559","20153908063905-670","3","2015-07-14 14:22:03",1436908923,"C4",273089,1437182012,"2015-07-17 18:13:32"
"3462","20151321061336-628","2","2015-07-14 14:32:40",1436909560,"C5",1008572,1437918132,"2015-07-26 06:42:12"
"2711","20152508032527-438","1","2015-07-14 14:46:21",1436910381,"C6",86009,1436996390,"2015-07-15 14:39:50"
"5886","20154206094218-555","1","2015-07-14 15:28:37",1436912917,"C2",711979,1437624896,"2015-07-22 21:14:56"
"2544","20153805103821-658","3","2015-07-14 15:41:29",1436913689,"C5",113684,1437027373,"2015-07-15 23:16:13"
"5083","20154912054955-518","1","2015-07-14 15:59:29",1436914769,"C3",83087,1436997856,"2015-07-15 15:04:16"
"4800","20150926090945-943","3","2015-07-14 16:14:33",1436915673,"C5",197586,1437113259,"2015-07-16 23:07:39"
"3432","20154811104853-331","3","2015-07-14 17:57:55",1436921875,"C4",284942,1437206817,"2015-07-18 01:06:57"
"6057","20150807090832-325","3","2015-07-14 18:24:55",1436923495,"C8",91169,1437014664,"2015-07-15 19:44:24"
"3464","20155713045735-33","1","2015-07-14 18:51:17",1436925077,"C2",93222,1437018299,"2015-07-15 20:44:59"
"1804","20155423105427-757","1","2015-07-14 19:18:33",1436926713,"C3",614882,1437541595,"2015-07-21 22:06:35"
"3994","20152729042736-714","2","2015-07-14 19:52:48",1436928768,"C0",436104,1437364872,"2015-07-19 21:01:12"
"731","20152813082850-252","1","2015-07-14 20:21:58",1436930518,"C6",129188,1437059706,"2015-07-16 08:15:06"
"428","20151908071935-977","1","2015-07-14 20:47:13",1436932033,"C8",283429,1437215462,"2015-07-18 03:31:02"
"6053","20154430034436-879","2","2015-07-14 21:43:00",1436935380,"C7",175872,1437111252,"2015-07-16 22:34:12"
"638","20153712013720-181","3","2015-07-14 22:20:11",1436937611,"C6",204171,1437141782,"2015-07-17 07:03:02"
"3461","20150827070855-530","3","2015-07-14 22:25:50",1436937950,"C8",304763,1437242713,"2015-07-18 11:05:13"
"378","20151008091058-366","1","2015-07-14 22:32:46",1436938366,"C6",94418,1437032784,"2015-07-16 00:46:24"
"1872","20151511041558-368","1","2015-07-14 22:56:00",1436939760,"C8",141601,1437081361,"2015-07-16 14:16:01"
"335","20152408122403-570","1","2015-07-14 23:18:46",1436941126,"C5",79669,1437020795,"2015-07-15 21:26:35"
"6434","20150408120450-64","1","2015-07-14 23:20:32",1436941232,"C6",93157,1437034389,"2015-07-16 01:13:09"
"3790","20152104072145-815","1","2015-07-14 23:48:13",1436942893,"C0",131884,1437074777,"2015-07-16 12:26:17"
"6075","20153909013957-769","1","2015-07-15 00:01:21",1436943681,"C8",234642,1437178323,"2015-07-17 17:12:03"
"1142","20153613013647-912","3","2015-07-15 00:05:13",1436943913,"C5",62053,1437005966,"2015-07-15 17:19:26"
"6351","20150704050743-697","1","2015-07-15 00:34:05",1436945645,"C7",445391,1437391036,"2015-07-20 04:17:16"
"2244","20153317013317-798","2","2015-07-15 00:40:36",1436946036,"C4",338977,1437285013,"2015-07-18 22:50:13"
"1815","20153006063005-968","2","2015-07-15 01:29:21",1436948961,"C4",108508,1437057469,"2015-07-16 07:37:49"
"3407","20150220040211-856","1","2015-07-15 02:08:27",1436951307,"C4",263747,1437215054,"2015-07-18 03:24:14"
"2016","20152705092735-661","1","2015-07-15 02:09:54",1436951394,"C4",119677,1437071071,"2015-07-16 11:24:31"
"3011","20150713020758-120","2","2015-07-15 02:33:52",1436952832,"C5",65577,1437018409,"2015-07-15 20:46:49"
"6062","20152404072411-614","1","2015-07-15 02:39:55",1436953195,"C2",116668,1437069863,"2015-07-16 11:04:23"
"1240","20150108100110-534","2","2015-07-15 03:30:54",1436956254,"C8",290692,1437246946,"2015-07-18 12:15:46"
"6172","20151611111649-796","1","2015-07-15 04:00:01",1436958001,"C8",159696,1437117697,"2015-07-17 00:21:37"
"5912","20152313032302-271","2","2015-07-15 04:47:00",1436960820,"C4",67319,1437028139,"2015-07-15 23:28:59"
"4632","20154923014909-680","3","2015-07-15 05:35:51",1436963751,"C5",623734,1437587485,"2015-07-22 10:51:25"
"3440","20150905070939-279","1","2015-07-15 05:39:18",1436963958,"C3",286193,1437250151,"2015-07-18 13:09:11"
"4603","20154519024544-322","False","2015-07-15 06:05:36",1436965536,"C4",201273,1437166809,"2015-07-17 14:00:09"
"4947","20153010083042-172","2","2015-07-15 06:13:16",1436965996,"C4",211877,1437177873,"2015-07-17 17:04:33"
"1019","20152322112332-133","1","2015-07-15 06:25:29",1436966729,"C3",281331,1437248060,"2015-07-18 12:34:20"
"4769","20152929022956-198","1","2015-07-15 06:33:37",1436967217,"C0",193403,1437160620,"2015-07-17 12:17:00"
"3640","20153112063157-147","3","2015-07-15 06:40:03",1436967603,"C5",86562,1437054165,"2015-07-16 06:42:45"
"5692","20153507043529-286","1","2015-07-15 07:01:54",1436968914,"C3",656785,1437625699,"2015-07-22 21:28:19"
"3291","20153514073546-814","3","2015-07-15 07:04:23",1436969063,"C0",84517,1437053580,"2015-07-16 06:33:00"
"610","20152411082436-105","3","2015-07-15 07:06:06",1436969166,"C0",340890,1437310056,"2015-07-19 05:47:36"
"4363","20151305041331-383","1","2015-07-15 07:34:16",1436970856,"C8",684969,1437655825,"2015-07-23 05:50:25"
"1642","20152009022052-994","2","2015-07-15 08:14:57",1436973297,"C8",99289,1437072586,"2015-07-16 11:49:46"
"2774","20152705112730-412","3","2015-07-15 08:16:34",1436973394,"C2",106568,1437079962,"2015-07-16 13:52:42"
"3877","20153218123229-36","2","2015-07-15 08:21:17",1436973677,"C5",772576,1437746253,"2015-07-24 06:57:33"
"4306","20151709081703-888","2","2015-07-15 08:40:09",1436974809,"C8",259893,1437234702,"2015-07-18 08:51:42"
"2396","20155221025244-122","1","2015-07-15 09:22:32",1436977352,"C4",684596,1437661948,"2015-07-23 07:32:28"
"4600","20151909021907-531","2","2015-07-15 09:24:47",1436977487,"C8",100148,1437077635,"2015-07-16 13:13:55"
"5677","20153230053236-758","2","2015-07-15 10:00:52",1436979652,"C5",158612,1437138264,"2015-07-17 06:04:24"
"4","20153111063125-468","2","2015-07-15 10:13:01",1436980381,"C5",179448,1437159829,"2015-07-17 12:03:49"
"4687","20150629060651-645","3","2015-07-15 10:48:51",1436982531,"C5",466440,1437448971,"2015-07-20 20:22:51"
"5172","20152605062636-836","1","2015-07-15 10:57:52",1436983072,"C8",440138,1437423210,"2015-07-20 13:13:30"
"2677","20150524110507-879","2","2015-07-15 11:15:55",1436984155,"C3",605016,1437589171,"2015-07-22 11:19:31"
"3549","20154409044439-912","3","2015-07-15 11:59:47",1436986787,"C5",250654,1437237441,"2015-07-18 09:37:21"
"5804","20152811092825-833","1","2015-07-15 12:05:09",1436987109,"C2",355004,1437342113,"2015-07-19 14:41:53"
"1433","20154613064658-613","1","2015-07-15 12:08:36",1436987316,"C7",96049,1437083365,"2015-07-16 14:49:25"
"1234","20151301111308-417","1","2015-07-15 12:43:12",1436989392,"C2",173572,1437162964,"2015-07-17 12:56:04"
"4870","20154209054227-699","1","2015-07-15 12:44:05",1436989445,"C5",250249,1437239694,"2015-07-18 10:14:54"
"1173","20152511102520-964","3","2015-07-15 13:08:02",1436990882,"C7",177681,1437168563,"2015-07-17 14:29:23"
"4942","20155307085318-512","3","2015-07-15 13:14:06",1436991246,"C0",88356,1437079602,"2015-07-16 13:46:42"
"836","20152613022643-189","1","2015-07-15 13:28:45",1436992125,"C0",84661,1437076786,"2015-07-16 12:59:46"
"16","20152614052608-658","1","2015-07-15 13:29:53",1436992193,"C4",72225,1437064418,"2015-07-16 09:33:38"
"3416","20153502063540-65","1","2015-07-15 13:30:52",1436992252,"C4",382704,1437374956,"2015-07-19 23:49:16"
"2603","20151001041004-853","3","2015-07-15 14:39:42",1436996382,"C8",602089,1437598471,"2015-07-22 13:54:31"
"2821","20151327011349-700","2","2015-07-15 14:53:03",1436997183,"C5",780577,1437777760,"2015-07-24 15:42:40"
"6249","20151911091902-88","3","2015-07-15 15:42:14",1437000134,"C4",122864,1437122998,"2015-07-17 01:49:58"
"4945","20154401034422-998","2","2015-07-15 16:52:19",1437004339,"C5",404559,1437408898,"2015-07-20 09:14:58"
"4586","20151709091702-944","1","2015-07-15 16:59:50",1437004790,"C4",727071,1437731861,"2015-07-24 02:57:41"
"4811","20155922015952-462","1","2015-07-15 17:40:02",1437007202,"C8",400082,1437407284,"2015-07-20 08:48:04"
"1442","20152908092908-702","1","2015-07-15 18:19:51",1437009591,"C5",90949,1437100540,"2015-07-16 19:35:40"
"2403","20155009075029-871","2","2015-07-15 18:47:23",1437011243,"C7",278907,1437290150,"2015-07-19 00:15:50"
"3692","20155311035305-535","1","2015-07-15 19:11:15",1437012675,"C4",178745,1437191420,"2015-07-17 20:50:20"
"4404","20152811072856-634","1","2015-07-15 19:25:16",1437013516,"C4",194290,1437207806,"2015-07-18 01:23:26"
"3405","20151501021548-648","1","2015-07-15 20:26:41",1437017201,"C4",175979,1437193180,"2015-07-17 21:19:40"
"1563","20154108114121-535","1","2015-07-15 21:08:21",1437019701,"C6",538470,1437558171,"2015-07-22 02:42:51"
"4447","20154722034718-115","2","2015-07-15 21:27:33",1437020853,"C2",669205,1437690058,"2015-07-23 15:20:58"
"1298","20150011120023-724","1","2015-07-15 21:33:17",1437021197,"C5",189987,1437211184,"2015-07-18 02:19:44"
"2514","20152312092334-13","3","2015-07-15 22:28:27",1437024507,"C6",306293,1437330800,"2015-07-19 11:33:20"
"5476","20151109071101-943","1","2015-07-15 22:38:03",1437025083,"C5",287011,1437312094,"2015-07-19 06:21:34"
"4877","20151414021427-933","1","2015-07-15 22:52:11",1437025931,"C2",117464,1437143395,"2015-07-17 07:29:55"
"1178","20154611044614-561","2","2015-07-15 22:54:46",1437026086,"C3",45964,1437072050,"2015-07-16 11:40:50"
"6216","20152226122251-984","3","2015-07-15 23:08:41",1437026921,"C5",240050,1437266971,"2015-07-18 17:49:31"
"2942","20154630124651-529","1","2015-07-15 23:18:03",1437027483,"C3",166734,1437194217,"2015-07-17 21:36:57"
"6187","20155002125000-291","1","2015-07-15 23:58:16",1437029896,"C0",145412,1437175308,"2015-07-17 16:21:48"
"3802","20151114021156-85","1","2015-07-16 01:10:20",1437034220,"C6",452984,1437487204,"2015-07-21 07:00:04"
"6210","20153302013336-618","1","2015-07-16 02:18:13",1437038293,"C2",167011,1437205304,"2015-07-18 00:41:44"
"4432","20155708025739-913","1","2015-07-16 03:25:01",1437042301,"C5",92806,1437135107,"2015-07-17 05:11:47"
"296","20152514102555-759","3","2015-07-16 03:37:03",1437043023,"C8",74134,1437117157,"2015-07-17 00:12:37"
"2187","20152010022051-412","2","2015-07-16 03:40:54",1437043254,"C3",160001,1437203255,"2015-07-18 00:07:35"
"4917","20153010023059-654","1","2015-07-16 03:56:07",1437044167,"C8",240154,1437284321,"2015-07-18 22:38:41"
"4535","20153125123107-117","2","2015-07-16 04:25:01",1437045901,"C2",595078,1437640979,"2015-07-23 01:42:59"
"6393","20152008092051-845","2","2015-07-16 04:50:17",1437047417,"C5",337483,1437384900,"2015-07-20 02:35:00"
"1925","20154205064237-776","2","2015-07-16 05:09:49",1437048589,"C8",472416,1437521005,"2015-07-21 16:23:25"
"772","20151106061100-410","1","2015-07-16 05:21:24",1437049284,"C0",431628,1437480912,"2015-07-21 05:15:12"
"84","20152312122312-603","1","2015-07-16 05:22:09",1437049329,"C0",970779,1438020108,"2015-07-27 11:01:48"
"908","20153502053554-349","2","2015-07-16 05:32:44",1437049964,"C8",233242,1437283206,"2015-07-18 22:20:06"
"5988","20150407090456-983","1","2015-07-16 06:10:05",1437052205,"C3",109587,1437161792,"2015-07-17 12:36:32"
"5786","20150514010523-466","1","2015-07-16 06:10:19",1437052219,"C2",73948,1437126167,"2015-07-17 02:42:47"
"801","20152408032428-524","1","2015-07-16 06:31:47",1437053507,"C0",94177,1437147684,"2015-07-17 08:41:24"
"4734","20155809065829-220","2","2015-07-16 06:52:25",1437054745,"C2",86348,1437141093,"2015-07-17 06:51:33"
"322","20150315030313-186","1","2015-07-16 07:54:08",1437058448,"C3",60655,1437119103,"2015-07-17 00:45:03"
"1232","20154506054509-852","2","2015-07-16 08:05:51",1437059151,"C7",92138,1437151289,"2015-07-17 09:41:29"
"577","20154303074351-681","1","2015-07-16 08:33:51",1437060831,"C3",464775,1437525606,"2015-07-21 17:40:06"
"1838","20151617051603-789","1","2015-07-16 08:38:42",1437061122,"C7",274951,1437336073,"2015-07-19 13:01:13"
"866","20155822125820-486","1","2015-07-16 08:44:32",1437061472,"C0",686124,1437747596,"2015-07-24 07:19:56"
"2331","20151409111433-68","2","2015-07-16 08:49:31",1437061771,"C3",298049,1437359820,"2015-07-19 19:37:00"
"5079","20150508050523-569","1","2015-07-16 09:10:43",1437063043,"C7",331360,1437394403,"2015-07-20 05:13:23"
"6446","20155304065358-506","3","2015-07-16 10:10:04",1437066604,"C7",524283,1437590887,"2015-07-22 11:48:07"
"5851","20155101075136-111","1","2015-07-16 10:14:48",1437066888,"C5",163074,1437229962,"2015-07-18 07:32:42"
"680","20154310054327-591","1","2015-07-16 10:46:47",1437068807,"C8",246700,1437315507,"2015-07-19 07:18:27"
"346","20150716030750-947","1","2015-07-16 10:50:16",1437069016,"C7",368078,1437437094,"2015-07-20 17:04:54"
"2317","20155012085048-766","2","2015-07-16 11:03:36",1437069816,"C5",176784,1437246600,"2015-07-18 12:10:00"
"2752","20151601031635-401","3","2015-07-16 11:30:02",1437071402,"C7",183201,1437254603,"2015-07-18 14:23:23"
"1995","20154911054914-248","1","2015-07-16 11:31:40",1437071500,"C2",409346,1437480846,"2015-07-21 05:14:06"
"962","20153428103417-553","2","2015-07-16 11:41:26",1437072086,"C2",519743,1437591829,"2015-07-22 12:03:49"
"5238","20152014052009-210","2","2015-07-16 11:45:54",1437072354,"C4",152745,1437225099,"2015-07-18 06:11:39"
"5954","20152008092020-195","3","2015-07-16 12:31:48",1437075108,"C2",351344,1437426452,"2015-07-20 14:07:32"
"6047","20150024090008-901","1","2015-07-16 13:18:08",1437077888,"C8",383256,1437461144,"2015-07-20 23:45:44"
"1611","20152730022758-606","1","2015-07-16 13:53:49",1437080029,"C2",197193,1437277222,"2015-07-18 20:40:22"
"2736","20152411032440-684","1","2015-07-16 15:20:23",1437085223,"C3",431743,1437516966,"2015-07-21 15:16:06"
"4256","20154201084214-252","1","2015-07-16 15:21:44",1437085304,"C5",439990,1437525294,"2015-07-21 17:34:54"
"1508","20150605080621-713","3","2015-07-16 15:55:36",1437087336,"C8",195711,1437283047,"2015-07-18 22:17:27"
"5505","20153214083255-828","2","2015-07-16 16:29:11",1437089351,"C8",100688,1437190039,"2015-07-17 20:27:19"
"5125","20155629125653-788","2","2015-07-16 16:44:15",1437090255,"C4",594406,1437684661,"2015-07-23 13:51:01"
"3593","20155617035626-878","3","2015-07-16 16:50:50",1437090650,"C4",313608,1437404258,"2015-07-20 07:57:38"
"3954","20153311033321-730","1","2015-07-16 17:02:48",1437091368,"C4",62481,1437153849,"2015-07-17 10:24:09"
"3208","20153708073726-600","2","2015-07-16 17:42:08",1437093728,"C7",363741,1437457469,"2015-07-20 22:44:29"
"1980","20151214101217-551","1","2015-07-16 17:54:25",1437094465,"C5",100264,1437194729,"2015-07-17 21:45:29"
"2183","20152307122306-159","3","2015-07-16 18:33:40",1437096820,"C4",799834,1437896654,"2015-07-26 00:44:14"
"3310","20153208073235-389","2","2015-07-16 18:50:44",1437097844,"C7",81321,1437179165,"2015-07-17 17:26:05"
"4055","20150830110807-384","1","2015-07-16 18:54:07",1437098047,"C8",201480,1437299527,"2015-07-19 02:52:07"
"6176","20150810010834-148","2","2015-07-16 19:05:34",1437098734,"C5",269910,1437368644,"2015-07-19 22:04:04"
"5727","20155824105804-483","2","2015-07-16 20:07:19",1437102439,"C8",386751,1437489190,"2015-07-21 07:33:10"
"5527","20153404113438-674","2","2015-07-16 20:25:58",1437103558,"C2",534340,1437637898,"2015-07-23 00:51:38"
"348","20153013023021-720","1","2015-07-16 20:37:27",1437104247,"C4",140613,1437244860,"2015-07-18 11:41:00"
"2757","20155121035116-274","1","2015-07-16 21:00:37",1437105637,"C4",311223,1437416860,"2015-07-20 11:27:40"
"4108","20153410073455-798","1","2015-07-16 21:07:22",1437106042,"C5",189049,1437295091,"2015-07-19 01:38:11"
"3397","20154712014753-800","1","2015-07-16 21:57:13",1437109033,"C8",74992,1437184025,"2015-07-17 18:47:05"
"5882","20153310023320-488","1","2015-07-16 22:02:53",1437109373,"C7",60597,1437169970,"2015-07-17 14:52:50"
"740","20153814073818-418","1","2015-07-16 22:30:49",1437111049,"C4",226351,1437337400,"2015-07-19 13:23:20"
"5377","20155705085712-420","1","2015-07-16 23:06:12",1437113172,"C8",200268,1437313440,"2015-07-19 06:44:00"
"4031","20153917063943-246","1","2015-07-16 23:12:43",1437113563,"C8",513036,1437626599,"2015-07-22 21:43:19"
"5482","20150024010014-301","2","2015-07-16 23:54:10",1437116050,"C4",277148,1437393198,"2015-07-20 04:53:18"
"1353","20151911031933-491","1","2015-07-17 00:02:07",1437116527,"C3",231677,1437348204,"2015-07-19 16:23:24"
"5848","20155122055116-333","1","2015-07-17 00:41:55",1437118915,"C4",699413,1437818328,"2015-07-25 02:58:48"
"2628","20154408014459-479","2","2015-07-17 01:17:19",1437121039,"C8",146548,1437267587,"2015-07-18 17:59:47"
"2811","20155515045550-909","1","2015-07-17 02:05:44",1437123944,"C2",59697,1437183641,"2015-07-17 18:40:41"
"2997","20153111043103-266","3","2015-07-17 02:19:19",1437124759,"C3",58412,1437183171,"2015-07-17 18:32:51"
"903","20151405111428-942","2","2015-07-17 02:19:40",1437124780,"C6",167452,1437292232,"2015-07-19 00:50:32"
"6001","20155115055126-836","3","2015-07-17 02:25:56",1437125156,"C8",58635,1437183791,"2015-07-17 18:43:11"
"666","20155514095514-716","1","2015-07-17 02:48:46",1437126526,"C5",116806,1437243332,"2015-07-18 11:15:32"
"6246","20155324015326-739","2","2015-07-17 03:22:46",1437128566,"C8",278480,1437407046,"2015-07-20 08:44:06"
"1977","20151210031224-723","2","2015-07-17 03:46:06",1437129966,"C5",281811,1437411777,"2015-07-20 10:02:57"
"5915","20150811030814-454","2","2015-07-17 04:09:44",1437131384,"C5",239445,1437370829,"2015-07-19 22:40:29"
"4109","20152303042327-304","1","2015-07-17 04:49:59",1437133799,"C8",166856,1437300655,"2015-07-19 03:10:55"
"5840","20151206051246-156","1","2015-07-17 05:08:55",1437134935,"C3",129567,1437264502,"2015-07-18 17:08:22"
"183","20154615084621-811","3","2015-07-17 06:14:21",1437138861,"C5",81840,1437220701,"2015-07-18 04:58:21"
"4199","20150213020216-787","3","2015-07-17 06:18:04",1437139084,"C2",317748,1437456832,"2015-07-20 22:33:52"
"2751","20150105040155-8","1","2015-07-17 07:08:49",1437142129,"C8",502407,1437644536,"2015-07-23 02:42:16"
"1755","20152816082835-10","1","2015-07-17 07:45:04",1437144304,"C4",83789,1437228093,"2015-07-18 07:01:33"
"3267","20153414073455-915","3","2015-07-17 09:30:29",1437150629,"C4",266134,1437416763,"2015-07-20 11:26:03"
"2983","20155405055416-800","1","2015-07-17 09:38:52",1437151132,"C5",503538,1437654670,"2015-07-23 05:31:10"
"3140","20155908035956-424","2","2015-07-17 11:01:00",1437156060,"C2",94958,1437251018,"2015-07-18 13:23:38"
"1810","20155911125954-688","1","2015-07-17 11:11:30",1437156690,"C7",73128,1437229818,"2015-07-18 07:30:18"
"4386","20151115041148-836","2","2015-07-17 11:43:38",1437158618,"C8",78355,1437236973,"2015-07-18 09:29:33"
"229","20154113074143-823","1","2015-07-17 13:31:34",1437165094,"C3",122197,1437287291,"2015-07-18 23:28:11"
"692","20154112094107-810","3","2015-07-17 13:38:42",1437165522,"C6",446255,1437611777,"2015-07-22 17:36:17"
"1946","20153914023918-636","1","2015-07-17 13:46:31",1437165991,"C0",256033,1437422024,"2015-07-20 12:53:44"
"4159","20153209073227-817","1","2015-07-17 13:56:46",1437166606,"C4",102037,1437268643,"2015-07-18 18:17:23"
"1160","20154507034519-6","2","2015-07-17 14:15:59",1437167759,"C8",171728,1437339487,"2015-07-19 13:58:07"
"1749","20154112014114-381","False","2015-07-17 15:04:59",1437170699,"C6",202407,1437373106,"2015-07-19 23:18:26"
"4916","20155002015002-492","1","2015-07-17 15:39:56",1437172796,"C5",434198,1437606994,"2015-07-22 16:16:34"
"6454","20150214070205-409","2","2015-07-17 15:48:22",1437173302,"C4",290777,1437464079,"2015-07-21 00:34:39"
"2864","20152408102406-549","2","2015-07-17 18:46:03",1437183963,"C5",269239,1437453202,"2015-07-20 21:33:22"
"5859","20152212112239-676","2","2015-07-17 18:53:11",1437184391,"C4",65576,1437249967,"2015-07-18 13:06:07"
"5000","20153905083900-16","3","2015-07-17 19:49:42",1437187782,"C4",359014,1437546796,"2015-07-21 23:33:16"
"2477","20153229033240-417","1","2015-07-17 20:05:12",1437188712,"C5",196444,1437385156,"2015-07-20 02:39:16"
"4327","20153314043314-37","1","2015-07-17 20:27:28",1437190048,"C2",409322,1437599370,"2015-07-22 14:09:30"
"5228","20153213013210-111","1","2015-07-17 20:33:30",1437190410,"C4",185440,1437375850,"2015-07-20 00:04:10"
"4625","20152612032640-395","1","2015-07-17 21:10:00",1437192600,"C2",56575,1437249175,"2015-07-18 12:52:55"
"3216","20152020062041-92","3","2015-07-17 21:18:53",1437193133,"C2",340956,1437534089,"2015-07-21 20:01:29"
"863","20153415093431-204","2","2015-07-17 22:07:33",1437196053,"C0",108991,1437305044,"2015-07-19 04:24:04"
"3708","20152716022735-871","1","2015-07-17 22:16:17",1437196577,"C8",57261,1437253838,"2015-07-18 14:10:38"
"2921","20154409044423-907","1","2015-07-17 22:23:40",1437197020,"C2",711557,1437908577,"2015-07-26 04:02:57"
"6313","20154404024426-337","2","2015-07-17 22:36:42",1437197802,"C4",143942,1437341744,"2015-07-19 14:35:44"
"2135","20152507052543-844","2","2015-07-17 22:56:29",1437198989,"C8",441923,1437640912,"2015-07-23 01:41:52"
"4952","20152614052641-115","1","2015-07-18 00:46:35",1437205595,"C2",95198,1437300793,"2015-07-19 03:13:13"
"1660","20152729112721-705","2","2015-07-18 01:07:21",1437206841,"C6",713800,1437920641,"2015-07-26 07:24:01"
"923","20154229014226-973","1","2015-07-18 01:21:21",1437207681,"C8",319427,1437527108,"2015-07-21 18:05:08"
"3083","20154718034701-35","1","2015-07-18 01:22:26",1437207746,"C7",362875,1437570621,"2015-07-22 06:10:21"
"2635","20152516122531-638","1","2015-07-18 02:05:45",1437210345,"C5",67807,1437278152,"2015-07-18 20:55:52"
"2927","20152907052915-532","2","2015-07-18 03:13:55",1437214435,"C0",128440,1437342875,"2015-07-19 14:54:35"
"1009","20152703072701-166","2","2015-07-18 03:24:04",1437215044,"C5",427141,1437642185,"2015-07-23 02:03:05"
"882","20154706044718-338","3","2015-07-18 03:31:18",1437215478,"C5",494520,1437709998,"2015-07-23 20:53:18"
"4601","20153803013812-529","1","2015-07-18 03:51:00",1437216660,"C7",630384,1437847044,"2015-07-25 10:57:24"
"5112","20150413050412-329","2","2015-07-18 03:58:04",1437217084,"C3",48104,1437265188,"2015-07-18 17:19:48"
"5468","20155501125529-527","3","2015-07-18 04:20:21",1437218421,"C8",718946,1437937367,"2015-07-26 12:02:47"
"6097","20150106080113-871","1","2015-07-18 04:49:21",1437220161,"C2",128161,1437348322,"2015-07-19 16:25:22"
"1843","20154612124636-207","2","2015-07-18 06:56:15",1437227775,"C5",165793,1437393568,"2015-07-20 04:59:28"
"5884","20152909082925-700","1","2015-07-18 07:00:33",1437228033,"C5",386134,1437614167,"2015-07-22 18:16:07"
"306","20150207110213-868","3","2015-07-18 07:10:46",1437228646,"C7",104057,1437332703,"2015-07-19 12:05:03"
"332","20151504021557-531","2","2015-07-18 07:12:34",1437228754,"C0",169171,1437397925,"2015-07-20 06:12:05"
"9","20151710051755-835","3","2015-07-18 07:17:55",1437229075,"C5",93600,1437322675,"2015-07-19 09:17:55"
"4682","20150810080815-587","2","2015-07-18 07:49:03",1437230943,"C5",86256,1437317199,"2015-07-19 07:46:39"
"4664","20154416054424-28","1","2015-07-18 07:52:40",1437231160,"C4",137296,1437368456,"2015-07-19 22:00:56"
"590","20153617013645-103","3","2015-07-18 07:54:54",1437231294,"C2",65889,1437297183,"2015-07-19 02:13:03"
"479","20155909075954-808","1","2015-07-18 08:02:27",1437231747,"C4",259251,1437490998,"2015-07-21 08:03:18"
"3631","20150903100903-596","2","2015-07-18 08:43:33",1437234213,"C4",184410,1437418623,"2015-07-20 11:57:03"
"3519","20152114062143-72","1","2015-07-18 08:45:30",1437234330,"C6",354227,1437588557,"2015-07-22 11:09:17"
"6054","20155710075750-214","1","2015-07-18 08:46:37",1437234397,"C8",99161,1437333558,"2015-07-19 12:19:18"
"4826","20153903123902-205","1","2015-07-18 08:47:35",1437234455,"C5",183159,1437417614,"2015-07-20 11:40:14"
"1615","20150304120307-360","1","2015-07-18 09:30:25",1437237025,"C6",632073,1437869098,"2015-07-25 17:04:58"
"4694","20152616032618-514","2","2015-07-18 10:22:28",1437240148,"C4",77285,1437317433,"2015-07-19 07:50:33"
"6205","20151610051648-803","2","2015-07-18 11:29:33",1437244173,"C4",223455,1437467628,"2015-07-21 01:33:48"
"2894","20155715075716-596","2","2015-07-18 11:32:16",1437244336,"C2",90700,1437335036,"2015-07-19 12:43:56"
"2973","20152624072652-602","3","2015-07-18 11:53:13",1437245593,"C5",696527,1437942120,"2015-07-26 13:22:00"
"368","20152712012712-669","2","2015-07-18 11:58:08",1437245888,"C5",64132,1437310020,"2015-07-19 05:47:00"
"4295","20154710114715-117","1","2015-07-18 12:39:37",1437248377,"C5",347171,1437595548,"2015-07-22 13:05:48"
"3999","20154519084549-54","1","2015-07-18 12:40:55",1437248455,"C6",419951,1437668406,"2015-07-23 09:20:06"
"1907","20151009041023-63","1","2015-07-18 12:50:23",1437249023,"C2",95700,1437344723,"2015-07-19 15:25:23"
"5324","20152814012834-417","2","2015-07-18 13:32:03",1437251523,"C3",419687,1437671210,"2015-07-23 10:06:50"
"5346","20155206025244-634","3","2015-07-18 13:38:58",1437251938,"C4",516187,1437768125,"2015-07-24 13:02:05"
"4847","20154711064739-979","1","2015-07-18 13:40:15",1437252015,"C0",209852,1437461867,"2015-07-20 23:57:47"
"4541","20154004024021-315","2","2015-07-18 13:42:21",1437252141,"C5",150765,1437402906,"2015-07-20 07:35:06"
"2020","20155112105111-296","3","2015-07-18 14:16:05",1437254165,"C0",176898,1437431063,"2015-07-20 15:24:23"
"1013","20152808032826-116","3","2015-07-18 15:37:10",1437259030,"C5",432262,1437691292,"2015-07-23 15:41:32"
"6539","20153914123913-490","3","2015-07-18 15:43:53",1437259433,"C7",178340,1437437773,"2015-07-20 17:16:13"
"4588","20153401073437-826","3","2015-07-18 15:58:54",1437260334,"C5",214151,1437474485,"2015-07-21 03:28:05"
"861","20153623073655-303","2","2015-07-18 16:23:59",1437261839,"C5",273953,1437535792,"2015-07-21 20:29:52"
"5222","20154715074737-500","2","2015-07-18 16:30:08",1437262208,"C6",290551,1437552759,"2015-07-22 01:12:39"
"2319","20151210101225-79","2","2015-07-18 16:33:37",1437262417,"C4",89259,1437351676,"2015-07-19 17:21:16"
"6350","20154712084755-402","1","2015-07-18 16:51:22",1437263482,"C2",182469,1437445951,"2015-07-20 19:32:31"
"290","20152612122652-844","1","2015-07-18 16:57:59",1437263879,"C5",76381,1437340260,"2015-07-19 14:11:00"
"2029","20150827020823-652","2","2015-07-18 17:03:51",1437264231,"C0",228116,1437492347,"2015-07-21 08:25:47"
"3610","20150901060931-375","3","2015-07-18 17:53:39",1437267219,"C4",188881,1437456100,"2015-07-20 22:21:40"
"4073","20151510081555-297","2","2015-07-18 18:19:27",1437268767,"C3",103916,1437372683,"2015-07-19 23:11:23"
"1943","20153914043938-754","2","2015-07-18 18:41:37",1437270097,"C8",50417,1437320514,"2015-07-19 08:41:54"
"660","20150810060851-257","1","2015-07-18 18:50:19",1437270619,"C4",92111,1437362730,"2015-07-19 20:25:30"
"2568","20154816014841-737","1","2015-07-18 19:04:59",1437271499,"C4",927926,1438199425,"2015-07-29 12:50:25"
"1407","20155014125011-81","1","2015-07-18 19:05:49",1437271549,"C4",184069,1437455618,"2015-07-20 22:13:38"
"4410","20155809045856-713","2","2015-07-18 19:38:48",1437273528,"C3",98399,1437371927,"2015-07-19 22:58:47"
"613","20155420065446-200","3","2015-07-18 20:25:22",1437276322,"C5",352548,1437628870,"2015-07-22 22:21:10"
"926","20154003074050-280","1","2015-07-18 20:36:46",1437277006,"C0",944708,1438221714,"2015-07-29 19:01:54"
"4461","20153612073632-445","1","2015-07-18 20:56:26",1437278186,"C8",283197,1437561383,"2015-07-22 03:36:23"
"3256","20150305030356-98","2","2015-07-18 21:16:31",1437279391,"C8",229111,1437508502,"2015-07-21 12:55:02"
"4865","20151006071021-877","2","2015-07-18 21:35:09",1437280509,"C3",136086,1437416595,"2015-07-20 11:23:15"
"297","20154306054321-56","1","2015-07-18 21:51:13",1437281473,"C2",131459,1437412932,"2015-07-20 10:22:12"
"1785","20155810095859-88","1","2015-07-18 21:56:52",1437281812,"C4",734273,1438016085,"2015-07-27 09:54:45"
"5682","20153817023845-593","1","2015-07-18 22:15:53",1437282953,"C5",56914,1437339867,"2015-07-19 14:04:27"
"567","20151415051449-943","1","2015-07-18 23:09:19",1437286159,"C6",478745,1437764904,"2015-07-24 12:08:24"
"6181","20155709095715-337","3","2015-07-18 23:31:42",1437287502,"C4",275489,1437562991,"2015-07-22 04:03:11"
"6007","20155617115643-257","1","2015-07-19 01:06:29",1437293189,"C5",66893,1437360082,"2015-07-19 19:41:22"
"2188","20152826032848-662","1","2015-07-19 01:59:00",1437296340,"C6",323102,1437619442,"2015-07-22 19:44:02"
"887","20155401025432-410","1","2015-07-19 02:19:08",1437297548,"C7",754938,1438052486,"2015-07-27 20:01:26"
"2245","20152109052153-334","1","2015-07-19 02:29:33",1437298173,"C8",162092,1437460265,"2015-07-20 23:31:05"
"2267","20154021014001-277","2","2015-07-19 03:16:33",1437300993,"C2",340256,1437641249,"2015-07-23 01:47:29"
"1894","20154111114145-439","2","2015-07-19 03:56:58",1437303418,"C7",94759,1437398177,"2015-07-20 06:16:17"
"2883","20150006070032-991","2","2015-07-19 04:01:48",1437303708,"C5",556238,1437859946,"2015-07-25 14:32:26"
"1329","20150112060145-428","1","2015-07-19 04:15:14",1437304514,"C7",85487,1437390001,"2015-07-20 04:00:01"
"4493","20151517081557-258","2","2015-07-19 04:19:47",1437304787,"C2",79315,1437384102,"2015-07-20 02:21:42"
"3908","20150816060849-742","3","2015-07-19 04:54:07",1437306847,"C5",84906,1437391753,"2015-07-20 04:29:13"
"5196","20153316063306-527","3","2015-07-19 05:15:54",1437308154,"C7",127284,1437435438,"2015-07-20 16:37:18"
"4497","20155625025639-594","1","2015-07-19 05:49:27",1437310167,"C3",255096,1437565263,"2015-07-22 04:41:03"
"2859","20154410024451-978","3","2015-07-19 05:59:39",1437310779,"C5",106584,1437417363,"2015-07-20 11:36:03"
"13","20151510121543-670","3","2015-07-19 06:21:04",1437312064,"C2",252107,1437564171,"2015-07-22 04:22:51"
"3240","20152018102004-940","1","2015-07-19 06:35:32",1437312932,"C0",72928,1437385860,"2015-07-20 02:51:00"
"2872","20150010080038-54","2","2015-07-19 06:59:50",1437314390,"C2",420744,1437735134,"2015-07-24 03:52:14"
"5273","20151502111546-232","1","2015-07-19 07:02:02",1437314522,"C4",181697,1437496219,"2015-07-21 09:30:19"
"2577","20153816113806-724","1","2015-07-19 07:09:06",1437314946,"C5",121530,1437436476,"2015-07-20 16:54:36"
"2556","20155617085640-226","2","2015-07-19 07:12:42",1437315162,"C8",83281,1437398443,"2015-07-20 06:20:43"
"411","20155303055334-250","2","2015-07-19 07:19:42",1437315582,"C0",168046,1437483628,"2015-07-21 06:00:28"
"4239","20154417114443-748","1","2015-07-19 07:36:43",1437316603,"C8",78960,1437395563,"2015-07-20 05:32:43"
"4499","20155516115547-576","2","2015-07-19 08:14:59",1437318899,"C8",122976,1437441875,"2015-07-20 18:24:35"
"5893","20152305012336-61","3","2015-07-19 08:46:50",1437320810,"C3",596497,1437917307,"2015-07-26 06:28:27"
"3712","20152201042246-439","2","2015-07-19 08:53:22",1437321202,"C7",764118,1438085320,"2015-07-28 05:08:40"
"3577","20152001072036-614","1","2015-07-19 08:57:24",1437321444,"C7",780504,1438101948,"2015-07-28 09:45:48"
"1684","20150517090518-811","3","2015-07-19 09:23:46",1437323026,"C7",86954,1437409980,"2015-07-20 09:33:00"
"1562","20152909082901-932","1","2015-07-19 09:25:56",1437323156,"C8",173483,1437496639,"2015-07-21 09:37:19"
"1165","20151911051900-484","1","2015-07-19 09:57:42",1437325062,"C2",221574,1437546636,"2015-07-21 23:30:36"
"556","20154111024150-826","1","2015-07-19 10:14:13",1437326053,"C7",96449,1437422502,"2015-07-20 13:01:42"
"1719","20150811050843-334","2","2015-07-19 10:59:55",1437328795,"C2",83634,1437412429,"2015-07-20 10:13:49"
"1670","20152907092902-279","2","2015-07-19 11:05:05",1437329105,"C5",1211521,1438540626,"2015-08-02 11:37:06"
"2600","20155524065529-638","3","2015-07-19 11:51:32",1437331892,"C0",725921,1438057813,"2015-07-27 21:30:13"
"446","20152414072405-565","2","2015-07-19 12:01:03",1437332463,"C0",434374,1437766837,"2015-07-24 12:40:37"
"3410","20152711032724-725","3","2015-07-19 12:16:59",1437333419,"C2",679775,1438013194,"2015-07-27 09:06:34"
"5971","20150005110029-714","3","2015-07-19 12:40:09",1437334809,"C8",243116,1437577925,"2015-07-22 08:12:05"
"6488","20153906123907-891","1","2015-07-19 13:28:31",1437337711,"C6",187694,1437525405,"2015-07-21 17:36:45"
"4728","20154204034234-400","3","2015-07-19 13:48:58",1437338938,"C4",161148,1437500086,"2015-07-21 10:34:46"
"1730","20152818092849-712","1","2015-07-19 14:07:23",1437340043,"C2",103114,1437443157,"2015-07-20 18:45:57"
"934","20155916065950-407","1","2015-07-19 14:22:28",1437340948,"C8",142879,1437483827,"2015-07-21 06:03:47"
"3186","20150109020137-850","3","2015-07-19 14:23:17",1437340997,"C8",432650,1437773647,"2015-07-24 14:34:07"
"5010","20153018013026-319","2","2015-07-19 14:33:53",1437341633,"C2",90207,1437431840,"2015-07-20 15:37:20"
"329","20152509102521-374","1","2015-07-19 14:48:01",1437342481,"C2",109970,1437452451,"2015-07-20 21:20:51"
"1650","20150903090936-932","1","2015-07-19 14:50:56",1437342656,"C0",175360,1437518016,"2015-07-21 15:33:36"
"6046","20150415090454-392","1","2015-07-19 15:01:39",1437343299,"C4",122335,1437465634,"2015-07-21 01:00:34"
"4705","20154703104742-613","1","2015-07-19 15:20:51",1437344451,"C3",199827,1437544278,"2015-07-21 22:51:18"
"377","20154913124955-986","3","2015-07-19 16:12:26",1437347546,"C4",75793,1437423339,"2015-07-20 13:15:39"
"3893","20152309092303-862","2","2015-07-19 16:28:03",1437348483,"C8",177900,1437526383,"2015-07-21 17:53:03"
"1491","20150115100135-182","2","2015-07-19 16:30:22",1437348622,"C2",368927,1437717549,"2015-07-23 22:59:09"
"2509","20150221080233-162","1","2015-07-19 16:42:48",1437349368,"C5",816805,1438166173,"2015-07-29 03:36:13"
"645","20154312014352-916","1","2015-07-19 17:01:30",1437350490,"C8",88094,1437438584,"2015-07-20 17:29:44"
"3616","20154210014220-695","3","2015-07-19 18:24:44",1437355484,"C5",264848,1437620332,"2015-07-22 19:58:52"
"3096","20150708030735-179","1","2015-07-19 18:30:41",1437355841,"C2",320862,1437676703,"2015-07-23 11:38:23"
"1926","20155517085542-741","3","2015-07-19 18:50:34",1437357034,"C0",208492,1437565526,"2015-07-22 04:45:26"
"3776","20151203101246-894","2","2015-07-19 19:04:01",1437357841,"C5",471425,1437829266,"2015-07-25 06:01:06"
"120","20155603075643-430","1","2015-07-19 19:46:12",1437360372,"C2",203567,1437563939,"2015-07-22 04:18:59"
"1036","20154809104801-644","3","2015-07-19 20:18:33",1437362313,"C5",112279,1437474592,"2015-07-21 03:29:52"
"469","20153310033332-410","2","2015-07-19 20:35:48",1437363348,"C4",99467,1437462815,"2015-07-21 00:13:35"
"1512","20151315121354-235","1","2015-07-19 20:37:35",1437363455,"C6",375821,1437739276,"2015-07-24 05:01:16"
"3292","20153407083404-718","2","2015-07-19 21:04:49",1437365089,"C7",120205,1437485294,"2015-07-21 06:28:14"
"3990","20154813094806-514","2","2015-07-19 21:45:21",1437367521,"C4",80205,1437447726,"2015-07-20 20:02:06"
"2739","20150818050836-609","2","2015-07-19 22:04:24",1437368664,"C5",52074,1437420738,"2015-07-20 12:32:18"
"158","20151817011850-621","1","2015-07-19 22:49:43",1437371383,"C4",207053,1437578436,"2015-07-22 08:20:36"
"1502","20150605120608-125","3","2015-07-20 00:21:38",1437376898,"C8",250746,1437627644,"2015-07-22 22:00:44"
"147","20150027120012-20","3","2015-07-20 00:32:36",1437377556,"C4",277992,1437655548,"2015-07-23 05:45:48"
"371","20154309074338-532","2","2015-07-20 00:38:20",1437377900,"C5",462441,1437840341,"2015-07-25 09:05:41"
"4709","20151202011253-62","3","2015-07-20 00:49:41",1437378581,"C4",188826,1437567407,"2015-07-22 05:16:47"
"1099","20154417114443-51","1","2015-07-20 01:09:45",1437379785,"C8",110551,1437490336,"2015-07-21 07:52:16"
"2279","20154107114151-839","2","2015-07-20 01:17:54",1437380274,"C8",155109,1437535383,"2015-07-21 20:23:03"
"892","20151501031546-207","3","2015-07-20 01:53:36",1437382416,"C2",796735,1438179151,"2015-07-29 07:12:31"
"387","20151412051446-871","1","2015-07-20 01:58:36",1437382716,"C2",90890,1437473606,"2015-07-21 03:13:26"
"1999","20152403122407-918","2","2015-07-20 02:18:45",1437383925,"C5",716239,1438100164,"2015-07-28 09:16:04"
"6034","20152112022147-274","2","2015-07-20 02:29:49",1437384589,"C8",324241,1437708830,"2015-07-23 20:33:50"
"1102","20150207050259-178","1","2015-07-20 03:09:30",1437386970,"C4",153313,1437540283,"2015-07-21 21:44:43"
"5146","20155707095706-832","1","2015-07-20 03:45:48",1437389148,"C8",550461,1437939609,"2015-07-26 12:40:09"
"263","20155704025719-973","1","2015-07-20 04:15:23",1437390923,"C5",671942,1438062865,"2015-07-27 22:54:25"
"4719","20151906061932-564","3","2015-07-20 04:21:00",1437391260,"C7",171784,1437563044,"2015-07-22 04:04:04"
"4286","20153012103050-559","1","2015-07-20 04:35:26",1437392126,"C7",334938,1437727064,"2015-07-24 01:37:44"
"5064","20155415065439-614","1","2015-07-20 05:07:05",1437394025,"C8",431078,1437825103,"2015-07-25 04:51:43"
"2269","20152517032501-916","1","2015-07-20 05:23:13",1437394993,"C5",111546,1437506539,"2015-07-21 12:22:19"
"2276","20151027121025-240","1","2015-07-20 05:45:57",1437396357,"C5",982066,1438378423,"2015-07-31 14:33:43"
"1356","20153015053016-75","1","2015-07-20 05:59:52",1437397192,"C4",130192,1437527384,"2015-07-21 18:09:44"
"3956","20152211042210-394","2","2015-07-20 06:27:15",1437398835,"C8",148381,1437547216,"2015-07-21 23:40:16"
"656","20151305011309-201","2","2015-07-20 06:33:09",1437399189,"C3",424000,1437823189,"2015-07-25 04:19:49"
"4741","20154903044916-720","1","2015-07-20 06:42:49",1437399769,"C2",477471,1437877240,"2015-07-25 19:20:40"
"822","20154604094636-292","2","2015-07-20 07:02:48",1437400968,"C4",457524,1437858492,"2015-07-25 14:08:12"
"5974","20150616070612-761","2","2015-07-20 08:10:46",1437405046,"C5",174737,1437579783,"2015-07-22 08:43:03"
"593","20153204093236-149","2","2015-07-20 08:45:50",1437407150,"C2",689797,1438096947,"2015-07-28 08:22:27"
"5055","20153616023658-518","2","2015-07-20 08:49:28",1437407368,"C2",162375,1437569743,"2015-07-22 05:55:43"
"227","20154212114201-175","2","2015-07-20 09:47:37",1437410857,"C5",85542,1437496399,"2015-07-21 09:33:19"
"3613","20151212021252-485","3","2015-07-20 10:22:36",1437412956,"C6",84673,1437497629,"2015-07-21 09:53:49"
"2671","20150115050115-511","2","2015-07-20 10:24:50",1437413090,"C0",408215,1437821305,"2015-07-25 03:48:25"
"4712","20153717083746-738","1","2015-07-20 10:27:24",1437413244,"C2",265778,1437679022,"2015-07-23 12:17:02"
"2381","20153102093104-707","2","2015-07-20 10:44:52",1437414292,"C3",519876,1437934168,"2015-07-26 11:09:28"
"5492","20151314051327-38","1","2015-07-20 10:51:07",1437414667,"C7",247730,1437662397,"2015-07-23 07:39:57"
"6514","20151212121250-641","1","2015-07-20 11:23:22",1437416602,"C5",86029,1437502631,"2015-07-21 11:17:11"
"2359","20152113062104-747","2","2015-07-20 11:58:18",1437418698,"C8",312517,1437731215,"2015-07-24 02:46:55"
"4160","20154405074442-509","2","2015-07-20 12:19:46",1437419986,"C4",164063,1437584049,"2015-07-22 09:54:09"
"1521","20155414025452-910","1","2015-07-20 12:43:52",1437421432,"C5",255270,1437676702,"2015-07-23 11:38:22"
"4186","20152120042149-770","2","2015-07-20 13:01:01",1437422461,"C2",322494,1437744955,"2015-07-24 06:35:55"
"562","20153910123921-997","1","2015-07-20 13:05:53",1437422753,"C4",108199,1437530952,"2015-07-21 19:09:12"
"4079","20151707051702-432","1","2015-07-20 13:08:47",1437422927,"C8",221661,1437644588,"2015-07-23 02:43:08"
"1089","20155216015226-188","2","2015-07-20 13:44:41",1437425081,"C5",979045,1438404126,"2015-07-31 21:42:06"
"2890","20151512111517-621","1","2015-07-20 14:28:11",1437427691,"C8",351387,1437779078,"2015-07-24 16:04:38"
"3516","20155520035557-954","1","2015-07-20 14:46:21",1437428781,"C7",585136,1438013917,"2015-07-27 09:18:37"
"4851","20153311113332-277","2","2015-07-20 14:52:04",1437429124,"C2",98689,1437527813,"2015-07-21 18:16:53"
"2461","20150518090500-717","3","2015-07-20 16:00:14",1437433214,"C4",197714,1437630928,"2015-07-22 22:55:28"
"2142","20155415015401-576","1","2015-07-20 16:04:16",1437433456,"C4",146605,1437580061,"2015-07-22 08:47:41"
"1568","20153012083039-675","1","2015-07-20 16:04:33",1437433473,"C6",119739,1437553212,"2015-07-22 01:20:12"
"4380","20155004015003-341","3","2015-07-20 17:23:42",1437438222,"C7",199317,1437637539,"2015-07-23 00:45:39"
"1988","20153015053056-910","2","2015-07-20 17:59:57",1437440397,"C2",61963,1437502360,"2015-07-21 11:12:40"
"4007","20153916033930-668","3","2015-07-20 18:02:08",1437440528,"C4",177079,1437617607,"2015-07-22 19:13:27"
"6184","20155715045720-815","2","2015-07-20 18:25:13",1437441913,"C0",437273,1437879186,"2015-07-25 19:53:06"
"4464","20154117054141-402","1","2015-07-20 18:27:21",1437442041,"C5",130970,1437573011,"2015-07-22 06:50:11"
"664","20155915055956-404","3","2015-07-20 19:17:20",1437445040,"C0",145548,1437590588,"2015-07-22 11:43:08"
"609","20151614071608-934","1","2015-07-20 19:19:48",1437445188,"C7",80260,1437525448,"2015-07-21 17:37:28"
"6411","20155417045444-36","1","2015-07-20 19:37:55",1437446275,"C2",268991,1437715266,"2015-07-23 22:21:06"
"1944","20150509030549-76","1","2015-07-20 20:04:28",1437447868,"C4",322773,1437770641,"2015-07-24 13:44:01"
"1661","20150217080254-664","2","2015-07-20 20:06:56",1437448016,"C4",302642,1437750658,"2015-07-24 08:10:58"
"3234","20155108075139-964","2","2015-07-20 20:07:29",1437448049,"C8",216190,1437664239,"2015-07-23 08:10:39"
"5539","20151514111514-132","3","2015-07-20 20:28:50",1437449330,"C5",275808,1437725138,"2015-07-24 01:05:38"
"1474","20154919034934-127","2","2015-07-20 20:42:08",1437450128,"C8",51977,1437502105,"2015-07-21 11:08:25"
"4902","20153810053835-229","1","2015-07-20 21:16:27",1437452187,"C8",438536,1437890723,"2015-07-25 23:05:23"
"5700","20153716053741-328","1","2015-07-20 21:27:11",1437452831,"C8",179685,1437632516,"2015-07-22 23:21:56"
"4180","20153512063509-117","1","2015-07-20 22:24:43",1437456283,"C2",106882,1437563165,"2015-07-22 04:06:05"
"5432","20154411064440-435","1","2015-07-20 23:13:52",1437459232,"C2",104619,1437563851,"2015-07-22 04:17:31"
"3467","20152117022136-22","1","2015-07-20 23:23:54",1437459834,"C4",97246,1437557080,"2015-07-22 02:24:40"
"6352","20153712063756-502","2","2015-07-20 23:25:32",1437459932,"C3",93957,1437553889,"2015-07-22 01:31:29"
"1933","20154516034505-603","1","2015-07-20 23:39:45",1437460785,"C8",74816,1437535601,"2015-07-21 20:26:41"
"715","20151812021854-880","2","2015-07-21 00:33:26",1437464006,"C2",364036,1437828042,"2015-07-25 05:40:42"
"4836","20151418111432-774","3","2015-07-21 00:47:24",1437464844,"C7",110786,1437575630,"2015-07-22 07:33:50"
"2844","20150517010500-796","2","2015-07-21 00:56:18",1437465378,"C0",150939,1437616317,"2015-07-22 18:51:57"
"1965","20151504071559-733","3","2015-07-21 01:33:14",1437467594,"C3",482745,1437950339,"2015-07-26 15:38:59"
"3289","20152518042537-745","2","2015-07-21 01:33:49",1437467629,"C0",102846,1437570475,"2015-07-22 06:07:55"
"5412","20155315015313-84","1","2015-07-21 01:56:58",1437469018,"C8",95085,1437564103,"2015-07-22 04:21:43"
"4685","20151618021648-198","2","2015-07-21 02:27:04",1437470824,"C8",108308,1437579132,"2015-07-22 08:32:12"
"2513","20152012012031-178","2","2015-07-21 02:44:36",1437471876,"C4",105635,1437577511,"2015-07-22 08:05:11"
"2024","20151621011631-58","1","2015-07-21 02:56:47",1437472607,"C5",319352,1437791959,"2015-07-24 19:39:19"
"2898","20153407043429-914","1","2015-07-21 03:13:20",1437473600,"C7",165933,1437639533,"2015-07-23 01:18:53"
"6000","20155508105537-280","1","2015-07-21 03:40:25",1437475225,"C8",548544,1438023769,"2015-07-27 12:02:49"
"6069","20150908080915-434","3","2015-07-21 04:29:05",1437478145,"C8",221998,1437700143,"2015-07-23 18:09:03"
"3642","20153312063341-591","3","2015-07-21 04:40:53",1437478853,"C4",96354,1437575207,"2015-07-22 07:26:47"
"6081","20151919061928-62","3","2015-07-21 04:56:16",1437479776,"C3",83904,1437563680,"2015-07-22 04:14:40"
"4722","20150315040346-314","1","2015-07-21 05:13:14",1437480794,"C8",239684,1437720478,"2015-07-23 23:47:58"
"5479","20155817085808-370","1","2015-07-21 05:23:56",1437481436,"C5",110916,1437592352,"2015-07-22 12:12:32"
"3057","20150303080344-262","1","2015-07-21 05:37:44",1437482264,"C7",220920,1437703184,"2015-07-23 18:59:44"
"1231","20150103100107-497","1","2015-07-21 05:41:55",1437482515,"C6",192456,1437674971,"2015-07-23 11:09:31"
"6475","20155219035228-248","1","2015-07-21 05:52:20",1437483140,"C8",68396,1437551536,"2015-07-22 00:52:16"
"6496","20153318113337-404","3","2015-07-21 06:10:15",1437484215,"C7",119899,1437604114,"2015-07-22 15:28:34"
"2915","20154018024000-428","1","2015-07-21 07:26:03",1437488763,"C4",233163,1437721926,"2015-07-24 00:12:06"
"3377","20151020031037-765","2","2015-07-21 07:26:06",1437488766,"C3",58529,1437547295,"2015-07-21 23:41:35"
"3751","20153824083801-208","1","2015-07-21 07:56:41",1437490601,"C4",291290,1437781891,"2015-07-24 16:51:31"
"1974","20150514120512-102","1","2015-07-21 08:30:12",1437492612,"C7",295950,1437788562,"2015-07-24 18:42:42"
"4141","20154219094203-849","2","2015-07-21 08:37:13",1437493033,"C8",84455,1437577488,"2015-07-22 08:04:48"
"5312","20150105010142-777","3","2015-07-21 08:56:09",1437494169,"C2",195381,1437689550,"2015-07-23 15:12:30"
"5872","20155118115127-143","1","2015-07-21 09:00:03",1437494403,"C3",82972,1437577375,"2015-07-22 08:02:55"
"1323","20153801073845-972","1","2015-07-21 09:25:25",1437495925,"C2",216800,1437712725,"2015-07-23 21:38:45"
"1039","20151612031639-61","1","2015-07-21 10:09:39",1437498579,"C8",151836,1437650415,"2015-07-23 04:20:15"
"3882","20151920101933-665","1","2015-07-21 10:26:51",1437499611,"C5",892946,1438392557,"2015-07-31 18:29:17"
"3934","20153718113750-118","2","2015-07-21 10:55:05",1437501305,"C4",85545,1437586850,"2015-07-22 10:40:50"
"6017","20153719063729-533","1","2015-07-21 12:20:57",1437506457,"C5",96704,1437603161,"2015-07-22 15:12:41"
"6404","20152709072703-969","1","2015-07-21 12:23:51",1437506631,"C6",607768,1438114399,"2015-07-28 13:13:19"
"4520","20151816061843-103","1","2015-07-21 13:14:57",1437509697,"C5",228487,1437738184,"2015-07-24 04:43:04"
"3058","20152413042403-986","3","2015-07-21 13:25:13",1437510313,"C8",97210,1437607523,"2015-07-22 16:25:23"
"3018","20152614112602-965","3","2015-07-21 13:51:45",1437511905,"C5",87649,1437599554,"2015-07-22 14:12:34"
"265","20151512011521-735","1","2015-07-21 13:55:21",1437512121,"C4",260000,1437772121,"2015-07-24 14:08:41"
"5037","20151215111234-603","2","2015-07-21 14:16:24",1437513384,"C5",264715,1437778099,"2015-07-24 15:48:19"
"3845","20150319090314-498","2","2015-07-21 14:20:52",1437513652,"C3",95929,1437609581,"2015-07-22 16:59:41"
"5862","20153505103526-82","1","2015-07-21 14:42:56",1437514976,"C4",465750,1437980726,"2015-07-27 00:05:26"
"475","20151713011710-914","3","2015-07-21 14:59:22",1437515962,"C5",348666,1437864628,"2015-07-25 15:50:28"
"2324","20151420041437-875","1","2015-07-21 16:18:46",1437520726,"C2",86649,1437607375,"2015-07-22 16:22:55"
"4396","20154511114515-568","1","2015-07-21 16:40:25",1437522025,"C8",176342,1437698367,"2015-07-23 17:39:27"
"184","20151008101045-291","3","2015-07-21 16:56:26",1437522986,"C2",1147541,1438670527,"2015-08-03 23:42:07"
"2535","20151717121704-659","3","2015-07-21 17:17:26",1437524246,"C0",181811,1437706057,"2015-07-23 19:47:37"
"2814","20151820101849-472","2","2015-07-21 17:19:58",1437524398,"C4",111669,1437636067,"2015-07-23 00:21:07"
"4680","20153518113501-500","1","2015-07-21 17:23:34",1437524614,"C3",93371,1437617985,"2015-07-22 19:19:45"
"3987","20154018034049-540","2","2015-07-21 17:25:33",1437524733,"C4",265484,1437790217,"2015-07-24 19:10:17"
"4040","20155504065559-69","1","2015-07-21 17:40:59",1437525659,"C8",301500,1437827159,"2015-07-25 05:25:59"
"1297","20153801123847-62","1","2015-07-21 17:41:15",1437525675,"C4",873074,1438398749,"2015-07-31 20:12:29"
"6067","20154617064600-936","1","2015-07-21 17:49:44",1437526184,"C7",192712,1437718896,"2015-07-23 23:21:36"
"6158","20155413095429-78","2","2015-07-21 18:11:51",1437527511,"C2",360521,1437888032,"2015-07-25 22:20:32"
"5344","20155605125654-111","1","2015-07-21 18:44:29",1437529469,"C8",200465,1437729934,"2015-07-24 02:25:34"
"3223","20154611014601-555","3","2015-07-21 18:55:43",1437530143,"C5",441291,1437971434,"2015-07-26 21:30:34"
"900","20150008010023-545","3","2015-07-21 21:08:02",1437538082,"C2",164637,1437702719,"2015-07-23 18:51:59"
"2369","20150820090811-228","2","2015-07-21 22:11:36",1437541896,"C0",133405,1437675301,"2015-07-23 11:15:01"
"418","20155809075828-607","1","2015-07-21 22:35:42",1437543342,"C0",544717,1438088059,"2015-07-28 05:54:19"
"639","20153712013720-181","False","2015-07-21 22:46:14",1437543974,"C6",205781,1437749755,"2015-07-24 07:55:55"
"4459","20152401092405-316","3","2015-07-21 23:00:37",1437544837,"C7",253856,1437798693,"2015-07-24 21:31:33"
"3564","20153516073525-833","2","2015-07-21 23:16:55",1437545815,"C6",81415,1437627230,"2015-07-22 21:53:50"
"6522","20155409035441-881","2","2015-07-21 23:22:11",1437546131,"C4",354550,1437900681,"2015-07-26 01:51:21"
"4182","20155013065048-240","1","2015-07-21 23:24:36",1437546276,"C7",375414,1437921690,"2015-07-26 07:41:30"
"4135","20155112125144-954","2","2015-07-21 23:44:31",1437547471,"C7",116681,1437664152,"2015-07-23 08:09:12"
"4797","20151413081417-823","1","2015-07-21 23:56:49",1437548209,"C0",93469,1437641678,"2015-07-23 01:54:38"
"3412","20155517115552-543","1","2015-07-22 00:01:54",1437548514,"C5",194581,1437743095,"2015-07-24 06:04:55"
"4217","20152319052357-61","3","2015-07-22 01:10:45",1437552645,"C0",349101,1437901746,"2015-07-26 02:09:06"
"6491","20150119010140-843","3","2015-07-22 01:42:12",1437554532,"C4",109216,1437663748,"2015-07-23 08:02:28"
"1386","20153205073222-529","2","2015-07-22 02:19:37",1437556777,"C4",483345,1438040122,"2015-07-27 16:35:22"
"2690","20154615114612-209","2","2015-07-22 03:04:44",1437559484,"C4",286756,1437846240,"2015-07-25 10:44:00"
"1561","20150817120835-419","3","2015-07-22 03:05:55",1437559555,"C8",79888,1437639443,"2015-07-23 01:17:23"
"1221","20155415105401-84","2","2015-07-22 03:15:45",1437560145,"C6",72163,1437632308,"2015-07-22 23:18:28"
"1610","20150920090915-26","2","2015-07-22 03:30:25",1437561025,"C8",76235,1437637260,"2015-07-23 00:41:00"
"1533","20153412063404-685","2","2015-07-22 03:30:29",1437561029,"C5",121855,1437682884,"2015-07-23 13:21:24"
"6342","20154111074111-452","1","2015-07-22 03:30:39",1437561039,"C5",467684,1438028723,"2015-07-27 13:25:23"
"3445","20153618113644-795","1","2015-07-22 04:11:47",1437563507,"C2",106301,1437669808,"2015-07-23 09:43:28"
"4117","20150319020304-688","1","2015-07-22 04:27:38",1437564458,"C0",112337,1437676795,"2015-07-23 11:39:55"
"1437","20153019043019-743","2","2015-07-22 04:30:11",1437564611,"C8",107996,1437672607,"2015-07-23 10:30:07"
"5938","20154114054132-501","2","2015-07-22 05:36:00",1437568560,"C4",92524,1437661084,"2015-07-23 07:18:04"
"3543","20155901125946-822","2","2015-07-22 07:02:32",1437573752,"C4",256138,1437829890,"2015-07-25 06:11:30"
"3343","20150320010324-914","2","2015-07-22 07:14:59",1437574499,"C2",151895,1437726394,"2015-07-24 01:26:34"
"669","20155218085232-407","3","2015-07-22 07:17:53",1437574673,"C2",113307,1437687980,"2015-07-23 14:46:20"
"5208","20153519103528-888","2","2015-07-22 07:55:28",1437576928,"C0",124800,1437701728,"2015-07-23 18:35:28"
"1428","20151505031524-959","2","2015-07-22 08:14:44",1437578084,"C3",180445,1437758529,"2015-07-24 10:22:09"
"5052","20151620101652-108","1","2015-07-22 08:37:18",1437579438,"C7",83413,1437662851,"2015-07-23 07:47:31"
"325","20154508124538-434","2","2015-07-22 09:42:21",1437583341,"C7",171229,1437754570,"2015-07-24 09:16:10"
"2062","20151314091343-744","1","2015-07-22 10:10:49",1437585049,"C6",547771,1438132820,"2015-07-28 18:20:20"
"4526","20154416044414-95","2","2015-07-22 10:16:38",1437585398,"C8",247572,1437832970,"2015-07-25 07:02:50"
"2652","20152813122838-287","2","2015-07-22 10:17:50",1437585470,"C6",420219,1438005689,"2015-07-27 07:01:29"
"4604","20154519024544-322","False","2015-07-22 11:03:18",1437588198,"C4",203600,1437791798,"2015-07-24 19:36:38"
"773","20150105060134-242","1","2015-07-22 11:14:26",1437588866,"C6",1487572,1439076438,"2015-08-08 16:27:18"
"1888","20152516072549-566","1","2015-07-22 11:43:31",1437590611,"C5",266931,1437857542,"2015-07-25 13:52:22"
"3378","20150011070002-311","3","2015-07-22 12:45:30",1437594330,"C0",485564,1438079894,"2015-07-28 03:38:14"
"3716","20150716100718-333","1","2015-07-22 13:11:23",1437595883,"C8",105889,1437701772,"2015-07-23 18:36:12"
"4013","20151520101518-94","3","2015-07-22 13:26:52",1437596812,"C8",92147,1437688959,"2015-07-23 15:02:39"
"2665","20155319035337-279","1","2015-07-22 13:34:46",1437597286,"C4",83623,1437680909,"2015-07-23 12:48:29"
"4730","20152117032144-298","1","2015-07-22 14:01:07",1437598867,"C2",427163,1438026030,"2015-07-27 12:40:30"
"2259","20154505124525-350","1","2015-07-22 14:43:17",1437601397,"C5",184484,1437785881,"2015-07-24 17:58:01"
"848","20150417070431-372","1","2015-07-22 14:47:17",1437601637,"C6",459766,1438061403,"2015-07-27 22:30:03"
"4882","20152918122930-367","2","2015-07-22 14:49:56",1437601796,"C8",177013,1437778809,"2015-07-24 16:00:09"
"2880","20153719053715-589","3","2015-07-22 15:01:03",1437602463,"C0",83276,1437685739,"2015-07-23 14:08:59"
"2119","20150010020057-694","2","2015-07-22 15:24:03",1437603843,"C5",520893,1438124736,"2015-07-28 16:05:36"
"6480","20150303120312-233","3","2015-07-22 15:25:12",1437603912,"C6",206715,1437810627,"2015-07-25 00:50:27"
"3508","20151315091329-68","1","2015-07-22 17:07:05",1437610025,"C2",79152,1437689177,"2015-07-23 15:06:17"
"2423","20154624094613-438","2","2015-07-22 17:11:32",1437610292,"C2",349417,1437959709,"2015-07-26 18:15:09"
"4394","20151113061132-529","3","2015-07-22 17:32:12",1437611532,"C2",818440,1438429972,"2015-08-01 04:52:52"
"6235","20153725083712-151","3","2015-07-22 17:46:48",1437612408,"C6",394296,1438006704,"2015-07-27 07:18:24"
"4309","20150226090206-282","1","2015-07-22 18:25:02",1437614702,"C3",285022,1437899724,"2015-07-26 01:35:24"
"5751","20154612014642-990","1","2015-07-22 19:27:47",1437618467,"C2",884465,1438502932,"2015-08-02 01:08:52"
"4392","20154618064654-392","1","2015-07-22 19:39:08",1437619148,"C8",195967,1437815115,"2015-07-25 02:05:15"
"3568","20154021044054-397","2","2015-07-22 20:14:38",1437621278,"C5",49612,1437670890,"2015-07-23 10:01:30"
"2459","20150214020239-72","2","2015-07-22 21:08:31",1437624511,"C6",413594,1438038105,"2015-07-27 16:01:45"
"635","20155619105610-134","2","2015-07-22 22:19:00",1437628740,"C6",300170,1437928910,"2015-07-26 09:41:50"
"3225","20154610074635-808","1","2015-07-23 01:06:11",1437638771,"C6",183196,1437821967,"2015-07-25 03:59:27"
"1141","20154708044728-934","1","2015-07-23 01:11:52",1437639112,"C4",413288,1438052400,"2015-07-27 20:00:00"
"3906","20150828060845-403","3","2015-07-23 02:09:10",1437642550,"C8",429125,1438071675,"2015-07-28 01:21:15"
"4168","20150304020357-184","1","2015-07-23 02:13:29",1437642809,"C3",799486,1438442295,"2015-08-01 08:18:15"
"2093","20150208020258-125","1","2015-07-23 02:30:27",1437643827,"C2",179207,1437823034,"2015-07-25 04:17:14"
"5511","20154519034526-395","1","2015-07-23 03:31:14",1437647474,"C3",100516,1437747990,"2015-07-24 07:26:30"
"5638","20153826063809-399","1","2015-07-23 04:17:45",1437650265,"C7",258264,1437908529,"2015-07-26 04:02:09"
"717","20153111123156-389","1","2015-07-23 04:32:18",1437651138,"C2",504011,1438155149,"2015-07-29 00:32:29"
"4025","20150604010643-971","3","2015-07-23 04:34:21",1437651261,"C5",805429,1438456690,"2015-08-01 12:18:10"
"5310","20154123054103-632","1","2015-07-23 06:29:03",1437658143,"C3",318960,1437977103,"2015-07-26 23:05:03"
"2797","20154203044240-260","1","2015-07-23 07:34:00",1437662040,"C7",612440,1438274480,"2015-07-30 09:41:20"
"5635","20155319105326-404","2","2015-07-23 08:01:36",1437663696,"C5",167645,1437831341,"2015-07-25 06:35:41"
"2729","20154821024843-807","2","2015-07-23 08:47:07",1437666427,"C8",75552,1437741979,"2015-07-24 05:46:19"
"2653","20154818074851-145","1","2015-07-23 09:30:27",1437669027,"C2",219048,1437888075,"2015-07-25 22:21:15"
"2061","20150519040533-38","2","2015-07-23 09:55:00",1437670500,"C2",107789,1437778289,"2015-07-24 15:51:29"
"4485","20151410081406-824","1","2015-07-23 10:28:32",1437672512,"C5",565633,1438238145,"2015-07-29 23:35:45"
"2071","20151121121126-475","1","2015-07-23 10:37:18",1437673038,"C5",83576,1437756614,"2015-07-24 09:50:14"
"4245","20152809032822-774","1","2015-07-23 10:59:46",1437674386,"C5",1892742,1439567128,"2015-08-14 08:45:28"
"5442","20151518041531-923","1","2015-07-23 11:22:37",1437675757,"C5",138142,1437813899,"2015-07-25 01:44:59"
"2077","20153722113733-394","1","2015-07-23 11:23:21",1437675801,"C0",85548,1437761349,"2015-07-24 11:09:09"
"5132","20150517110524-251","2","2015-07-23 11:41:12",1437676872,"C5",74364,1437751236,"2015-07-24 08:20:36"
"5920","20151522081519-492","2","2015-07-23 12:12:46",1437678766,"C4",100647,1437779413,"2015-07-24 16:10:13"
"1110","20150513060545-668","1","2015-07-23 12:18:12",1437679092,"C4",126621,1437805713,"2015-07-24 23:28:33"
"4750","20152211022237-502","2","2015-07-23 13:39:53",1437683993,"C3",147748,1437831741,"2015-07-25 06:42:21"
"5609","20154509024548-175","1","2015-07-23 14:00:52",1437685252,"C4",603452,1438288704,"2015-07-30 13:38:24"
"318","20150722110714-462","3","2015-07-23 14:21:30",1437686490,"C3",98056,1437784546,"2015-07-24 17:35:46"
"5215","20152512062542-417","1","2015-07-23 14:22:54",1437686574,"C4",122379,1437808953,"2015-07-25 00:22:33"
"243","20151921051948-603","3","2015-07-23 14:35:06",1437687306,"C0",81459,1437768765,"2015-07-24 13:12:45"
"1492","20151615061625-429","3","2015-07-23 15:34:57",1437690897,"C5",473816,1438164713,"2015-07-29 03:11:53"
"829","20155405035411-744","3","2015-07-23 16:26:26",1437693986,"C8",311427,1438005413,"2015-07-27 06:56:53"
"6473","20154305084350-216","2","2015-07-23 16:59:26",1437695966,"C5",522117,1438218083,"2015-07-29 18:01:23"
"2951","20153202033251-484","2","2015-07-23 17:34:35",1437698075,"C5",227713,1437925788,"2015-07-26 08:49:48"
"3597","20153103113118-650","1","2015-07-23 17:56:17",1437699377,"C4",250157,1437949534,"2015-07-26 15:25:34"
"2141","20153419063421-197","2","2015-07-23 18:12:12",1437700332,"C2",129157,1437829489,"2015-07-25 06:04:49"
"4494","20152019112015-444","3","2015-07-23 18:19:49",1437700789,"C4",185387,1437886176,"2015-07-25 21:49:36"
"2755","20151603061640-724","2","2015-07-23 18:20:22",1437700822,"C8",885711,1438586533,"2015-08-03 00:22:13"
"2439","20153604123646-881","3","2015-07-23 18:28:08",1437701288,"C5",237526,1437938814,"2015-07-26 12:26:54"
"5673","20152914062912-293","2","2015-07-23 18:49:22",1437702562,"C7",117430,1437819992,"2015-07-25 03:26:32"
"6277","20151029081008-399","1","2015-07-23 18:52:40",1437702760,"C7",301736,1438004496,"2015-07-27 06:41:36"
"5676","20153721113747-248","3","2015-07-23 18:55:03",1437702903,"C4",99518,1437802421,"2015-07-24 22:33:41"
"2235","20153011083029-396","1","2015-07-23 19:28:20",1437704900,"C5",358757,1438063657,"2015-07-27 23:07:37"
"4319","20152115022106-782","1","2015-07-23 20:02:08",1437706928,"C5",101666,1437808594,"2015-07-25 00:16:34"
"3214","20155121075125-805","2","2015-07-23 20:46:37",1437709597,"C4",351414,1438061011,"2015-07-27 22:23:31"
"4161","20154918014930-425","1","2015-07-23 21:17:00",1437711420,"C8",91770,1437803190,"2015-07-24 22:46:30"
"4932","20152408032407-297","2","2015-07-23 22:26:31",1437715591,"C5",165168,1437880759,"2015-07-25 20:19:19"
"6394","20154003034016-1","2","2015-07-23 22:44:48",1437716688,"C8",250496,1437967184,"2015-07-26 20:19:44"
"6323","20152517092529-612","3","2015-07-23 22:46:05",1437716765,"C6",94406,1437811171,"2015-07-25 00:59:31"
"741","20151526051513-980","1","2015-07-23 23:38:06",1437719886,"C4",336539,1438056425,"2015-07-27 21:07:05"
"1694","20151109081144-678","3","2015-07-23 23:57:44",1437721064,"C3",422120,1438143184,"2015-07-28 21:13:04"
"3565","20153609073654-587","1","2015-07-24 00:03:32",1437721412,"C8",634399,1438355811,"2015-07-31 08:16:51"
"3139","20150615090601-623","2","2015-07-24 00:14:28",1437722068,"C3",248569,1437970637,"2015-07-26 21:17:17"
"123","20150219060243-351","3","2015-07-24 01:00:34",1437724834,"C3",137957,1437862791,"2015-07-25 15:19:51"
"5260","20154925034902-555","1","2015-07-24 01:07:24",1437725244,"C5",350386,1438075630,"2015-07-28 02:27:10"
"5647","20153917023952-510","3","2015-07-24 01:21:31",1437726091,"C5",79557,1437805648,"2015-07-24 23:27:28"
"3062","20151322051315-282","1","2015-07-24 01:43:27",1437727407,"C8",58506,1437785913,"2015-07-24 17:58:33"
"5081","20154106054126-881","3","2015-07-24 02:12:22",1437729142,"C5",187432,1437916574,"2015-07-26 06:16:14"
"2178","20153219083225-701","1","2015-07-24 03:52:31",1437735151,"C8",207603,1437942754,"2015-07-26 13:32:34"
"5983","20151722101713-627","2","2015-07-24 05:13:37",1437740017,"C5",77292,1437817309,"2015-07-25 02:41:49"
"6080","20151722051724-428","1","2015-07-24 05:22:52",1437740572,"C5",340241,1438080813,"2015-07-28 03:53:33"
"1640","20154822114816-84","1","2015-07-24 05:43:08",1437741788,"C7",75446,1437817234,"2015-07-25 02:40:34"
"4820","20151920081908-214","2","2015-07-24 05:56:16",1437742576,"C4",168514,1437911090,"2015-07-26 04:44:50"
"5286","20155016015015-241","1","2015-07-24 06:44:54",1437745494,"C8",95097,1437840591,"2015-07-25 09:09:51"
"2775","20150508030553-514","3","2015-07-24 07:10:33",1437747033,"C8",270776,1438017809,"2015-07-27 10:23:29"
"3827","20153626053623-916","3","2015-07-24 07:31:14",1437748274,"C4",794297,1438542571,"2015-08-02 12:09:31"
"2974","20152221102210-862","1","2015-07-24 08:17:22",1437751042,"C0",125856,1437876898,"2015-07-25 19:14:58"
"5965","20153915073941-58","1","2015-07-24 08:35:39",1437752139,"C3",390479,1438142618,"2015-07-28 21:03:38"
"4816","20151523061521-500","1","2015-07-24 08:45:14",1437752714,"C4",95393,1437848107,"2015-07-25 11:15:07"
"4926","20155722025727-208","1","2015-07-24 08:50:11",1437753011,"C8",75382,1437828393,"2015-07-25 05:46:33"
"2581","20155313085311-65","3","2015-07-24 08:57:16",1437753436,"C8",190129,1437943565,"2015-07-26 13:46:05"
"236","20155320095336-544","2","2015-07-24 09:18:00",1437754680,"C2",114488,1437869168,"2015-07-25 17:06:08"
"5978","20152005042050-261","1","2015-07-24 10:29:59",1437758999,"C5",540183,1438299182,"2015-07-30 16:33:02"
"3116","20155901075938-57","2","2015-07-24 10:30:38",1437759038,"C8",285180,1438044218,"2015-07-27 17:43:38"
"1723","20155712035738-767","3","2015-07-24 10:32:55",1437759175,"C4",1017317,1438776492,"2015-08-05 05:08:12"
"2073","20150722090733-194","1","2015-07-24 10:33:22",1437759202,"C4",177949,1437937151,"2015-07-26 11:59:11"
"1487","20154619054626-112","2","2015-07-24 11:29:56",1437762596,"C8",81882,1437844478,"2015-07-25 10:14:38"
"1627","20152917012956-923","1","2015-07-24 11:31:08",1437762668,"C4",199224,1437961892,"2015-07-26 18:51:32"
"6050","20155317105335-21","1","2015-07-24 12:34:41",1437766481,"C7",67874,1437834355,"2015-07-25 07:25:55"
"1384","20151208041208-309","1","2015-07-24 12:42:28",1437766948,"C8",273964,1438040912,"2015-07-27 16:48:32"
"3731","20150722040729-834","1","2015-07-24 12:48:18",1437767298,"C2",160849,1437928147,"2015-07-26 09:29:07"
"2589","20155222035235-759","1","2015-07-24 12:50:03",1437767403,"C8",80924,1437848327,"2015-07-25 11:18:47"
"3375","20150221060206-207","2","2015-07-24 12:58:24",1437767904,"C2",142089,1437909993,"2015-07-26 04:26:33"
"1852","20153919053954-565","1","2015-07-24 13:42:39",1437770559,"C3",139255,1437909814,"2015-07-26 04:23:34"
"5159","20151307081300-707","1","2015-07-24 15:14:28",1437776068,"C5",510761,1438286829,"2015-07-30 13:07:09"
"4823","20152704022701-232","1","2015-07-24 15:30:07",1437777007,"C5",577262,1438354269,"2015-07-31 07:51:09"
"6243","20152118082127-664","2","2015-07-24 16:23:25",1437780205,"C0",273659,1438053864,"2015-07-27 20:24:24"
"6242","20155417075428-77","1","2015-07-24 16:33:32",1437780812,"C6",79493,1437860305,"2015-07-25 14:38:25"
"2700","20154213044259-545","1","2015-07-24 16:56:42",1437782202,"C8",135889,1437918091,"2015-07-26 06:41:31"
"4528","20152824112857-18","1","2015-07-24 16:59:33",1437782373,"C2",870612,1438652985,"2015-08-03 18:49:45"
"1750","20154112014114-381","False","2015-07-24 17:20:09",1437783609,"C6",203760,1437987369,"2015-07-27 01:56:09"
"6284","20152819062830-519","2","2015-07-24 17:36:15",1437784575,"C0",472065,1438256640,"2015-07-30 04:44:00"
"631","20152021052037-513","2","2015-07-24 17:54:15",1437785655,"C5",130609,1437916264,"2015-07-26 06:11:04"
"825","20152216082220-757","1","2015-07-24 18:21:47",1437787307,"C8",103881,1437891188,"2015-07-25 23:13:08"
"6492","20153817073832-550","2","2015-07-24 18:40:02",1437788402,"C4",214830,1438003232,"2015-07-27 06:20:32"
"124","20152316052346-175","2","2015-07-24 18:44:55",1437788695,"C2",232023,1438020718,"2015-07-27 11:11:58"
"5122","20152207082206-772","2","2015-07-24 18:56:26",1437789386,"C8",301372,1438090758,"2015-07-28 06:39:18"
"1500","20155620065658-617","1","2015-07-24 19:16:16",1437790576,"C2",425994,1438216570,"2015-07-29 17:36:10"
"3285","20151210101237-47","2","2015-07-24 20:11:31",1437793891,"C2",415178,1438209069,"2015-07-29 15:31:09"
"897","20152515112517-831","1","2015-07-24 20:20:50",1437794450,"C0",269911,1438064361,"2015-07-27 23:19:21"
"4985","20153215113217-764","3","2015-07-24 20:49:45",1437796185,"C2",101381,1437897566,"2015-07-26 00:59:26"
"4408","20152207042208-551","1","2015-07-24 21:07:48",1437797268,"C8",742970,1438540238,"2015-08-02 11:30:38"
"726","20155705065729-214","2","2015-07-24 21:09:59",1437797399,"C6",282125,1438079524,"2015-07-28 03:32:04"
"1887","20153310113338-127","2","2015-07-24 21:38:40",1437799120,"C7",177986,1437977106,"2015-07-26 23:05:06"
"576","20151618051609-530","1","2015-07-24 21:50:11",1437799811,"C5",267421,1438067232,"2015-07-28 00:07:12"
"3324","20155610125653-388","2","2015-07-24 23:06:49",1437804409,"C5",178028,1437982437,"2015-07-27 00:33:57"
"376","20155210025230-794","1","2015-07-24 23:14:18",1437804858,"C4",619854,1438424712,"2015-08-01 03:25:12"
"5068","20152819122847-981","1","2015-07-25 00:11:33",1437808293,"C7",67738,1437876031,"2015-07-25 19:00:31"
"71","20152909122903-463","1","2015-07-25 00:23:03",1437808983,"C4",167355,1437976338,"2015-07-26 22:52:18"
"5807","20153125023152-681","2","2015-07-25 00:33:52",1437809632,"C4",847240,1438656872,"2015-08-03 19:54:32"
"3971","20155905015920-414","1","2015-07-25 00:47:00",1437810420,"C8",840230,1438650650,"2015-08-03 18:10:50"
"353","20154809124808-913","3","2015-07-25 01:00:49",1437811249,"C4",191423,1438002672,"2015-07-27 06:11:12"
"140","20154116034139-452","1","2015-07-25 01:56:59",1437814619,"C0",91015,1437905634,"2015-07-26 03:13:54"
"3001","20154719024718-326","1","2015-07-25 02:15:10",1437815710,"C5",236636,1438052346,"2015-07-27 19:59:06"
"796","20151722091759-375","2","2015-07-25 02:48:05",1437817685,"C0",78602,1437896287,"2015-07-26 00:38:07"
"1985","20150516080500-163","1","2015-07-25 02:51:46",1437817906,"C4",379403,1438197309,"2015-07-29 12:15:09"
"2","20153118013100-425","2","2015-07-25 02:55:06",1437818106,"C7",283323,1438101429,"2015-07-28 09:37:09"
"2460","20152517072551-546","1","2015-07-25 02:56:50",1437818210,"C0",96437,1437914647,"2015-07-26 05:44:07"
"6254","20152817062846-890","2","2015-07-25 03:02:25",1437818545,"C0",226273,1438044818,"2015-07-27 17:53:38"
"2830","20151211061235-957","2","2015-07-25 03:13:58",1437819238,"C5",171269,1437990507,"2015-07-27 02:48:27"
"6507","20155614075656-559","1","2015-07-25 04:09:56",1437822596,"C8",468390,1438290986,"2015-07-30 14:16:26"
"6549","20150019010017-785","2","2015-07-25 04:48:15",1437824895,"C4",244439,1438069334,"2015-07-28 00:42:14"
"5279","20153324063329-147","1","2015-07-25 06:04:15",1437829455,"C6",84646,1437914101,"2015-07-26 05:35:01"
"1210","20151724081751-413","2","2015-07-25 06:13:15",1437829995,"C4",78924,1437908919,"2015-07-26 04:08:39"
"831","20150408090423-286","1","2015-07-25 06:22:55",1437830575,"C2",182389,1438012964,"2015-07-27 09:02:44"
"5900","20150123070109-172","2","2015-07-25 06:25:50",1437830750,"C4",170681,1438001431,"2015-07-27 05:50:31"
"453","20152119092102-380","1","2015-07-25 06:34:32",1437831272,"C7",72630,1437903902,"2015-07-26 02:45:02"
"3300","20152118022105-958","1","2015-07-25 06:50:45",1437832245,"C2",577780,1438410025,"2015-07-31 23:20:25"
"869","20154109074131-62","2","2015-07-25 07:07:57",1437833277,"C7",197198,1438030475,"2015-07-27 13:54:35"
"5202","20153117063125-391","3","2015-07-25 08:42:29",1437838949,"C4",87383,1437926332,"2015-07-26 08:58:52"
"2167","20154819044802-78","2","2015-07-25 08:57:54",1437839874,"C8",245096,1438084970,"2015-07-28 05:02:50"
"3088","20152120032107-809","1","2015-07-25 09:11:31",1437840691,"C2",51228,1437891919,"2015-07-25 23:25:19"
"4098","20154823074803-769","1","2015-07-25 09:29:26",1437841766,"C4",178883,1438020649,"2015-07-27 11:10:49"
"4776","20150409070446-883","2","2015-07-25 10:50:26",1437846626,"C8",279188,1438125814,"2015-07-28 16:23:34"
"4736","20151319041336-619","2","2015-07-25 10:53:54",1437846834,"C6",83203,1437930037,"2015-07-26 10:00:37"
"2130","20155203065228-993","1","2015-07-25 11:22:38",1437848558,"C8",383402,1438231960,"2015-07-29 21:52:40"
"3794","20153717113702-835","1","2015-07-25 11:36:46",1437849406,"C5",86398,1437935804,"2015-07-26 11:36:44"
"2891","20151523091548-948","2","2015-07-25 12:08:10",1437851290,"C4",91571,1437942861,"2015-07-26 13:34:21"
"2021","20151721111744-664","1","2015-07-25 12:19:26",1437851966,"C8",174651,1438026617,"2015-07-27 12:50:17"
"5391","20153723103744-695","1","2015-07-25 12:28:08",1437852488,"C3",89712,1437942200,"2015-07-26 13:23:20"
"4532","20154103084141-252","3","2015-07-25 13:38:08",1437856688,"C4",639529,1438496217,"2015-08-01 23:16:57"
"1626","20151918061901-392","3","2015-07-25 14:29:35",1437859775,"C8",317117,1438176892,"2015-07-29 06:34:52"
"3109","20151811041814-115","2","2015-07-25 14:59:50",1437861590,"C4",172128,1438033718,"2015-07-27 14:48:38"
"5771","20154320014349-634","1","2015-07-25 15:01:24",1437861684,"C5",432665,1438294349,"2015-07-30 15:12:29"
"2419","20155522055527-809","1","2015-07-25 15:58:54",1437865134,"C0",84069,1437949203,"2015-07-26 15:20:03"
"5408","20154421044426-552","1","2015-07-25 16:16:02",1437866162,"C7",171948,1438038110,"2015-07-27 16:01:50"
"5206","20152005092047-998","2","2015-07-25 16:22:45",1437866565,"C5",250474,1438117039,"2015-07-28 13:57:19"
"3201","20153322083304-339","2","2015-07-25 16:35:39",1437867339,"C2",288155,1438155494,"2015-07-29 00:38:14"
"5923","20153428103458-866","2","2015-07-25 18:05:06",1437872706,"C4",294976,1438167682,"2015-07-29 04:01:22"
"899","20153920073949-207","1","2015-07-25 18:25:27",1437873927,"C5",437534,1438311461,"2015-07-30 19:57:41"
"5910","20152217032234-627","2","2015-07-25 18:34:10",1437874450,"C5",87837,1437962287,"2015-07-26 18:58:07"
"1674","20155704065719-686","1","2015-07-25 18:49:19",1437875359,"C8",371424,1438246783,"2015-07-30 01:59:43"
"2971","20152723112739-990","3","2015-07-25 18:51:55",1437875515,"C8",99728,1437975243,"2015-07-26 22:34:03"
"3541","20152917092938-198","1","2015-07-25 19:56:26",1437879386,"C5",91101,1437970487,"2015-07-26 21:14:47"
"12","20154219104241-223","1","2015-07-25 19:59:56",1437879596,"C2",183945,1438063541,"2015-07-27 23:05:41"
"4163","20152721082743-391","1","2015-07-25 20:11:16",1437880276,"C4",129271,1438009547,"2015-07-27 08:05:47"
"5809","20154217044214-559","1","2015-07-25 20:22:35",1437880955,"C5",234807,1438115762,"2015-07-28 13:36:02"
"1060","20155920055919-29","1","2015-07-25 20:31:43",1437881503,"C7",49016,1437930519,"2015-07-26 10:08:39"
"1106","20154824044810-764","1","2015-07-25 20:49:30",1437882570,"C8",50440,1437933010,"2015-07-26 10:50:10"
"5503","20153915073941-756","1","2015-07-25 21:03:11",1437883391,"C8",456105,1438339496,"2015-07-31 03:44:56"
"5595","20154422084401-555","2","2015-07-25 21:09:46",1437883786,"C5",101315,1437985101,"2015-07-27 01:18:21"
"3486","20150311010308-753","3","2015-07-25 21:59:26",1437886766,"C5",620889,1438507655,"2015-08-02 02:27:35"
"3886","20154324024355-579","3","2015-07-25 22:03:37",1437887017,"C8",56391,1437943408,"2015-07-26 13:43:28"
"2001","20155919085959-705","1","2015-07-25 22:04:40",1437887080,"C5",80783,1437967863,"2015-07-26 20:31:03"
"3600","20155518095558-521","1","2015-07-25 22:26:13",1437888373,"C4",216605,1438104978,"2015-07-28 10:36:18"
"2962","20154715084738-41","2","2015-07-25 23:03:14",1437890594,"C2",438417,1438329011,"2015-07-31 00:50:11"
"6087","20150619110604-788","1","2015-07-26 00:11:22",1437894682,"C5",282759,1438177441,"2015-07-29 06:44:01"
"1180","20153909083938-573","2","2015-07-26 00:43:30",1437896610,"C5",180029,1438076639,"2015-07-28 02:43:59"
"4471","20150411110416-472","2","2015-07-26 00:45:36",1437896736,"C2",179840,1438076576,"2015-07-28 02:42:56"
"2209","20154219114228-262","2","2015-07-26 01:21:53",1437898913,"C8",113513,1438012426,"2015-07-27 08:53:46"
"6419","20152817062832-264","2","2015-07-26 01:41:56",1437900116,"C5",380202,1438280318,"2015-07-30 11:18:38"
"1954","20151820101815-744","2","2015-07-26 01:42:20",1437900140,"C5",69635,1437969775,"2015-07-26 21:02:55"
"5658","20154922084949-200","3","2015-07-26 01:52:43",1437900763,"C0",106858,1438007621,"2015-07-27 07:33:41"
"4530","20150723070741-205","2","2015-07-26 02:17:53",1437902273,"C5",80604,1437982877,"2015-07-27 00:41:17"
"798","20151116031103-753","1","2015-07-26 02:36:43",1437903403,"C8",409370,1438312773,"2015-07-30 20:19:33"
"5466","20152416012433-808","1","2015-07-26 02:39:09",1437903549,"C4",275092,1438178641,"2015-07-29 07:04:01"
"2504","20155717065720-517","1","2015-07-26 03:40:26",1437907226,"C6",127631,1438034857,"2015-07-27 15:07:37"
"835","20155706075759-768","2","2015-07-26 03:40:47",1437907247,"C2",214071,1438121318,"2015-07-28 15:08:38"
"1209","20155416105428-103","2","2015-07-26 04:19:13",1437909553,"C8",168057,1438077610,"2015-07-28 03:00:10"
"3595","20155217115255-205","1","2015-07-26 05:07:13",1437912433,"C5",376629,1438289062,"2015-07-30 13:44:22"
"2400","20155005065043-343","1","2015-07-26 06:19:34",1437916774,"C4",604177,1438520951,"2015-08-02 06:09:11"
"1564","20154421044450-831","3","2015-07-26 07:00:20",1437919220,"C4",396930,1438316150,"2015-07-30 21:15:50"
"2741","20153623113600-392","1","2015-07-26 07:23:03",1437920583,"C6",244023,1438164606,"2015-07-29 03:10:06"
"4234","20154704014703-466","1","2015-07-26 07:42:23",1437921743,"C6",234865,1438156608,"2015-07-29 00:56:48"
"5119","20150922110928-182","1","2015-07-26 08:58:18",1437926298,"C5",168865,1438095163,"2015-07-28 07:52:43"
"5336","20151922121927-280","2","2015-07-26 09:44:05",1437929045,"C5",168139,1438097184,"2015-07-28 08:26:24"
"2957","20153020023013-76","1","2015-07-26 09:50:35",1437929435,"C4",441946,1438371381,"2015-07-31 12:36:21"
"162","20154324014347-139","1","2015-07-26 10:02:13",1437930133,"C5",79753,1438009886,"2015-07-27 08:11:26"
"3345","20153324083337-471","3","2015-07-26 10:09:45",1437930585,"C2",89284,1438019869,"2015-07-27 10:57:49"
"2354","20151510031519-222","1","2015-07-26 10:19:19",1437931159,"C8",272928,1438204087,"2015-07-29 14:08:07"
"6261","20154216104239-427","3","2015-07-26 10:40:08",1437932408,"C8",123407,1438055815,"2015-07-27 20:56:55"
"1695","20151602031635-816","1","2015-07-26 11:08:03",1437934083,"C3",257336,1438191419,"2015-07-29 10:36:59"
"5808","20155513115543-669","1","2015-07-26 11:19:43",1437934783,"C6",186840,1438121623,"2015-07-28 15:13:43"
"3041","20154708064723-472","3","2015-07-26 11:43:12",1437936192,"C4",224707,1438160899,"2015-07-29 02:08:19"
"2458","20150922070941-505","3","2015-07-26 11:50:26",1437936626,"C4",120815,1438057441,"2015-07-27 21:24:01"
"2916","20153113043100-622","2","2015-07-26 12:14:54",1437938094,"C4",1107834,1439045928,"2015-08-08 07:58:48"
"2391","20154323064305-880","1","2015-07-26 12:26:09",1437938769,"C0",139892,1438078661,"2015-07-28 03:17:41"
"1159","20151710081736-544","3","2015-07-26 13:02:32",1437940952,"C5",174937,1438115889,"2015-07-28 13:38:09"
"3649","20151521011536-810","2","2015-07-26 13:40:21",1437943221,"C8",86697,1438029918,"2015-07-27 13:45:18"
"6364","20151413021408-91","2","2015-07-26 14:44:14",1437947054,"C6",187501,1438134555,"2015-07-28 18:49:15"
"2543","20152724022714-969","3","2015-07-26 14:44:45",1437947085,"C4",173851,1438120936,"2015-07-28 15:02:16"
"1700","20155616075650-682","1","2015-07-26 14:48:40",1437947320,"C8",177742,1438125062,"2015-07-28 16:11:02"
"2151","20150312110353-306","1","2015-07-26 14:50:25",1437947425,"C5",152899,1438100324,"2015-07-28 09:18:44"
"5045","20153317083347-992","1","2015-07-26 14:53:17",1437947597,"C0",800370,1438747967,"2015-08-04 21:12:47"
"4237","20150420090410-374","3","2015-07-26 15:10:22",1437948622,"C4",77196,1438025818,"2015-07-27 12:36:58"
"2858","20151216041200-755","1","2015-07-26 15:37:38",1437950258,"C5",430969,1438381227,"2015-07-31 15:20:27"
"4452","20155812015855-673","3","2015-07-26 15:55:35",1437951335,"C5",152075,1438103410,"2015-07-28 10:10:10"
"1189","20154513114555-897","1","2015-07-26 16:27:07",1437953227,"C5",380024,1438333251,"2015-07-31 02:00:51"
"356","20153012023040-460","1","2015-07-26 16:47:59",1437954479,"C7",173977,1438128456,"2015-07-28 17:07:36"
"4950","20150007090049-931","2","2015-07-26 17:13:51",1437956031,"C2",609026,1438565057,"2015-08-02 18:24:17"
"2302","20155620115651-849","1","2015-07-26 17:23:33",1437956613,"C8",269001,1438225614,"2015-07-29 20:06:54"
"5667","20154929114937-129","2","2015-07-26 17:26:18",1437956778,"C3",336143,1438292921,"2015-07-30 14:48:41"
"3950","20153418033431-409","1","2015-07-26 17:40:31",1437957631,"C4",87345,1438044976,"2015-07-27 17:56:16"
"1732","20155126035129-589","2","2015-07-26 19:26:57",1437964017,"C5",325616,1438289633,"2015-07-30 13:53:53"
"3085","20152715102715-129","2","2015-07-26 19:42:51",1437964971,"C4",327912,1438292883,"2015-07-30 14:48:03"
"1779","20152824122825-461","2","2015-07-26 20:22:25",1437967345,"C4",931080,1438898425,"2015-08-06 15:00:25"
"2546","20152216022232-679","1","2015-07-26 21:14:40",1437970480,"C3",111091,1438081571,"2015-07-28 04:06:11"
"975","20152610062612-425","1","2015-07-26 21:57:42",1437973062,"C8",287658,1438260720,"2015-07-30 05:52:00"
"4066","20152816102825-722","1","2015-07-26 21:59:40",1437973180,"C5",301825,1438275005,"2015-07-30 09:50:05"
"4220","20151429051412-750","1","2015-07-26 22:17:24",1437974244,"C8",335856,1438310100,"2015-07-30 19:35:00"
"5219","20154005114042-468","1","2015-07-26 22:41:51",1437975711,"C4",264867,1438240578,"2015-07-30 00:16:18"
"2666","20154025124046-991","1","2015-07-26 23:28:32",1437978512,"C3",62633,1438041145,"2015-07-27 16:52:25"
"242","20151923041923-108","2","2015-07-27 01:31:59",1437985919,"C8",146178,1438132097,"2015-07-28 18:08:17"
"4344","20151920101907-951","1","2015-07-27 02:17:23",1437988643,"C2",71987,1438060630,"2015-07-27 22:17:10"
"2158","20153523083548-153","1","2015-07-27 02:39:48",1437989988,"C2",108080,1438098068,"2015-07-28 08:41:08"
"1292","20152921092932-891","1","2015-07-27 02:41:02",1437990062,"C5",246945,1438237007,"2015-07-29 23:16:47"
"1228","20151801041821-719","2","2015-07-27 02:42:42",1437990162,"C7",313923,1438304085,"2015-07-30 17:54:45"
"705","20150111030116-821","1","2015-07-27 02:48:17",1437990497,"C0",191203,1438181700,"2015-07-29 07:55:00"
"2795","20154018034028-142","1","2015-07-27 02:56:58",1437991018,"C8",365895,1438356913,"2015-07-31 08:35:13"
"4198","20150403120428-179","2","2015-07-27 04:23:16",1437996196,"C2",681976,1438678172,"2015-08-04 01:49:32"
"5477","20151522091559-339","1","2015-07-27 04:32:19",1437996739,"C0",207490,1438204229,"2015-07-29 14:10:29"
"6344","20154819014838-806","2","2015-07-27 04:33:26",1437996806,"C5",82236,1438079042,"2015-07-28 03:24:02"
"4438","20151001091034-497","1","2015-07-27 04:38:22",1437997102,"C1",371678,1438368780,"2015-07-31 11:53:00"
"5019","20153602043607-343","1","2015-07-27 05:13:59",1437999239,"C4",264884,1438264123,"2015-07-30 06:48:43"
"4874","20155823115812-779","1","2015-07-27 05:30:21",1438000221,"C4",107443,1438107664,"2015-07-28 11:21:04"
"239","20152625102655-249","1","2015-07-27 06:13:11",1438002791,"C4",78788,1438081579,"2015-07-28 04:06:19"
"6355","20152020062024-190","1","2015-07-27 06:24:48",1438003488,"C8",302532,1438306020,"2015-07-30 18:27:00"
"2036","20153017103045-244","1","2015-07-27 06:37:25",1438004245,"C8",170000,1438174245,"2015-07-29 05:50:45"
"6333","20151322101302-482","1","2015-07-27 07:40:38",1438008038,"C5",211428,1438219466,"2015-07-29 18:24:26"
"5715","20154002114020-604","2","2015-07-27 08:03:08",1438009388,"C5",268371,1438277759,"2015-07-30 10:35:59"
"2126","20153017103047-976","1","2015-07-27 08:10:53",1438009853,"C0",427803,1438437656,"2015-08-01 07:00:56"
"5397","20151222061237-438","3","2015-07-27 08:14:27",1438010067,"C3",219655,1438229722,"2015-07-29 21:15:22"
"4653","20154023044021-772","2","2015-07-27 08:38:19",1438011499,"C3",158339,1438169838,"2015-07-29 04:37:18"
"2237","20154208034244-0","1","2015-07-27 08:41:46",1438011706,"C4",230906,1438242612,"2015-07-30 00:50:12"
"3786","20150320030349-572","1","2015-07-27 09:09:25",1438013365,"C5",453648,1438467013,"2015-08-01 15:10:13"
"3213","20150704100721-493","2","2015-07-27 09:15:07",1438013707,"C3",283438,1438297145,"2015-07-30 15:59:05"
"4975","20153718113730-766","1","2015-07-27 09:54:42",1438016082,"C2",420429,1438436511,"2015-08-01 06:41:51"
"2045","20153317093336-203","2","2015-07-27 09:58:16",1438016296,"C7",123640,1438139936,"2015-07-28 20:18:56"
"43","20151617011611-701","1","2015-07-27 10:13:13",1438017193,"C3",426511,1438443704,"2015-08-01 08:41:44"
"3941","20155021015058-471","1","2015-07-27 10:17:21",1438017441,"C6",505583,1438523024,"2015-08-02 06:43:44"
"1914","20151501041530-577","2","2015-07-27 10:39:27",1438018767,"C4",742079,1438760846,"2015-08-05 00:47:26"
"3177","20150308110350-292","2","2015-07-27 10:59:20",1438019960,"C6",273555,1438293515,"2015-07-30 14:58:35"
"1655","20152416072430-9","3","2015-07-27 11:08:40",1438020520,"C8",192770,1438213290,"2015-07-29 16:41:30"
"3402","20150910060904-59","2","2015-07-27 11:20:30",1438021230,"C7",212498,1438233728,"2015-07-29 22:22:08"
"2083","20152119072136-180","1","2015-07-27 11:29:32",1438021772,"C8",100868,1438122640,"2015-07-28 15:30:40"
"4435","20151921021945-394","3","2015-07-27 11:39:36",1438022376,"C0",169597,1438191973,"2015-07-29 10:46:13"
"6354","20151621121625-608","3","2015-07-27 11:51:05",1438023065,"C8",103376,1438126441,"2015-07-28 16:34:01"
"3067","20151623091621-956","1","2015-07-27 12:43:09",1438026189,"C2",119336,1438145525,"2015-07-28 21:52:05"
"5806","20150306080327-887","2","2015-07-27 12:51:09",1438026669,"C7",261666,1438288335,"2015-07-30 13:32:15"
"4501","20152616042649-259","1","2015-07-27 13:06:34",1438027594,"C3",134055,1438161649,"2015-07-29 02:20:49"
"2417","20153603093633-912","2","2015-07-27 13:26:18",1438028778,"C8",417477,1438446255,"2015-08-01 09:24:15"
"5050","20152917082925-523","1","2015-07-27 13:26:37",1438028797,"C2",293944,1438322741,"2015-07-30 23:05:41"
"2517","20151526051501-87","1","2015-07-27 14:11:56",1438031516,"C4",75415,1438106931,"2015-07-28 11:08:51"
"5522","20153322053343-539","1","2015-07-27 14:28:27",1438032507,"C2",420884,1438453391,"2015-08-01 11:23:11"
"5707","20155623015620-828","1","2015-07-27 14:56:05",1438034165,"C5",116395,1438150560,"2015-07-28 23:16:00"
"2136","20153217063258-545","2","2015-07-27 14:57:40",1438034260,"C5",298094,1438332354,"2015-07-31 01:45:54"
"6487","20154413074407-257","1","2015-07-27 15:37:43",1438036663,"C5",478752,1438515415,"2015-08-02 04:36:55"
"4636","20152519082511-770","2","2015-07-27 16:16:33",1438038993,"C5",359741,1438398734,"2015-07-31 20:12:14"
"2899","20150817070821-454","2","2015-07-27 16:23:57",1438039437,"C2",112167,1438151604,"2015-07-28 23:33:24"
"1934","20153021083029-997","3","2015-07-27 16:47:49",1438040869,"C8",109648,1438150517,"2015-07-28 23:15:17"
"4320","20155121015153-897","1","2015-07-27 16:55:07",1438041307,"C5",264697,1438306004,"2015-07-30 18:26:44"
"4763","20151518111558-749","2","2015-07-27 16:58:54",1438041534,"C2",99772,1438141306,"2015-07-28 20:41:46"
"1763","20154417054458-449","1","2015-07-27 17:06:20",1438041980,"C7",430841,1438472821,"2015-08-01 16:47:01"
"971","20154914104905-829","3","2015-07-27 17:13:29",1438042409,"C0",382088,1438424497,"2015-08-01 03:21:37"
"6467","20151621031648-283","2","2015-07-27 17:37:12",1438043832,"C4",65853,1438109685,"2015-07-28 11:54:45"
"1701","20155517065511-650","1","2015-07-27 17:44:43",1438044283,"C2",128996,1438173279,"2015-07-29 05:34:39"
"4248","20152421062416-977","1","2015-07-27 17:50:37",1438044637,"C4",559581,1438604218,"2015-08-03 05:16:58"
"1967","20154525054551-322","1","2015-07-27 18:21:27",1438046487,"C5",87468,1438133955,"2015-07-28 18:39:15"
"1299","20151519021534-355","3","2015-07-27 18:25:22",1438046722,"C4",100884,1438147606,"2015-07-28 22:26:46"
"6174","20154415064448-712","1","2015-07-27 20:28:37",1438054117,"C3",1086229,1439140346,"2015-08-09 10:12:26"
"1945","20153423013422-332","2","2015-07-27 22:20:52",1438060852,"C8",75438,1438136290,"2015-07-28 19:18:10"
"5392","20152513092550-113","1","2015-07-27 22:45:00",1438062300,"C0",179650,1438241950,"2015-07-30 00:39:10"
"5907","20152923052943-630","1","2015-07-27 23:16:13",1438064173,"C5",183195,1438247368,"2015-07-30 02:09:28"
"2989","20154926124932-480","1","2015-07-28 00:09:14",1438067354,"C7",63591,1438130945,"2015-07-28 17:49:05"
"3993","20150517090533-187","1","2015-07-28 00:17:39",1438067859,"C4",306242,1438374101,"2015-07-31 13:21:41"
"3669","20155605065613-54","2","2015-07-28 00:53:25",1438070005,"C6",569679,1438639684,"2015-08-03 15:08:04"
"1364","20151424021410-748","3","2015-07-28 01:57:28",1438073848,"C7",150699,1438224547,"2015-07-29 19:49:07"
"2005","20150418030419-69","1","2015-07-28 02:49:22",1438076962,"C5",273301,1438350263,"2015-07-31 06:44:23"
"5363","20153219043201-719","1","2015-07-28 03:09:09",1438078149,"C7",104204,1438182353,"2015-07-29 08:05:53"
"3124","20154321124336-179","1","2015-07-28 03:09:56",1438078196,"C0",1581190,1439659386,"2015-08-15 10:23:06"
"6408","20151710021746-134","1","2015-07-28 03:55:31",1438080931,"C4",505955,1438586886,"2015-08-03 00:28:06"
"1775","20155023065033-796","3","2015-07-28 04:18:39",1438082319,"C4",140962,1438223281,"2015-07-29 19:28:01"
"254","20153425013459-560","1","2015-07-28 04:26:35",1438082795,"C5",352287,1438435082,"2015-08-01 06:18:02"
"1449","20154317114331-457","1","2015-07-28 05:00:51",1438084851,"C2",115780,1438200631,"2015-07-29 13:10:31"
"794","20154517044506-783","3","2015-07-28 05:15:56",1438085756,"C8",181810,1438267566,"2015-07-30 07:46:06"
"5711","20154215124253-8","3","2015-07-28 05:16:32",1438085792,"C4",365473,1438451265,"2015-08-01 10:47:45"
"885","20150022090025-737","1","2015-07-28 05:21:45",1438086105,"C8",101056,1438187161,"2015-07-29 09:26:01"
"1460","20153024113026-294","2","2015-07-28 05:49:00",1438087740,"C5",162557,1438250297,"2015-07-30 02:58:17"
"4566","20153306073311-379","2","2015-07-28 05:51:51",1438087911,"C8",378944,1438466855,"2015-08-01 15:07:35"
"3819","20151022101006-317","1","2015-07-28 06:17:02",1438089422,"C4",387052,1438476474,"2015-08-01 17:47:54"
"488","20150001080044-124","1","2015-07-28 06:44:23",1438091063,"C5",776073,1438867136,"2015-08-06 06:18:56"
"2590","20155621035631-676","2","2015-07-28 07:13:03",1438092783,"C5",395674,1438488457,"2015-08-01 21:07:37"
"1450","20152105062151-555","2","2015-07-28 07:27:15",1438093635,"C5",995562,1439089197,"2015-08-08 19:59:57"
"155","20155219085255-410","1","2015-07-28 07:30:14",1438093814,"C2",110377,1438204191,"2015-07-29 14:09:51"
"5303","20154714074704-144","3","2015-07-28 07:50:43",1438095043,"C4",543117,1438638160,"2015-08-03 14:42:40"
"2410","20153211103235-736","1","2015-07-28 07:55:08",1438095308,"C4",208479,1438303787,"2015-07-30 17:49:47"
"5184","20154513074545-202","1","2015-07-28 08:05:29",1438095929,"C8",185312,1438281241,"2015-07-30 11:34:01"
"2397","20155722085740-393","1","2015-07-28 08:13:56",1438096436,"C0",257888,1438354324,"2015-07-31 07:52:04"
"2678","20151824121833-994","1","2015-07-28 08:34:30",1438097670,"C6",332157,1438429827,"2015-08-01 04:50:27"
"2936","20151312101325-662","3","2015-07-28 09:26:17",1438100777,"C2",689786,1438790563,"2015-08-05 09:02:43"
"1249","20153522073506-41","1","2015-07-28 09:51:24",1438102284,"C5",175526,1438277810,"2015-07-30 10:36:50"
"5031","20152921082906-529","3","2015-07-28 10:23:56",1438104236,"C4",457670,1438561906,"2015-08-02 17:31:46"
"5889","20151711081724-536","1","2015-07-28 10:34:44",1438104884,"C4",184630,1438289514,"2015-07-30 13:51:54"
"2042","20151823031815-439","1","2015-07-28 10:53:51",1438106031,"C4",52017,1438158048,"2015-07-29 01:20:48"
"6027","20150825070821-784","2","2015-07-28 11:16:01",1438107361,"C4",137030,1438244391,"2015-07-30 01:19:51"
"190","20150910080926-255","1","2015-07-28 12:14:12",1438110852,"C8",784943,1438895795,"2015-08-06 14:16:35"
"1324","20152021062038-745","2","2015-07-28 12:59:20",1438113560,"C4",209574,1438323134,"2015-07-30 23:12:14"
"1093","20154822094857-448","2","2015-07-28 13:10:12",1438114212,"C8",1160175,1439274387,"2015-08-10 23:26:27"
"3393","20150518020501-460","1","2015-07-28 14:28:29",1438118909,"C6",432176,1438551085,"2015-08-02 14:31:25"
"3050","20153922013946-38","3","2015-07-28 14:40:22",1438119622,"C2",174012,1438293634,"2015-07-30 15:00:34"
"2785","20152512062545-262","1","2015-07-28 14:59:00",1438120740,"C2",471065,1438591805,"2015-08-03 01:50:05"
"5235","20153910033908-495","3","2015-07-28 15:26:04",1438122364,"C3",518302,1438640666,"2015-08-03 15:24:26"
"1883","20150026110014-327","3","2015-07-28 15:36:24",1438122984,"C5",94685,1438217669,"2015-07-29 17:54:29"
"1073","20155419055407-635","2","2015-07-28 15:40:23",1438123223,"C4",96197,1438219420,"2015-07-29 18:23:40"
"2320","20154816064800-119","1","2015-07-28 15:52:22",1438123942,"C5",523066,1438647008,"2015-08-03 17:10:08"
"4862","20153726023718-952","1","2015-07-28 15:56:44",1438124204,"C3",177566,1438301770,"2015-07-30 17:16:10"
"824","20155017105044-579","1","2015-07-28 16:11:34",1438125094,"C8",193930,1438319024,"2015-07-30 22:03:44"
"4866","20153424103412-281","2","2015-07-28 16:29:48",1438126188,"C5",183468,1438309656,"2015-07-30 19:27:36"
"4861","20152524032503-334","3","2015-07-28 17:05:49",1438128349,"C4",175823,1438304172,"2015-07-30 17:56:12"
"3939","20151723091752-582","1","2015-07-28 17:25:11",1438129511,"C4",461239,1438590750,"2015-08-03 01:32:30"
"5911","20153126013121-122","3","2015-07-28 17:30:07",1438129807,"C7",93563,1438223370,"2015-07-29 19:29:30"
"3810","20154706014712-28","2","2015-07-28 17:47:12",1438130832,"C2",273600,1438404432,"2015-07-31 21:47:12"
"4151","20154315094344-834","2","2015-07-28 18:45:23",1438134323,"C2",385233,1438519556,"2015-08-02 05:45:56"
"4238","20150807050820-790","1","2015-07-28 19:45:00",1438137900,"C8",883160,1439021060,"2015-08-08 01:04:20"
"5217","20152421072403-434","3","2015-07-28 19:50:23",1438138223,"C8",129916,1438268139,"2015-07-30 07:55:39"
"3230","20155723025701-227","1","2015-07-28 20:05:04",1438139104,"C2",150161,1438289265,"2015-07-30 13:47:45"
"1549","20153610043627-233","2","2015-07-28 20:14:24",1438139664,"C5",522759,1438662423,"2015-08-03 21:27:03"
"2946","20155724065712-217","1","2015-07-28 20:17:24",1438139844,"C2",131204,1438271048,"2015-07-30 08:44:08"
"4398","20151704071753-165","1","2015-07-28 20:18:47",1438139927,"C5",302922,1438442849,"2015-08-01 08:27:29"
"100","20153313023303-282","3","2015-07-28 20:24:43",1438140283,"C8",263420,1438403703,"2015-07-31 21:35:03"
"2706","20150806030837-471","1","2015-07-28 20:40:26",1438141226,"C5",274387,1438415613,"2015-08-01 00:53:33"
"6510","20155426095420-438","2","2015-07-28 20:57:50",1438142270,"C8",106305,1438248575,"2015-07-30 02:29:35"
"2211","20153504073526-319","1","2015-07-28 21:48:01",1438145281,"C8",424951,1438570232,"2015-08-02 19:50:32"
"3557","20151501041514-837","1","2015-07-28 21:57:03",1438145823,"C7",336187,1438482010,"2015-08-01 19:20:10"
"3447","20150923050915-668","1","2015-07-28 22:13:22",1438146802,"C0",64321,1438211123,"2015-07-29 16:05:23"
"4474","20150523010518-241","1","2015-07-28 22:45:10",1438148710,"C2",58349,1438207059,"2015-07-29 14:57:39"
"640","20153712013720-181","False","2015-07-28 22:51:09",1438149069,"C6",206677,1438355746,"2015-07-31 08:15:46"
"1786","20153424123435-575","2","2015-07-28 23:56:49",1438153009,"C7",193267,1438346276,"2015-07-31 05:37:56"
"6357","20153920123932-501","2","2015-07-29 00:08:02",1438153682,"C8",664902,1438818584,"2015-08-05 16:49:44"
"1473","20154825104838-640","2","2015-07-29 00:53:56",1438156436,"C5",103306,1438259742,"2015-07-30 05:35:42"
"3531","20153211063223-512","1","2015-07-29 00:56:55",1438156615,"C5",191884,1438348499,"2015-07-31 06:14:59"
"4666","20154626064610-637","1","2015-07-29 01:11:10",1438157470,"C8",119550,1438277020,"2015-07-30 10:23:40"
"5162","20155917015932-755","3","2015-07-29 01:33:38",1438158818,"C8",496023,1438654841,"2015-08-03 19:20:41"
"4197","20155123015131-999","1","2015-07-29 01:50:19",1438159819,"C5",158376,1438318195,"2015-07-30 21:49:55"
"2875","20155327105347-925","1","2015-07-29 02:04:27",1438160667,"C8",70520,1438231187,"2015-07-29 21:39:47"
"3131","20152219092238-393","3","2015-07-29 02:31:02",1438162262,"C2",279768,1438442030,"2015-08-01 08:13:50"
"5670","20155306095352-482","3","2015-07-29 02:39:54",1438162794,"C5",280166,1438442960,"2015-08-01 08:29:20"
"1370","20153925023931-202","2","2015-07-29 03:06:21",1438164381,"C5",152005,1438316386,"2015-07-30 21:19:46"
"761","20155526125517-937","1","2015-07-29 03:35:51",1438166151,"C8",112817,1438278968,"2015-07-30 10:56:08"
"1471","20152525042519-381","2","2015-07-29 03:50:49",1438167049,"C2",100110,1438267159,"2015-07-30 07:39:19"
"538","20152126032100-410","3","2015-07-29 04:16:03",1438168563,"C4",73101,1438241664,"2015-07-30 00:34:24"
"5860","20151622041646-326","1","2015-07-29 04:26:44",1438169204,"C8",281099,1438450303,"2015-08-01 10:31:43"
"533","20153622103615-743","2","2015-07-29 04:27:21",1438169241,"C4",194222,1438363463,"2015-07-31 10:24:23"
"4179","20155303025331-674","1","2015-07-29 04:39:31",1438169971,"C6",368260,1438538231,"2015-08-02 10:57:11"
"4114","20155008095000-690","2","2015-07-29 05:16:53",1438172213,"C0",256859,1438429072,"2015-08-01 04:37:52"
"3688","20152824012815-413","1","2015-07-29 05:36:49",1438173409,"C2",201857,1438375266,"2015-07-31 13:41:06"
"3528","20151127091156-609","3","2015-07-29 07:23:06",1438179786,"C8",83135,1438262921,"2015-07-30 06:28:41"
"477","20155914045934-20","2","2015-07-29 07:28:54",1438180134,"C2",481720,1438661854,"2015-08-03 21:17:34"
"226","20152322092332-533","3","2015-07-29 08:00:12",1438182012,"C0",74975,1438256987,"2015-07-30 04:49:47"
"4605","20154519024544-322","False","2015-07-29 08:12:11",1438182731,"C4",202131,1438384862,"2015-07-31 16:21:02"
"4891","20153824043829-635","3","2015-07-29 08:33:49",1438184029,"C8",80584,1438264613,"2015-07-30 06:56:53"
"4661","20155009035026-293","1","2015-07-29 08:40:38",1438184438,"C2",851106,1439035544,"2015-08-08 05:05:44"
"2296","20155206025224-627","2","2015-07-29 08:41:20",1438184480,"C0",245617,1438430097,"2015-08-01 04:54:57"
"4152","20155424105453-864","1","2015-07-29 08:54:33",1438185273,"C1",212390,1438397663,"2015-07-31 19:54:23"
"2622","20152028022013-691","1","2015-07-29 09:15:33",1438186533,"C6",68120,1438254653,"2015-07-30 04:10:53"
"5996","20153419013456-499","2","2015-07-29 09:22:32",1438186952,"C2",424428,1438611380,"2015-08-03 07:16:20"
"5944","20154121094145-294","1","2015-07-29 09:51:14",1438188674,"C0",691769,1438880443,"2015-08-06 10:00:43"
"471","20150528080517-604","1","2015-07-29 10:31:44",1438191104,"C6",95187,1438286291,"2015-07-30 12:58:11"
"4092","20155027085049-858","2","2015-07-29 11:23:39",1438194219,"C8",90985,1438285204,"2015-07-30 12:40:04"
"454","20155209085255-542","3","2015-07-29 11:45:07",1438195507,"C6",289722,1438485229,"2015-08-01 20:13:49"
"2189","20155325045321-836","1","2015-07-29 11:45:13",1438195513,"C0",327112,1438522625,"2015-08-02 06:37:05"
"2420","20153611043604-222","2","2015-07-29 12:02:33",1438196553,"C0",219827,1438416380,"2015-08-01 01:06:20"
"252","20153624073615-56","1","2015-07-29 12:04:31",1438196671,"C3",224048,1438420719,"2015-08-01 02:18:39"
"307","20155216055209-787","2","2015-07-29 13:08:21",1438200501,"C6",1106172,1439306673,"2015-08-11 08:24:33"
"3630","20150105080122-729","1","2015-07-29 13:29:15",1438201755,"C5",299039,1438500794,"2015-08-02 00:33:14"
"160","20150717050734-803","1","2015-07-29 13:43:12",1438202592,"C5",512269,1438714861,"2015-08-04 12:01:01"
"4992","20150820090851-701","2","2015-07-29 13:43:45",1438202625,"C8",113442,1438316067,"2015-07-30 21:14:27"
"258","20150624060606-582","1","2015-07-29 14:26:48",1438205208,"C7",231021,1438436229,"2015-08-01 06:37:09"
"523","20152130052126-284","1","2015-07-29 14:43:29",1438206209,"C5",356589,1438562798,"2015-08-02 17:46:38"
"5074","20150825050807-78","1","2015-07-29 15:13:43",1438208023,"C4",338736,1438546759,"2015-08-02 13:19:19"
"3556","20151811021803-685","1","2015-07-29 15:17:09",1438208229,"C5",779373,1438987602,"2015-08-07 15:46:42"
"2750","20153328073330-51","1","2015-07-29 15:43:38",1438209818,"C4",115808,1438325626,"2015-07-30 23:53:46"
"14","20152923102955-348","2","2015-07-29 16:27:22",1438212442,"C8",77121,1438289563,"2015-07-30 13:52:43"
"1856","20154812054846-708","1","2015-07-29 16:37:31",1438213051,"C2",488175,1438701226,"2015-08-04 08:13:46"
"1326","20153228033232-771","1","2015-07-29 17:32:44",1438216364,"C2",93612,1438309976,"2015-07-30 19:32:56"
"4188","20152528012542-188","1","2015-07-29 17:45:26",1438217126,"C4",101984,1438319110,"2015-07-30 22:05:10"
"137","20150826100844-912","2","2015-07-29 17:53:59",1438217639,"C5",95705,1438313344,"2015-07-30 20:29:04"
"2295","20151219051238-555","2","2015-07-29 19:00:09",1438221609,"C6",870451,1439092060,"2015-08-08 20:47:40"
"1490","20152726032754-124","1","2015-07-29 19:01:43",1438221703,"C5",409147,1438630850,"2015-08-03 12:40:50"
"6413","20155026125036-291","2","2015-07-29 19:15:35",1438222535,"C2",282299,1438504834,"2015-08-02 01:40:34"
"3807","20150910090926-819","1","2015-07-29 19:26:26",1438223186,"C6",279770,1438502956,"2015-08-02 01:09:16"
"2025","20155317125332-60","2","2015-07-29 19:47:57",1438224477,"C4",1061665,1439286142,"2015-08-11 02:42:22"
"2846","20150923090925-163","3","2015-07-29 20:13:35",1438226015,"C5",79750,1438305765,"2015-07-30 18:22:45"
"1764","20150624030614-941","1","2015-07-29 21:12:32",1438229552,"C8",64854,1438294406,"2015-07-30 15:13:26"
"5745","20155724025757-642","2","2015-07-29 21:30:18",1438230618,"C5",151847,1438382465,"2015-07-31 15:41:05"
"4189","20151920081921-606","3","2015-07-29 21:40:25",1438231225,"C5",117952,1438349177,"2015-07-31 06:26:17"
"3986","20153423013440-640","1","2015-07-29 21:46:08",1438231568,"C3",68486,1438300054,"2015-07-30 16:47:34"
"1374","20152926022953-770","1","2015-07-29 22:02:39",1438232559,"C3",143183,1438375742,"2015-07-31 13:49:02"
"4009","20150925050919-689","3","2015-07-29 22:31:53",1438234313,"C7",182477,1438416790,"2015-08-01 01:13:10"
"5200","20151121031117-949","1","2015-07-29 23:14:47",1438236887,"C4",240070,1438476957,"2015-08-01 17:55:57"
"5339","20152709082754-396","1","2015-07-29 23:17:28",1438237048,"C7",254482,1438491530,"2015-08-01 21:58:50"
"4085","20153922073948-796","1","2015-07-29 23:23:12",1438237392,"C3",220468,1438457860,"2015-08-01 12:37:40"
"5127","20155724015759-778","1","2015-07-29 23:49:59",1438238999,"C7",233760,1438472759,"2015-08-01 16:45:59"
"3086","20150915010905-807","2","2015-07-29 23:55:25",1438239325,"C2",178340,1438417665,"2015-08-01 01:27:45"
"711","20151612101618-908","3","2015-07-30 00:18:42",1438240722,"C6",253224,1438493946,"2015-08-01 22:39:06"
"5149","20154526024508-653","1","2015-07-30 00:21:43",1438240903,"C8",58759,1438299662,"2015-07-30 16:41:02"
"4778","20154217104217-430","1","2015-07-30 00:36:04",1438241764,"C2",155261,1438397025,"2015-07-31 19:43:45"
"250","20153227033233-52","1","2015-07-30 01:09:36",1438243776,"C4",69141,1438312917,"2015-07-30 20:21:57"
"3406","20152207112247-321","3","2015-07-30 02:00:23",1438246823,"C4",244182,1438491005,"2015-08-01 21:50:05"
"1146","20152012092008-483","1","2015-07-30 02:11:06",1438247466,"C5",218494,1438465960,"2015-08-01 14:52:40"
"6477","20154212064205-889","2","2015-07-30 02:32:05",1438248725,"C6",192525,1438441250,"2015-08-01 08:00:50"
"6206","20152205022233-507","2","2015-07-30 02:52:25",1438249945,"C0",264824,1438514769,"2015-08-02 04:26:09"
"2930","20155822115853-505","1","2015-07-30 03:29:17",1438252157,"C7",330312,1438582469,"2015-08-02 23:14:29"
"2528","20155514015554-802","2","2015-07-30 03:36:06",1438252566,"C7",149468,1438402034,"2015-07-31 21:07:14"
"4713","20151224121210-614","2","2015-07-30 04:06:34",1438254394,"C5",163088,1438417482,"2015-08-01 01:24:42"
"976","20153324033341-637","2","2015-07-30 04:08:51",1438254531,"C4",238655,1438493186,"2015-08-01 22:26:26"
"5421","20154221064205-207","1","2015-07-30 04:37:40",1438256260,"C7",480305,1438736565,"2015-08-04 18:02:45"
"2810","20153123103101-33","2","2015-07-30 05:20:20",1438258820,"C8",83737,1438342557,"2015-07-31 04:35:57"
"4620","20155618095623-707","1","2015-07-30 05:25:29",1438259129,"C3",340182,1438599311,"2015-08-03 03:55:11"
"6400","20151621091605-465","1","2015-07-30 05:31:03",1438259463,"C7",382049,1438641512,"2015-08-03 15:38:32"
"32","20152902022959-436","1","2015-07-30 06:40:25",1438263625,"C0",1195513,1439459138,"2015-08-13 02:45:38"
"2474","20151318101338-951","2","2015-07-30 06:48:26",1438264106,"C7",512244,1438776350,"2015-08-05 05:05:50"
"2493","20150117060105-392","1","2015-07-30 07:29:45",1438266585,"C5",141065,1438407650,"2015-07-31 22:40:50"
"3830","20155929045944-214","1","2015-07-30 07:59:52",1438268392,"C0",330751,1438599143,"2015-08-03 03:52:23"
"4626","20151923121906-266","3","2015-07-30 08:58:33",1438271913,"C5",197589,1438469502,"2015-08-01 15:51:42"
"491","20154805104835-68","3","2015-07-30 09:13:55",1438272835,"C2",269290,1438542125,"2015-08-02 12:02:05"
"1595","20153816023820-577","2","2015-07-30 09:35:30",1438274130,"C8",238286,1438512416,"2015-08-02 03:46:56"
"2161","20150925110937-663","3","2015-07-30 09:38:08",1438274288,"C6",426511,1438700799,"2015-08-04 08:06:39"
"2102","20153026053002-255","3","2015-07-30 09:38:53",1438274333,"C4",45333,1438319666,"2015-07-30 22:14:26"
"4420","20154218024228-691","1","2015-07-30 10:01:32",1438275692,"C4",509972,1438785664,"2015-08-05 07:41:04"
"74","20152824082844-651","3","2015-07-30 10:35:42",1438277742,"C8",263009,1438540751,"2015-08-02 11:39:11"
"4099","20151105091109-417","2","2015-07-30 11:04:39",1438279479,"C6",361135,1438640614,"2015-08-03 15:23:34"
"864","20152520092520-405","2","2015-07-30 11:21:21",1438280481,"C3",124423,1438404904,"2015-07-31 21:55:04"
"5536","20155230115226-97","3","2015-07-30 11:40:54",1438281654,"C8",1295654,1439577308,"2015-08-14 11:35:08"
"642","20154724114756-664","2","2015-07-30 12:03:00",1438282980,"C6",64913,1438347893,"2015-07-31 06:04:53"
"4771","20153623073647-385","3","2015-07-30 14:01:05",1438290065,"C5",89694,1438379759,"2015-07-31 14:55:59"
"2805","20153404053446-388","1","2015-07-30 14:10:06",1438290606,"C2",319160,1438609766,"2015-08-03 06:49:26"
"2837","20153706033723-432","3","2015-07-30 14:13:23",1438290803,"C3",582570,1438873373,"2015-08-06 08:02:53"
"3536","20153526063512-278","1","2015-07-30 15:12:48",1438294368,"C8",188328,1438482696,"2015-08-01 19:31:36"
"2173","20150719120749-370","1","2015-07-30 15:33:44",1438295624,"C8",192551,1438488175,"2015-08-01 21:02:55"
"6527","20152624102605-26","1","2015-07-30 15:46:01",1438296361,"C8",268798,1438565159,"2015-08-02 18:25:59"
"1802","20154101014157-341","1","2015-07-30 16:05:56",1438297556,"C7",359177,1438656733,"2015-08-03 19:52:13"
"3933","20155825015847-776","3","2015-07-30 16:09:18",1438297758,"C2",62833,1438360591,"2015-07-31 09:36:31"
"2845","20150918090928-755","2","2015-07-30 16:30:00",1438299000,"C5",531616,1438830616,"2015-08-05 20:10:16"
"2335","20150217100259-352","1","2015-07-30 17:30:44",1438302644,"C2",164295,1438466939,"2015-08-01 15:08:59"
"2356","20150923010916-544","3","2015-07-30 17:41:41",1438303301,"C0",88735,1438392036,"2015-07-31 18:20:36"
"6128","20153225093249-352","1","2015-07-30 17:45:09",1438303509,"C8",92308,1438395817,"2015-07-31 19:23:37"
"4635","20152601112611-300","2","2015-07-30 17:52:50",1438303970,"C4",361257,1438665227,"2015-08-03 22:13:47"
"6028","20150223090243-726","3","2015-07-30 17:52:51",1438303971,"C0",90944,1438394915,"2015-07-31 19:08:35"
"1994","20151426111428-477","2","2015-07-30 18:26:38",1438305998,"C2",185765,1438491763,"2015-08-01 22:02:43"
"1830","20150122050120-946","1","2015-07-30 18:57:56",1438307876,"C4",349098,1438656974,"2015-08-03 19:56:14"
"1621","20150817040833-849","2","2015-07-30 19:11:28",1438308688,"C8",162025,1438470713,"2015-08-01 16:11:53"
"4470","20155820065827-219","2","2015-07-30 19:53:24",1438311204,"C2",130071,1438441275,"2015-08-01 08:01:15"
"2965","20155705025745-109","1","2015-07-30 20:10:21",1438312221,"C7",242084,1438554305,"2015-08-02 15:25:05"
"159","20155424015436-907","3","2015-07-30 21:18:37",1438316317,"C2",77863,1438394180,"2015-07-31 18:56:20"
"3471","20151428031458-998","1","2015-07-30 21:23:56",1438316636,"C8",97469,1438414105,"2015-08-01 00:28:25"
"4506","20154726064756-747","1","2015-07-30 22:00:32",1438318832,"C7",200178,1438519010,"2015-08-02 05:36:50"
"3443","20154023084005-11","1","2015-07-30 22:27:32",1438320452,"C4",218149,1438538601,"2015-08-02 11:03:21"
"4212","20155804035844-100","3","2015-07-30 22:37:21",1438321041,"C5",324331,1438645372,"2015-08-03 16:42:52"
"1814","20155724015737-87","3","2015-07-30 22:45:45",1438321545,"C3",275044,1438596589,"2015-08-03 03:09:49"
"940","20153726073704-996","3","2015-07-30 23:01:43",1438322503,"C5",133693,1438456196,"2015-08-01 12:09:56"
"2922","20152301022309-569","2","2015-07-30 23:13:04",1438323184,"C5",362485,1438685669,"2015-08-04 03:54:29"
"210","20155710015717-292","2","2015-07-30 23:34:20",1438324460,"C5",587541,1438912001,"2015-08-06 18:46:41"
"4337","20150112110147-385","1","2015-07-31 00:18:23",1438327103,"C6",699166,1439026269,"2015-08-08 02:31:09"
"4906","20153617033658-794","3","2015-07-31 01:33:49",1438331629,"C5",165573,1438497202,"2015-08-01 23:33:22"
"70","20151924091930-39","1","2015-07-31 01:47:26",1438332446,"C5",288838,1438621284,"2015-08-03 10:01:24"
"2473","20150004010010-724","2","2015-07-31 02:16:23",1438334183,"C3",327739,1438661922,"2015-08-03 21:18:42"
"504","20153404123427-942","1","2015-07-31 02:48:42",1438336122,"C0",765885,1439102007,"2015-08-08 23:33:27"
"1892","20152208032247-227","1","2015-07-31 03:20:23",1438338023,"C0",242982,1438581005,"2015-08-02 22:50:05"
"4774","20151124031108-240","1","2015-07-31 03:22:51",1438338171,"C2",80329,1438418500,"2015-08-01 01:41:40"
"5790","20154818114855-997","1","2015-07-31 03:26:39",1438338399,"C5",546532,1438884931,"2015-08-06 11:15:31"
"6389","20150426070452-144","1","2015-07-31 04:08:12",1438340892,"C8",84280,1438425172,"2015-08-01 03:32:52"
"6085","20155109045104-759","3","2015-07-31 04:33:45",1438342425,"C4",265223,1438607648,"2015-08-03 06:14:08"
"3656","20152024062006-883","3","2015-07-31 04:37:56",1438342676,"C5",299335,1438642011,"2015-08-03 15:46:51"
"6465","20153223113200-303","1","2015-07-31 05:18:10",1438345090,"C3",334385,1438679475,"2015-08-04 02:11:15"
"2857","20151119031125-461","2","2015-07-31 05:20:13",1438345213,"C2",333776,1438678989,"2015-08-04 02:03:09"
"5723","20150804100804-119","1","2015-07-31 05:38:26",1438346306,"C7",330946,1438677252,"2015-08-04 01:34:12"
"6099","20150115080143-276","2","2015-07-31 05:45:33",1438346733,"C7",687115,1439033848,"2015-08-08 04:37:28"
"2388","20153423073421-295","3","2015-07-31 05:54:43",1438347283,"C8",342611,1438689894,"2015-08-04 05:04:54"
"3072","20155029045031-175","2","2015-07-31 06:07:13",1438348033,"C3",134202,1438482235,"2015-08-01 19:23:55"
"6149","20152626062625-468","1","2015-07-31 06:13:22",1438348402,"C5",143739,1438492141,"2015-08-01 22:09:01"
"6494","20154926124914-356","1","2015-07-31 06:34:12",1438349652,"C2",204749,1438554401,"2015-08-02 15:26:41"
"6396","20154721044741-483","2","2015-07-31 06:41:41",1438350101,"C4",413820,1438763921,"2015-08-05 01:38:41"
"1368","20155230025233-218","1","2015-07-31 07:15:35",1438352135,"C6",58982,1438411117,"2015-07-31 23:38:37"
"1756","20154924014948-415","1","2015-07-31 07:37:06",1438353426,"C6",97073,1438450499,"2015-08-01 10:34:59"
"5569","20154428094403-173","1","2015-07-31 07:57:17",1438354637,"C7",126397,1438481034,"2015-08-01 19:03:54"
"6300","20151221091244-979","2","2015-07-31 08:22:32",1438356152,"C7",430494,1438786646,"2015-08-05 07:57:26"
"4115","20153510103502-685","1","2015-07-31 08:27:08",1438356428,"C5",602242,1438958670,"2015-08-07 07:44:30"
"3205","20150103020130-343","1","2015-07-31 08:40:26",1438357226,"C4",623992,1438981218,"2015-08-07 14:00:18"
"5054","20154517094500-459","2","2015-07-31 08:57:40",1438358260,"C8",542680,1438900940,"2015-08-06 15:42:20"
"791","20151029071056-312","1","2015-07-31 10:06:38",1438362398,"C8",91671,1438454069,"2015-08-01 11:34:29"
"2035","20154107104138-147","2","2015-07-31 10:51:50",1438365110,"C2",296316,1438661426,"2015-08-03 21:10:26"
"670","20150029080012-457","2","2015-07-31 12:02:56",1438369376,"C5",93682,1438463058,"2015-08-01 14:04:18"
"4972","20152727032734-400","2","2015-07-31 12:11:34",1438369894,"C8",166920,1438536814,"2015-08-02 10:33:34"
"4665","20153927083929-384","1","2015-07-31 12:12:11",1438369931,"C4",119454,1438489385,"2015-08-01 21:23:05"
"4729","20153123063158-685","1","2015-07-31 12:39:57",1438371597,"C0",101897,1438473494,"2015-08-01 16:58:14"
"2827","20155317095355-5","1","2015-07-31 13:30:55",1438374655,"C6",203770,1438578425,"2015-08-02 22:07:05"
"1751","20154112014114-381","False","2015-07-31 14:15:50",1438377350,"C6",201840,1438579190,"2015-08-02 22:19:50"
"3316","20153817033857-516","1","2015-07-31 14:25:36",1438377936,"C2",1205199,1439583135,"2015-08-14 13:12:15"
"1090","20150216030218-144","1","2015-07-31 14:41:15",1438378875,"C5",431579,1438810454,"2015-08-05 14:34:14"
"2131","20150727070729-782","1","2015-07-31 15:07:20",1438380440,"C2",374391,1438754831,"2015-08-04 23:07:11"
"4582","20154821044806-248","2","2015-07-31 15:57:28",1438383448,"C4",430481,1438813929,"2015-08-05 15:32:09"
"1104","20155229095223-993","1","2015-07-31 16:30:19",1438385419,"C6",196676,1438582095,"2015-08-02 23:08:15"
"3398","20151422011417-46","1","2015-07-31 16:45:29",1438386329,"C7",112896,1438499225,"2015-08-02 00:07:05"
"3750","20155225025231-666","2","2015-07-31 17:18:23",1438388303,"C4",65894,1438454197,"2015-08-01 11:36:37"
"3337","20155818035853-341","2","2015-07-31 17:37:15",1438389435,"C5",531586,1438921021,"2015-08-06 21:17:01"
"1902","20155726085710-998","2","2015-07-31 17:44:38",1438389878,"C4",463648,1438853526,"2015-08-06 02:32:06"
"2998","20150124090106-75","1","2015-07-31 17:45:21",1438389921,"C3",212085,1438602006,"2015-08-03 04:40:06"
"5155","20151125121136-226","2","2015-07-31 17:55:51",1438390551,"C5",179685,1438570236,"2015-08-02 19:50:36"
"6038","20151824041829-872","1","2015-07-31 18:11:24",1438391484,"C0",611575,1439003059,"2015-08-07 20:04:19"
"2196","20154908044958-492","1","2015-07-31 18:19:16",1438391956,"C2",664186,1439056142,"2015-08-08 10:49:02"
"3574","20150530110520-639","3","2015-07-31 18:40:54",1438393254,"C2",113734,1438506988,"2015-08-02 02:16:28"
"747","20154615054615-774","3","2015-07-31 19:23:27",1438395807,"C5",173529,1438569336,"2015-08-02 19:35:36"
"3927","20150526060526-540","2","2015-07-31 19:32:09",1438396329,"C0",480403,1438876732,"2015-08-06 08:58:52"
"2638","20151426021410-715","1","2015-07-31 19:45:59",1438397159,"C3",451909,1438849068,"2015-08-06 01:17:48"
"3599","20155304035331-275","1","2015-07-31 19:47:01",1438397221,"C8",1173405,1439570626,"2015-08-14 09:43:46"
"842","20150316030333-652","2","2015-07-31 19:50:55",1438397455,"C5",187606,1438585061,"2015-08-02 23:57:41"
"187","20151328091352-263","1","2015-07-31 19:51:19",1438397479,"C5",99149,1438496628,"2015-08-01 23:23:48"
"4448","20155123035157-563","2","2015-07-31 20:45:51",1438400751,"C2",101262,1438502013,"2015-08-02 00:53:33"
"3130","20150425050434-33","1","2015-07-31 20:56:50",1438401410,"C6",532336,1438933746,"2015-08-07 00:49:06"
"2195","20154423094459-117","2","2015-07-31 21:30:11",1438403411,"C3",366756,1438770167,"2015-08-05 03:22:47"
"6219","20151329051347-815","3","2015-07-31 22:44:59",1438407899,"C8",96336,1438504235,"2015-08-02 01:30:35"
"910","20155427065441-961","1","2015-07-31 22:59:01",1438408741,"C0",201730,1438610471,"2015-08-03 07:01:11"
"911","20154625084640-549","1","2015-07-31 23:12:33",1438409553,"C4",81479,1438491032,"2015-08-01 21:50:32"
"969","20154725114714-121","3","2015-08-01 00:16:27",1438413387,"C7",80479,1438493866,"2015-08-01 22:37:46"
"150","20154211034247-278","1","2015-08-01 00:22:09",1438413729,"C8",879581,1439293310,"2015-08-11 04:41:50"
"6486","20150830090823-240","1","2015-08-01 01:01:36",1438416096,"C8",390799,1438806895,"2015-08-05 13:34:55"
"3840","20153901033952-705","3","2015-08-01 01:22:22",1438417342,"C5",875650,1439292992,"2015-08-11 04:36:32"
"4565","20154124104119-137","3","2015-08-01 01:23:33",1438417413,"C8",93962,1438511375,"2015-08-02 03:29:35"
"4133","20155227085257-55","1","2015-08-01 01:25:49",1438417549,"C2",202586,1438620135,"2015-08-03 09:42:15"
"3143","20155625055644-429","1","2015-08-01 01:26:42",1438417602,"C2",77914,1438495516,"2015-08-01 23:05:16"
"6247","20154107124133-326","2","2015-08-01 01:38:05",1438418285,"C5",589024,1439007309,"2015-08-07 21:15:09"
"3427","20151916101912-704","2","2015-08-01 02:04:15",1438419855,"C2",450901,1438870756,"2015-08-06 07:19:16"
"6552","20151229041225-130","1","2015-08-01 03:28:48",1438424928,"C2",400769,1438825697,"2015-08-05 18:48:17"
"4990","20155424065455-846","2","2015-08-01 03:30:04",1438425004,"C7",96987,1438521991,"2015-08-02 06:26:31"
"341","20151326031334-997","1","2015-08-01 03:32:39",1438425159,"C8",95269,1438520428,"2015-08-02 06:00:28"
"1029","20154905084932-890","3","2015-08-01 03:54:38",1438426478,"C0",771702,1439198180,"2015-08-10 02:16:20"
"3294","20153018053053-129","2","2015-08-01 04:26:25",1438428385,"C7",166076,1438594461,"2015-08-03 02:34:21"
"1271","20150703080734-840","2","2015-08-01 04:28:01",1438428481,"C2",356061,1438784542,"2015-08-05 07:22:22"
"5964","20151819091842-213","1","2015-08-01 04:49:27",1438429767,"C3",528435,1438958202,"2015-08-07 07:36:42"
"4657","20150624050603-927","3","2015-08-01 04:58:17",1438430297,"C8",323767,1438754064,"2015-08-04 22:54:24"
"1383","20150021080000-521","3","2015-08-01 05:26:50",1438432010,"C3",470605,1438902615,"2015-08-06 16:10:15"
"3290","20150725030751-337","1","2015-08-01 05:28:15",1438432095,"C4",81432,1438513527,"2015-08-02 04:05:27"
"774","20151317071311-118","3","2015-08-01 05:43:06",1438432986,"C8",258119,1438691105,"2015-08-04 05:25:05"
"5016","20153622083653-391","1","2015-08-01 06:14:59",1438434899,"C5",427743,1438862642,"2015-08-06 05:04:02"
"2103","20152405122436-184","3","2015-08-01 06:25:48",1438435548,"C2",288909,1438724457,"2015-08-04 14:40:57"
"1821","20153924083911-558","2","2015-08-01 06:30:27",1438435827,"C5",341738,1438777565,"2015-08-05 05:26:05"
"5316","20153117083124-431","2","2015-08-01 06:33:14",1438435994,"C7",184130,1438620124,"2015-08-03 09:42:04"
"6084","20152731082747-677","1","2015-08-01 06:37:10",1438436230,"C2",79763,1438515993,"2015-08-02 04:46:33"
"3815","20155627055642-893","2","2015-08-01 07:51:14",1438440674,"C5",49459,1438490133,"2015-08-01 21:35:33"
"1391","20153730013710-947","1","2015-08-01 08:02:19",1438441339,"C3",152709,1438594048,"2015-08-03 02:27:28"
"6255","20155729095756-876","3","2015-08-01 08:52:18",1438444338,"C5",127631,1438571969,"2015-08-02 20:19:29"
"178","20155407085436-987","2","2015-08-01 09:24:20",1438446260,"C5",270223,1438716483,"2015-08-04 12:28:03"
"6154","20152118042118-402","3","2015-08-01 09:48:43",1438447723,"C2",169435,1438617158,"2015-08-03 08:52:38"
"896","20151824101840-224","2","2015-08-01 09:50:40",1438447840,"C8",344760,1438792600,"2015-08-05 09:36:40"
"5348","20151102031156-128","2","2015-08-01 09:53:41",1438448021,"C8",514581,1438962602,"2015-08-07 08:50:02"
"2994","20152529092534-521","3","2015-08-01 10:42:30",1438450950,"C8",131908,1438582858,"2015-08-02 23:20:58"
"5294","20154029064002-238","1","2015-08-01 11:00:14",1438452014,"C4",274812,1438726826,"2015-08-04 15:20:26"
"5289","20152830082817-542","1","2015-08-01 11:00:33",1438452033,"C6",181936,1438633969,"2015-08-03 13:32:49"
"1542","20155509065515-933","2","2015-08-01 12:00:03",1438455603,"C7",222832,1438678435,"2015-08-04 01:53:55"
"619","20152027072040-298","1","2015-08-01 13:41:40",1438461700,"C7",227430,1438689130,"2015-08-04 04:52:10"
"6523","20155418045421-624","1","2015-08-01 13:55:01",1438462501,"C4",599420,1439061921,"2015-08-08 12:25:21"
"3885","20150828090834-36","2","2015-08-01 14:20:50",1438464050,"C5",182168,1438646218,"2015-08-03 16:56:58"
"1518","20151623071615-935","2","2015-08-01 16:23:15",1438471395,"C0",270140,1438741535,"2015-08-04 19:25:35"
"3351","20150031030030-236","1","2015-08-01 16:35:29",1438472129,"C2",92099,1438564228,"2015-08-02 18:10:28"
"1406","20150725040701-369","2","2015-08-01 16:51:01",1438473061,"C5",75930,1438548991,"2015-08-02 13:56:31"
"2651","20154530054541-361","2","2015-08-01 16:51:59",1438473119,"C5",84789,1438557908,"2015-08-02 16:25:08"
"4706","20154119074113-792","1","2015-08-01 18:04:19",1438477459,"C5",165798,1438643257,"2015-08-03 16:07:37"
"2594","20154129034133-355","1","2015-08-01 18:52:27",1438480347,"C5",90218,1438570565,"2015-08-02 19:56:05"
"1757","20153011023048-461","3","2015-08-01 19:00:53",1438480853,"C5",261515,1438742368,"2015-08-04 19:39:28"
"1792","20153722023710-935","2","2015-08-01 19:21:38",1438482098,"C0",440534,1438922632,"2015-08-06 21:43:52"
"4130","20150209060231-540","1","2015-08-01 19:34:54",1438482894,"C5",290849,1438773743,"2015-08-05 04:22:23"
"1472","20155129045107-400","2","2015-08-01 19:56:16",1438484176,"C3",90103,1438574279,"2015-08-02 20:57:59"
"1197","20155625015652-201","2","2015-08-01 20:19:20",1438485560,"C2",459964,1438945524,"2015-08-07 04:05:24"
"3106","20152330112320-637","1","2015-08-01 21:07:23",1438488443,"C2",69281,1438557724,"2015-08-02 16:22:04"
"1761","20155028105016-754","3","2015-08-01 21:29:26",1438489766,"C2",191975,1438681741,"2015-08-04 02:49:01"
"844","20153321033321-89","1","2015-08-01 21:34:36",1438490076,"C5",324025,1438814101,"2015-08-05 15:35:01"
"39","20154625054615-85","3","2015-08-01 21:42:47",1438490567,"C2",309496,1438800063,"2015-08-05 11:41:03"
"293","20155628055649-858","1","2015-08-01 22:57:18",1438495038,"C0",51947,1438546985,"2015-08-02 13:23:05"
"5110","20152505102539-470","3","2015-08-01 23:08:43",1438495723,"C2",621323,1439117046,"2015-08-09 03:44:06"
"2935","20153913013912-134","2","2015-08-01 23:24:57",1438496697,"C4",239535,1438736232,"2015-08-04 17:57:12"
"4629","20151804111828-884","1","2015-08-01 23:42:20",1438497740,"C8",1231916,1439729656,"2015-08-16 05:54:16"
"6356","20152830032844-398","2","2015-08-01 23:43:54",1438497834,"C8",101255,1438599089,"2015-08-03 03:51:29"
"4793","20155226125229-218","3","2015-08-01 23:48:15",1438498095,"C3",79678,1438577773,"2015-08-02 21:56:13"
"1588","20152227032235-207","1","2015-08-01 23:50:17",1438498217,"C0",66066,1438564283,"2015-08-02 18:11:23"
"164","20152830022802-299","1","2015-08-01 23:52:04",1438498324,"C2",103321,1438601645,"2015-08-03 04:34:05"
"549","20151927091933-671","2","2015-08-01 23:53:33",1438498413,"C6",512740,1439011153,"2015-08-07 22:19:13"
"4922","20152813042802-5","2","2015-08-02 00:05:22",1438499122,"C8",333808,1438832930,"2015-08-05 20:48:50"
"4118","20150410080439-253","3","2015-08-02 00:10:05",1438499405,"C5",279818,1438779223,"2015-08-05 05:53:43"
"304","20155918045905-885","3","2015-08-02 00:16:03",1438499763,"C5",617909,1439117672,"2015-08-09 03:54:32"
"2764","20151231121203-449","2","2015-08-02 00:16:25",1438499785,"C5",64931,1438564716,"2015-08-02 18:18:36"
"3774","20150224010207-397","2","2015-08-02 01:02:07",1438502527,"C0",415800,1438918327,"2015-08-06 20:32:07"
"2348","20151626121657-196","2","2015-08-02 01:02:18",1438502538,"C3",188107,1438690645,"2015-08-04 05:17:25"
"5193","20152628082657-500","3","2015-08-02 01:11:31",1438503091,"C5",202937,1438706028,"2015-08-04 09:33:48"
"6126","20153628093659-387","1","2015-08-02 01:41:01",1438504861,"C5",201721,1438706582,"2015-08-04 09:43:02"
"3320","20153022073058-275","1","2015-08-02 01:57:43",1438505863,"C8",186081,1438691944,"2015-08-04 05:39:04"
"3045","20155827095826-435","1","2015-08-02 02:03:02",1438506182,"C8",440268,1438946450,"2015-08-07 04:20:50"
"2217","20152711032704-985","2","2015-08-02 02:09:47",1438506587,"C3",264709,1438771296,"2015-08-05 03:41:36"
"4224","20150124050126-399","3","2015-08-02 02:28:41",1438507721,"C8",145047,1438652768,"2015-08-03 18:46:08"
"4258","20155118055120-195","1","2015-08-02 02:33:00",1438507980,"C5",620450,1439128430,"2015-08-09 06:53:50"
"2879","20154931034945-124","3","2015-08-02 02:50:55",1438509055,"C7",63035,1438572090,"2015-08-02 20:21:30"
"5195","20154218114238-384","1","2015-08-02 02:51:21",1438509081,"C5",180589,1438689670,"2015-08-04 05:01:10"
"5153","20153521083522-988","1","2015-08-02 03:38:42",1438511922,"C5",127375,1438639297,"2015-08-03 15:01:37"
"537","20152008052025-846","2","2015-08-02 03:50:01",1438512601,"C3",263922,1438776523,"2015-08-05 05:08:43"
"1098","20150231010230-879","1","2015-08-02 03:50:02",1438512602,"C8",69826,1438582428,"2015-08-02 23:13:48"
"2782","20154130124118-316","1","2015-08-02 04:20:06",1438514406,"C7",114564,1438628970,"2015-08-03 12:09:30"
"1284","20152217012232-158","3","2015-08-02 04:32:59",1438515179,"C2",450209,1438965388,"2015-08-07 09:36:28"
"6385","20153125033101-388","2","2015-08-02 04:38:59",1438515539,"C7",93154,1438608693,"2015-08-03 06:31:33"
"5916","20154530104517-465","1","2015-08-02 04:43:02",1438515782,"C0",79155,1438594937,"2015-08-03 02:42:17"
"1574","20150626110605-541","1","2015-08-02 05:25:41",1438518341,"C2",1058792,1439577133,"2015-08-14 11:32:13"
"5385","20155908025926-104","2","2015-08-02 05:37:34",1438519054,"C6",265786,1438784840,"2015-08-05 07:27:20"
"5458","20155620125614-440","1","2015-08-02 06:21:53",1438521713,"C4",366513,1438888226,"2015-08-06 12:10:26"
"4842","20155910035954-864","1","2015-08-02 07:09:20",1438524560,"C8",279338,1438803898,"2015-08-05 12:44:58"
"3988","20152210032211-174","3","2015-08-02 07:37:32",1438526252,"C4",279903,1438806155,"2015-08-05 13:22:35"
"204","20155417065414-463","1","2015-08-02 08:24:46",1438529086,"C0",173479,1438702565,"2015-08-04 08:36:05"
"5347","20153224123257-617","1","2015-08-02 08:56:06",1438530966,"C5",254863,1438785829,"2015-08-05 07:43:49"
"6109","20153617013601-315","1","2015-08-02 09:01:51",1438531311,"C8",682975,1439214286,"2015-08-10 06:44:46"
"134","20155701025756-944","2","2015-08-02 10:16:11",1438535771,"C4",69495,1438605266,"2015-08-03 05:34:26"
"1591","20153709093756-988","1","2015-08-02 11:04:11",1438538651,"C8",415755,1438954406,"2015-08-07 06:33:26"
"4686","20153928053942-429","3","2015-08-02 11:12:28",1438539148,"C0",408766,1438947914,"2015-08-07 04:45:14"
"2840","20150201060238-845","2","2015-08-02 11:15:25",1438539325,"C3",105167,1438644492,"2015-08-03 16:28:12"
"148","20151231031233-897","2","2015-08-02 11:22:19",1438539739,"C3",158986,1438698725,"2015-08-04 07:32:05"
"194","20154428124429-300","2","2015-08-02 11:26:52",1438540012,"C7",61049,1438601061,"2015-08-03 04:24:21"
"5590","20152001012059-836","1","2015-08-02 11:29:15",1438540155,"C4",79696,1438619851,"2015-08-03 09:37:31"
"2338","20153226073247-72","1","2015-08-02 11:42:13",1438540933,"C2",88538,1438629471,"2015-08-03 12:17:51"
"5461","20154122054140-30","1","2015-08-02 11:54:53",1438541693,"C5",132799,1438674492,"2015-08-04 00:48:12"
"231","20155223015236-307","3","2015-08-02 12:18:52",1438543132,"C8",429188,1438972320,"2015-08-07 11:32:00"
"1259","20155631125645-432","1","2015-08-02 12:23:41",1438543421,"C4",85408,1438628829,"2015-08-03 12:07:09"
"233","20151731021708-898","2","2015-08-02 12:52:47",1438545167,"C0",167739,1438712906,"2015-08-04 11:28:26"
"5972","20154111034148-335","1","2015-08-02 12:56:44",1438545404,"C0",270128,1438815532,"2015-08-05 15:58:52"
"6358","20151227041255-244","3","2015-08-02 12:58:39",1438545519,"C0",506744,1439052263,"2015-08-08 09:44:23"
"584","20153029033042-152","1","2015-08-02 13:35:58",1438547758,"C7",169358,1438717116,"2015-08-04 12:38:36"
"629","20153601103622-897","1","2015-08-02 14:11:54",1438549914,"C6",99332,1438649246,"2015-08-03 17:47:26"
"3379","20155625015640-843","2","2015-08-02 14:18:19",1438550299,"C5",230833,1438781132,"2015-08-05 06:25:32"
"1475","20150121020117-781","1","2015-08-02 14:26:29",1438550789,"C5",346104,1438896893,"2015-08-06 14:34:53"
"354","20153327123320-68","1","2015-08-02 14:27:38",1438550858,"C6",87543,1438638401,"2015-08-03 14:46:41"
"1535","20150829100839-801","1","2015-08-02 14:36:43",1438551403,"C2",180842,1438732245,"2015-08-04 16:50:45"
"291","20151429041405-463","1","2015-08-02 14:45:59",1438551959,"C5",418902,1438970861,"2015-08-07 11:07:41"
"5012","20151008121044-244","1","2015-08-02 15:20:56",1438554056,"C7",529268,1439083324,"2015-08-08 18:22:04"
"1138","20155827015856-404","3","2015-08-02 15:21:32",1438554092,"C5",174452,1438728544,"2015-08-04 15:49:04"
"5157","20152027062003-395","2","2015-08-02 15:35:39",1438554939,"C0",275868,1438830807,"2015-08-05 20:13:27"
"6215","20152726042723-397","1","2015-08-02 16:03:42",1438556622,"C8",86197,1438642819,"2015-08-03 16:00:19"
"4096","20152818022812-310","3","2015-08-02 16:47:56",1438559276,"C4",163048,1438722324,"2015-08-04 14:05:24"
"633","20150206080212-82","1","2015-08-02 17:00:18",1438560018,"C4",788362,1439348380,"2015-08-11 19:59:40"
"4032","20152709092720-465","2","2015-08-02 17:10:32",1438560632,"C2",262674,1438823306,"2015-08-05 18:08:26"
"4753","20155430115403-341","1","2015-08-02 17:30:30",1438561830,"C0",93129,1438654959,"2015-08-03 19:22:39"
"3465","20152819042821-876","1","2015-08-02 17:37:41",1438562261,"C5",151720,1438713981,"2015-08-04 11:46:21"
"4571","20153323043307-820","2","2015-08-02 18:06:03",1438563963,"C8",434788,1438998751,"2015-08-07 18:52:31"
"4946","20152913082912-781","1","2015-08-02 18:35:02",1438565702,"C5",882175,1439447877,"2015-08-12 23:37:57"
"2437","20151301021340-472","2","2015-08-02 19:23:03",1438568583,"C2",104963,1438673546,"2015-08-04 00:32:26"
"2455","20153931123943-847","3","2015-08-02 20:18:01",1438571881,"C5",100149,1438672030,"2015-08-04 00:07:10"
"3813","20155704015728-85","1","2015-08-02 20:21:54",1438572114,"C4",361238,1438933352,"2015-08-07 00:42:32"
"3592","20155201035213-815","2","2015-08-02 20:30:35",1438572635,"C0",103102,1438675737,"2015-08-04 01:08:57"
"1915","20151503041535-262","3","2015-08-02 21:12:55",1438575175,"C0",326230,1438901405,"2015-08-06 15:50:05"
"4805","20155309115343-721","3","2015-08-02 22:46:07",1438580767,"C5",588093,1439168860,"2015-08-09 18:07:40"
"1580","20151826021816-332","1","2015-08-02 23:05:12",1438581912,"C2",79552,1438661464,"2015-08-03 21:11:04"
"5781","20155025015032-304","3","2015-08-02 23:13:42",1438582422,"C8",144998,1438727420,"2015-08-04 15:30:20"
"1315","20153704073745-278","2","2015-08-02 23:15:10",1438582510,"C8",512369,1439094879,"2015-08-08 21:34:39"
"4940","20151801021811-599","1","2015-08-02 23:24:39",1438583079,"C4",1398794,1439981873,"2015-08-19 03:57:53"
"1634","20155130035117-109","3","2015-08-02 23:35:11",1438583711,"C5",143517,1438727228,"2015-08-04 15:27:08"
"5413","20151820041854-851","3","2015-08-03 00:32:30",1438587150,"C2",144102,1438731252,"2015-08-04 16:34:12"
"223","20155314125319-412","3","2015-08-03 01:54:50",1438592090,"C7",241213,1438833303,"2015-08-05 20:55:03"
"1682","20155019115035-365","1","2015-08-03 02:12:09",1438593129,"C7",630647,1439223776,"2015-08-10 09:22:56"
"3699","20152701022725-153","3","2015-08-03 02:17:52",1438593472,"C2",401061,1438994533,"2015-08-07 17:42:13"
"2182","20150801120848-517","1","2015-08-03 02:19:28",1438593568,"C5",68720,1438662288,"2015-08-03 21:24:48"
"6030","20155323075349-302","2","2015-08-03 03:57:59",1438599479,"C0",133750,1438733229,"2015-08-04 17:07:09"
"6036","20153414123429-267","1","2015-08-03 04:37:29",1438601849,"C8",339876,1438941725,"2015-08-07 03:02:05"
"269","20153025093014-930","1","2015-08-03 04:38:08",1438601888,"C4",253358,1438855246,"2015-08-06 03:00:46"
"2052","20154524114509-609","1","2015-08-03 04:38:47",1438601927,"C5",119774,1438721701,"2015-08-04 13:55:01"
"1782","20151124111122-818","1","2015-08-03 05:15:55",1438604155,"C2",280891,1438885046,"2015-08-06 11:17:26"
"5584","20150325060300-912","1","2015-08-03 05:45:11",1438605911,"C4",110933,1438716844,"2015-08-04 12:34:04"
"5201","20153802053827-252","1","2015-08-03 06:15:03",1438607703,"C2",45396,1438653099,"2015-08-03 18:51:39"
"1638","20151507011530-88","1","2015-08-03 07:24:10",1438611850,"C5",288965,1438900815,"2015-08-06 15:40:15"
"4738","20152128072158-862","1","2015-08-03 07:29:28",1438612168,"C2",172950,1438785118,"2015-08-05 07:31:58"
"2039","20154801104828-144","2","2015-08-03 07:37:36",1438612656,"C5",80674,1438693330,"2015-08-04 06:02:10"
"4377","20154431124423-688","2","2015-08-03 08:14:11",1438614851,"C4",80996,1438695847,"2015-08-04 06:44:07"
"722","20155401015444-439","1","2015-08-03 08:18:26",1438615106,"C4",152622,1438767728,"2015-08-05 02:42:08"
"1123","20152928122936-347","2","2015-08-03 08:34:30",1438616070,"C5",168098,1438784168,"2015-08-05 07:16:08"
"4341","20155326105308-899","1","2015-08-03 09:00:50",1438617650,"C2",684462,1439302112,"2015-08-11 07:08:32"
"4403","20150501090516-171","3","2015-08-03 09:21:28",1438618888,"C2",86886,1438705774,"2015-08-04 09:29:34"
"6120","20150818050817-70","1","2015-08-03 09:21:33",1438618893,"C4",677198,1439296091,"2015-08-11 05:28:11"
"1770","20154901124955-525","2","2015-08-03 09:50:10",1438620610,"C4",162015,1438782625,"2015-08-05 06:50:25"
"2380","20150619040651-207","2","2015-08-03 09:52:12",1438620732,"C5",424507,1439045239,"2015-08-08 07:47:19"
"5909","20153007073050-177","1","2015-08-03 10:13:54",1438622034,"C0",616823,1439238857,"2015-08-10 13:34:17"
"1618","20153501083518-306","1","2015-08-03 10:36:36",1438623396,"C8",90039,1438713435,"2015-08-04 11:37:15"
"2463","20150228020203-565","3","2015-08-03 11:28:27",1438626507,"C4",509184,1439135691,"2015-08-09 08:54:51"
"855","20153019033053-367","2","2015-08-03 11:51:23",1438627883,"C8",256566,1438884449,"2015-08-06 11:07:29"
"3242","20154626054643-936","2","2015-08-03 11:52:46",1438627966,"C4",95709,1438723675,"2015-08-04 14:27:55"
"4970","20152123022155-571","1","2015-08-03 12:51:50",1438631510,"C4",505285,1439136795,"2015-08-09 09:13:15"
"6204","20151031101009-945","1","2015-08-03 13:01:36",1438632096,"C4",89829,1438721925,"2015-08-04 13:58:45"
"5803","20153121043157-485","1","2015-08-03 13:11:32",1438632692,"C8",222235,1438854927,"2015-08-06 02:55:27"
"5325","20152031102058-485","1","2015-08-03 13:13:22",1438632802,"C4",89848,1438722650,"2015-08-04 14:10:50"
"5","20154502084548-823","3","2015-08-03 13:32:07",1438633927,"C0",103579,1438737506,"2015-08-04 18:18:26"
"3473","20153329053307-752","2","2015-08-03 13:43:07",1438634587,"C5",52275,1438686862,"2015-08-04 04:14:22"
"1714","20154520064525-417","3","2015-08-03 13:47:58",1438634878,"C7",137217,1438772095,"2015-08-05 03:54:55"
"5011","20152430032437-581","2","2015-08-03 13:51:23",1438635083,"C5",170003,1438805086,"2015-08-05 13:04:46"
"5645","20154915104900-986","2","2015-08-03 14:14:52",1438636492,"C6",530744,1439167236,"2015-08-09 17:40:36"
"3470","20154502054501-178","1","2015-08-03 14:41:35",1438638095,"C4",75394,1438713489,"2015-08-04 11:38:09"
"800","20154120014128-465","1","2015-08-03 15:12:28",1438639948,"C5",173580,1438813528,"2015-08-05 15:25:28"
"4540","20152823122846-410","1","2015-08-03 15:17:50",1438640270,"C4",120068,1438760338,"2015-08-05 00:38:58"
"4384","20151102121127-564","2","2015-08-03 15:24:25",1438640665,"C2",97978,1438738643,"2015-08-04 18:37:23"
"6371","20155726015743-944","2","2015-08-03 15:33:55",1438641235,"C2",348486,1438989721,"2015-08-07 16:22:01"
"3063","20154217104228-732","1","2015-08-03 15:41:31",1438641691,"C4",1486743,1440128434,"2015-08-20 20:40:34"
"1049","20154201104219-611","1","2015-08-03 16:07:45",1438643265,"C4",96163,1438739428,"2015-08-04 18:50:28"
"991","20155926125915-298","3","2015-08-03 16:18:11",1438643891,"C8",351568,1438995459,"2015-08-07 17:57:39"
"4431","20153115033133-708","1","2015-08-03 17:02:54",1438646574,"C2",605583,1439252157,"2015-08-10 17:15:57"
"3902","20150827060823-4","1","2015-08-03 17:31:11",1438648271,"C2",215256,1438863527,"2015-08-06 05:18:47"
"4903","20154326034342-937","2","2015-08-03 18:03:22",1438650202,"C0",99940,1438750142,"2015-08-04 21:49:02"
"5396","20152728102719-723","3","2015-08-03 18:17:48",1438651068,"C2",546629,1439197697,"2015-08-10 02:08:17"
"967","20155916045900-996","2","2015-08-03 18:21:40",1438651300,"C7",222880,1438874180,"2015-08-06 08:16:20"
"316","20155526025520-19","1","2015-08-03 18:45:59",1438652759,"C3",235013,1438887772,"2015-08-06 12:02:52"
"5266","20153402113431-964","2","2015-08-03 20:02:27",1438657347,"C4",116876,1438774223,"2015-08-05 04:30:23"
"2913","20150620030629-901","1","2015-08-03 20:12:29",1438657949,"C8",245592,1438903541,"2015-08-06 16:25:41"
"637","20152502112545-83","1","2015-08-03 20:13:29",1438658009,"C4",118064,1438776073,"2015-08-05 05:01:13"
"110","20154226054249-628","1","2015-08-03 20:27:41",1438658861,"C4",350546,1439009407,"2015-08-07 21:50:07"
"6445","20152614072648-135","1","2015-08-03 20:39:53",1438659593,"C7",253655,1438913248,"2015-08-06 19:07:28"
"6542","20150003020050-522","2","2015-08-03 20:51:14",1438660274,"C5",337878,1438998152,"2015-08-07 18:42:32"
"3158","20154625104616-641","2","2015-08-03 21:12:07",1438661527,"C5",271717,1438933244,"2015-08-07 00:40:44"
"5277","20150701060721-840","1","2015-08-03 21:16:05",1438661765,"C2",227324,1438889089,"2015-08-06 12:24:49"
"1263","20154022104050-662","1","2015-08-03 21:23:59",1438662239,"C5",358463,1439020702,"2015-08-08 00:58:22"
"5631","20150831010810-141","1","2015-08-03 21:34:58",1438662898,"C2",289608,1438952506,"2015-08-07 06:01:46"
"2027","20150816060823-385","3","2015-08-03 21:44:53",1438663493,"C3",805695,1439469188,"2015-08-13 05:33:08"
"2186","20150431030458-145","3","2015-08-03 22:09:56",1438664996,"C4",284698,1438949694,"2015-08-07 05:14:54"
"1703","20150213100244-187","1","2015-08-03 22:31:56",1438666316,"C2",619784,1439286100,"2015-08-11 02:41:40"
"5102","20155716015702-925","3","2015-08-03 22:51:56",1438667516,"C6",696549,1439364065,"2015-08-12 00:21:05"
"4623","20150828090847-178","1","2015-08-03 22:54:22",1438667662,"C8",113587,1438781249,"2015-08-05 06:27:29"
"4995","20153802053822-860","3","2015-08-03 23:21:48",1438669308,"C7",53503,1438722811,"2015-08-04 14:13:31"
"17","20152715102727-628","3","2015-08-04 00:18:57",1438672737,"C8",338298,1439011035,"2015-08-07 22:17:15"
"2559","20152411112403-168","1","2015-08-04 00:27:00",1438673220,"C8",1043511,1439716731,"2015-08-16 02:18:51"
"372","20155401115443-339","2","2015-08-04 00:27:19",1438673239,"C7",108978,1438782217,"2015-08-05 06:43:37"
"4332","20155730085755-371","1","2015-08-04 00:31:35",1438673495,"C7",200810,1438874305,"2015-08-06 08:18:25"
"5775","20150327100356-183","1","2015-08-04 01:03:58",1438675438,"C5",329401,1439004839,"2015-08-07 20:33:59"
"526","20155431045446-47","1","2015-08-04 01:20:02",1438676402,"C3",144758,1438821160,"2015-08-05 17:32:40"
"2926","20151128051129-591","1","2015-08-04 02:17:56",1438679876,"C8",78741,1438758617,"2015-08-05 00:10:17"
"799","20150527050515-636","2","2015-08-04 02:34:15",1438680855,"C8",319470,1439000325,"2015-08-07 19:18:45"
"4822","20154202034222-47","2","2015-08-04 03:31:32",1438684292,"C4",64475,1438748767,"2015-08-04 21:26:07"
"3428","20150626070610-771","1","2015-08-04 03:48:16",1438685296,"C4",382863,1439068159,"2015-08-08 14:09:19"
"2526","20150122090132-684","1","2015-08-04 03:49:40",1438685380,"C5",462061,1439147441,"2015-08-09 12:10:41"
"2467","20150730030734-264","1","2015-08-04 03:52:16",1438685536,"C2",195741,1438881277,"2015-08-06 10:14:37"
"4553","20154320064328-347","2","2015-08-04 04:32:44",1438687964,"C2",644078,1439332042,"2015-08-11 15:27:22"
"1516","20155825095828-312","3","2015-08-04 04:57:03",1438689423,"C7",120845,1438810268,"2015-08-05 14:31:08"
"5161","20151529031505-215","2","2015-08-04 05:02:49",1438689769,"C3",60208,1438749977,"2015-08-04 21:46:17"
"5987","20151127061136-939","2","2015-08-04 05:32:18",1438691538,"C5",344421,1439035959,"2015-08-08 05:12:39"
"765","20155602105614-229","1","2015-08-04 06:18:16",1438694296,"C4",78061,1438772357,"2015-08-05 03:59:17"
"4835","20154003074029-430","1","2015-08-04 06:25:39",1438694739,"C4",394330,1439089069,"2015-08-08 19:57:49"
"4825","20154228074250-471","3","2015-08-04 06:28:15",1438694895,"C4",600325,1439295220,"2015-08-11 05:13:40"
"1261","20154305014335-971","3","2015-08-04 06:39:25",1438695565,"C5",366650,1439062215,"2015-08-08 12:30:15"
"3501","20150030050037-993","1","2015-08-04 06:56:29",1438696589,"C4",49469,1438746058,"2015-08-04 20:40:58"
"424","20153602033634-853","1","2015-08-04 07:01:54",1438696914,"C5",70960,1438767874,"2015-08-05 02:44:34"
"5891","20152703012733-565","3","2015-08-04 07:04:47",1438697087,"C6",63434,1438760521,"2015-08-05 00:42:01"
"5826","20153723013743-159","1","2015-08-04 07:45:52",1438699552,"C5",338563,1439038115,"2015-08-08 05:48:35"
"5861","20152901062908-724","1","2015-08-04 08:01:32",1438700492,"C2",264744,1438965236,"2015-08-07 09:33:56"
"3372","20154214064232-812","2","2015-08-04 08:30:48",1438702248,"C0",260128,1438962376,"2015-08-07 08:46:16"
"2672","20155410115442-469","2","2015-08-04 08:57:46",1438703866,"C3",268673,1438972539,"2015-08-07 11:35:39"
"4472","20155825075830-372","3","2015-08-04 09:03:06",1438704186,"C0",289292,1438993478,"2015-08-07 17:24:38"
"3275","20153431073442-374","1","2015-08-04 09:11:56",1438704716,"C8",175717,1438880433,"2015-08-06 10:00:33"
"5966","20154726014714-186","2","2015-08-04 09:33:22",1438706002,"C4",95296,1438801298,"2015-08-05 12:01:38"
"1244","20150126050104-378","1","2015-08-04 10:28:35",1438709315,"C4",754051,1439463366,"2015-08-13 03:56:06"
"3439","20152829102829-430","2","2015-08-04 11:03:59",1438711439,"C5",260265,1438971704,"2015-08-07 11:21:44"
"1119","20155525115532-571","1","2015-08-04 11:39:36",1438713576,"C0",431522,1439145098,"2015-08-09 11:31:38"
"2401","20151201061251-794","3","2015-08-04 11:48:32",1438714112,"C6",279341,1438993453,"2015-08-07 17:24:13"
"57","20155726065746-437","3","2015-08-04 11:50:24",1438714224,"C7",113594,1438827818,"2015-08-05 19:23:38"
"6192","20151421031443-290","2","2015-08-04 12:32:33",1438716753,"C7",599935,1439316688,"2015-08-11 11:11:28"
"139","20152830082847-300","2","2015-08-04 12:39:47",1438717187,"C8",223530,1438940717,"2015-08-07 02:45:17"
"5561","20154523124510-943","1","2015-08-04 13:06:57",1438718817,"C4",148301,1438867118,"2015-08-06 06:18:38"
"4113","20154903084903-690","2","2015-08-04 13:07:32",1438718852,"C0",101909,1438820761,"2015-08-05 17:26:01"
"2498","20155502025511-119","2","2015-08-04 13:47:09",1438721229,"C2",84359,1438805588,"2015-08-05 13:13:08"
"3298","20152330112343-14","1","2015-08-04 13:58:48",1438721928,"C8",88261,1438810189,"2015-08-05 14:29:49"
"33","20154729054707-256","2","2015-08-04 14:08:53",1438722533,"C4",252653,1438975186,"2015-08-07 12:19:46"
"6297","20152328052341-673","3","2015-08-04 15:15:00",1438726500,"C2",597079,1439323579,"2015-08-11 13:06:19"
"531","20150802090855-889","2","2015-08-04 15:18:17",1438726697,"C6",194962,1438921659,"2015-08-06 21:27:39"
"575","20150808090842-727","1","2015-08-04 15:20:24",1438726824,"C6",824517,1439551341,"2015-08-14 04:22:21"
"5844","20151906011943-68","2","2015-08-04 15:28:53",1438727333,"C2",359050,1439086383,"2015-08-08 19:13:03"
"6231","20155111095142-349","1","2015-08-04 15:38:46",1438727926,"C4",261803,1438989729,"2015-08-07 16:22:09"
"78","20155824015804-38","1","2015-08-04 15:42:52",1438728172,"C4",318896,1439047068,"2015-08-08 08:17:48"
"3389","20155013085022-330","2","2015-08-04 16:27:18",1438730838,"C5",565027,1439295865,"2015-08-11 05:24:25"
"482","20150231060233-191","1","2015-08-04 16:36:27",1438731387,"C5",127878,1438859265,"2015-08-06 04:07:45"
"5148","20153402093448-712","1","2015-08-04 17:02:49",1438732969,"C2",199681,1438932650,"2015-08-07 00:30:50"
"5164","20150325010306-666","3","2015-08-04 17:18:44",1438733924,"C4",439669,1439173593,"2015-08-09 19:26:33"
"2435","20154024044050-101","2","2015-08-04 17:53:32",1438736012,"C2",318254,1439054266,"2015-08-08 10:17:46"
"5100","20155924015914-772","2","2015-08-04 17:55:11",1438736111,"C6",87687,1438823798,"2015-08-05 18:16:38"
"3955","20151431101444-411","1","2015-08-04 18:58:56",1438739936,"C5",188526,1438928462,"2015-08-06 23:21:02"
"2076","20155626095622-144","3","2015-08-04 19:34:01",1438742041,"C3",116037,1438858078,"2015-08-06 03:47:58"
"1248","20152431022403-301","2","2015-08-04 20:13:39",1438744419,"C0",52368,1438796787,"2015-08-05 10:46:27"
"5934","20150425010459-670","1","2015-08-04 20:33:31",1438745611,"C3",111364,1438856975,"2015-08-06 03:29:35"
"5176","20151029031046-528","2","2015-08-04 20:38:43",1438745923,"C0",179359,1438925282,"2015-08-06 22:28:02"
"5134","20155729095741-271","1","2015-08-04 21:18:55",1438748335,"C5",450182,1439198517,"2015-08-10 02:21:57"
"4549","20150503030532-116","1","2015-08-04 21:34:19",1438749259,"C6",109727,1438858986,"2015-08-06 04:03:06"
"197","20152931062933-133","2","2015-08-04 21:38:39",1438749519,"C3",133382,1438882901,"2015-08-06 10:41:41"
"95","20151103021143-224","1","2015-08-04 22:00:38",1438750838,"C3",114535,1438865373,"2015-08-06 05:49:33"
"3862","20151231081203-407","2","2015-08-04 22:04:54",1438751094,"C4",131857,1438882951,"2015-08-06 10:42:31"
"5129","20150802090811-979","1","2015-08-04 22:20:53",1438752053,"C5",110181,1438862234,"2015-08-06 04:57:14"
"641","20153712013720-181","False","2015-08-04 22:28:16",1438752496,"C6",203932,1438956428,"2015-08-07 07:07:08"
"2907","20151730011708-691","3","2015-08-04 23:40:26",1438756826,"C5",234699,1438991525,"2015-08-07 16:52:05"
"4023","20153813103815-223","1","2015-08-04 23:47:55",1438757275,"C7",974090,1439731365,"2015-08-16 06:22:45"
"1833","20151902061935-596","3","2015-08-04 23:49:45",1438757385,"C0",117905,1438875290,"2015-08-06 08:34:50"
"3757","20151626021639-5","1","2015-08-04 23:59:25",1438757965,"C4",406283,1439164248,"2015-08-09 16:50:48"
"4263","20150019010004-372","1","2015-08-05 00:56:54",1438761414,"C7",203630,1438965044,"2015-08-07 09:30:44"
"3544","20153411103404-448","1","2015-08-05 01:36:46",1438763806,"C6",354627,1439118433,"2015-08-09 04:07:13"
"4468","20152030112000-524","1","2015-08-05 02:24:15",1438766655,"C2",162085,1438928740,"2015-08-06 23:25:40"
"216","20154431124424-721","1","2015-08-05 02:28:38",1438766918,"C7",197527,1438964445,"2015-08-07 09:20:45"
"709","20151704041733-844","1","2015-08-05 03:30:29",1438770629,"C5",339847,1439110476,"2015-08-09 01:54:36"
"2842","20155431125443-408","1","2015-08-05 03:35:19",1438770919,"C0",199218,1438970137,"2015-08-07 10:55:37"
"2506","20151929111952-130","2","2015-08-05 03:41:04",1438771264,"C4",288636,1439059900,"2015-08-08 11:51:40"
"3215","20151907011937-909","3","2015-08-05 03:52:57",1438771977,"C8",494320,1439266297,"2015-08-10 21:11:37"
"3762","20155724055744-118","2","2015-08-05 04:34:20",1438774460,"C7",141228,1438915688,"2015-08-06 19:48:08"
"6092","20154514034553-145","2","2015-08-05 04:45:37",1438775137,"C5",232648,1439007785,"2015-08-07 21:23:05"
"5169","20154728034746-685","2","2015-08-05 05:31:42",1438777902,"C4",59476,1438837378,"2015-08-05 22:02:58"
"734","20151901091942-196","1","2015-08-05 06:08:00",1438780080,"C4",167049,1438947129,"2015-08-07 04:32:09"
"1922","20152423072412-875","1","2015-08-05 06:18:30",1438780710,"C0",373086,1439153796,"2015-08-09 13:56:36"
"4436","20153004113046-680","3","2015-08-05 06:40:58",1438782058,"C4",69012,1438851070,"2015-08-06 01:51:10"
"4606","20154519024544-322","False","2015-08-05 06:43:44",1438782224,"C4",201446,1438983670,"2015-08-07 14:41:10"
"320","20153407113449-132","1","2015-08-05 07:19:27",1438784367,"C8",355754,1439140121,"2015-08-09 10:08:41"
"5984","20154225044228-490","2","2015-08-05 08:14:53",1438787693,"C8",183989,1438971682,"2015-08-07 11:21:22"
"399","20150415070401-918","2","2015-08-05 08:42:43",1438789363,"C4",260046,1439049409,"2015-08-08 08:56:49"
"6213","20155328125314-729","1","2015-08-05 08:55:22",1438790122,"C5",84616,1438874738,"2015-08-06 08:25:38"
"818","20151003011029-293","3","2015-08-05 09:00:21",1438790421,"C5",78896,1438869317,"2015-08-06 06:55:17"
"1668","20150829110854-562","2","2015-08-05 09:06:45",1438790805,"C4",85353,1438876158,"2015-08-06 08:49:18"
"121","20155330125308-863","3","2015-08-05 10:59:52",1438797592,"C2",255802,1439053394,"2015-08-08 10:03:14"
"5186","20150013110015-112","2","2015-08-05 11:04:55",1438797895,"C3",248435,1439046330,"2015-08-08 08:05:30"
"6137","20150010120037-8","1","2015-08-05 11:50:35",1438800635,"C2",1122899,1439923534,"2015-08-18 11:45:34"
"3265","20153102063100-491","1","2015-08-05 12:35:09",1438803309,"C4",281049,1439084358,"2015-08-08 18:39:18"
"1686","20150010030002-664","2","2015-08-05 12:51:54",1438804314,"C3",279839,1439084153,"2015-08-08 18:35:53"
"1654","20155522095506-197","2","2015-08-05 13:14:15",1438805655,"C7",174507,1438980162,"2015-08-07 13:42:42"
"3188","20150815100857-72","1","2015-08-05 13:47:42",1438807662,"C5",261075,1439068737,"2015-08-08 14:18:57"
"3660","20154701104706-898","1","2015-08-05 15:03:02",1438812182,"C2",180478,1438992660,"2015-08-07 17:11:00"
"778","20151731051740-917","3","2015-08-05 15:08:45",1438812525,"C2",424265,1439236790,"2015-08-10 12:59:50"
"4084","20152123012154-34","2","2015-08-05 15:12:12",1438812732,"C5",376606,1439189338,"2015-08-09 23:48:58"
"1882","20152513102558-161","2","2015-08-05 15:30:46",1438813846,"C2",250686,1439064532,"2015-08-08 13:08:52"
"3569","20150901080955-679","1","2015-08-05 16:15:16",1438816516,"C3",124907,1438941423,"2015-08-07 02:57:03"
"4367","20150420100416-232","1","2015-08-05 17:09:09",1438819749,"C6",1407893,1440227642,"2015-08-22 00:14:02"
"2393","20150618050611-599","2","2015-08-05 17:16:24",1438820184,"C3",222259,1439042443,"2015-08-08 07:00:43"
"5033","20155601125604-18","1","2015-08-05 17:17:50",1438820270,"C7",180653,1439000923,"2015-08-07 19:28:43"
"2007","20154723054713-268","1","2015-08-05 19:42:58",1438828978,"C7",531735,1439360713,"2015-08-11 23:25:13"
"5881","20150530020556-90","1","2015-08-05 19:51:00",1438829460,"C5",269552,1439099012,"2015-08-08 22:43:32"
"6338","20153408093405-996","1","2015-08-05 20:36:24",1438832184,"C2",351277,1439183461,"2015-08-09 22:11:01"
"1659","20150224100248-221","1","2015-08-05 20:43:48",1438832628,"C8",215052,1439047680,"2015-08-08 08:28:00"
"5439","20155702055701-405","3","2015-08-05 21:10:39",1438834239,"C7",135409,1438969648,"2015-08-07 10:47:28"
"5244","20155129055147-431","1","2015-08-05 21:56:33",1438836993,"C8",309743,1439146736,"2015-08-09 11:58:56"
"500","20150201080243-358","2","2015-08-05 22:26:51",1438838811,"C5",198724,1439037535,"2015-08-08 05:38:55"
"3921","20153426053424-13","1","2015-08-06 01:51:24",1438851084,"C8",697164,1439548248,"2015-08-14 03:30:48"
"3510","20153827043838-171","1","2015-08-06 01:54:58",1438851298,"C0",405490,1439256788,"2015-08-10 18:33:08"
"5358","20154302084358-573","1","2015-08-06 01:59:22",1438851562,"C2",107108,1438958670,"2015-08-07 07:44:30"
"2597","20150405090426-651","2","2015-08-06 03:37:11",1438857431,"C8",549033,1439406464,"2015-08-12 12:07:44"
"3911","20154930044907-211","1","2015-08-06 03:40:11",1438857611,"C4",69683,1438927294,"2015-08-06 23:01:34"
"6285","20155019065049-871","3","2015-08-06 04:06:57",1438859217,"C6",193171,1439052388,"2015-08-08 09:46:28"
"3238","20152714062757-568","3","2015-08-06 04:15:27",1438859727,"C5",282750,1439142477,"2015-08-09 10:47:57"
"1256","20155124035131-240","1","2015-08-06 04:40:39",1438861239,"C7",541474,1439402713,"2015-08-12 11:05:13"
"4668","20155323025342-343","1","2015-08-06 04:52:42",1438861962,"C8",586770,1439448732,"2015-08-12 23:52:12"
"1780","20154530034541-167","1","2015-08-06 06:22:38",1438867358,"C5",190339,1439057697,"2015-08-08 11:14:57"
"792","20153828073820-71","1","2015-08-06 06:42:24",1438868544,"C8",387122,1439255666,"2015-08-10 18:14:26"
"4053","20150521120547-745","1","2015-08-06 07:22:32",1438870952,"C8",273081,1439144033,"2015-08-09 11:13:53"
"676","20155631115626-437","3","2015-08-06 08:27:18",1438874838,"C5",252926,1439127764,"2015-08-09 06:42:44"
"721","20155501065521-181","2","2015-08-06 08:45:41",1438875941,"C8",219310,1439095251,"2015-08-08 21:40:51"
"3760","20152131082145-700","2","2015-08-06 09:45:51",1438879551,"C6",87241,1438966792,"2015-08-07 09:59:52"
"878","20153602053648-835","1","2015-08-06 09:50:26",1438879826,"C5",158809,1439038635,"2015-08-08 05:57:15"
"748","20151031021043-605","2","2015-08-06 10:11:07",1438881067,"C5",252012,1439133079,"2015-08-09 08:11:19"
"6198","20151728111711-22","1","2015-08-06 10:14:29",1438881269,"C5",257946,1439139215,"2015-08-09 09:53:35"
"3027","20151313051340-385","2","2015-08-06 10:19:30",1438881570,"C8",409750,1439291320,"2015-08-11 04:08:40"
"4302","20150326090318-883","1","2015-08-06 10:27:04",1438882024,"C5",477713,1439359737,"2015-08-11 23:08:57"
"6553","20151727081750-912","1","2015-08-06 10:27:15",1438882035,"C8",174353,1439056388,"2015-08-08 10:53:08"
"929","20151128071144-68","3","2015-08-06 11:21:35",1438885295,"C2",264197,1439149492,"2015-08-09 12:44:52"
"5104","20155202025227-496","1","2015-08-06 11:47:25",1438886845,"C3",167249,1439054094,"2015-08-08 10:14:54"
"1399","20150001100019-538","1","2015-08-06 12:03:13",1438887793,"C6",73229,1438961022,"2015-08-07 08:23:42"
"5605","20150623110625-496","3","2015-08-06 12:19:27",1438888767,"C4",173426,1439062193,"2015-08-08 12:29:53"
"5810","20153015023001-696","2","2015-08-06 13:02:34",1438891354,"C5",631851,1439523205,"2015-08-13 20:33:25"
"6498","20153431103412-743","1","2015-08-06 14:32:53",1438896773,"C4",76103,1438972876,"2015-08-07 11:41:16"
"4579","20150702020750-193","2","2015-08-06 14:56:47",1438898207,"C0",116179,1439014386,"2015-08-07 23:13:06"
"1835","20155224025254-187","1","2015-08-06 15:22:06",1438899726,"C4",140619,1439040345,"2015-08-08 06:25:45"
"3314","20155505035539-722","3","2015-08-06 16:05:11",1438902311,"C2",86972,1438989283,"2015-08-07 16:14:43"
"5689","20151624031658-684","3","2015-08-06 16:07:14",1438902434,"C8",160888,1439063322,"2015-08-08 12:48:42"
"4655","20155708025703-505","3","2015-08-06 16:07:51",1438902471,"C0",313731,1439216202,"2015-08-10 07:16:42"
"1625","20151008061031-83","1","2015-08-06 16:27:21",1438903641,"C7",363230,1439266871,"2015-08-10 21:21:11"
"4379","20155904025922-23","1","2015-08-06 17:23:51",1438907031,"C2",181469,1439088500,"2015-08-08 19:48:20"
"6525","20155623095618-430","1","2015-08-06 17:50:46",1438908646,"C5",619034,1439527680,"2015-08-13 21:48:00"
"698","20152605012634-824","1","2015-08-06 19:11:04",1438913464,"C4",185698,1439099162,"2015-08-08 22:46:02"
"5617","20151704061733-850","1","2015-08-06 19:13:11",1438913591,"C8",109669,1439023260,"2015-08-08 01:41:00"
"5036","20153011023028-435","1","2015-08-06 19:56:20",1438916180,"C6",283244,1439199424,"2015-08-10 02:37:04"
"1319","20155630105651-729","2","2015-08-06 19:58:11",1438916291,"C2",79660,1438995951,"2015-08-07 18:05:51"
"1949","20154831094847-710","1","2015-08-06 20:08:27",1438916907,"C8",111116,1439028023,"2015-08-08 03:00:23"
"2982","20152012042036-344","1","2015-08-06 20:35:31",1438918531,"C8",435059,1439353590,"2015-08-11 21:26:30"
"2781","20152027032011-806","2","2015-08-06 20:38:55",1438918735,"C2",441562,1439360297,"2015-08-11 23:18:17"
"727","20155926095918-705","1","2015-08-06 20:39:58",1438918798,"C4",123605,1439042403,"2015-08-08 07:00:03"
"5818","20150509050552-677","1","2015-08-06 21:16:58",1438921018,"C7",270474,1439191492,"2015-08-10 00:24:52"
"5268","20150811050851-143","2","2015-08-06 21:18:00",1438921080,"C7",251261,1439172341,"2015-08-09 19:05:41"
"5136","20155229095213-604","1","2015-08-06 22:04:37",1438923877,"C5",91893,1439015770,"2015-08-07 23:36:10"
"4288","20150429080442-199","2","2015-08-06 22:08:16",1438924096,"C6",741814,1439665910,"2015-08-15 12:11:50"
"4812","20150323030348-749","1","2015-08-06 22:44:14",1438926254,"C4",618613,1439544867,"2015-08-14 02:34:27"
"6106","20154301074308-402","1","2015-08-06 22:56:33",1438926993,"C8",97361,1439024354,"2015-08-08 01:59:14"
"3091","20155625015640-270","2","2015-08-06 23:52:20",1438930340,"C0",153220,1439083560,"2015-08-08 18:26:00"
"3944","20150922010936-575","1","2015-08-07 02:13:30",1438938810,"C4",191862,1439130672,"2015-08-09 07:31:12"
"2414","20155731055752-472","2","2015-08-07 02:50:54",1438941054,"C4",78626,1439019680,"2015-08-08 00:41:20"
"2893","20154325114323-182","1","2015-08-07 03:57:52",1438945072,"C0",156467,1439101539,"2015-08-08 23:25:39"
"3241","20152804122805-486","2","2015-08-07 04:03:44",1438945424,"C4",76313,1439021737,"2015-08-08 01:15:37"
"943","20153613053658-337","1","2015-08-07 04:08:38",1438945718,"C8",422300,1439368018,"2015-08-12 01:26:58"
"1545","20153905113904-390","2","2015-08-07 04:16:22",1438946182,"C6",470773,1439416955,"2015-08-12 15:02:35"
"625","20151828051857-513","3","2015-08-07 05:32:48",1438950768,"C2",273877,1439224645,"2015-08-10 09:37:25"
"5315","20150621090620-651","2","2015-08-07 06:07:32",1438952852,"C0",506259,1439459111,"2015-08-13 02:45:11"
"1860","20154127084151-732","2","2015-08-07 06:30:39",1438954239,"C3",117816,1439072055,"2015-08-08 15:14:15"
"2112","20150904060946-997","1","2015-08-07 06:33:30",1438954410,"C0",130312,1439084722,"2015-08-08 18:45:22"
"1683","20154706044711-22","1","2015-08-07 07:46:59",1438958819,"C3",53988,1439012807,"2015-08-07 22:46:47"
"1289","20155701085744-294","1","2015-08-07 07:49:59",1438958999,"C5",171445,1439130444,"2015-08-09 07:27:24"
"2010","20150503070532-763","3","2015-08-07 07:59:06",1438959546,"C4",348814,1439308360,"2015-08-11 08:52:40"
"2284","20150329030344-472","2","2015-08-07 08:12:05",1438960325,"C0",250967,1439211292,"2015-08-10 05:54:52"
"6324","20155307125327-646","1","2015-08-07 08:29:47",1438961387,"C8",532516,1439493903,"2015-08-13 12:25:03"
"3184","20154703044709-708","1","2015-08-07 08:55:49",1438962949,"C3",427960,1439390909,"2015-08-12 07:48:29"
"2271","20152905062952-3","1","2015-08-07 09:25:34",1438964734,"C4",183342,1439148076,"2015-08-09 12:21:16"
"2133","20153401123448-154","1","2015-08-07 09:48:52",1438966132,"C5",254222,1439220354,"2015-08-10 08:25:54"
"1041","20154606054615-464","2","2015-08-07 10:53:47",1438970027,"C7",391436,1439361463,"2015-08-11 23:37:43"
"248","20150030100046-714","2","2015-08-07 10:55:48",1438970148,"C7",347251,1439317399,"2015-08-11 11:23:19"
"4583","20153616093612-196","1","2015-08-07 11:01:00",1438970460,"C4",635296,1439605756,"2015-08-14 19:29:16"
"6452","20150517100545-515","1","2015-08-07 11:07:57",1438970877,"C6",303022,1439273899,"2015-08-10 23:18:19"
"994","20151603061654-187","1","2015-08-07 11:16:24",1438971384,"C2",121190,1439092574,"2015-08-08 20:56:14"
"2817","20155906055936-524","1","2015-08-07 11:47:51",1438973271,"C2",64095,1439037366,"2015-08-08 05:36:06"
"3235","20152331032358-34","3","2015-08-07 11:48:10",1438973290,"C6",98642,1439071932,"2015-08-08 15:12:12"
"1998","20152525102559-950","2","2015-08-07 11:52:59",1438973579,"C7",125380,1439098959,"2015-08-08 22:42:39"
"617","20154506054510-602","3","2015-08-07 12:30:00",1438975800,"C3",392270,1439368070,"2015-08-12 01:27:50"
"5057","20151431021452-330","1","2015-08-07 13:14:44",1438978484,"C5",75149,1439053633,"2015-08-08 10:07:13"
"6500","20155119025114-185","2","2015-08-07 14:04:09",1438981449,"C8",327755,1439309204,"2015-08-11 09:06:44"
"4156","20150104050127-736","1","2015-08-07 14:44:03",1438983843,"C0",83652,1439067495,"2015-08-08 13:58:15"
"5870","20150604040619-38","1","2015-08-07 15:16:03",1438985763,"C6",256184,1439241947,"2015-08-10 14:25:47"
"1752","20154112014114-381","False","2015-08-07 16:21:27",1438989687,"C6",203285,1439192972,"2015-08-10 00:49:32"
"4442","20151003111052-171","1","2015-08-07 16:22:16",1438989736,"C4",364284,1439354020,"2015-08-11 21:33:40"
"1305","20153206033254-715","2","2015-08-07 16:43:02",1438990982,"C4",90608,1439081590,"2015-08-08 17:53:10"
"3855","20152028072036-773","3","2015-08-07 17:28:20",1438993700,"C5",112558,1439106258,"2015-08-09 00:44:18"
"3868","20155530035556-433","2","2015-08-07 18:16:14",1438996574,"C8",349809,1439346383,"2015-08-11 19:26:23"
"1861","20151725041726-478","2","2015-08-07 18:18:52",1438996732,"C3",161498,1439158230,"2015-08-09 15:10:30"
"5124","20154126024158-664","2","2015-08-07 18:48:41",1438998521,"C3",150229,1439148750,"2015-08-09 12:32:30"
"1187","20152705042730-318","2","2015-08-07 18:51:58",1438998718,"C4",90734,1439089452,"2015-08-08 20:04:12"
"5318","20151730061703-165","2","2015-08-07 19:05:03",1438999503,"C5",92160,1439091663,"2015-08-08 20:41:03"
"6401","20152629022625-52","1","2015-08-07 20:55:21",1439006121,"C2",424117,1439430238,"2015-08-12 18:43:58"
"5753","20152706112749-394","2","2015-08-07 21:20:02",1439007602,"C4",121933,1439129535,"2015-08-09 07:12:15"
"2367","20154604044619-717","2","2015-08-07 21:44:16",1439009056,"C6",277077,1439286133,"2015-08-11 02:42:13"
"6275","20151601101604-955","2","2015-08-07 22:11:34",1439010694,"C0",80190,1439090884,"2015-08-08 20:28:04"
"6185","20151625101651-52","1","2015-08-07 22:30:07",1439011807,"C3",537028,1439548835,"2015-08-14 03:40:35"
"3068","20153113063149-619","2","2015-08-07 22:44:55",1439012695,"C4",687198,1439699893,"2015-08-15 21:38:13"
"4008","20155129085126-994","2","2015-08-07 22:46:41",1439012801,"C7",118245,1439131046,"2015-08-09 07:37:26"
"1528","20154429124439-546","3","2015-08-08 01:55:06",1439024106,"C0",117861,1439141967,"2015-08-09 10:39:27"
"551","20154718044706-170","1","2015-08-08 02:23:04",1439025784,"C5",251794,1439277578,"2015-08-11 00:19:38"
"359","20151001041055-580","1","2015-08-08 02:53:09",1439027589,"C7",278467,1439306056,"2015-08-11 08:14:16"
"2226","20152221072217-797","1","2015-08-08 03:50:08",1439031008,"C7",220353,1439251361,"2015-08-10 17:02:41"
"3650","20155929065908-355","1","2015-08-08 03:50:11",1439031011,"C7",121809,1439152820,"2015-08-09 13:40:20"
"3502","20150406040417-783","1","2015-08-08 04:39:23",1439033963,"C8",65853,1439099816,"2015-08-08 22:56:56"
"5570","20152102082141-663","1","2015-08-08 05:20:41",1439036441,"C7",253770,1439290211,"2015-08-11 03:50:11"
"1812","20150708100721-172","3","2015-08-08 05:47:53",1439038073,"C5",332854,1439370927,"2015-08-12 02:15:27"
"2799","20150717060746-729","3","2015-08-08 06:07:08",1439039228,"C7",950381,1439989609,"2015-08-19 06:06:49"
"5462","20155227125212-315","3","2015-08-08 06:50:22",1439041822,"C7",507545,1439549367,"2015-08-14 03:49:27"
"4794","20155004035020-880","3","2015-08-08 07:29:15",1439044155,"C8",63107,1439107262,"2015-08-09 01:01:02"
"1462","20150102080153-960","2","2015-08-08 08:46:49",1439048809,"C5",260548,1439309357,"2015-08-11 09:09:17"
"720","20151001051049-770","1","2015-08-08 08:49:13",1439048953,"C3",71838,1439120791,"2015-08-09 04:46:31"
"1622","20155330095334-363","2","2015-08-08 08:52:22",1439049142,"C4",96741,1439145883,"2015-08-09 11:44:43"
"1853","20153203113245-908","1","2015-08-08 09:00:07",1439049607,"C5",211421,1439261028,"2015-08-10 19:43:48"
"1405","20150702020734-303","1","2015-08-08 09:33:28",1439051608,"C2",501954,1439553562,"2015-08-14 04:59:22"
"6337","20154128094123-201","1","2015-08-08 09:39:47",1439051987,"C5",442788,1439494775,"2015-08-13 12:39:35"
"6101","20154118114130-34","1","2015-08-08 10:32:50",1439055170,"C8",362056,1439417226,"2015-08-12 15:07:06"
"5853","20153530053501-879","2","2015-08-08 10:48:21",1439056101,"C8",150640,1439206741,"2015-08-10 04:39:01"
"6178","20153801063819-939","1","2015-08-08 10:54:17",1439056457,"C5",310079,1439366536,"2015-08-12 01:02:16"
"688","20155431025449-131","3","2015-08-08 11:31:36",1439058696,"C2",97001,1439155697,"2015-08-09 14:28:17"
"4766","20152922072959-445","3","2015-08-08 11:55:34",1439060134,"C0",212105,1439272239,"2015-08-10 22:50:39"
"6458","20151101121144-520","2","2015-08-08 12:00:48",1439060448,"C4",410318,1439470766,"2015-08-13 05:59:26"
"2740","20150427060448-246","3","2015-08-08 12:25:00",1439061900,"C7",529806,1439591706,"2015-08-14 15:35:06"
"6240","20152922022915-661","2","2015-08-08 13:00:11",1439064011,"C5",182932,1439246943,"2015-08-10 15:49:03"
"2023","20150929080924-256","2","2015-08-08 13:36:20",1439066180,"C5",110452,1439176632,"2015-08-09 20:17:12"
"1718","20154423014424-392","1","2015-08-08 14:00:00",1439067600,"C2",691668,1439759268,"2015-08-16 14:07:48"
"2108","20155330095316-775","3","2015-08-08 14:21:55",1439068915,"C0",264573,1439333488,"2015-08-11 15:51:28"
"1825","20151230021228-117","1","2015-08-08 14:25:46",1439069146,"C2",259466,1439328612,"2015-08-11 14:30:12"
"5367","20152030032051-557","2","2015-08-08 18:25:48",1439083548,"C4",262899,1439346447,"2015-08-11 19:27:27"
"5370","20153403083413-579","3","2015-08-08 18:43:19",1439084599,"C3",468546,1439553145,"2015-08-14 04:52:25"
"5328","20151303081343-855","1","2015-08-08 18:45:44",1439084744,"C4",469921,1439554665,"2015-08-14 05:17:45"
"4894","20150725010752-511","1","2015-08-08 19:43:36",1439088216,"C4",176192,1439264408,"2015-08-10 20:40:08"
"6071","20155703055759-244","2","2015-08-08 20:02:05",1439089325,"C2",62778,1439152103,"2015-08-09 13:28:23"
"498","20154430054442-410","2","2015-08-08 20:17:17",1439090237,"C8",157351,1439247588,"2015-08-10 15:59:48"
"5867","20155914105910-953","1","2015-08-08 20:24:38",1439090678,"C4",274241,1439364919,"2015-08-12 00:35:19"
"5395","20152903032937-233","3","2015-08-08 21:40:05",1439095205,"C5",227114,1439322319,"2015-08-11 12:45:19"
"6108","20155725075727-219","1","2015-08-08 21:43:34",1439095414,"C4",179881,1439275295,"2015-08-10 23:41:35"
"4496","20150607040626-348","2","2015-08-08 22:05:08",1439096708,"C0",53961,1439150669,"2015-08-09 13:04:29"
"4138","20153710023741-996","1","2015-08-08 22:12:45",1439097165,"C4",316613,1439413778,"2015-08-12 14:09:38"
"2124","20154705044710-733","2","2015-08-08 22:44:28",1439099068,"C6",46773,1439145841,"2015-08-09 11:44:01"
"3889","20153007013003-908","1","2015-08-08 23:19:23",1439101163,"C5",350020,1439451183,"2015-08-13 00:33:03"
"4044","20155402045434-428","2","2015-08-09 00:19:26",1439104766,"C5",272546,1439377312,"2015-08-12 04:01:52"
"3435","20151318051330-957","3","2015-08-09 02:15:42",1439111742,"C7",923466,1440035208,"2015-08-19 18:46:48"
"345","20151002041036-991","1","2015-08-09 02:23:28",1439112208,"C3",277586,1439389794,"2015-08-12 07:29:54"
"6225","20150521080528-185","1","2015-08-09 02:34:16",1439112856,"C6",526716,1439639572,"2015-08-15 04:52:52"
"363","20153107033125-767","1","2015-08-09 02:34:41",1439112881,"C5",63098,1439175979,"2015-08-09 20:06:19"
"3103","20151202101257-746","1","2015-08-09 02:47:17",1439113637,"C0",82580,1439196217,"2015-08-10 01:43:37"
"5082","20151002021015-986","1","2015-08-09 03:14:15",1439115255,"C5",282720,1439397975,"2015-08-12 09:46:15"
"4979","20152217062234-111","3","2015-08-09 03:17:55",1439115475,"C4",282303,1439397778,"2015-08-12 09:42:58"
"2996","20150701070729-336","1","2015-08-09 03:31:14",1439116274,"C5",226075,1439342349,"2015-08-11 18:19:09"
"2532","20153222103251-804","1","2015-08-09 03:48:07",1439117287,"C5",765458,1439882745,"2015-08-18 00:25:45"
"846","20150917110936-396","3","2015-08-09 04:02:03",1439118123,"C4",280221,1439398344,"2015-08-12 09:52:24"
"1083","20154125044106-999","1","2015-08-09 04:19:00",1439119140,"C2",178782,1439297922,"2015-08-11 05:58:42"
"465","20154425094430-276","1","2015-08-09 04:27:44",1439119664,"C2",638497,1439758161,"2015-08-16 13:49:21"
"5678","20151002071039-91","1","2015-08-09 04:35:17",1439120117,"C8",297739,1439417856,"2015-08-12 15:17:36"
"4659","20150206110226-989","2","2015-08-09 05:21:41",1439122901,"C4",79585,1439202486,"2015-08-10 03:28:06"
"4271","20152831082802-61","1","2015-08-09 06:16:32",1439126192,"C6",128285,1439254477,"2015-08-10 17:54:37"
"1084","20152028062056-368","3","2015-08-09 06:39:50",1439127590,"C0",345978,1439473568,"2015-08-13 06:46:08"
"6311","20150102020155-899","1","2015-08-09 06:57:57",1439128677,"C4",82766,1439211443,"2015-08-10 05:57:23"
"1854","20152106092141-219","1","2015-08-09 07:02:19",1439128939,"C5",125419,1439254358,"2015-08-10 17:52:38"
"1865","20154020024044-998","3","2015-08-09 07:03:58",1439129038,"C5",242942,1439371980,"2015-08-12 02:33:00"
"2373","20154131064108-797","1","2015-08-09 07:07:32",1439129252,"C2",259728,1439388980,"2015-08-12 07:16:20"
"1696","20150122100136-869","1","2015-08-09 07:37:27",1439131047,"C2",515517,1439646564,"2015-08-15 06:49:24"
"6294","20154028074004-866","1","2015-08-09 07:50:12",1439131812,"C5",129676,1439261488,"2015-08-10 19:51:28"
"4006","20154726114709-355","1","2015-08-09 07:57:33",1439132253,"C4",170832,1439303085,"2015-08-11 07:24:45"
"5484","20150607050608-159","2","2015-08-09 08:06:37",1439132797,"C2",140429,1439273226,"2015-08-10 23:07:06"
"3741","20151001091013-536","1","2015-08-09 09:30:25",1439137825,"C2",98916,1439236741,"2015-08-10 12:59:01"
"1669","20155731015742-412","1","2015-08-09 09:30:33",1439137833,"C5",253857,1439391690,"2015-08-12 08:01:30"
"5014","20151907021947-595","2","2015-08-09 10:39:31",1439141971,"C0",159584,1439301555,"2015-08-11 06:59:15"
"2895","20151112011137-325","1","2015-08-09 11:24:10",1439144650,"C2",344679,1439489329,"2015-08-13 11:08:49"
"2644","20155607015659-126","2","2015-08-09 11:26:49",1439144809,"C7",81895,1439226704,"2015-08-10 10:11:44"
"4219","20152022082028-22","2","2015-08-09 11:28:04",1439144884,"C5",783228,1439928112,"2015-08-18 13:01:52"
"2349","20152830062810-554","1","2015-08-09 11:46:22",1439145982,"C2",294364,1439440346,"2015-08-12 21:32:26"
"1485","20154912084916-322","1","2015-08-09 12:09:08",1439147348,"C6",303899,1439451247,"2015-08-13 00:34:07"
"3114","20152707022754-808","3","2015-08-09 12:30:31",1439148631,"C6",165757,1439314388,"2015-08-11 10:33:08"
"3831","20154202074243-737","1","2015-08-09 12:49:55",1439149795,"C4",311616,1439461411,"2015-08-13 03:23:31"
"5305","20153122093107-869","1","2015-08-09 13:11:23",1439151083,"C5",196052,1439347135,"2015-08-11 19:38:55"
"2392","20152821042813-361","2","2015-08-09 13:55:14",1439153714,"C3",233203,1439386917,"2015-08-12 06:41:57"
"6113","20150324060332-594","2","2015-08-09 15:03:02",1439157782,"C8",282954,1439440736,"2015-08-12 21:38:56"
"4370","20151428111428-181","3","2015-08-09 15:03:08",1439157788,"C8",210104,1439367892,"2015-08-12 01:24:52"
"2180","20152716122736-950","1","2015-08-09 15:11:42",1439158302,"C1",347241,1439505543,"2015-08-13 15:39:03"
"519","20150405080425-970","2","2015-08-09 15:12:14",1439158334,"C5",435667,1439594001,"2015-08-14 16:13:21"
"3182","20152531072521-938","3","2015-08-09 15:59:27",1439161167,"C4",269482,1439430649,"2015-08-12 18:50:49"
"6321","20150902110946-207","1","2015-08-09 16:06:34",1439161594,"C7",88944,1439250538,"2015-08-10 16:48:58"
"373","20155807125802-565","1","2015-08-09 16:13:34",1439162014,"C0",92266,1439254280,"2015-08-10 17:51:20"
"3077","20154622054623-743","3","2015-08-09 16:29:25",1439162965,"C7",775291,1439938256,"2015-08-18 15:50:56"
"881","20153508033513-874","1","2015-08-09 17:24:10",1439166250,"C2",92937,1439259187,"2015-08-10 19:13:07"
"2030","20153703073756-936","1","2015-08-09 17:48:23",1439167703,"C3",555027,1439722730,"2015-08-16 03:58:50"
"5290","20150206080226-163","1","2015-08-09 18:49:41",1439171381,"C5",99345,1439270726,"2015-08-10 22:25:26"
"4065","20152806032847-86","3","2015-08-09 19:13:19",1439172799,"C3",368884,1439541683,"2015-08-14 01:41:23"
"6485","20150406120427-726","3","2015-08-09 19:36:52",1439174212,"C3",423535,1439597747,"2015-08-14 17:15:47"
"2137","20150923010958-595","3","2015-08-09 20:13:26",1439176406,"C5",583744,1439760150,"2015-08-16 14:22:30"
"834","20155407095436-165","2","2015-08-09 20:56:12",1439178972,"C4",106248,1439285220,"2015-08-11 02:27:00"
"4720","20151025071006-134","3","2015-08-09 21:01:24",1439179284,"C6",224313,1439403597,"2015-08-12 11:19:57"
"5784","20155204125243-368","2","2015-08-09 21:02:27",1439179347,"C8",65912,1439245259,"2015-08-10 15:20:59"
"5007","20155520045513-443","2","2015-08-09 22:16:58",1439183818,"C8",249615,1439433433,"2015-08-12 19:37:13"
"2247","20154931014916-410","2","2015-08-09 22:19:36",1439183976,"C0",115460,1439299436,"2015-08-11 06:23:56"
"434","20152626032621-951","3","2015-08-09 22:39:42",1439185182,"C3",411867,1439597049,"2015-08-14 17:04:09"
"6286","20155307115300-161","1","2015-08-09 22:49:36",1439185776,"C4",70732,1439256508,"2015-08-10 18:28:28"
"3302","20154026024058-952","2","2015-08-09 23:01:00",1439186460,"C4",177086,1439363546,"2015-08-12 00:12:26"
"4953","20152008102034-994","1","2015-08-10 00:49:52",1439192992,"C8",69279,1439262271,"2015-08-10 20:04:31"
"2286","20154402034401-435","2","2015-08-10 00:50:15",1439193015,"C8",91082,1439284097,"2015-08-11 02:08:17"
"3560","20154103084118-72","1","2015-08-10 00:50:20",1439193020,"C8",288271,1439481291,"2015-08-13 08:54:51"
"2385","20155507025512-789","2","2015-08-10 01:04:02",1439193842,"C5",104665,1439298507,"2015-08-11 06:08:27"
"2708","20151607061640-872","1","2015-08-10 01:15:52",1439194552,"C7",120576,1439315128,"2015-08-11 10:45:28"
"1311","20153724023747-163","1","2015-08-10 01:16:11",1439194571,"C7",710352,1439904923,"2015-08-18 06:35:23"
"4061","20150228010235-447","2","2015-08-10 01:25:01",1439195101,"C3",154478,1439349579,"2015-08-11 20:19:39"
"1345","20150108120140-67","1","2015-08-10 02:04:08",1439197448,"C5",68474,1439265922,"2015-08-10 21:05:22"
"5343","20150218120246-220","1","2015-08-10 02:43:09",1439199789,"C0",279089,1439478878,"2015-08-13 08:14:38"
"2402","20155706045723-418","1","2015-08-10 02:50:19",1439200219,"C8",147388,1439347607,"2015-08-11 19:46:47"
"5760","20150704010749-266","1","2015-08-10 03:04:47",1439201087,"C7",241109,1439442196,"2015-08-12 22:03:16"
"837","20153707093749-951","2","2015-08-10 03:58:03",1439204283,"C3",119407,1439323690,"2015-08-11 13:08:10"
"1094","20151805101809-893","1","2015-08-10 04:12:54",1439205174,"C8",82017,1439287191,"2015-08-11 02:59:51"
"1877","20155525045517-999","1","2015-08-10 04:22:14",1439205734,"C5",191031,1439396765,"2015-08-12 09:26:05"
"8","20155525065551-662","1","2015-08-10 04:30:31",1439206231,"C8",196240,1439402471,"2015-08-12 11:01:11"
"3814","20154728094759-13","2","2015-08-10 04:37:08",1439206628,"C5",368183,1439574811,"2015-08-14 10:53:31"
"392","20154922104905-300","1","2015-08-10 05:09:38",1439208578,"C7",180137,1439388715,"2015-08-12 07:11:55"
"1590","20153531103551-510","1","2015-08-10 05:23:19",1439209399,"C2",105656,1439315055,"2015-08-11 10:44:15"
"2297","20151101081109-505","3","2015-08-10 05:43:57",1439210637,"C5",96096,1439306733,"2015-08-11 08:25:33"
"1338","20151518061551-586","2","2015-08-10 06:01:57",1439211717,"C0",993183,1440204900,"2015-08-21 17:55:00"
"5021","20150401070439-330","1","2015-08-10 06:26:07",1439213167,"C4",96911,1439310078,"2015-08-11 09:21:18"
"1330","20153416013430-901","2","2015-08-10 06:29:02",1439213342,"C2",266809,1439480151,"2015-08-13 08:35:51"
"3896","20150201070216-808","2","2015-08-10 06:32:12",1439213532,"C4",775796,1439989328,"2015-08-19 06:02:08"
"2157","20154931024946-567","1","2015-08-10 06:47:06",1439214426,"C7",417520,1439631946,"2015-08-15 02:45:46"
"3367","20151522041501-365","1","2015-08-10 06:48:34",1439214514,"C4",229659,1439444173,"2015-08-12 22:36:13"
"2199","20155531115507-502","2","2015-08-10 07:31:12",1439217072,"C8",169633,1439386705,"2015-08-12 06:38:25"
"4855","20150629090627-62","2","2015-08-10 08:25:31",1439220331,"C0",129293,1439349624,"2015-08-11 20:20:24"
"4233","20153124113131-106","2","2015-08-10 08:41:07",1439221267,"C4",182322,1439403589,"2015-08-12 11:19:49"
"912","20153308073320-351","1","2015-08-10 09:29:54",1439224194,"C8",89897,1439314091,"2015-08-11 10:28:11"
"4716","20154408074420-516","1","2015-08-10 09:36:38",1439224598,"C7",89769,1439314367,"2015-08-11 10:32:47"
"1202","20150109060133-67","1","2015-08-10 09:45:59",1439225159,"C2",99866,1439325025,"2015-08-11 13:30:25"
"6303","20154309054331-529","3","2015-08-10 09:48:51",1439225331,"C6",57920,1439283251,"2015-08-11 01:54:11"
"232","20153609033627-164","2","2015-08-10 09:56:57",1439225817,"C0",66030,1439291847,"2015-08-11 04:17:27"
"5712","20153201063205-376","1","2015-08-10 10:10:35",1439226635,"C6",131785,1439358420,"2015-08-11 22:47:00"
"1741","20154629034645-799","1","2015-08-10 10:15:51",1439226951,"C7",508473,1439735424,"2015-08-16 07:30:24"
"2587","20152119042123-730","2","2015-08-10 10:41:39",1439228499,"C5",235052,1439463551,"2015-08-13 03:59:11"
"1805","20152626022659-583","1","2015-08-10 10:51:31",1439229091,"C8",183296,1439412387,"2015-08-12 13:46:27"
"2116","20153606053617-896","3","2015-08-10 11:24:11",1439231051,"C8",161637,1439392688,"2015-08-12 08:18:08"
"6462","20151506031520-642","2","2015-08-10 11:25:42",1439231142,"C3",331822,1439562964,"2015-08-14 07:36:04"
"2803","20150130030134-783","1","2015-08-10 11:37:34",1439231854,"C7",104240,1439336094,"2015-08-11 16:34:54"
"3080","20154205034205-330","1","2015-08-10 11:52:05",1439232725,"C5",52275,1439285000,"2015-08-11 02:23:20"
"1272","20153028093055-321","3","2015-08-10 12:26:01",1439234761,"C4",377902,1439612663,"2015-08-14 21:24:23"
"1972","20154006014046-882","1","2015-08-10 12:52:40",1439236360,"C2",171357,1439407717,"2015-08-12 12:28:37"
"1078","20154605024652-886","1","2015-08-10 13:35:58",1439238958,"C0",142582,1439381540,"2015-08-12 05:12:20"
"1467","20150724010756-126","2","2015-08-10 13:45:56",1439239556,"C6",245180,1439484736,"2015-08-13 09:52:16"
"3614","20155102045128-941","1","2015-08-10 14:19:40",1439241580,"C7",75788,1439317368,"2015-08-11 11:22:48"
"589","20152517012540-586","2","2015-08-10 14:26:20",1439241980,"C0",583655,1439825635,"2015-08-17 08:33:55"
"6209","20152608082638-702","2","2015-08-10 14:32:21",1439242341,"C4",194743,1439437084,"2015-08-12 20:38:04"
"3547","20151606081628-560","1","2015-08-10 15:12:42",1439244762,"C3",185287,1439430049,"2015-08-12 18:40:49"
"1306","20153108053138-793","1","2015-08-10 15:31:58",1439245918,"C0",82810,1439328728,"2015-08-11 14:32:08"
"6346","20150701020723-76","1","2015-08-10 16:08:04",1439248084,"C4",784841,1440032925,"2015-08-19 18:08:45"
"4307","20151023041017-423","1","2015-08-10 16:26:56",1439249216,"C2",518733,1439767949,"2015-08-16 16:32:29"
"812","20155313015324-374","1","2015-08-10 16:43:42",1439250222,"C6",404903,1439655125,"2015-08-15 09:12:05"
"2680","20155529045530-793","2","2015-08-10 17:09:54",1439251794,"C2",129708,1439381502,"2015-08-12 05:11:42"
"2663","20151608091658-472","1","2015-08-10 17:35:58",1439253358,"C7",101370,1439354728,"2015-08-11 21:45:28"
"5603","20152904022933-687","2","2015-08-10 17:49:33",1439254173,"C2",401100,1439655273,"2015-08-15 09:14:33"
"2087","20153225063218-391","1","2015-08-10 17:57:38",1439254658,"C5",711760,1439966418,"2015-08-18 23:40:18"
"142","20154821124856-434","3","2015-08-10 18:42:12",1439257332,"C8",874598,1440131930,"2015-08-20 21:38:50"
"2990","20151709111735-195","1","2015-08-10 18:52:55",1439257975,"C5",349015,1439606990,"2015-08-14 19:49:50"
"1441","20155026015047-456","2","2015-08-10 19:20:32",1439259632,"C3",438595,1439698227,"2015-08-15 21:10:27"
"3233","20154505024531-4","2","2015-08-10 19:22:01",1439259721,"C6",74765,1439334486,"2015-08-11 16:08:06"
"2309","20150507060531-534","1","2015-08-10 19:30:04",1439260204,"C0",1859291,1441119495,"2015-09-01 07:58:15"
"3472","20151303091355-495","3","2015-08-10 20:19:34",1439263174,"C5",214913,1439478087,"2015-08-13 08:01:27"
"93","20154508114523-645","1","2015-08-10 20:36:31",1439264191,"C2",204668,1439468859,"2015-08-13 05:27:39"
"5431","20154731124720-805","1","2015-08-10 20:40:32",1439264432,"C5",111549,1439375981,"2015-08-12 03:39:41"
"5472","20150606050653-525","1","2015-08-10 20:52:29",1439265149,"C4",44892,1439310041,"2015-08-11 09:20:41"
"5333","20155508035530-98","1","2015-08-10 21:19:34",1439266774,"C0",96122,1439362896,"2015-08-12 00:01:36"
"3207","20153604053608-723","2","2015-08-10 21:27:04",1439267224,"C0",401332,1439668556,"2015-08-15 12:55:56"
"5062","20155719125713-529","1","2015-08-10 22:00:17",1439269217,"C4",241673,1439510890,"2015-08-13 17:08:10"
"3076","20150624080630-565","1","2015-08-10 22:11:30",1439269890,"C8",303900,1439573790,"2015-08-14 10:36:30"
"4961","20150929090919-621","1","2015-08-10 22:21:55",1439270515,"C8",542178,1439812693,"2015-08-17 04:58:13"
"4486","20151309051316-267","3","2015-08-11 00:11:34",1439277094,"C5",55749,1439332843,"2015-08-11 15:40:43"
"906","20152209112223-837","2","2015-08-11 00:24:17",1439277857,"C0",66657,1439344514,"2015-08-11 18:55:14"
"1677","20150115110144-566","1","2015-08-11 00:25:44",1439277944,"C2",286830,1439564774,"2015-08-14 08:06:14"
"1960","20155108015134-360","3","2015-08-11 00:37:22",1439278642,"C5",105774,1439384416,"2015-08-12 06:00:16"
"4567","20152718012719-661","3","2015-08-11 00:45:11",1439279111,"C5",253484,1439532595,"2015-08-13 23:09:55"
"6490","20151409051437-834","2","2015-08-11 01:13:09",1439280789,"C4",57556,1439338345,"2015-08-11 17:12:25"
"2925","20150112050122-27","1","2015-08-11 01:27:29",1439281649,"C5",362281,1439643930,"2015-08-15 06:05:30"
"4832","20154127094129-318","1","2015-08-11 01:33:20",1439282000,"C4",422237,1439704237,"2015-08-15 22:50:37"
"2793","20150223110226-578","1","2015-08-11 02:04:42",1439283882,"C5",201167,1439485049,"2015-08-13 09:57:29"
"2162","20155622095638-223","2","2015-08-11 02:36:14",1439285774,"C5",536697,1439822471,"2015-08-17 07:41:11"
"909","20152726032711-587","1","2015-08-11 02:46:56",1439286416,"C8",267357,1439553773,"2015-08-14 05:02:53"
"330","20152704022721-344","2","2015-08-11 03:17:57",1439288277,"C8",282318,1439570595,"2015-08-14 09:43:15"
"1637","20154623104653-166","1","2015-08-11 03:35:45",1439289345,"C5",807866,1440097211,"2015-08-20 12:00:11"
"2549","20152101012104-141","1","2015-08-11 03:41:52",1439289712,"C2",103656,1439393368,"2015-08-12 08:29:28"
"3250","20152922072911-283","2","2015-08-11 03:54:39",1439290479,"C5",214391,1439504870,"2015-08-13 15:27:50"
"1928","20155830065855-504","3","2015-08-11 04:18:25",1439291905,"C6",171195,1439463100,"2015-08-13 03:51:40"
"6018","20155304095343-996","2","2015-08-11 04:23:59",1439292239,"C7",292508,1439584747,"2015-08-14 13:39:07"
"819","20154328084349-846","1","2015-08-11 04:47:49",1439293669,"C0",473430,1439767099,"2015-08-16 16:18:19"
"2272","20152803022825-787","3","2015-08-11 05:24:27",1439295867,"C3",329281,1439625148,"2015-08-15 00:52:28"
"6274","20150207100218-368","1","2015-08-11 05:39:52",1439296792,"C8",164927,1439461719,"2015-08-13 03:28:39"
"3710","20151929111950-606","1","2015-08-11 05:54:35",1439297675,"C2",367895,1439665570,"2015-08-15 12:06:10"
"2097","20150405120404-360","2","2015-08-11 06:03:29",1439298209,"C8",99353,1439397562,"2015-08-12 09:39:22"
"5843","20151503081552-98","2","2015-08-11 06:23:44",1439299424,"C8",342236,1439641660,"2015-08-15 05:27:40"
"4491","20155407095431-303","3","2015-08-11 06:40:49",1439300449,"C5",111326,1439411775,"2015-08-12 13:36:15"
"5158","20154303014356-798","2","2015-08-11 07:09:00",1439302140,"C4",418238,1439720378,"2015-08-16 03:19:38"
"2570","20151621071645-193","3","2015-08-11 07:22:49",1439302969,"C5",259252,1439562221,"2015-08-14 07:23:41"
"2713","20152205052223-701","2","2015-08-11 08:15:19",1439306119,"C5",69368,1439375487,"2015-08-12 03:31:27"
"2278","20150303100354-126","2","2015-08-11 08:32:30",1439307150,"C5",342858,1439650008,"2015-08-15 07:46:48"
"3968","20150925070901-487","2","2015-08-11 09:50:46",1439311846,"C0",211215,1439523061,"2015-08-13 20:31:01"
"4247","20150818040832-50","2","2015-08-11 10:04:29",1439312669,"C5",683919,1439996588,"2015-08-19 08:03:08"
"5106","20152307042315-347","2","2015-08-11 10:17:05",1439313425,"C0",323630,1439637055,"2015-08-15 04:10:55"
"4487","20152109052119-324","1","2015-08-11 11:14:50",1439316890,"C6",150811,1439467701,"2015-08-13 05:08:21"
"4374","20151719041725-731","1","2015-08-11 11:20:07",1439317207,"C6",328227,1439645434,"2015-08-15 06:30:34"
"3791","20152928092934-717","3","2015-08-11 11:51:05",1439319065,"C2",174013,1439493078,"2015-08-13 12:11:18"
"932","20154028084056-791","2","2015-08-11 12:02:40",1439319760,"C5",610852,1439930612,"2015-08-18 13:43:32"
"4534","20150010080005-370","1","2015-08-11 12:46:11",1439322371,"C4",103566,1439425937,"2015-08-12 17:32:17"
"3756","20151826071854-437","1","2015-08-11 12:54:14",1439322854,"C8",280504,1439603358,"2015-08-14 18:49:18"
"79","20151720091715-120","1","2015-08-11 13:39:32",1439325572,"C8",273791,1439599363,"2015-08-14 17:42:43"
"1905","20155908025917-368","1","2015-08-11 15:14:13",1439331253,"C6",260096,1439591349,"2015-08-14 15:29:09"
"5684","20154431104451-420","2","2015-08-11 16:04:31",1439334271,"C8",193916,1439528187,"2015-08-13 21:56:27"
"2092","20152123102144-807","1","2015-08-11 16:18:40",1439335120,"C5",207877,1439542997,"2015-08-14 02:03:17"
"4171","20150418040454-388","3","2015-08-11 17:02:38",1439337758,"C5",259633,1439597391,"2015-08-14 17:09:51"
"6111","20151028081039-84","1","2015-08-11 17:41:17",1439340077,"C5",621919,1439961996,"2015-08-18 22:26:36"
"2664","20153706063755-802","1","2015-08-11 17:50:06",1439340606,"C0",472331,1439812937,"2015-08-17 05:02:17"
"2798","20154709044740-841","1","2015-08-11 18:33:14",1439343194,"C4",89567,1439432761,"2015-08-12 19:26:01"
"2399","20151106031107-912","2","2015-08-11 18:46:11",1439343971,"C2",55613,1439399584,"2015-08-12 10:13:04"
"2914","20153604073634-474","1","2015-08-11 18:56:04",1439344564,"C0",215190,1439559754,"2015-08-14 06:42:34"
"678","20155423015434-702","2","2015-08-11 19:13:37",1439345617,"C8",237249,1439582866,"2015-08-14 13:07:46"
"3869","20155230015235-98","1","2015-08-11 19:15:41",1439345741,"C2",528093,1439873834,"2015-08-17 21:57:14"
"5800","20152412032403-590","3","2015-08-11 19:49:33",1439347773,"C6",434655,1439782428,"2015-08-16 20:33:48"
"694","20155601065611-898","2","2015-08-11 20:54:19",1439351659,"C2",114286,1439465945,"2015-08-13 04:39:05"
"1509","20151210021258-493","1","2015-08-11 21:09:27",1439352567,"C4",111389,1439463956,"2015-08-13 04:05:56"
"2588","20153706123753-969","1","2015-08-11 21:14:11",1439352851,"C3",462978,1439815829,"2015-08-17 05:50:29"
"1607","20151707041712-312","3","2015-08-11 21:14:16",1439352856,"C8",181712,1439534568,"2015-08-13 23:42:48"
"2214","20153322063340-765","3","2015-08-11 21:49:00",1439354940,"C4",222865,1439577805,"2015-08-14 11:43:25"
"4469","20150205050251-251","2","2015-08-11 22:54:45",1439358885,"C7",269757,1439628642,"2015-08-15 01:50:42"
"4589","20154303024314-609","1","2015-08-11 23:06:19",1439359579,"C7",103055,1439462634,"2015-08-13 03:43:54"
"5846","20155509115514-291","1","2015-08-11 23:42:38",1439361758,"C5",107622,1439469380,"2015-08-13 05:36:20"
"4803","20151007011028-996","1","2015-08-11 23:59:48",1439362788,"C8",76912,1439439700,"2015-08-12 21:21:40"
"5271","20155703055749-564","1","2015-08-12 00:14:07",1439363647,"C8",1696089,1441059736,"2015-08-31 15:22:16"
"723","20151612081630-430","3","2015-08-12 00:39:48",1439365188,"C5",378714,1439743902,"2015-08-16 09:51:42"
"6439","20155925035953-311","2","2015-08-12 01:04:56",1439366696,"C0",500501,1439867197,"2015-08-17 20:06:37"
"916","20155209065239-593","1","2015-08-12 01:12:03",1439367123,"C5",119382,1439486505,"2015-08-13 10:21:45"
"3938","20154708044711-639","1","2015-08-12 01:26:56",1439368016,"C2",96795,1439464811,"2015-08-13 04:20:11"
"4102","20153014103053-84","3","2015-08-12 01:59:17",1439369957,"C3",633363,1440003320,"2015-08-19 09:55:20"
"5233","20151621011611-3","2","2015-08-12 02:32:11",1439371931,"C4",232770,1439604701,"2015-08-14 19:11:41"
"5469","20151607011652-132","2","2015-08-12 02:54:52",1439373292,"C5",197340,1439570632,"2015-08-14 09:43:52"
"442","20155710055728-180","3","2015-08-12 03:41:58",1439376118,"C4",60735,1439436853,"2015-08-12 20:34:13"
"5181","20155529095550-67","1","2015-08-12 04:12:32",1439377952,"C8",594501,1439972453,"2015-08-19 01:20:53"
"2712","20154527064556-11","3","2015-08-12 04:53:14",1439380394,"C5",687819,1440068213,"2015-08-20 03:56:53"
"6406","20153802043859-167","1","2015-08-12 05:08:35",1439381315,"C3",102822,1439484137,"2015-08-13 09:42:17"
"5460","20155709095720-363","1","2015-08-12 05:39:29",1439383169,"C5",417447,1439800616,"2015-08-17 01:36:56"
"3995","20152831092837-751","1","2015-08-12 05:42:52",1439383372,"C8",204651,1439588023,"2015-08-14 14:33:43"
"4977","20153909123939-465","3","2015-08-12 05:46:24",1439383584,"C3",78135,1439461719,"2015-08-13 03:28:39"
"2114","20151330041314-275","2","2015-08-12 06:30:34",1439386234,"C3",136030,1439522264,"2015-08-13 20:17:44"
"5588","20153122063134-260","1","2015-08-12 06:34:26",1439386466,"C5",907286,1440293752,"2015-08-22 18:35:52"
"915","20153711073747-446","1","2015-08-12 06:43:37",1439387017,"C8",552310,1439939327,"2015-08-18 16:08:47"
"1957","20155519095518-431","3","2015-08-12 07:05:57",1439388357,"C0",294777,1439683134,"2015-08-15 16:58:54"
"6029","20152426062434-212","1","2015-08-12 07:41:23",1439390483,"C7",210487,1439600970,"2015-08-14 18:09:30"
"2431","20150228040218-159","1","2015-08-12 08:08:11",1439392091,"C5",181079,1439573170,"2015-08-14 10:26:10"
"5702","20154008044039-692","1","2015-08-12 08:12:18",1439392338,"C5",105033,1439497371,"2015-08-13 13:22:51"
"2330","20153607053604-567","2","2015-08-12 09:02:35",1439395355,"C3",57313,1439452668,"2015-08-13 00:57:48"
"6379","20152524072545-996","1","2015-08-12 09:03:13",1439395393,"C6",205931,1439601324,"2015-08-14 18:15:24"
"4607","20154519024544-322","False","2015-08-12 09:24:30",1439396670,"C4",202844,1439599514,"2015-08-14 17:45:14"
"4106","20153208123237-878","1","2015-08-12 12:27:42",1439407662,"C0",345305,1439752967,"2015-08-16 12:22:47"
"2949","20152803082807-792","1","2015-08-12 12:53:19",1439409199,"C6",99189,1439508388,"2015-08-13 16:26:28"
"2508","20150609030606-244","1","2015-08-12 13:00:01",1439409601,"C6",251635,1439661236,"2015-08-15 10:53:56"
"3820","20154302094310-152","1","2015-08-12 13:27:50",1439411270,"C7",438740,1439850010,"2015-08-17 15:20:10"
"3589","20152606022653-437","3","2015-08-12 14:27:37",1439414857,"C7",259222,1439674079,"2015-08-15 14:27:59"
"5523","20154109014116-716","2","2015-08-12 15:16:52",1439417812,"C2",88312,1439506124,"2015-08-13 15:48:44"
"1185","20154622104622-839","1","2015-08-12 15:47:57",1439419677,"C3",261785,1439681462,"2015-08-15 16:31:02"
"3481","20152109022102-894","3","2015-08-12 16:15:56",1439421356,"C4",266094,1439687450,"2015-08-15 18:10:50"
"1979","20152607092603-350","2","2015-08-12 16:22:44",1439421764,"C6",457001,1439878765,"2015-08-17 23:19:25"
"4455","20152502092544-104","1","2015-08-12 17:23:58",1439425438,"C8",446347,1439871785,"2015-08-17 21:23:05"
"6417","20151110101156-652","2","2015-08-12 18:01:30",1439427690,"C5",100487,1439528177,"2015-08-13 21:56:17"
"186","20152304012310-843","1","2015-08-12 19:34:16",1439433256,"C4",237822,1439671078,"2015-08-15 13:37:58"
"4093","20151030091029-116","2","2015-08-12 19:45:25",1439433925,"C5",469162,1439903087,"2015-08-18 06:04:47"
"2055","20151407071448-332","1","2015-08-12 21:07:43",1439438863,"C8",96395,1439535258,"2015-08-13 23:54:18"
"4581","20151013041011-524","1","2015-08-12 21:21:41",1439439701,"C8",870230,1440309931,"2015-08-22 23:05:31"
"1351","20150217070227-343","1","2015-08-12 21:31:31",1439440291,"C4",287318,1439727609,"2015-08-16 05:20:09"
"4745","20150031060051-429","1","2015-08-12 21:38:39",1439440719,"C5",364356,1439805075,"2015-08-17 02:51:15"
"522","20150407050402-325","1","2015-08-12 22:21:38",1439443298,"C3",451056,1439894354,"2015-08-18 03:39:14"
"4385","20151902011959-320","1","2015-08-12 22:32:15",1439443935,"C3",112142,1439556077,"2015-08-14 05:41:17"
"1845","20150127110109-336","1","2015-08-12 22:47:29",1439444849,"C8",284956,1439729805,"2015-08-16 05:56:45"
"1198","20154530024516-715","3","2015-08-12 22:50:34",1439445034,"C2",1152318,1440597352,"2015-08-26 06:55:52"
"20","20155430085434-503","1","2015-08-12 23:31:55",1439447515,"C7",418649,1439866164,"2015-08-17 19:49:24"
"6186","20150804040846-173","1","2015-08-12 23:36:16",1439447776,"C3",359025,1439806801,"2015-08-17 03:20:01"
"1722","20154211104241-339","1","2015-08-13 00:51:59",1439452319,"C5",68679,1439520998,"2015-08-13 19:56:38"
"1065","20151324061307-900","2","2015-08-13 01:28:59",1439454539,"C6",537869,1439992408,"2015-08-19 06:53:28"
"5060","20153926083915-568","3","2015-08-13 01:48:21",1439455701,"C2",1374182,1440829883,"2015-08-28 23:31:23"
"3306","20150329080354-90","3","2015-08-13 01:58:59",1439456339,"C4",182015,1439638354,"2015-08-15 04:32:34"
"2937","20153711013755-30","1","2015-08-13 02:16:31",1439457391,"C4",65958,1439523349,"2015-08-13 20:35:49"
"435","20154304074334-798","1","2015-08-13 02:49:42",1439459382,"C3",429796,1439889178,"2015-08-18 02:12:58"
"4824","20154309044344-578","3","2015-08-13 03:04:20",1439460260,"C6",49406,1439509666,"2015-08-13 16:47:46"
"5387","20150709120708-806","3","2015-08-13 03:27:17",1439461637,"C5",104803,1439566440,"2015-08-14 08:34:00"
"4999","20150831030801-105","2","2015-08-13 03:52:40",1439463160,"C4",360893,1439824053,"2015-08-17 08:07:33"
"3276","20153320043305-28","2","2015-08-13 03:58:09",1439463489,"C2",577538,1440041027,"2015-08-19 20:23:47"
"4148","20152526082520-23","3","2015-08-13 04:38:32",1439465912,"C5",192699,1439658611,"2015-08-15 10:10:11"
"4671","20150726030718-420","2","2015-08-13 05:54:48",1439470488,"C8",761025,1440231513,"2015-08-22 01:18:33"
"6180","20153002083005-261","1","2015-08-13 05:57:41",1439470661,"C7",104584,1439575245,"2015-08-14 11:00:45"
"2436","20153107123119-251","1","2015-08-13 06:20:13",1439472013,"C8",248067,1439720080,"2015-08-16 03:14:40"
"3346","20153710073716-970","1","2015-08-13 06:28:22",1439472502,"C3",85022,1439557524,"2015-08-14 06:05:24"
"1241","20153722113716-211","1","2015-08-13 06:55:04",1439474104,"C2",269124,1439743228,"2015-08-16 09:40:28"
"5126","20154517094544-833","2","2015-08-13 06:55:41",1439474141,"C4",774199,1440248340,"2015-08-22 05:59:00"
"5425","20155904015930-845","3","2015-08-13 07:13:04",1439475184,"C4",107602,1439582786,"2015-08-14 13:06:26"
"5075","20151510051559-717","1","2015-08-13 07:41:26",1439476886,"C2",224727,1439701613,"2015-08-15 22:06:53"
"2242","20152331102327-0","1","2015-08-13 07:59:35",1439477975,"C7",159224,1439637199,"2015-08-15 04:13:19"
"1021","20151418011444-201","3","2015-08-13 08:38:20",1439480300,"C4",278727,1439759027,"2015-08-16 14:03:47"
"5443","20150024060019-914","1","2015-08-13 08:44:51",1439480691,"C5",541234,1440021925,"2015-08-19 15:05:25"
"6409","20153310073359-286","3","2015-08-13 09:04:14",1439481854,"C2",88205,1439570059,"2015-08-14 09:34:19"
"2944","20154113114117-693","2","2015-08-13 09:11:46",1439482306,"C7",381347,1439863653,"2015-08-17 19:07:33"
"3997","20153731083734-496","1","2015-08-13 09:17:40",1439482660,"C5",375202,1439857862,"2015-08-17 17:31:02"
"6387","20155525045542-362","3","2015-08-13 09:29:54",1439483394,"C5",538284,1440021678,"2015-08-19 15:01:18"
"1459","20153626093628-77","2","2015-08-13 09:57:48",1439485068,"C2",518560,1440003628,"2015-08-19 10:00:28"
"2969","20153525023538-936","2","2015-08-13 11:03:14",1439488994,"C6",271476,1439760470,"2015-08-16 14:27:50"
"3479","20150609050629-558","3","2015-08-13 11:34:17",1439490857,"C6",54278,1439545135,"2015-08-14 02:38:55"
"91","20153813033817-519","2","2015-08-13 12:40:41",1439494841,"C6",444624,1439939465,"2015-08-18 16:11:05"
"6218","20153303113325-724","1","2015-08-13 13:08:53",1439496533,"C0",434864,1439931397,"2015-08-18 13:56:37"
"3430","20155501115503-638","2","2015-08-13 13:59:16",1439499556,"C8",149179,1439648735,"2015-08-15 07:25:35"
"1952","20150310050337-557","1","2015-08-13 14:19:16",1439500756,"C3",83113,1439583869,"2015-08-14 13:24:29"
"5892","20152131042143-820","2","2015-08-13 14:21:32",1439500892,"C8",159427,1439660319,"2015-08-15 10:38:39"
"2903","20151211061241-520","1","2015-08-13 15:42:38",1439505758,"C6",206997,1439712755,"2015-08-16 01:12:35"
"1524","20155310055324-613","1","2015-08-13 15:42:42",1439505762,"C2",251358,1439757120,"2015-08-16 13:32:00"
"2212","20153818113831-85","1","2015-08-13 16:02:16",1439506936,"C4",323175,1439830111,"2015-08-17 09:48:31"
"3339","20154311044358-220","2","2015-08-13 16:42:48",1439509368,"C2",172730,1439682098,"2015-08-15 16:41:38"
"1130","20154428104404-828","1","2015-08-13 17:33:54",1439512434,"C8",281398,1439793832,"2015-08-16 23:43:52"
"46","20150109040106-69","3","2015-08-13 18:03:31",1439514211,"C8",70589,1439584800,"2015-08-14 13:40:00"
"2800","20151113121156-771","2","2015-08-13 18:16:56",1439515016,"C8",540060,1440055076,"2015-08-20 00:17:56"
"2901","20150917070930-301","3","2015-08-13 18:22:53",1439515373,"C5",339029,1439854402,"2015-08-17 16:33:22"
"4445","20153924013929-447","1","2015-08-13 18:39:20",1439516360,"C4",619713,1440136073,"2015-08-20 22:47:53"
"4599","20153629093621-951","1","2015-08-13 19:25:41",1439519141,"C4",166420,1439685561,"2015-08-15 17:39:21"
"6118","20152407022444-628","1","2015-08-13 20:46:38",1439523998,"C5",180438,1439704436,"2015-08-15 22:53:56"
"4400","20152216102203-558","1","2015-08-13 20:58:51",1439524731,"C5",721344,1440246075,"2015-08-22 05:21:15"
"4437","20153710023738-627","1","2015-08-13 21:14:41",1439525681,"C4",283023,1439808704,"2015-08-17 03:51:44"
"5435","20151501051519-505","1","2015-08-13 21:31:11",1439526671,"C6",131519,1439658190,"2015-08-15 10:03:10"
"3138","20154711064710-266","3","2015-08-13 21:40:38",1439527238,"C7",113204,1439640442,"2015-08-15 05:07:22"
"2345","20155610055653-905","2","2015-08-13 21:43:11",1439527391,"C3",90926,1439618317,"2015-08-14 22:58:37"
"5933","20151723021731-685","3","2015-08-13 21:57:11",1439528231,"C5",263140,1439791371,"2015-08-16 23:02:51"
"3803","20155804085814-147","1","2015-08-13 22:15:42",1439529342,"C5",103181,1439632523,"2015-08-15 02:55:23"
"1862","20150307020308-823","1","2015-08-13 22:27:56",1439530076,"C6",68586,1439598662,"2015-08-14 17:31:02"
"5084","20154813034829-169","1","2015-08-13 22:49:55",1439531395,"C8",1351843,1440883238,"2015-08-29 14:20:38"
"4457","20155117075129-610","2","2015-08-13 23:02:53",1439532173,"C6",397914,1439930087,"2015-08-18 13:34:47"
"6100","20154018084053-456","1","2015-08-14 00:17:43",1439536663,"C7",699230,1440235893,"2015-08-22 02:31:33"
"3281","20153126023103-958","2","2015-08-14 00:26:17",1439537177,"C7",795457,1440332634,"2015-08-23 05:23:54"
"4176","20151305041332-847","3","2015-08-14 00:35:24",1439537724,"C5",360656,1439898380,"2015-08-18 04:46:20"
"6320","20151431041410-501","3","2015-08-14 01:02:04",1439539324,"C4",164982,1439704306,"2015-08-15 22:51:46"
"432","20155903065939-454","3","2015-08-14 01:52:18",1439542338,"C8",133137,1439675475,"2015-08-15 14:51:15"
"3099","20152813072833-760","1","2015-08-14 02:51:37",1439545897,"C2",343523,1439889420,"2015-08-18 02:17:00"
"4259","20154702084714-863","1","2015-08-14 05:13:53",1439554433,"C5",341333,1439895766,"2015-08-18 04:02:46"
"3764","20154708044705-32","1","2015-08-14 05:33:37",1439555617,"C8",238996,1439794613,"2015-08-16 23:56:53"
"3793","20154030094014-979","1","2015-08-14 06:05:10",1439557510,"C2",160387,1439717897,"2015-08-16 02:38:17"
"5970","20150825040838-487","1","2015-08-14 06:37:44",1439559464,"C7",188194,1439747658,"2015-08-16 10:54:18"
"4806","20151429111451-30","3","2015-08-14 06:46:43",1439560003,"C5",170789,1439730792,"2015-08-16 06:13:12"
"6349","20154525024508-630","2","2015-08-14 07:30:32",1439562632,"C5",243132,1439805764,"2015-08-17 03:02:44"
"2364","20154107124142-501","1","2015-08-14 07:39:37",1439563177,"C8",117335,1439680512,"2015-08-15 16:15:12"
"5832","20153526053516-741","2","2015-08-14 07:52:36",1439563956,"C2",229520,1439793476,"2015-08-16 23:37:56"
"3243","20150601070655-151","1","2015-08-14 07:53:27",1439564007,"C5",475549,1440039556,"2015-08-19 19:59:16"
"6166","20150411120449-453","2","2015-08-14 08:08:47",1439564927,"C4",122519,1439687446,"2015-08-15 18:10:46"
"327","20154804044849-878","3","2015-08-14 08:32:57",1439566377,"C2",439081,1440005458,"2015-08-19 10:30:58"
"1166","20151511081530-342","1","2015-08-14 09:24:22",1439569462,"C2",131666,1439701128,"2015-08-15 21:58:48"
"5594","20154011084036-355","3","2015-08-14 09:24:27",1439569467,"C5",420033,1439989500,"2015-08-19 06:05:00"
"2352","20155613045650-872","1","2015-08-14 09:33:04",1439569984,"C4",59774,1439629758,"2015-08-15 02:09:18"
"319","20151031071048-450","1","2015-08-14 09:58:20",1439571500,"C5",174236,1439745736,"2015-08-16 10:22:16"
"4670","20152004082011-358","1","2015-08-14 10:29:07",1439573347,"C2",443767,1440017114,"2015-08-19 13:45:14"
"1543","20153701093702-509","1","2015-08-14 11:02:22",1439575342,"C2",564160,1440139502,"2015-08-20 23:45:02"
"2515","20152911062908-132","3","2015-08-14 11:29:34",1439576974,"C2",138613,1439715587,"2015-08-16 01:59:47"
"1584","20150304070342-20","2","2015-08-14 11:56:38",1439578598,"C0",444997,1440023595,"2015-08-19 15:33:15"
"5404","20150003080058-668","3","2015-08-14 12:03:59",1439579039,"C0",520483,1440099522,"2015-08-20 12:38:42"
"2519","20153406113422-942","1","2015-08-14 12:05:02",1439579102,"C8",346520,1439925622,"2015-08-18 12:20:22"
"3851","20154312114332-412","1","2015-08-14 12:08:02",1439579282,"C3",87135,1439666417,"2015-08-15 12:20:17"
"4162","20155809115800-678","1","2015-08-14 13:11:12",1439583072,"C4",1038264,1440621336,"2015-08-26 13:35:36"
"163","20153011093025-374","1","2015-08-14 14:28:52",1439587732,"C4",92369,1439680101,"2015-08-15 16:08:21"
"6451","20155208075242-780","3","2015-08-14 14:30:18",1439587818,"C4",180752,1439768570,"2015-08-16 16:42:50"
"4335","20155907045941-874","3","2015-08-14 14:56:05",1439589365,"C2",409473,1439998838,"2015-08-19 08:40:38"
"4323","20153209023251-83","1","2015-08-14 16:51:53",1439596313,"C8",62906,1439659219,"2015-08-15 10:20:19"
"6431","20154408124457-555","2","2015-08-14 17:09:31",1439597371,"C5",267137,1439864508,"2015-08-17 19:21:48"
"5750","20151106071155-474","1","2015-08-14 17:35:24",1439598924,"C7",104087,1439703011,"2015-08-15 22:30:11"
"6214","20155308045321-417","1","2015-08-14 18:14:11",1439601251,"C8",104650,1439705901,"2015-08-15 23:18:21"
"2822","20153208083206-395","2","2015-08-14 18:44:28",1439603068,"C5",79306,1439682374,"2015-08-15 16:46:14"
"85","20154008014020-3","2","2015-08-14 18:50:02",1439603402,"C3",268491,1439871893,"2015-08-17 21:24:53"
"1541","20152610112615-740","1","2015-08-14 19:23:17",1439605397,"C2",187111,1439792508,"2015-08-16 23:21:48"
"2371","20151206061257-541","2","2015-08-14 19:56:13",1439607373,"C4",370298,1439977671,"2015-08-19 02:47:51"
"5239","20153111053127-294","2","2015-08-14 20:10:59",1439608259,"C7",134386,1439742645,"2015-08-16 09:30:45"
"333","20150726110738-643","1","2015-08-14 20:39:50",1439609990,"C4",558644,1440168634,"2015-08-21 07:50:34"
"5608","20153910113938-766","3","2015-08-14 20:48:28",1439610508,"C8",189265,1439799773,"2015-08-17 01:22:53"
"5483","20150429010400-59","1","2015-08-14 20:58:10",1439611090,"C8",201550,1439812640,"2015-08-17 04:57:20"
"1255","20153320083339-666","1","2015-08-14 20:59:09",1439611149,"C8",440946,1440052095,"2015-08-19 23:28:15"
"1245","20150202040220-736","3","2015-08-14 21:19:58",1439612398,"C4",527929,1440140327,"2015-08-20 23:58:47"
"5763","20150430110428-833","2","2015-08-14 21:58:38",1439614718,"C7",190750,1439805468,"2015-08-17 02:57:48"
"5905","20152126102142-711","1","2015-08-14 22:35:42",1439616942,"C8",337128,1439954070,"2015-08-18 20:14:30"
"5454","20154307124353-199","1","2015-08-14 23:11:31",1439619091,"C7",844694,1440463785,"2015-08-24 17:49:45"
"2980","20153604073602-444","1","2015-08-14 23:50:34",1439621434,"C5",461236,1440082670,"2015-08-20 07:57:50"
"1424","20155008055031-646","1","2015-08-15 00:04:05",1439622245,"C8",270407,1439892652,"2015-08-18 03:10:52"
"1055","20150509010550-822","2","2015-08-15 00:51:23",1439625083,"C3",158111,1439783194,"2015-08-16 20:46:34"
"1375","20151808051800-604","1","2015-08-15 01:52:22",1439628742,"C7",78466,1439707208,"2015-08-15 23:40:08"
"904","20152619052654-46","3","2015-08-15 01:59:12",1439629152,"C4",759046,1440388198,"2015-08-23 20:49:58"
"4550","20155611085614-73","1","2015-08-15 02:28:58",1439630938,"C4",161182,1439792120,"2015-08-16 23:15:20"
"4280","20152805082823-737","2","2015-08-15 02:34:59",1439631299,"C5",280932,1439912231,"2015-08-18 08:37:11"
"1565","20155916015917-666","1","2015-08-15 02:37:11",1439631431,"C1",425179,1440056610,"2015-08-20 00:43:30"
"3079","20151124081114-91","1","2015-08-15 02:41:26",1439631686,"C8",268716,1439900402,"2015-08-18 05:20:02"
"528","20154414024400-712","1","2015-08-15 02:54:00",1439632440,"C3",340275,1439972715,"2015-08-19 01:25:15"
"3419","20150207030221-800","2","2015-08-15 02:56:47",1439632607,"C4",323833,1439956440,"2015-08-18 20:54:00"
"5332","20155903075911-687","1","2015-08-15 03:17:07",1439633827,"C2",509938,1440143765,"2015-08-21 00:56:05"
"4221","20155608105623-726","3","2015-08-15 03:40:20",1439635220,"C5",465291,1440100511,"2015-08-20 12:55:11"
"4230","20152707102724-384","1","2015-08-15 03:59:32",1439636372,"C8",333964,1439970336,"2015-08-19 00:45:36"
"4538","20152102102155-887","1","2015-08-15 04:05:33",1439636733,"C5",550309,1440187042,"2015-08-21 12:57:22"
"3100","20150112080120-851","2","2015-08-15 04:17:32",1439637452,"C3",81924,1439719376,"2015-08-16 03:02:56"
"4202","20155829085817-23","1","2015-08-15 04:17:33",1439637453,"C8",725978,1440363431,"2015-08-23 13:57:11"
"1379","20155631045627-683","1","2015-08-15 04:45:05",1439639105,"C4",178874,1439817979,"2015-08-17 06:26:19"
"5429","20151402081427-528","2","2015-08-15 05:23:47",1439641427,"C2",473920,1440115347,"2015-08-20 17:02:27"
"6227","20152530082532-866","3","2015-08-15 05:23:59",1439641439,"C4",457169,1440098608,"2015-08-20 12:23:28"
"5399","20152211072207-967","1","2015-08-15 05:43:27",1439642607,"C7",169840,1439812447,"2015-08-17 04:54:07"
"3737","20155205095236-132","1","2015-08-15 07:20:09",1439648409,"C2",284951,1439933360,"2015-08-18 14:29:20"
"3023","20151324041317-432","1","2015-08-15 07:40:12",1439649612,"C7",267145,1439916757,"2015-08-18 09:52:37"
"5521","20150908080923-414","3","2015-08-15 07:56:49",1439650609,"C4",604046,1440254655,"2015-08-22 07:44:15"
"4756","20150704110737-327","1","2015-08-15 08:14:49",1439651689,"C5",117504,1439769193,"2015-08-16 16:53:13"
"3456","20155824085808-856","3","2015-08-15 08:15:48",1439651748,"C7",271180,1439922928,"2015-08-18 11:35:28"
"853","20153005123012-657","1","2015-08-15 08:15:52",1439651752,"C8",424370,1440076122,"2015-08-20 06:08:42"
"437","20155012025014-139","1","2015-08-15 08:24:59",1439652299,"C6",236085,1439888384,"2015-08-18 01:59:44"
"4057","20155410035426-585","1","2015-08-15 09:19:06",1439655546,"C8",81656,1439737202,"2015-08-16 08:00:02"
"2940","20154209044216-651","2","2015-08-15 09:20:12",1439655612,"C5",70268,1439725880,"2015-08-16 04:51:20"
"5135","20151631031602-96","2","2015-08-15 09:34:41",1439656481,"C7",182217,1439838698,"2015-08-17 12:11:38"
"4318","20154828014808-208","2","2015-08-15 09:48:56",1439657336,"C2",516606,1440173942,"2015-08-21 09:19:02"
"3915","20152712082719-296","1","2015-08-15 09:52:57",1439657577,"C8",132169,1439789746,"2015-08-16 22:35:46"
"4204","20155805085848-703","3","2015-08-15 10:22:44",1439659364,"C7",124148,1439783512,"2015-08-16 20:51:52"
"3784","20150809010801-971","1","2015-08-15 10:47:37",1439660857,"C2",169992,1439830849,"2015-08-17 10:00:49"
"1672","20154912014924-804","2","2015-08-15 11:39:30",1439663970,"C2",251406,1439915376,"2015-08-18 09:29:36"
"649","20151826121830-361","3","2015-08-15 11:46:54",1439664414,"C5",863052,1440527466,"2015-08-25 11:31:06"
"2050","20153529033559-238","1","2015-08-15 11:59:43",1439665183,"C5",505978,1440171161,"2015-08-21 08:32:41"
"6052","20150018020030-238","3","2015-08-15 12:45:57",1439667957,"C8",344961,1440012918,"2015-08-19 12:35:18"
"3772","20151513041529-826","3","2015-08-15 12:48:33",1439668113,"C4",80192,1439748305,"2015-08-16 11:05:05"
"4021","20155110125158-386","1","2015-08-15 12:55:08",1439668508,"C2",444370,1440112878,"2015-08-20 16:21:18"
"659","20152713122742-24","1","2015-08-15 13:28:32",1439670512,"C8",88225,1439758737,"2015-08-16 13:58:57"
"3615","20154426054401-248","1","2015-08-15 14:19:01",1439673541,"C8",857850,1440531391,"2015-08-25 12:36:31"
"578","20151307021320-869","1","2015-08-15 15:21:22",1439677282,"C2",99326,1439776608,"2015-08-16 18:56:48"
"884","20153010043052-895","2","2015-08-15 15:49:32",1439678972,"C3",61360,1439740332,"2015-08-16 08:52:12"
"5811","20154027014057-847","1","2015-08-15 15:54:17",1439679257,"C8",329920,1440009177,"2015-08-19 11:32:57"
"3704","20154507064517-275","1","2015-08-15 16:05:53",1439679953,"C4",103548,1439783501,"2015-08-16 20:51:41"
"559","20153507033523-248","2","2015-08-15 16:22:11",1439680931,"C6",86751,1439767682,"2015-08-16 16:28:02"
"2147","20150911060927-249","2","2015-08-15 16:46:13",1439682373,"C8",191903,1439874276,"2015-08-17 22:04:36"
"5481","20150314100300-561","2","2015-08-15 17:21:23",1439684483,"C6",112703,1439797186,"2015-08-17 00:39:46"
"4957","20153601083623-683","1","2015-08-15 17:34:23",1439685263,"C8",248376,1439933639,"2015-08-18 14:33:59"
"5240","20155405125402-226","1","2015-08-15 17:46:22",1439685982,"C8",176308,1439862290,"2015-08-17 18:44:50"
"308","20150312070334-705","1","2015-08-15 17:53:25",1439686405,"C4",99397,1439785802,"2015-08-16 21:30:02"
"5069","20154709044702-412","3","2015-08-15 18:02:08",1439686928,"C7",261453,1439948381,"2015-08-18 18:39:41"
"5071","20151114071121-782","2","2015-08-15 18:46:32",1439689592,"C0",128111,1439817703,"2015-08-17 06:21:43"
"1111","20150309030327-506","3","2015-08-15 19:52:17",1439693537,"C5",53573,1439747110,"2015-08-16 10:45:10"
"2815","20154403054427-199","2","2015-08-15 19:58:35",1439693915,"C7",149264,1439843179,"2015-08-17 13:26:19"
"5698","20153029063040-935","2","2015-08-15 20:23:43",1439695423,"C5",216969,1439912392,"2015-08-18 08:39:52"
"6410","20151028111000-621","2","2015-08-15 20:48:36",1439696916,"C6",264986,1439961902,"2015-08-18 22:25:02"
"3474","20153610123659-887","3","2015-08-15 21:07:43",1439698063,"C7",66092,1439764155,"2015-08-16 15:29:15"
"693","20155410075450-130","1","2015-08-15 22:20:08",1439702408,"C2",483918,1440186326,"2015-08-21 12:45:26"
"5589","20155910035914-610","3","2015-08-15 22:56:42",1439704602,"C8",228524,1439933126,"2015-08-18 14:25:26"
"2425","20155206105220-877","1","2015-08-15 23:00:52",1439704852,"C4",437464,1440142316,"2015-08-21 00:31:56"
"2960","20151225031208-655","1","2015-08-15 23:45:14",1439707514,"C5",263598,1439971112,"2015-08-19 00:58:32"
"1970","20154910024932-203","1","2015-08-16 00:38:00",1439710680,"C5",233654,1439944334,"2015-08-18 17:32:14"
"543","20155707125735-181","2","2015-08-16 01:29:32",1439713772,"C2",245439,1439959211,"2015-08-18 21:40:11"
"588","20152330112343-461","1","2015-08-16 01:38:23",1439714303,"C2",179210,1439893513,"2015-08-18 03:25:13"
"4242","20153609113649-758","1","2015-08-16 01:43:20",1439714600,"C4",81313,1439795913,"2015-08-17 00:18:33"
"5721","20155303045356-851","1","2015-08-16 02:24:48",1439717088,"C2",535636,1440252724,"2015-08-22 07:12:04"
"4405","20152509072510-961","1","2015-08-16 02:45:31",1439718331,"C4",196007,1439914338,"2015-08-18 09:12:18"
"2314","20153706123730-475","2","2015-08-16 02:48:30",1439718510,"C8",1219812,1440938322,"2015-08-30 05:38:42"
"5393","20153302123354-327","1","2015-08-16 03:35:29",1439721329,"C8",235459,1439956788,"2015-08-18 20:59:48"
"2689","20155720095723-531","2","2015-08-16 04:13:41",1439723621,"C6",385363,1440108984,"2015-08-20 15:16:24"
"4524","20150108050153-619","3","2015-08-16 04:17:09",1439723829,"C0",92188,1439816017,"2015-08-17 05:53:37"
"4051","20150509110512-433","2","2015-08-16 04:24:20",1439724260,"C5",290374,1440014634,"2015-08-19 13:03:54"
"1024","20150702040744-309","2","2015-08-16 04:31:12",1439724672,"C5",145976,1439870648,"2015-08-17 21:04:08"
"1439","20152008042053-423","1","2015-08-16 05:07:01",1439726821,"C7",325384,1440052205,"2015-08-19 23:30:05"
"3839","20154303074311-913","1","2015-08-16 05:52:37",1439729557,"C4",558283,1440287840,"2015-08-22 16:57:20"
"3246","20150302120354-207","2","2015-08-16 05:56:18",1439729778,"C4",148443,1439878221,"2015-08-17 23:10:21"
"5962","20151309041300-869","1","2015-08-16 06:03:04",1439730184,"C3",81172,1439811356,"2015-08-17 04:35:56"
"5925","20150514030514-420","1","2015-08-16 06:26:42",1439731602,"C2",352511,1440084113,"2015-08-20 08:21:53"
"6083","20152502062553-799","3","2015-08-16 06:44:41",1439732681,"C3",1210728,1440943409,"2015-08-30 07:03:29"
"2552","20153417043413-536","2","2015-08-16 07:16:49",1439734609,"C7",365508,1440100117,"2015-08-20 12:48:37"
"817","20151409111437-111","2","2015-08-16 07:30:13",1439735413,"C7",295668,1440031081,"2015-08-19 17:38:01"
"448","20153731093738-268","2","2015-08-16 07:34:28",1439735668,"C8",196430,1439932098,"2015-08-18 14:08:18"
"212","20154122074105-174","2","2015-08-16 08:03:12",1439737392,"C3",308761,1440046153,"2015-08-19 21:49:13"
"2571","20151914011913-652","3","2015-08-16 09:40:14",1439743214,"C2",159661,1439902875,"2015-08-18 06:01:15"
"1658","20150514090525-937","3","2015-08-16 10:13:07",1439745187,"C5",88431,1439833618,"2015-08-17 10:46:58"
"2215","20155020045059-811","1","2015-08-16 10:49:44",1439747384,"C5",770375,1440517759,"2015-08-25 08:49:19"
"6072","20150613070601-595","2","2015-08-16 11:13:07",1439748787,"C8",137013,1439885800,"2015-08-18 01:16:40"
"4165","20153401073445-361","2","2015-08-16 11:29:44",1439749784,"C0",187157,1439936941,"2015-08-18 15:29:01"
"2120","20155314085317-744","3","2015-08-16 12:10:10",1439752210,"C2",184613,1439936823,"2015-08-18 15:27:03"
"686","20153511073525-756","1","2015-08-16 13:14:07",1439756047,"C8",447246,1440203293,"2015-08-21 17:28:13"
"4086","20155704085706-777","3","2015-08-16 13:44:52",1439757892,"C4",527033,1440284925,"2015-08-22 16:08:45"
"4760","20151315011308-405","1","2015-08-16 13:53:49",1439758429,"C0",88841,1439847270,"2015-08-17 14:34:30"
"1559","20154504094510-630","1","2015-08-16 14:23:06",1439760186,"C5",526738,1440286924,"2015-08-22 16:42:04"
"4215","20153729093742-70","1","2015-08-16 14:25:34",1439760334,"C4",196559,1439956893,"2015-08-18 21:01:33"
"4918","20150112110110-857","1","2015-08-16 14:36:04",1439760964,"C2",358494,1440119458,"2015-08-20 18:10:58"
"5247","20153205073220-30","1","2015-08-16 15:16:38",1439763398,"C2",978258,1440741656,"2015-08-27 23:00:56"
"6560","20153229043251-293","1","2015-08-16 15:24:06",1439763846,"C2",517025,1440280871,"2015-08-22 15:01:11"
"281","20151710111713-168","3","2015-08-16 15:54:03",1439765643,"C8",107002,1439872645,"2015-08-17 21:37:25"
"3483","20155201035224-590","1","2015-08-16 16:54:40",1439769280,"C0",497267,1440266547,"2015-08-22 11:02:27"
"3262","20150823060803-803","1","2015-08-16 17:02:11",1439769731,"C3",264106,1440033837,"2015-08-19 18:23:57"
"2697","20153014043029-662","2","2015-08-16 17:19:32",1439770772,"C4",58581,1439829353,"2015-08-17 09:35:53"
"1075","20155829125801-230","2","2015-08-16 17:55:03",1439772903,"C0",786511,1440559414,"2015-08-25 20:23:34"
"3719","20151531021539-858","2","2015-08-16 17:55:44",1439772944,"C8",279121,1440052065,"2015-08-19 23:27:45"
"6217","20151608061603-479","1","2015-08-16 18:11:23",1439773883,"C8",367060,1440140943,"2015-08-21 00:09:03"
"1061","20153013113037-790","1","2015-08-16 20:16:37",1439781397,"C3",290760,1440072157,"2015-08-20 05:02:37"
"5446","20151114121111-116","2","2015-08-16 20:32:37",1439782357,"C8",101443,1439883800,"2015-08-18 00:43:20"
"5794","20152215092246-386","1","2015-08-16 22:30:54",1439789454,"C2",133688,1439923142,"2015-08-18 11:39:02"
"1540","20150615050655-209","3","2015-08-16 23:02:47",1439791367,"C8",53876,1439845243,"2015-08-17 14:00:43"
"652","20154009074056-552","1","2015-08-16 23:12:31",1439791951,"C8",132139,1439924090,"2015-08-18 11:54:50"
"5602","20152408052435-531","2","2015-08-16 23:34:23",1439793263,"C5",237796,1440031059,"2015-08-19 17:37:39"
"5960","20154412024403-809","1","2015-08-16 23:49:21",1439794161,"C7",189159,1439983320,"2015-08-19 04:22:00"
"4265","20155521125533-941","1","2015-08-17 01:12:42",1439799162,"C5",763543,1440562705,"2015-08-25 21:18:25"
"6170","20152412032434-101","1","2015-08-17 01:15:47",1439799347,"C4",54439,1439853786,"2015-08-17 16:23:06"
"285","20155815125829-147","1","2015-08-17 01:26:41",1439800001,"C5",65646,1439865647,"2015-08-17 19:40:47"
"3852","20155814095824-763","1","2015-08-17 01:34:52",1439800492,"C4",114494,1439914986,"2015-08-18 09:23:06"
"208","20154501084500-257","2","2015-08-17 01:43:59",1439801039,"C4",193877,1439994916,"2015-08-19 07:35:16"
"3537","20154212044243-346","1","2015-08-17 02:05:41",1439802341,"C7",189689,1439992030,"2015-08-19 06:47:10"
"1465","20152631112623-34","3","2015-08-17 02:15:53",1439802953,"C8",287154,1440090107,"2015-08-20 10:01:47"
"2661","20153521103532-680","3","2015-08-17 03:13:00",1439806380,"C4",288281,1440094661,"2015-08-20 11:17:41"
"1560","20152315102309-132","2","2015-08-17 03:24:09",1439807049,"C2",73830,1439880879,"2015-08-17 23:54:39"
"4885","20155213095235-98","2","2015-08-17 03:47:31",1439808451,"C4",161848,1439970299,"2015-08-19 00:44:59"
"6138","20153821043846-584","2","2015-08-17 04:20:50",1439810450,"C8",326932,1440137382,"2015-08-20 23:09:42"
"2075","20150006080007-531","3","2015-08-17 05:41:53",1439815313,"C7",471053,1440286366,"2015-08-22 16:32:46"
"4748","20150010040007-631","2","2015-08-17 06:46:07",1439819167,"C6",95260,1439914427,"2015-08-18 09:13:47"
"4954","20153931053905-915","2","2015-08-17 06:50:11",1439819411,"C3",476622,1440296033,"2015-08-22 19:13:53"
"3598","20154314064318-347","2","2015-08-17 06:56:41",1439819801,"C4",260003,1440079804,"2015-08-20 07:10:04"
"1050","20152805012826-73","1","2015-08-17 07:35:02",1439822102,"C2",338532,1440160634,"2015-08-21 05:37:14"
"4072","20152007102018-450","1","2015-08-17 07:47:59",1439822879,"C7",122123,1439945002,"2015-08-18 17:43:22"
"5613","20153222073236-42","1","2015-08-17 07:57:16",1439823436,"C4",280985,1440104421,"2015-08-20 14:00:21"
"5221","20150014030027-293","2","2015-08-17 08:11:36",1439824296,"C4",78223,1439902519,"2015-08-18 05:55:19"
"3523","20150914110948-268","1","2015-08-17 08:21:48",1439824908,"C7",325280,1440150188,"2015-08-21 02:43:08"
"5118","20155117065115-489","3","2015-08-17 09:15:15",1439828115,"C0",179136,1440007251,"2015-08-19 11:00:51"
"2261","20151726061756-646","1","2015-08-17 09:26:02",1439828762,"C4",637362,1440466124,"2015-08-24 18:28:44"
"1846","20152419022425-210","1","2015-08-17 10:11:30",1439831490,"C7",355775,1440187265,"2015-08-21 13:01:05"
"2079","20154315064331-937","1","2015-08-17 10:42:41",1439833361,"C5",93575,1439926936,"2015-08-18 12:42:16"
"3409","20155804015811-880","1","2015-08-17 10:49:15",1439833755,"C4",797783,1440631538,"2015-08-26 16:25:38"
"225","20151109101115-984","1","2015-08-17 10:52:03",1439833923,"C4",86706,1439920629,"2015-08-18 10:57:09"
"3779","20152001122012-967","1","2015-08-17 10:59:42",1439834382,"C8",275514,1440109896,"2015-08-20 15:31:36"
"806","20150113120141-485","1","2015-08-17 11:02:59",1439834579,"C8",171039,1440005618,"2015-08-19 10:33:38"
"402","20153007113051-98","2","2015-08-17 11:12:45",1439835165,"C5",431457,1440266622,"2015-08-22 11:03:42"
"1859","20154607094631-516","2","2015-08-17 11:15:13",1439835313,"C5",434661,1440269974,"2015-08-22 11:59:34"
"6239","20153915043953-171","2","2015-08-17 11:23:53",1439835833,"C4",153840,1439989673,"2015-08-19 06:07:53"
"311","20155030075000-793","2","2015-08-17 11:30:24",1439836224,"C5",522808,1440359032,"2015-08-23 12:43:52"
"6073","20154927084959-505","2","2015-08-17 11:50:49",1439837449,"C0",912625,1440750074,"2015-08-28 01:21:14"
"1754","20151114081116-872","2","2015-08-17 12:09:56",1439838596,"C4",368990,1440207586,"2015-08-21 18:39:46"
"6110","20154415014417-163","2","2015-08-17 13:41:01",1439844061,"C2",172604,1440016665,"2015-08-19 13:37:45"
"4331","20150208100221-140","3","2015-08-17 13:47:40",1439844460,"C7",113017,1439957477,"2015-08-18 21:11:17"
"3676","20153408043401-757","3","2015-08-17 14:02:16",1439845336,"C5",51233,1439896569,"2015-08-18 04:16:09"
"4598","20155222025217-753","1","2015-08-17 15:31:20",1439850680,"C8",321249,1440171929,"2015-08-21 08:45:29"
"3887","20153402013445-750","1","2015-08-17 15:35:17",1439850917,"C0",186176,1440037093,"2015-08-19 19:18:13"
"1020","20153503063500-934","2","2015-08-17 15:49:59",1439851799,"C7",177557,1440029356,"2015-08-19 17:09:16"
"1616","20153013113059-327","1","2015-08-17 16:08:46",1439852926,"C7",434381,1440287307,"2015-08-22 16:48:27"
"5326","20151823021857-278","3","2015-08-17 16:39:45",1439854785,"C0",271056,1440125841,"2015-08-20 19:57:21"
"4717","20155615065643-355","3","2015-08-17 16:39:48",1439854788,"C4",207785,1440062573,"2015-08-20 02:22:53"
"5280","20154830024817-212","3","2015-08-17 16:48:35",1439855315,"C5",520806,1440376121,"2015-08-23 17:28:41"
"3071","20154610024627-393","3","2015-08-17 16:59:34",1439855974,"C8",87541,1439943515,"2015-08-18 17:18:35"
"3500","20151505101551-848","3","2015-08-17 17:08:29",1439856509,"C5",530779,1440387288,"2015-08-23 20:34:48"
"3127","20150812050800-581","1","2015-08-17 17:08:33",1439856513,"C7",61719,1439918232,"2015-08-18 10:17:12"
"2804","20153731033739-510","2","2015-08-17 17:19:55",1439857195,"C4",184367,1440041562,"2015-08-19 20:32:42"
"1823","20154319044337-154","1","2015-08-17 17:40:55",1439858455,"C8",358434,1440216889,"2015-08-21 21:14:49"
"4418","20150903050915-821","1","2015-08-17 19:50:27",1439866227,"C5",152409,1440018636,"2015-08-19 14:10:36"
"6182","20155426075432-816","2","2015-08-17 20:36:23",1439868983,"C4",278073,1440147056,"2015-08-21 01:50:56"
"5107","20155816065857-340","1","2015-08-17 21:18:18",1439871498,"C4",137961,1440009459,"2015-08-19 11:37:39"
"2470","20152707072751-974","1","2015-08-17 21:23:00",1439871780,"C8",130587,1440002367,"2015-08-19 09:39:27"
"872","20151425111443-882","3","2015-08-17 21:23:45",1439871825,"C5",289106,1440160931,"2015-08-21 05:42:11"
"2565","20151329111340-193","2","2015-08-17 22:36:52",1439876212,"C5",210324,1440086536,"2015-08-20 09:02:16"
"2334","20154011014002-294","1","2015-08-17 23:00:35",1439877635,"C0",184011,1440061646,"2015-08-20 02:07:26"
"4105","20152010062058-60","1","2015-08-17 23:10:01",1439878201,"C4",221781,1440099982,"2015-08-20 12:46:22"
"5796","20151514111535-583","1","2015-08-18 00:38:25",1439883505,"C0",153685,1440037190,"2015-08-19 19:19:50"
"2475","20152917072944-998","1","2015-08-18 00:54:04",1439884444,"C4",391580,1440276024,"2015-08-22 13:40:24"
"5353","20152504102511-329","2","2015-08-18 01:32:47",1439886767,"C4",1285352,1441172119,"2015-09-01 22:35:19"
"416","20153509033522-770","1","2015-08-18 01:40:52",1439887252,"C5",363765,1440251017,"2015-08-22 06:43:37"
"1879","20152305112331-211","1","2015-08-18 03:02:40",1439892160,"C7",121461,1440013621,"2015-08-19 12:47:01"
"1550","20151911041901-689","3","2015-08-18 03:29:17",1439893757,"C6",69827,1439963584,"2015-08-18 22:53:04"
"1834","20153324083347-572","2","2015-08-18 03:52:59",1439895179,"C2",1071576,1440966755,"2015-08-30 13:32:35"
"2722","20151612121658-752","1","2015-08-18 04:32:09",1439897529,"C8",70073,1439967602,"2015-08-19 00:00:02"
"2408","20151211091201-575","2","2015-08-18 05:24:35",1439900675,"C7",295577,1440196252,"2015-08-21 15:30:52"
"5792","20150411020405-25","3","2015-08-18 05:32:23",1439901143,"C4",287049,1440188192,"2015-08-21 13:16:32"
"1781","20151914041953-619","1","2015-08-18 06:00:51",1439902851,"C5",154229,1440057080,"2015-08-20 00:51:20"
"4840","20151528061539-192","1","2015-08-18 06:14:19",1439903659,"C8",362864,1440266523,"2015-08-22 11:02:03"
"784","20153915063956-914","3","2015-08-18 06:18:14",1439903894,"C8",128949,1440032843,"2015-08-19 18:07:23"
"3805","20150321080345-584","2","2015-08-18 07:25:45",1439907945,"C4",302115,1440210060,"2015-08-21 19:21:00"
"1340","20152501032501-316","1","2015-08-18 07:29:40",1439908180,"C7",160031,1440068211,"2015-08-20 03:56:51"
"5953","20150207100246-511","1","2015-08-18 07:41:46",1439908906,"C8",188388,1440097294,"2015-08-20 12:01:34"
"1971","20151019101010-336","1","2015-08-18 08:30:30",1439911830,"C8",517204,1440429034,"2015-08-24 08:10:34"
"1128","20155216055230-781","1","2015-08-18 09:38:24",1439915904,"C3",71577,1439987481,"2015-08-19 05:31:21"
"3534","20153603053617-529","3","2015-08-18 09:53:32",1439916812,"C8",253647,1440170459,"2015-08-21 08:20:59"
"4868","20155529075511-496","1","2015-08-18 09:53:51",1439916831,"C0",216890,1440133721,"2015-08-20 22:08:41"
"5633","20155602125643-208","2","2015-08-18 10:06:51",1439917611,"C5",171526,1440089137,"2015-08-20 09:45:37"
"6559","20151307121323-821","1","2015-08-18 10:39:23",1439919563,"C4",118095,1440037658,"2015-08-19 19:27:38"
"4484","20154307124354-819","2","2015-08-18 10:44:34",1439919874,"C5",117905,1440037779,"2015-08-19 19:29:39"
"3480","20150909120927-426","1","2015-08-18 11:00:02",1439920802,"C6",773435,1440694237,"2015-08-27 09:50:37"
"5174","20152414112403-762","2","2015-08-18 11:08:48",1439921328,"C5",114895,1440036223,"2015-08-19 19:03:43"
"5229","20153715093725-365","1","2015-08-18 11:34:53",1439922893,"C7",133124,1440056017,"2015-08-20 00:33:37"
"102","20155109115123-786","1","2015-08-18 12:13:56",1439925236,"C4",259651,1440184887,"2015-08-21 12:21:27"
"1144","20152716102734-529","1","2015-08-18 12:18:58",1439925538,"C7",89742,1440015280,"2015-08-19 13:14:40"
"4100","20152509052554-869","1","2015-08-18 12:42:06",1439926926,"C2",253524,1440180450,"2015-08-21 11:07:30"
"206","20153318013311-102","2","2015-08-18 13:00:31",1439928031,"C5",334555,1440262586,"2015-08-22 09:56:26"
"3137","20154215114244-418","2","2015-08-18 13:27:08",1439929628,"C0",88488,1440018116,"2015-08-19 14:01:56"
"876","20151116021105-602","1","2015-08-18 13:53:19",1439931199,"C5",407162,1440338361,"2015-08-23 06:59:21"
"922","20153412103450-486","1","2015-08-18 14:04:54",1439931894,"C3",531004,1440462898,"2015-08-24 17:34:58"
"3732","20154605074608-859","2","2015-08-18 14:24:32",1439933072,"C4",478188,1440411260,"2015-08-24 03:14:20"
"3864","20150714090715-693","1","2015-08-18 14:39:29",1439933969,"C6",365534,1440299503,"2015-08-22 20:11:43"
"5685","20151129101109-424","3","2015-08-18 15:36:45",1439937405,"C6",291256,1440228661,"2015-08-22 00:31:01"
"3913","20152815042814-977","2","2015-08-18 16:00:03",1439938803,"C6",257509,1440196312,"2015-08-21 15:31:52"
"5434","20154729074714-800","2","2015-08-18 16:26:49",1439940409,"C8",351835,1440292244,"2015-08-22 18:10:44"
"2984","20153510103505-180","2","2015-08-18 16:27:05",1439940425,"C4",423840,1440364265,"2015-08-23 14:11:05"
"3038","20153316013306-455","1","2015-08-18 16:56:19",1439942179,"C0",184993,1440127172,"2015-08-20 20:19:32"
"816","20155325075339-490","2","2015-08-18 17:36:41",1439944601,"C5",301226,1440245827,"2015-08-22 05:17:07"
"3905","20152816122841-313","1","2015-08-18 17:46:01",1439945161,"C0",95920,1440041081,"2015-08-19 20:24:41"
"2843","20151910031914-568","1","2015-08-18 18:58:38",1439949518,"C8",352182,1440301700,"2015-08-22 20:48:20"
"973","20155208085206-672","2","2015-08-18 19:21:27",1439950887,"C5",300587,1440251474,"2015-08-22 06:51:14"
"2873","20154231084240-825","2","2015-08-18 19:23:55",1439951035,"C7",177075,1440128110,"2015-08-20 20:35:10"
"6312","20150514060535-722","1","2015-08-18 19:41:30",1439952090,"C6",394555,1440346645,"2015-08-23 09:17:25"
"2218","20151225091206-465","2","2015-08-18 19:48:48",1439952528,"C2",301686,1440254214,"2015-08-22 07:36:54"
"1312","20152030112009-638","2","2015-08-18 19:54:16",1439952856,"C8",238921,1440191777,"2015-08-21 14:16:17"
"44","20154917014946-993","3","2015-08-18 20:27:01",1439954821,"C4",110235,1440065056,"2015-08-20 03:04:16"
"2794","20155019085012-883","2","2015-08-18 22:23:10",1439961790,"C4",377254,1440339044,"2015-08-23 07:10:44"
"2602","20151812061805-214","1","2015-08-18 22:24:41",1439961881,"C2",288198,1440250079,"2015-08-22 06:27:59"
"3052","20155027045016-281","2","2015-08-18 22:42:00",1439962920,"C5",240238,1440203158,"2015-08-21 17:25:58"
"4507","20154407104408-451","2","2015-08-18 22:53:47",1439963627,"C4",331393,1440295020,"2015-08-22 18:57:00"
"2134","20150007020012-126","1","2015-08-18 23:36:38",1439966198,"C3",492493,1440458691,"2015-08-24 16:24:51"
"6151","20155318075328-481","3","2015-08-19 00:40:08",1439970008,"C5",342350,1440312358,"2015-08-22 23:45:58"
"1679","20153722083744-703","1","2015-08-19 00:56:56",1439971016,"C4",298944,1440269960,"2015-08-22 11:59:20"
"4677","20152212112246-498","1","2015-08-19 01:04:22",1439971462,"C5",283848,1440255310,"2015-08-22 07:55:10"
"6328","20154003094041-201","1","2015-08-19 01:07:45",1439971665,"C2",503753,1440475418,"2015-08-24 21:03:38"
"3206","20154423074437-690","2","2015-08-19 01:35:17",1439973317,"C2",288830,1440262147,"2015-08-22 09:49:07"
"5896","20150425060412-481","2","2015-08-19 02:08:22",1439975302,"C8",306550,1440281852,"2015-08-22 15:17:32"
"902","20155914045902-906","1","2015-08-19 02:26:54",1439976414,"C8",189836,1440166250,"2015-08-21 07:10:50"
"2945","20154505014505-202","2","2015-08-19 02:30:41",1439976641,"C6",804942,1440781583,"2015-08-28 10:06:23"
"1620","20151212051226-954","3","2015-08-19 02:53:53",1439978033,"C4",79041,1440057074,"2015-08-20 00:51:14"
"6327","20154517024507-611","1","2015-08-19 04:45:55",1439984755,"C4",68424,1440053179,"2015-08-19 23:46:19"
"3789","20150914030948-203","2","2015-08-19 05:32:51",1439987571,"C3",56769,1440044340,"2015-08-19 21:19:00"
"2563","20155618085617-440","2","2015-08-19 05:56:23",1439988983,"C6",459001,1440447984,"2015-08-24 13:26:24"
"1303","20151630041632-789","1","2015-08-19 06:03:47",1439989427,"C2",241605,1440231032,"2015-08-22 01:10:32"
"1544","20153717103748-173","3","2015-08-19 06:18:21",1439990301,"C4",157233,1440147534,"2015-08-21 01:58:54"
"4123","20154824034807-478","2","2015-08-19 06:26:07",1439990767,"C5",276585,1440267352,"2015-08-22 11:15:52"
"1735","20151217101248-377","3","2015-08-19 06:57:26",1439992646,"C8",80539,1440073185,"2015-08-20 05:19:45"
"3942","20153316073319-342","3","2015-08-19 07:04:01",1439993041,"C7",128721,1440121762,"2015-08-20 18:49:22"
"5622","20153707123730-758","3","2015-08-19 07:29:48",1439994588,"C6",169723,1440164311,"2015-08-21 06:38:31"
"4981","20154127124144-803","3","2015-08-19 07:55:42",1439996142,"C2",281434,1440277576,"2015-08-22 14:06:16"
"4413","20151115121122-695","3","2015-08-19 09:00:48",1440000048,"C2",167083,1440167131,"2015-08-21 07:25:31"
"6202","20150116070109-391","1","2015-08-19 09:02:07",1440000127,"C6",266458,1440266585,"2015-08-22 11:03:05"
"4675","20150217030209-500","2","2015-08-19 09:26:07",1440001567,"C2",76319,1440077886,"2015-08-20 06:38:06"
"4608","20154519024544-322","False","2015-08-19 09:52:50",1440003170,"C4",203002,1440206172,"2015-08-21 18:16:12"
"2254","20150106030143-319","1","2015-08-19 11:11:59",1440007919,"C2",158488,1440166407,"2015-08-21 07:13:27"
"4593","20154715054748-43","2","2015-08-19 11:34:18",1440009258,"C2",46170,1440055428,"2015-08-20 00:23:48"
"2562","20152310062340-347","1","2015-08-19 12:00:31",1440010831,"C7",113973,1440124804,"2015-08-20 19:40:04"
"1003","20154931054946-146","1","2015-08-19 12:21:46",1440012106,"C8",324384,1440336490,"2015-08-23 06:28:10"
"4997","20151813031829-984","2","2015-08-19 12:23:57",1440012237,"C0",63491,1440075728,"2015-08-20 06:02:08"
"3373","20154427024429-109","1","2015-08-19 13:07:01",1440014821,"C4",247669,1440262490,"2015-08-22 09:54:50"
"5464","20151516011512-70","1","2015-08-19 13:30:18",1440016218,"C2",260106,1440276324,"2015-08-22 13:45:24"
"5237","20151716071747-621","1","2015-08-19 13:31:44",1440016304,"C2",281637,1440297941,"2015-08-22 19:45:41"
"3977","20155028125010-618","1","2015-08-19 14:43:35",1440020615,"C5",272515,1440293130,"2015-08-22 18:25:30"
"4450","20154116074134-300","3","2015-08-19 14:56:59",1440021419,"C4",285325,1440306744,"2015-08-22 22:12:24"
"5030","20151514031512-498","1","2015-08-19 15:29:10",1440023350,"C8",61834,1440085184,"2015-08-20 08:39:44"
"5077","20152314082352-547","2","2015-08-19 15:42:49",1440024169,"C4",458337,1440482506,"2015-08-24 23:01:46"
"5756","20152317012342-801","2","2015-08-19 15:54:28",1440024868,"C3",90923,1440115791,"2015-08-20 17:09:51"
"4136","20153818123807-188","1","2015-08-19 16:07:21",1440025641,"C6",98954,1440124595,"2015-08-20 19:36:35"
"2726","20154229104255-661","3","2015-08-19 17:23:12",1440030192,"C0",262631,1440292823,"2015-08-22 18:20:23"
"5504","20150126050104-905","3","2015-08-19 17:52:58",1440031978,"C5",692238,1440724216,"2015-08-27 18:10:16"
"4791","20155616025653-750","1","2015-08-19 18:09:06",1440032946,"C4",270733,1440303679,"2015-08-22 21:21:19"
"2294","20151318061334-243","2","2015-08-19 18:46:02",1440035162,"C0",131548,1440166710,"2015-08-21 07:18:30"
"2521","20150518040539-572","3","2015-08-19 18:58:35",1440035915,"C2",96776,1440132691,"2015-08-20 21:51:31"
"6150","20152405122407-516","1","2015-08-19 18:58:52",1440035932,"C8",246657,1440282589,"2015-08-22 15:29:49"
"3110","20151125071146-648","2","2015-08-19 19:31:36",1440037896,"C8",440878,1440478774,"2015-08-24 21:59:34"
"2067","20151411101443-797","1","2015-08-19 19:56:33",1440039393,"C8",680902,1440720295,"2015-08-27 17:04:55"
"480","20151607071627-500","1","2015-08-19 20:20:23",1440040823,"C4",541918,1440582741,"2015-08-26 02:52:21"
"1056","20154212044215-152","1","2015-08-19 20:23:55",1440041035,"C4",309050,1440350085,"2015-08-23 10:14:45"
"3837","20150525050525-344","3","2015-08-19 20:53:48",1440042828,"C0",310529,1440353357,"2015-08-23 11:09:17"
"3094","20154117054153-286","2","2015-08-19 21:15:37",1440044137,"C8",92812,1440136949,"2015-08-20 23:02:29"
"3566","20150606090640-663","1","2015-08-19 21:16:10",1440044170,"C0",166710,1440210880,"2015-08-21 19:34:40"
"2877","20152118032137-233","2","2015-08-19 21:58:57",1440046737,"C4",110240,1440156977,"2015-08-21 04:36:17"
"420","20155519125535-358","1","2015-08-19 21:59:53",1440046793,"C6",451843,1440498636,"2015-08-25 03:30:36"
"5362","20151907011912-142","1","2015-08-19 22:10:12",1440047412,"C5",356220,1440403632,"2015-08-24 01:07:12"
"1743","20152207052205-192","1","2015-08-19 23:01:09",1440050469,"C2",96104,1440146573,"2015-08-21 01:42:53"
"810","20155114095131-368","2","2015-08-19 23:20:48",1440051648,"C2",68651,1440120299,"2015-08-20 18:24:59"
"5940","20152115072114-129","1","2015-08-19 23:49:48",1440053388,"C5",202457,1440255845,"2015-08-22 08:04:05"
"4974","20152731042731-228","3","2015-08-19 23:51:31",1440053491,"C5",834120,1440887611,"2015-08-29 15:33:31"
"4910","20154316124308-991","1","2015-08-20 00:39:58",1440056398,"C4",151105,1440207503,"2015-08-21 18:38:23"
"1250","20154630124653-489","1","2015-08-20 00:45:32",1440056732,"C4",253017,1440309749,"2015-08-22 23:02:29"
"4054","20152101072110-270","1","2015-08-20 00:53:48",1440057228,"C5",809179,1440866407,"2015-08-29 09:40:07"
"3371","20152116012117-783","1","2015-08-20 00:57:05",1440057425,"C2",150474,1440207899,"2015-08-21 18:44:59"
"5101","20150713090739-797","1","2015-08-20 01:15:09",1440058509,"C8",288225,1440346734,"2015-08-23 09:18:54"
"4321","20152714022709-931","2","2015-08-20 03:03:21",1440065001,"C5",159124,1440224125,"2015-08-21 23:15:25"
"3989","20150214110230-668","1","2015-08-20 03:17:30",1440065850,"C0",245250,1440311100,"2015-08-22 23:25:00"
"4127","20150205030232-909","1","2015-08-20 03:18:08",1440065888,"C8",626868,1440692756,"2015-08-27 09:25:56"
"1320","20151403101408-211","1","2015-08-20 03:52:30",1440067950,"C0",589186,1440657136,"2015-08-26 23:32:16"
"1523","20150207080240-722","1","2015-08-20 04:17:30",1440069450,"C8",554845,1440624295,"2015-08-26 14:24:55"
"4439","20151916021928-359","1","2015-08-20 04:37:53",1440070673,"C8",62141,1440132814,"2015-08-20 21:53:34"
"2464","20154115044115-752","1","2015-08-20 04:50:01",1440071401,"C8",194663,1440266064,"2015-08-22 10:54:24"
"5596","20154424084414-48","1","2015-08-20 06:11:18",1440076278,"C4",614453,1440690731,"2015-08-27 08:52:11"
"5420","20150112080156-678","3","2015-08-20 06:31:50",1440077510,"C7",342897,1440420407,"2015-08-24 05:46:47"
"657","20152115052114-277","1","2015-08-20 07:17:26",1440080246,"C6",65962,1440146208,"2015-08-21 01:36:48"
"167","20150516060520-936","2","2015-08-20 07:29:05",1440080945,"C3",116875,1440197820,"2015-08-21 15:57:00"
"6199","20155206035248-482","3","2015-08-20 07:40:08",1440081608,"C0",147505,1440229113,"2015-08-22 00:38:33"
"3923","20152823092842-19","1","2015-08-20 08:12:42",1440083562,"C5",301830,1440385392,"2015-08-23 20:03:12"
"3891","20154703044754-258","3","2015-08-20 09:45:33",1440089133,"C4",481153,1440570286,"2015-08-25 23:24:46"
"2216","20154216104223-278","1","2015-08-20 10:31:37",1440091897,"C5",172477,1440264374,"2015-08-22 10:26:14"
"6503","20150707060746-607","2","2015-08-20 10:59:31",1440093571,"C8",228141,1440321712,"2015-08-23 02:21:52"
"3518","20151518011542-627","3","2015-08-20 11:08:06",1440094086,"C5",82572,1440176658,"2015-08-21 10:04:18"
"738","20150418120408-87","3","2015-08-20 11:31:23",1440095483,"C6",170835,1440266318,"2015-08-22 10:58:38"
"495","20150231120236-701","1","2015-08-20 11:32:36",1440095556,"C7",246600,1440342156,"2015-08-23 08:02:36"
"6132","20153808033819-967","3","2015-08-20 11:40:19",1440096019,"C3",786615,1440882634,"2015-08-29 14:10:34"
"6443","20154115084152-940","1","2015-08-20 12:02:46",1440097366,"C2",222027,1440319393,"2015-08-23 01:43:13"
"3107","20152318082356-512","1","2015-08-20 12:12:02",1440097922,"C5",93243,1440191165,"2015-08-21 14:06:05"
"1252","20154024064023-567","1","2015-08-20 12:26:33",1440098793,"C8",989114,1441087907,"2015-08-31 23:11:47"
"4155","20152421122448-609","1","2015-08-20 12:48:24",1440100104,"C2",370488,1440470592,"2015-08-24 19:43:12"
"1716","20151717021725-292","1","2015-08-20 13:01:55",1440100915,"C2",977690,1441078605,"2015-08-31 20:36:45"
"6348","20152710022715-872","1","2015-08-20 13:07:45",1440101265,"C7",95470,1440196735,"2015-08-21 15:38:55"
"1047","20150412070442-715","2","2015-08-20 13:32:53",1440102773,"C4",714491,1440817264,"2015-08-28 20:01:04"
"566","20152510092527-332","1","2015-08-20 13:37:03",1440103023,"C8",439548,1440542571,"2015-08-25 15:42:51"
"1357","20153102043137-348","1","2015-08-20 14:25:48",1440105948,"C5",221093,1440327041,"2015-08-23 03:50:41"
"1689","20153918123921-858","1","2015-08-20 14:34:25",1440106465,"C2",357263,1440463728,"2015-08-24 17:48:48"
"6370","20155511105504-943","1","2015-08-20 15:07:07",1440108427,"C3",792723,1440901150,"2015-08-29 19:19:10"
"6402","20154612104653-119","1","2015-08-20 15:16:05",1440108965,"C5",423219,1440532184,"2015-08-25 12:49:44"
"200","20150316120315-424","1","2015-08-20 15:23:59",1440109439,"C5",178822,1440288261,"2015-08-22 17:04:21"
"5491","20153418023443-272","2","2015-08-20 16:50:17",1440114617,"C5",90467,1440205084,"2015-08-21 17:58:04"
"2852","20152630102651-351","3","2015-08-20 16:53:11",1440114791,"C8",367516,1440482307,"2015-08-24 22:58:27"
"5774","20151218101204-383","3","2015-08-20 17:28:58",1440116938,"C5",99507,1440216445,"2015-08-21 21:07:25"
"1766","20155611055605-588","3","2015-08-20 17:40:09",1440117609,"C6",776644,1440894253,"2015-08-29 17:24:13"
"3171","20151416101435-915","1","2015-08-20 17:53:19",1440118399,"C8",186562,1440304961,"2015-08-22 21:42:41"
"4292","20152818012813-881","1","2015-08-20 17:59:19",1440118759,"C0",409638,1440528397,"2015-08-25 11:46:37"
"3922","20152312112319-869","2","2015-08-20 19:03:09",1440122589,"C7",359395,1440481984,"2015-08-24 22:53:04"
"4479","20152801032847-862","2","2015-08-20 19:12:59",1440123179,"C6",275842,1440399021,"2015-08-23 23:50:21"
"970","20153114033108-799","1","2015-08-20 19:44:08",1440125048,"C8",106716,1440231764,"2015-08-22 01:22:44"
"1380","20151415041441-660","3","2015-08-20 20:21:27",1440127287,"C7",446458,1440573745,"2015-08-26 00:22:25"
"1444","20155111095109-411","1","2015-08-20 20:40:13",1440128413,"C5",436868,1440565281,"2015-08-25 22:01:21"
"5028","20150016120041-181","3","2015-08-20 20:45:13",1440128713,"C5",188536,1440317249,"2015-08-23 01:07:29"
"2398","20153409013402-796","1","2015-08-20 21:39:44",1440131984,"C5",489771,1440621755,"2015-08-26 13:42:35"
"60","20154114034126-781","1","2015-08-20 21:43:56",1440132236,"C8",270075,1440402311,"2015-08-24 00:45:11"
"3488","20155123095125-681","2","2015-08-20 22:08:47",1440133727,"C3",722206,1440855933,"2015-08-29 06:45:33"
"5009","20151514111539-957","1","2015-08-20 22:59:48",1440136788,"C5",186883,1440323671,"2015-08-23 02:54:31"
"6147","20152027122000-634","2","2015-08-20 23:10:08",1440137408,"C2",264076,1440401484,"2015-08-24 00:31:24"
"4693","20152307032337-327","1","2015-08-20 23:20:45",1440138045,"C4",575914,1440713959,"2015-08-27 15:19:19"
"1233","20152031082031-756","1","2015-08-20 23:32:43",1440138763,"C4",891366,1441030129,"2015-08-31 07:08:49"
"4358","20153219033258-970","3","2015-08-20 23:41:50",1440139310,"C5",57866,1440197176,"2015-08-21 15:46:16"
"5758","20152814062834-4","1","2015-08-20 23:53:04",1440139984,"C2",290535,1440430519,"2015-08-24 08:35:19"
"1283","20151025031037-733","1","2015-08-21 00:38:07",1440142687,"C4",760150,1440902837,"2015-08-29 19:47:17"
"1015","20151318101343-137","1","2015-08-21 01:23:13",1440145393,"C4",113685,1440259078,"2015-08-22 08:57:58"
"3579","20151616091623-588","1","2015-08-21 01:40:29",1440146429,"C5",202323,1440348752,"2015-08-23 09:52:32"
"2954","20152915072932-837","1","2015-08-21 01:40:57",1440146457,"C8",99497,1440245954,"2015-08-22 05:19:14"
"5879","20153804013823-112","1","2015-08-21 01:48:01",1440146881,"C8",713089,1440859970,"2015-08-29 07:52:50"
"5546","20152109072151-681","1","2015-08-21 03:01:31",1440151291,"C8",204236,1440355527,"2015-08-23 11:45:27"
"228","20154201024259-199","2","2015-08-21 03:46:17",1440153977,"C7",485222,1440639199,"2015-08-26 18:33:19"
"2762","20155618065604-631","2","2015-08-21 03:51:44",1440154304,"C7",124070,1440278374,"2015-08-22 14:19:34"
"4827","20152921082952-995","2","2015-08-21 05:01:28",1440158488,"C1",444316,1440602804,"2015-08-26 08:26:44"
"3161","20154805094814-860","2","2015-08-21 06:18:37",1440163117,"C5",195689,1440358806,"2015-08-23 12:40:06"
"1120","20150330050315-215","1","2015-08-21 06:27:31",1440163651,"C5",232832,1440396483,"2015-08-23 23:08:03"
"3254","20150722110730-245","1","2015-08-21 06:44:55",1440164695,"C8",368035,1440532730,"2015-08-25 12:58:50"
"6019","20155812115832-295","1","2015-08-21 07:00:02",1440165602,"C8",151938,1440317540,"2015-08-23 01:12:20"
"5046","20154602014652-42","1","2015-08-21 07:14:36",1440166476,"C7",231152,1440397628,"2015-08-23 23:27:08"
"6148","20154708104711-651","2","2015-08-21 07:24:14",1440167054,"C0",370341,1440537395,"2015-08-25 14:16:35"
"580","20155414075423-495","1","2015-08-21 07:53:32",1440168812,"C5",201583,1440370395,"2015-08-23 15:53:15"
"1453","20153602043658-257","3","2015-08-21 07:58:16",1440169096,"C6",268413,1440437509,"2015-08-24 10:31:49"
"6361","20153017023011-609","1","2015-08-21 08:00:28",1440169228,"C6",322217,1440491445,"2015-08-25 01:30:45"
"1707","20154114104153-864","1","2015-08-21 08:23:50",1440170630,"C0",198839,1440369469,"2015-08-23 15:37:49"
"3","20150909100908-893","1","2015-08-21 08:29:56",1440170996,"C5",128856,1440299852,"2015-08-22 20:17:32"
"5249","20150420090434-499","1","2015-08-21 10:21:44",1440177704,"C6",91030,1440268734,"2015-08-22 11:38:54"
"1355","20150514090518-434","2","2015-08-21 10:51:09",1440179469,"C5",203717,1440383186,"2015-08-23 19:26:26"
"370","20150616020625-232","1","2015-08-21 11:22:00",1440181320,"C5",60305,1440241625,"2015-08-22 04:07:05"
"2749","20154714074732-183","3","2015-08-21 11:45:16",1440182716,"C8",309532,1440492248,"2015-08-25 01:44:08"
"3931","20155116025119-682","1","2015-08-21 12:35:36",1440185736,"C3",60551,1440246287,"2015-08-22 05:24:47"
"1280","20150311040324-846","3","2015-08-21 12:39:55",1440185995,"C3",504313,1440690308,"2015-08-27 08:45:08"
"3090","20152317122348-82","3","2015-08-21 12:42:04",1440186124,"C2",346696,1440532820,"2015-08-25 13:00:20"
"4088","20153214063240-340","1","2015-08-21 12:49:58",1440186598,"C6",627438,1440814036,"2015-08-28 19:07:16"
"5573","20153226033231-156","3","2015-08-21 13:05:57",1440187557,"C4",319658,1440507215,"2015-08-25 05:53:35"
"1555","20150922030934-439","1","2015-08-21 13:52:49",1440190369,"C8",517479,1440707848,"2015-08-27 13:37:28"
"1698","20152913092907-731","1","2015-08-21 15:03:49",1440194629,"C6",118547,1440313176,"2015-08-22 23:59:36"
"5470","20152310122332-782","2","2015-08-21 15:43:48",1440197028,"C6",455102,1440652130,"2015-08-26 22:08:50"
"3283","20153114093133-433","2","2015-08-21 16:33:21",1440200001,"C7",70012,1440270013,"2015-08-22 12:00:13"
"4622","20150409090411-319","1","2015-08-21 17:02:09",1440201729,"C5",532739,1440734468,"2015-08-27 21:01:08"
"4033","20150911080911-37","2","2015-08-21 17:17:29",1440202649,"C4",298966,1440501615,"2015-08-25 04:20:15"
"2031","20152019052023-769","1","2015-08-21 17:23:41",1440203021,"C5",57666,1440260687,"2015-08-22 09:24:47"
"1503","20150115020146-483","3","2015-08-21 17:33:30",1440203610,"C2",66388,1440269998,"2015-08-22 11:59:58"
"3524","20155206095205-734","1","2015-08-21 18:30:53",1440207053,"C5",165891,1440372944,"2015-08-23 16:35:44"
"5949","20151630081603-922","1","2015-08-21 18:34:41",1440207281,"C4",968959,1441176240,"2015-09-01 23:44:00"
"72","20153601023624-894","1","2015-08-21 19:39:32",1440211172,"C3",873094,1441084266,"2015-08-31 22:11:06"
"5304","20155115095152-620","1","2015-08-21 19:57:04",1440212224,"C2",277356,1440489580,"2015-08-25 00:59:40"
"4934","20151806101819-946","1","2015-08-21 20:07:55",1440212875,"C6",166422,1440379297,"2015-08-23 18:21:37"
"4177","20153107103116-521","1","2015-08-21 20:11:46",1440213106,"C8",622215,1440835321,"2015-08-29 01:02:01"
"3490","20151115041109-804","1","2015-08-21 20:23:57",1440213837,"C0",76224,1440290061,"2015-08-22 17:34:21"
"2905","20151708101713-388","1","2015-08-21 20:46:13",1440215173,"C5",386980,1440602153,"2015-08-26 08:15:53"
"103","20151804021836-532","1","2015-08-21 21:41:36",1440218496,"C5",747690,1440966186,"2015-08-30 13:23:06"
"4443","20150904090957-319","2","2015-08-21 21:52:46",1440219166,"C3",216367,1440435533,"2015-08-24 09:58:53"
"4504","20153617103638-247","1","2015-08-21 21:56:02",1440219362,"C7",193182,1440412544,"2015-08-24 03:35:44"
"2660","20153612043651-254","1","2015-08-21 22:23:56",1440221036,"C8",159685,1440380721,"2015-08-23 18:45:21"
"1300","20153312023359-569","1","2015-08-21 22:36:03",1440221763,"C3",806524,1441028287,"2015-08-31 06:38:07"
"3060","20151410061424-60","1","2015-08-21 23:07:28",1440223648,"C5",126398,1440350046,"2015-08-23 10:14:06"
"4888","20152925032929-380","1","2015-08-21 23:19:05",1440224345,"C5",1180488,1441404833,"2015-09-04 15:13:53"
"1006","20151817051852-380","1","2015-08-21 23:19:34",1440224374,"C3",183621,1440407995,"2015-08-24 02:19:55"
"3423","20153329073300-377","1","2015-08-21 23:48:44",1440226124,"C6",255718,1440481842,"2015-08-24 22:50:42"
"3458","20152016012038-49","1","2015-08-22 00:08:53",1440227333,"C2",156965,1440384298,"2015-08-23 19:44:58"
"3163","20152603092611-468","1","2015-08-22 00:13:49",1440227629,"C4",804229,1441031858,"2015-08-31 07:37:38"
"4064","20152015102054-215","3","2015-08-22 00:41:25",1440229285,"C7",81433,1440310718,"2015-08-22 23:18:38"
"4679","20153712043748-60","3","2015-08-22 01:57:48",1440233868,"C5",436200,1440670068,"2015-08-27 03:07:48"
"4272","20155018015058-838","1","2015-08-22 02:59:04",1440237544,"C5",153243,1440390787,"2015-08-23 21:33:07"
"6222","20154518104543-3","1","2015-08-22 03:25:10",1440239110,"C5",106389,1440345499,"2015-08-23 08:58:19"
"1294","20153707063710-587","1","2015-08-22 03:37:45",1440239865,"C8",257047,1440496912,"2015-08-25 03:01:52"
"430","20153815113857-329","3","2015-08-22 03:42:43",1440240163,"C0",288113,1440528276,"2015-08-25 11:44:36"
"665","20152003102027-431","1","2015-08-22 04:08:59",1440241739,"C6",537214,1440778953,"2015-08-28 09:22:33"
"814","20152204122238-160","2","2015-08-22 05:35:42",1440246942,"C2",526148,1440773090,"2015-08-28 07:44:50"
"5583","20153813083855-252","1","2015-08-22 05:36:45",1440247005,"C4",383335,1440630340,"2015-08-26 16:05:40"
"5495","20153915113920-94","3","2015-08-22 05:37:50",1440247070,"C5",194370,1440441440,"2015-08-24 11:37:20"
"273","20152614122614-782","2","2015-08-22 06:35:02",1440250502,"C6",111688,1440362190,"2015-08-23 13:36:30"
"2754","20155321125321-407","2","2015-08-22 06:35:52",1440250552,"C6",63751,1440314303,"2015-08-23 00:18:23"
"767","20150220080208-953","1","2015-08-22 06:49:16",1440251356,"C5",84214,1440335570,"2015-08-23 06:12:50"
"4107","20151926091952-816","3","2015-08-22 08:31:27",1440257487,"C8",465979,1440723466,"2015-08-27 17:57:46"
"4561","20154407014405-908","2","2015-08-22 09:19:50",1440260390,"C8",256029,1440516419,"2015-08-25 08:26:59"
"856","20152018072024-196","1","2015-08-22 09:33:59",1440261239,"C3",353615,1440614854,"2015-08-26 11:47:34"
"5329","20153111043111-321","2","2015-08-22 09:48:17",1440262097,"C4",308742,1440570839,"2015-08-25 23:33:59"
"6381","20153604033631-714","3","2015-08-22 10:35:49",1440264949,"C4",1537158,1441802107,"2015-09-09 05:35:07"
"6556","20153518113519-608","1","2015-08-22 10:41:05",1440265265,"C3",171173,1440436438,"2015-08-24 10:13:58"
"76","20152309042301-368","2","2015-08-22 10:48:52",1440265732,"C4",157593,1440423325,"2015-08-24 06:35:25"
"4965","20150916010956-355","3","2015-08-22 10:59:52",1440266392,"C5",255298,1440521690,"2015-08-25 09:54:50"
"5619","20154116094115-530","1","2015-08-22 11:14:41",1440267281,"C5",262003,1440529284,"2015-08-25 12:01:24"
"6306","20154214044236-934","2","2015-08-22 11:47:48",1440269268,"C0",224504,1440493772,"2015-08-25 02:09:32"
"6422","20152023122039-382","1","2015-08-22 12:22:19",1440271339,"C7",370300,1440641639,"2015-08-26 19:13:59"
"2043","20152005092011-809","1","2015-08-22 13:10:35",1440274235,"C6",247104,1440521339,"2015-08-25 09:48:59"
"185","20150714060734-528","1","2015-08-22 13:11:56",1440274316,"C4",358331,1440632647,"2015-08-26 16:44:07"
"978","20152919122944-137","3","2015-08-22 13:11:59",1440274319,"C8",588027,1440862346,"2015-08-29 08:32:26"
"4897","20155304095307-596","2","2015-08-22 13:28:03",1440275283,"C4",196012,1440471295,"2015-08-24 19:54:55"
"6056","20152412092409-540","2","2015-08-22 15:32:59",1440282779,"C8",712906,1440995685,"2015-08-30 21:34:45"
"2228","20153816123820-926","1","2015-08-22 15:38:52",1440283132,"C7",264616,1440547748,"2015-08-25 17:09:08"
"1759","20151019011020-645","3","2015-08-22 15:56:36",1440284196,"C3",368447,1440652643,"2015-08-26 22:17:23"
"805","20155602045649-200","1","2015-08-22 15:59:37",1440284377,"C4",862284,1441146661,"2015-09-01 15:31:01"
"3151","20153711093723-390","1","2015-08-22 16:03:15",1440284595,"C5",121694,1440406289,"2015-08-24 01:51:29"
"6229","20151021011047-387","1","2015-08-22 16:32:42",1440286362,"C4",98515,1440384877,"2015-08-23 19:54:37"
"569","20152724032744-453","2","2015-08-22 16:32:59",1440286379,"C8",501903,1440788282,"2015-08-28 11:58:02"
"169","20155810125837-406","1","2015-08-22 17:34:40",1440290080,"C0",351121,1440641201,"2015-08-26 19:06:41"
"2416","20151018101055-192","2","2015-08-22 18:22:01",1440292921,"C8",187533,1440480454,"2015-08-24 22:27:34"
"3181","20150207100251-836","1","2015-08-22 18:42:03",1440294123,"C2",165894,1440460017,"2015-08-24 16:46:57"
"1840","20154920044939-697","2","2015-08-22 19:28:31",1440296911,"C5",91166,1440388077,"2015-08-23 20:47:57"
"5147","20150620030643-457","2","2015-08-22 19:33:00",1440297180,"C4",188777,1440485957,"2015-08-24 23:59:17"
"1225","20150218020205-444","1","2015-08-22 19:35:20",1440297320,"C3",365595,1440662915,"2015-08-27 01:08:35"
"337","20154016054003-520","2","2015-08-22 20:02:43",1440298963,"C2",263480,1440562443,"2015-08-25 21:14:03"
"981","20153219093204-479","1","2015-08-22 20:06:13",1440299173,"C0",297249,1440596422,"2015-08-26 06:40:22"
"1578","20153517083522-960","2","2015-08-22 21:06:15",1440302775,"C4",450779,1440753554,"2015-08-28 02:19:14"
"2144","20150115080147-541","1","2015-08-22 21:18:38",1440303518,"C4",217537,1440521055,"2015-08-25 09:44:15"
"2009","20154909074911-878","1","2015-08-22 21:40:11",1440304811,"C6",195510,1440500321,"2015-08-25 03:58:41"
"5044","20150024110036-855","1","2015-08-22 22:19:12",1440307152,"C3",848772,1441155924,"2015-09-01 18:05:24"
"450","20154224024247-121","2","2015-08-22 22:49:46",1440308986,"C2",362117,1440671103,"2015-08-27 03:25:03"
"5592","20150422010448-761","1","2015-08-23 00:10:54",1440313854,"C6",453061,1440766915,"2015-08-28 06:01:55"
"1136","20154502094535-864","3","2015-08-23 00:18:21",1440314301,"C2",254338,1440568639,"2015-08-25 22:57:19"
"3514","20154516014531-348","2","2015-08-23 01:22:33",1440318153,"C7",280111,1440598264,"2015-08-26 07:11:04"
"6368","20154707014750-447","2","2015-08-23 02:11:08",1440321068,"C5",191514,1440512582,"2015-08-25 07:23:02"
"3147","20152220042220-374","1","2015-08-23 02:31:40",1440322300,"C5",104680,1440426980,"2015-08-24 07:36:20"
"3632","20150214020240-113","1","2015-08-23 03:05:52",1440324352,"C2",105456,1440429808,"2015-08-24 08:23:28"
"3183","20152913112925-155","1","2015-08-23 03:42:21",1440326541,"C5",104497,1440431038,"2015-08-24 08:43:58"
"2046","20150319120301-287","3","2015-08-23 03:52:04",1440327124,"C7",332727,1440659851,"2015-08-27 00:17:31"
"4547","20151221021214-964","2","2015-08-23 03:58:22",1440327502,"C4",67984,1440395486,"2015-08-23 22:51:26"
"2263","20153609013658-819","3","2015-08-23 04:35:31",1440329731,"C5",168159,1440497890,"2015-08-25 03:18:10"
"5457","20153802063824-325","3","2015-08-23 04:52:52",1440330772,"C8",640924,1440971696,"2015-08-30 14:54:56"
"1264","20153213013249-868","1","2015-08-23 05:43:37",1440333817,"C5",417924,1440751741,"2015-08-28 01:49:01"
"4049","20150125080138-74","3","2015-08-23 06:26:06",1440336366,"C7",357124,1440693490,"2015-08-27 09:38:10"
"3522","20151315121331-773","1","2015-08-23 06:28:23",1440336503,"C0",670492,1441006995,"2015-08-31 00:43:15"
"2384","20150722040736-505","1","2015-08-23 06:31:06",1440336666,"C4",51810,1440388476,"2015-08-23 20:54:36"
"1671","20153320073331-255","1","2015-08-23 06:40:27",1440337227,"C0",366802,1440704029,"2015-08-27 12:33:49"
"804","20154826114830-851","2","2015-08-23 06:56:15",1440338175,"C4",343095,1440681270,"2015-08-27 06:14:30"
"394","20153813123814-541","1","2015-08-23 07:11:26",1440339086,"C4",105549,1440444635,"2015-08-24 12:30:35"
"1520","20155118115128-12","1","2015-08-23 07:42:20",1440340940,"C5",208526,1440549466,"2015-08-25 17:37:46"
"4059","20150219040226-843","1","2015-08-23 08:43:13",1440344593,"C5",798521,1441143114,"2015-09-01 14:31:54"
"3468","20152322042319-725","2","2015-08-23 09:08:12",1440346092,"C4",60293,1440406385,"2015-08-24 01:53:05"
"2171","20153614113645-637","1","2015-08-23 10:55:25",1440352525,"C6",96890,1440449415,"2015-08-24 13:50:15"
"1435","20150503040553-197","2","2015-08-23 11:42:19",1440355339,"C7",244598,1440599937,"2015-08-26 07:38:57"
"2241","20152504042522-96","2","2015-08-23 12:16:11",1440357371,"C8",615007,1440972378,"2015-08-30 15:06:18"
"2910","20153822023828-796","2","2015-08-23 12:18:15",1440357495,"C4",77987,1440435482,"2015-08-24 09:58:02"
"2207","20153217083226-786","2","2015-08-23 12:41:23",1440358883,"C0",76191,1440435074,"2015-08-24 09:51:14"
"5276","20154920074921-321","1","2015-08-23 13:12:03",1440360723,"C5",92854,1440453577,"2015-08-24 14:59:37"
"1819","20154906014902-527","1","2015-08-23 13:35:50",1440362150,"C5",183501,1440545651,"2015-08-25 16:34:11"
"1425","20153322063352-729","2","2015-08-23 13:40:24",1440362424,"C4",348799,1440711223,"2015-08-27 14:33:43"
"5773","20150016090035-720","1","2015-08-23 13:46:19",1440362779,"C3",77743,1440440522,"2015-08-24 11:22:02"
"1900","20151714061754-756","1","2015-08-23 14:21:42",1440364902,"C4",403314,1440768216,"2015-08-28 06:23:36"
"3916","20155321105314-535","2","2015-08-23 14:41:26",1440366086,"C2",93246,1440459332,"2015-08-24 16:35:32"
"1035","20151319061333-620","1","2015-08-23 14:49:13",1440366553,"C4",436420,1440802973,"2015-08-28 16:02:53"
"4773","20155107025107-822","1","2015-08-23 14:50:02",1440366602,"C8",276467,1440643069,"2015-08-26 19:37:49"
"2796","20150617100636-148","1","2015-08-23 14:52:12",1440366732,"C5",267768,1440634500,"2015-08-26 17:15:00"
"1214","20150815120847-511","1","2015-08-23 14:55:19",1440366919,"C2",87649,1440454568,"2015-08-24 15:16:08"
"939","20153519023513-548","3","2015-08-23 15:20:29",1440368429,"C2",432388,1440800817,"2015-08-28 15:26:57"
"2049","20152218052241-425","1","2015-08-23 15:32:02",1440369122,"C2",425361,1440794483,"2015-08-28 13:41:23"
"4322","20153315073301-37","3","2015-08-23 16:01:49",1440370909,"C8",360864,1440731773,"2015-08-27 20:16:13"
"5959","20152130072111-229","2","2015-08-23 17:12:51",1440375171,"C0",301300,1440676471,"2015-08-27 04:54:31"
"938","20151522081515-994","1","2015-08-23 17:37:16",1440376636,"C6",120121,1440496757,"2015-08-25 02:59:17"
"2081","20153921023939-728","2","2015-08-23 17:56:44",1440377804,"C3",184625,1440562429,"2015-08-25 21:13:49"
"3665","20155624115628-693","1","2015-08-23 18:24:36",1440379476,"C5",326911,1440706387,"2015-08-27 13:13:07"
"3540","20152719032729-250","1","2015-08-23 18:29:36",1440379776,"C0",356527,1440736303,"2015-08-27 21:31:43"
"5140","20154521054515-644","2","2015-08-23 19:49:26",1440384566,"C2",180251,1440564817,"2015-08-25 21:53:37"
"68","20151722051720-973","1","2015-08-23 20:59:28",1440388768,"C3",347266,1440736034,"2015-08-27 21:27:14"
"433","20150919080932-475","1","2015-08-23 21:58:06",1440392286,"C4",439102,1440831388,"2015-08-28 23:56:28"
"5061","20154211064241-592","1","2015-08-23 22:18:01",1440393481,"C4",538760,1440932241,"2015-08-30 03:57:21"
"6269","20150419040419-734","1","2015-08-23 23:28:05",1440397685,"C4",186113,1440583798,"2015-08-26 03:09:58"
"4365","20153914043919-947","1","2015-08-23 23:45:13",1440398713,"C3",401577,1440800290,"2015-08-28 15:18:10"
"1203","20150511080548-765","3","2015-08-23 23:57:09",1440399429,"C3",364627,1440764056,"2015-08-28 05:14:16"
"2034","20150328070321-554","1","2015-08-24 00:10:41",1440400241,"C0",288505,1440688746,"2015-08-27 08:19:06"
"1177","20153004013007-217","3","2015-08-24 00:21:47",1440400907,"C8",336140,1440737047,"2015-08-27 21:44:07"
"5714","20155415015459-549","1","2015-08-24 00:26:15",1440401175,"C7",857068,1441258243,"2015-09-02 22:30:43"
"3175","20154606044639-126","3","2015-08-24 00:55:43",1440402943,"C3",749072,1441152015,"2015-09-01 17:00:15"
"1239","20153811123837-345","3","2015-08-24 01:19:01",1440404341,"C6",180404,1440584745,"2015-08-26 03:25:45"
"4359","20150105090139-623","1","2015-08-24 03:08:10",1440410890,"C0",614113,1441025003,"2015-08-31 05:43:23"
"544","20153526043555-14","1","2015-08-24 03:43:55",1440413035,"C8",491856,1440904891,"2015-08-29 20:21:31"
"3960","20153930043916-979","1","2015-08-24 04:05:22",1440414322,"C3",704922,1441119244,"2015-09-01 07:54:04"
"2758","20151122081111-931","3","2015-08-24 04:59:21",1440417561,"C5",80645,1440498206,"2015-08-25 03:23:26"
"2143","20153914023947-993","1","2015-08-24 05:53:35",1440420815,"C4",416214,1440837029,"2015-08-29 01:30:29"
"3222","20152925102911-696","3","2015-08-24 06:33:33",1440423213,"C7",368266,1440791479,"2015-08-28 12:51:19"
"1813","20152026042055-270","1","2015-08-24 07:43:19",1440427399,"C3",309318,1440736717,"2015-08-27 21:38:37"
"4913","20153317103355-433","1","2015-08-24 07:51:52",1440427912,"C5",198359,1440626271,"2015-08-26 14:57:51"
"3070","20152329032334-147","3","2015-08-24 08:37:12",1440430632,"C5",1111009,1441541641,"2015-09-06 05:14:01"
"2438","20152507072524-315","2","2015-08-24 08:44:19",1440431059,"C3",210505,1440641564,"2015-08-26 19:12:44"
"3957","20151623041622-269","2","2015-08-24 08:59:39",1440431979,"C3",60197,1440492176,"2015-08-25 01:42:56"
"5580","20154115114122-286","1","2015-08-24 09:03:56",1440432236,"C5",384077,1440816313,"2015-08-28 19:45:13"
"2383","20151021011021-123","3","2015-08-24 09:11:15",1440432675,"C5",974418,1441407093,"2015-09-04 15:51:33"
"5489","20155518075547-219","1","2015-08-24 09:16:49",1440433009,"C5",261631,1440694640,"2015-08-27 09:57:20"
"5117","20152015112055-777","1","2015-08-24 09:30:55",1440433855,"C4",385500,1440819355,"2015-08-28 20:35:55"
"2612","20153721083755-788","3","2015-08-24 09:46:23",1440434783,"C8",131654,1440566437,"2015-08-25 22:20:37"
"5272","20153521033513-856","2","2015-08-24 09:57:10",1440435430,"C2",238917,1440674347,"2015-08-27 04:19:07"
"913","20155525025541-454","1","2015-08-24 09:57:59",1440435479,"C5",367734,1440803213,"2015-08-28 16:06:53"
"3022","20153931123938-639","2","2015-08-24 11:20:50",1440440450,"C6",258609,1440699059,"2015-08-27 11:10:59"
"690","20153118123109-283","1","2015-08-24 13:12:26",1440447146,"C0",74411,1440521557,"2015-08-25 09:52:37"
"2125","20151023091027-655","3","2015-08-24 13:22:22",1440447742,"C2",101515,1440549257,"2015-08-25 17:34:17"
"4678","20151717061717-630","2","2015-08-24 13:24:05",1440447845,"C4",315204,1440763049,"2015-08-28 04:57:29"
"366","20155418075447-174","2","2015-08-24 14:44:17",1440452657,"C5",271485,1440724142,"2015-08-27 18:09:02"
"2558","20150209060231-719","1","2015-08-24 15:14:46",1440454486,"C8",1319907,1441774393,"2015-09-08 21:53:13"
"3821","20150602070645-93","1","2015-08-24 15:18:27",1440454707,"C5",643434,1441098141,"2015-09-01 02:02:21"
"6049","20150018110057-525","1","2015-08-24 15:31:42",1440455502,"C4",178215,1440633717,"2015-08-26 17:01:57"
"1216","20155820025827-627","2","2015-08-24 16:25:35",1440458735,"C5",175414,1440634149,"2015-08-26 17:09:09"
"2415","20150721010748-517","1","2015-08-24 17:07:39",1440461259,"C5",91197,1440552456,"2015-08-25 18:27:36"
"4076","20153412053414-307","3","2015-08-24 17:30:26",1440462626,"C6",172762,1440635388,"2015-08-26 17:29:48"
"4489","20154515054549-826","1","2015-08-24 18:01:04",1440464464,"C8",155703,1440620167,"2015-08-26 13:16:07"
"965","20150509020558-681","1","2015-08-24 18:03:34",1440464614,"C7",145584,1440610198,"2015-08-26 10:29:58"
"4813","20151614121612-952","1","2015-08-24 18:52:04",1440467524,"C6",110969,1440578493,"2015-08-26 01:41:33"
"3111","20153129013121-858","2","2015-08-24 19:15:36",1440468936,"C5",323865,1440792801,"2015-08-28 13:13:21"
"658","20152207072213-862","3","2015-08-24 19:39:22",1440470362,"C0",216147,1440686509,"2015-08-27 07:41:49"
"5555","20154614114643-419","1","2015-08-24 19:44:11",1440470651,"C8",446324,1440916975,"2015-08-29 23:42:55"
"4294","20151913121932-661","3","2015-08-24 20:02:14",1440471734,"C0",978162,1441449896,"2015-09-05 03:44:56"
"2596","20152122082127-299","1","2015-08-24 20:40:23",1440474023,"C7",108568,1440582591,"2015-08-26 02:49:51"
"5850","20152815022839-704","1","2015-08-24 21:02:53",1440475373,"C5",400627,1440876000,"2015-08-29 12:20:00"
"3322","20150115060113-519","3","2015-08-24 21:32:49",1440477169,"C2",277832,1440755001,"2015-08-28 02:43:21"
"5131","20150423040436-953","1","2015-08-24 21:36:10",1440477370,"C5",53147,1440530517,"2015-08-25 12:21:57"
"830","20152318102340-546","2","2015-08-25 00:04:31",1440486271,"C8",81093,1440567364,"2015-08-25 22:36:04"
"1536","20153223113254-722","1","2015-08-25 00:23:58",1440487438,"C3",66332,1440553770,"2015-08-25 18:49:30"
"2301","20151907011919-265","1","2015-08-25 00:52:45",1440489165,"C4",755203,1441244368,"2015-09-02 18:39:28"
"2993","20155318045348-403","2","2015-08-25 01:01:48",1440489708,"C3",182560,1440672268,"2015-08-27 03:44:28"
"3317","20150214070255-757","1","2015-08-25 01:02:22",1440489742,"C7",132681,1440622423,"2015-08-26 13:53:43"
"3191","20151507041515-490","1","2015-08-25 01:03:07",1440489787,"C3",187559,1440677346,"2015-08-27 05:09:06"
"4731","20150809060853-307","2","2015-08-25 01:10:08",1440490208,"C8",272895,1440763103,"2015-08-28 04:58:23"
"3668","20155009105054-571","2","2015-08-25 01:46:30",1440492390,"C2",674868,1441167258,"2015-09-01 21:14:18"
"1807","20152009032045-131","3","2015-08-25 02:34:17",1440495257,"C0",668206,1441163463,"2015-09-01 20:11:03"
"3685","20151721041729-734","1","2015-08-25 02:56:53",1440496613,"C0",99188,1440595801,"2015-08-26 06:30:01"
"788","20153022043047-509","2","2015-08-25 03:03:11",1440496991,"C0",70248,1440567239,"2015-08-25 22:33:59"
"5445","20153310053343-896","3","2015-08-25 03:07:59",1440497279,"C4",155507,1440652786,"2015-08-26 22:19:46"
"1331","20155618025650-853","1","2015-08-25 03:34:27",1440498867,"C4",80551,1440579418,"2015-08-26 01:56:58"
"4444","20153112113145-165","2","2015-08-25 04:09:39",1440500979,"C2",548337,1441049316,"2015-08-31 12:28:36"
"684","20154108034131-291","1","2015-08-25 04:11:39",1440501099,"C5",178426,1440679525,"2015-08-27 05:45:25"
"6459","20155813075840-171","2","2015-08-25 04:12:00",1440501120,"C2",462700,1440963820,"2015-08-30 12:43:40"
"1975","20155211075244-304","1","2015-08-25 04:15:58",1440501358,"C4",170942,1440672300,"2015-08-27 03:45:00"
"5485","20151415121445-482","1","2015-08-25 04:35:45",1440502545,"C5",418230,1440920775,"2015-08-30 00:46:15"
"6360","20155615035612-506","2","2015-08-25 04:36:44",1440502604,"C6",102904,1440605508,"2015-08-26 09:11:48"
"1069","20154319104353-504","3","2015-08-25 04:57:01",1440503821,"C8",71084,1440574905,"2015-08-26 00:41:45"
"2615","20155403015401-677","2","2015-08-25 05:40:17",1440506417,"C2",233897,1440740314,"2015-08-27 22:38:34"
"2249","20152207122249-225","3","2015-08-25 05:54:57",1440507297,"C4",191491,1440698788,"2015-08-27 11:06:28"
"193","20154731044702-403","1","2015-08-25 06:13:36",1440508416,"C8",303142,1440811558,"2015-08-28 18:25:58"
"3943","20155219075248-264","1","2015-08-25 06:22:06",1440508926,"C5",170986,1440679912,"2015-08-27 05:51:52"
"407","20155615105630-534","3","2015-08-25 06:33:35",1440509615,"C8",121175,1440630790,"2015-08-26 16:13:10"
"4483","20150619060603-933","1","2015-08-25 06:36:33",1440509793,"C8",639726,1441149519,"2015-09-01 16:18:39"
"2992","20153311113346-259","1","2015-08-25 06:49:20",1440510560,"C4",170362,1440680922,"2015-08-27 06:08:42"
"4412","20153023053020-213","2","2015-08-25 06:52:20",1440510740,"C7",67260,1440578000,"2015-08-26 01:33:20"
"5517","20151511111500-654","3","2015-08-25 07:25:28",1440512728,"C7",597914,1441110642,"2015-09-01 05:30:42"
"2829","20154515064509-76","2","2015-08-25 08:06:24",1440515184,"C5",289625,1440804809,"2015-08-28 16:33:29"
"5895","20152208112234-845","1","2015-08-25 08:15:36",1440515736,"C8",728791,1441244527,"2015-09-02 18:42:07"
"6260","20155616035612-493","1","2015-08-25 08:18:15",1440515895,"C8",489789,1441005684,"2015-08-31 00:21:24"
"362","20150526110553-791","2","2015-08-25 08:25:14",1440516314,"C4",1724787,1442241101,"2015-09-14 07:31:41"
"775","20153920073940-995","1","2015-08-25 09:33:52",1440520432,"C8",219426,1440739858,"2015-08-27 22:30:58"
"6263","20151220061227-950","1","2015-08-25 09:37:12",1440520632,"C8",88857,1440609489,"2015-08-26 10:18:09"
"119","20153723103750-402","3","2015-08-25 09:49:09",1440521349,"C0",169879,1440691228,"2015-08-27 09:00:28"
"5836","20154420094443-603","3","2015-08-25 09:53:07",1440521587,"C6",72084,1440593671,"2015-08-26 05:54:31"
"6442","20150210100228-734","1","2015-08-25 10:01:01",1440522061,"C2",431971,1440954032,"2015-08-30 10:00:32"
"5216","20153624073607-630","3","2015-08-25 10:23:08",1440523388,"C4",96421,1440619809,"2015-08-26 13:10:09"
"2963","20151723051709-947","1","2015-08-25 10:25:42",1440523542,"C2",49371,1440572913,"2015-08-26 00:08:33"
"5906","20150411110416-875","1","2015-08-25 10:52:11",1440525131,"C4",555325,1441080456,"2015-08-31 21:07:36"
"1253","20155010025035-931","3","2015-08-25 11:56:11",1440528971,"C5",183648,1440712619,"2015-08-27 14:56:59"
"3730","20151116121132-353","1","2015-08-25 13:11:38",1440533498,"C2",260402,1440793900,"2015-08-28 13:31:40"
"468","20151329101325-617","2","2015-08-25 13:30:29",1440534629,"C5",293078,1440827707,"2015-08-28 22:55:07"
"2928","20153123053121-598","2","2015-08-25 14:10:15",1440537015,"C0",80367,1440617382,"2015-08-26 12:29:42"
"583","20152023022026-39","1","2015-08-25 14:26:28",1440537988,"C7",86581,1440624569,"2015-08-26 14:29:29"
"5170","20153223063219-462","1","2015-08-25 14:28:12",1440538092,"C6",201353,1440739445,"2015-08-27 22:24:05"
"3671","20153220053251-142","3","2015-08-25 14:34:31",1440538471,"C8",619940,1441158411,"2015-09-01 18:46:51"
"782","20154918094949-366","1","2015-08-25 15:31:15",1440541875,"C2",625286,1441167161,"2015-09-01 21:12:41"
"3919","20150223060208-554","3","2015-08-25 15:39:06",1440542346,"C7",103709,1440646055,"2015-08-26 20:27:35"
"5995","20152822122853-937","2","2015-08-25 16:51:03",1440546663,"C4",274930,1440821593,"2015-08-28 21:13:13"
"1269","20153224043244-563","1","2015-08-25 16:57:24",1440547044,"C2",87880,1440634924,"2015-08-26 17:22:04"
"1382","20152619072610-850","2","2015-08-25 17:24:26",1440548666,"C2",554296,1441102962,"2015-09-01 03:22:42"
"1129","20154812014855-638","2","2015-08-25 17:51:27",1440550287,"C2",142219,1440692506,"2015-08-27 09:21:46"
"1546","20155621035652-898","2","2015-08-25 18:01:56",1440550916,"C8",176552,1440727468,"2015-08-27 19:04:28"
"2433","20153631043604-397","2","2015-08-25 18:39:32",1440553172,"C5",270926,1440824098,"2015-08-28 21:54:58"
"4081","20152220092213-786","3","2015-08-25 18:53:05",1440553985,"C2",466252,1441020237,"2015-08-31 04:23:57"
"2933","20153222073210-586","1","2015-08-25 18:56:21",1440554181,"C4",300251,1440854432,"2015-08-29 06:20:32"
"38","20155520105535-51","1","2015-08-25 19:58:06",1440557886,"C8",448993,1441006879,"2015-08-31 00:41:19"
"3354","20151025061010-490","2","2015-08-25 20:10:40",1440558640,"C2",532083,1441090723,"2015-08-31 23:58:43"
"2986","20151705091722-67","3","2015-08-25 20:17:54",1440559074,"C5",555754,1441114828,"2015-09-01 06:40:28"
"1429","20153906043931-40","2","2015-08-25 20:50:12",1440561012,"C8",236663,1440797675,"2015-08-28 14:34:35"
"189","20153115123154-557","1","2015-08-25 20:51:32",1440561092,"C4",446989,1441008081,"2015-08-31 01:01:21"
"942","20152919022949-193","2","2015-08-25 22:28:47",1440566927,"C5",273569,1440840496,"2015-08-29 02:28:16"
"5246","20152819072857-484","2","2015-08-25 22:32:49",1440567169,"C2",730379,1441297548,"2015-09-03 09:25:48"
"5632","20153216013236-330","2","2015-08-25 22:45:42",1440567942,"C5",405393,1440973335,"2015-08-30 15:22:15"
"4425","20152202052214-494","1","2015-08-25 23:01:58",1440568918,"C4",585748,1441154666,"2015-09-01 17:44:26"
"2059","20150723030707-46","2","2015-08-25 23:50:19",1440571819,"C2",68064,1440639883,"2015-08-26 18:44:43"
"4724","20152021072036-530","2","2015-08-26 01:21:52",1440577312,"C8",205238,1440782550,"2015-08-28 10:22:30"
"1776","20155620045633-63","3","2015-08-26 02:59:45",1440583185,"C4",156064,1440739249,"2015-08-27 22:20:49"
"4371","20155417105422-842","1","2015-08-26 03:29:34",1440584974,"C4",93864,1440678838,"2015-08-27 05:33:58"
"5982","20153721043705-857","2","2015-08-26 03:35:47",1440585347,"C4",192561,1440777908,"2015-08-28 09:05:08"
"3258","20150121030143-599","1","2015-08-26 03:42:53",1440585773,"C5",195635,1440781408,"2015-08-28 10:03:28"
"6298","20154906094920-919","1","2015-08-26 03:56:56",1440586616,"C3",213357,1440799973,"2015-08-28 15:12:53"
"2070","20155022075049-151","3","2015-08-26 05:26:29",1440591989,"C1",168470,1440760459,"2015-08-28 04:14:19"
"4609","20154519024544-322","False","2015-08-26 05:30:23",1440592223,"C4",200923,1440793146,"2015-08-28 13:19:06"
"1693","20150023030012-350","3","2015-08-26 05:45:12",1440593112,"C7",112950,1440706062,"2015-08-27 13:07:42"
"2447","20151416101425-25","2","2015-08-26 06:16:21",1440594981,"C5",424858,1441019839,"2015-08-31 04:17:19"
"1302","20152701112759-138","1","2015-08-26 06:17:25",1440595045,"C7",688538,1441283583,"2015-09-03 05:33:03"
"618","20152202022209-169","1","2015-08-26 06:50:45",1440597045,"C0",674988,1441272033,"2015-09-03 02:20:33"
"5514","20155717125750-508","1","2015-08-26 06:55:02",1440597302,"C2",377916,1440975218,"2015-08-30 15:53:38"
"2975","20152415082432-673","2","2015-08-26 07:25:20",1440599120,"C8",473424,1441072544,"2015-08-31 18:55:44"
"952","20154025094008-773","2","2015-08-26 08:02:06",1440601326,"C4",80518,1440681844,"2015-08-27 06:24:04"
"737","20154513024507-271","1","2015-08-26 08:10:47",1440601847,"C4",1099540,1441701387,"2015-09-08 01:36:27"
"92","20152125092114-567","1","2015-08-26 08:18:10",1440602290,"C5",345127,1440947417,"2015-08-30 08:10:17"
"4083","20155724015758-338","2","2015-08-26 08:25:22",1440602722,"C5",76422,1440679144,"2015-08-27 05:39:04"
"813","20152522062547-875","1","2015-08-26 09:08:05",1440605285,"C2",355338,1440960623,"2015-08-30 11:50:23"
"3019","20152424042420-968","1","2015-08-26 09:28:17",1440606497,"C5",49279,1440655776,"2015-08-26 23:09:36"
"2701","20152719102718-287","1","2015-08-26 09:32:58",1440606778,"C2",601540,1441208318,"2015-09-02 08:38:38"
"888","20154023064009-80","1","2015-08-26 09:37:30",1440607050,"C2",269841,1440876891,"2015-08-29 12:34:51"
"1589","20151714081717-477","3","2015-08-26 09:40:45",1440607245,"C5",130226,1440737471,"2015-08-27 21:51:11"
"2861","20152322022341-751","2","2015-08-26 09:58:47",1440608327,"C6",54951,1440663278,"2015-08-27 01:14:38"
"3672","20152720112739-23","1","2015-08-26 10:12:17",1440609137,"C4",256939,1440866076,"2015-08-29 09:34:36"
"6373","20154524044536-939","3","2015-08-26 10:15:56",1440609356,"C4",74710,1440684066,"2015-08-27 07:01:06"
"3623","20154222034228-99","1","2015-08-26 14:14:38",1440623678,"C8",170165,1440793843,"2015-08-28 13:30:43"
"983","20151420051444-405","2","2015-08-26 14:15:54",1440623754,"C2",253835,1440877589,"2015-08-29 12:46:29"
"5001","20154115124146-703","3","2015-08-26 15:54:52",1440629692,"C4",320662,1440950354,"2015-08-30 08:59:14"
"2601","20154618074635-802","2","2015-08-26 16:29:25",1440631765,"C6",722570,1441354335,"2015-09-04 01:12:15"
"1643","20151625021627-767","2","2015-08-26 16:55:37",1440633337,"C4",95950,1440729287,"2015-08-27 19:34:47"
"1507","20151711071703-72","1","2015-08-26 17:24:28",1440635068,"C8",266489,1440901557,"2015-08-29 19:25:57"
"2961","20151113081103-202","1","2015-08-26 18:46:13",1440639973,"C5",548530,1441188503,"2015-09-02 03:08:23"
"5554","20152106052156-327","1","2015-08-26 19:22:50",1440642170,"C6",1167609,1441809779,"2015-09-09 07:42:59"
"1362","20152425092455-910","1","2015-08-26 19:38:15",1440643095,"C2",123200,1440766295,"2015-08-28 05:51:35"
"421","20154421024437-278","2","2015-08-26 19:45:27",1440643527,"C0",450050,1441093577,"2015-09-01 00:46:17"
"5372","20151502101538-958","1","2015-08-26 20:03:03",1440644583,"C8",421769,1441066352,"2015-08-31 17:12:32"
"1783","20150322110349-365","1","2015-08-26 20:04:15",1440644655,"C2",189013,1440833668,"2015-08-29 00:34:28"
"3228","20155624045618-21","1","2015-08-26 20:20:58",1440645658,"C0",681935,1441327593,"2015-09-03 17:46:33"
"5433","20153130073133-253","3","2015-08-26 20:31:17",1440646277,"C0",621448,1441267725,"2015-09-03 01:08:45"
"1470","20155220085241-907","1","2015-08-26 20:33:36",1440646416,"C8",80065,1440726481,"2015-08-27 18:48:01"
"4542","20153925013947-835","3","2015-08-26 20:55:30",1440647730,"C4",112543,1440760273,"2015-08-28 04:11:13"
"2224","20152814122805-968","2","2015-08-26 20:58:55",1440647935,"C0",533725,1441181660,"2015-09-02 01:14:20"
"253","20155101045148-763","2","2015-08-26 21:39:20",1440650360,"C5",311036,1440961396,"2015-08-30 12:03:16"
"5355","20155418015419-112","1","2015-08-26 21:40:11",1440650411,"C7",359576,1441009987,"2015-08-31 01:33:07"
"4525","20150114070109-176","2","2015-08-26 23:14:45",1440656085,"C5",136902,1440792987,"2015-08-28 13:16:27"
"674","20154018114036-212","1","2015-08-26 23:26:57",1440656817,"C3",1137327,1441794144,"2015-09-09 03:22:24"
"1395","20152723012751-951","1","2015-08-27 00:30:33",1440660633,"C4",149481,1440810114,"2015-08-28 18:01:54"
"28","20153024053044-807","2","2015-08-27 01:26:35",1440663995,"C2",67117,1440731112,"2015-08-27 20:05:12"
"3390","20154728064727-282","3","2015-08-27 01:48:28",1440665308,"C5",367723,1441033031,"2015-08-31 07:57:11"
"785","20150017120055-53","2","2015-08-27 01:49:53",1440665393,"C3",413669,1441079062,"2015-08-31 20:44:22"
"4087","20150415020406-610","3","2015-08-27 02:08:21",1440666501,"C8",198771,1440865272,"2015-08-29 09:21:12"
"1418","20150129070156-888","1","2015-08-27 02:13:54",1440666834,"C4",355474,1441022308,"2015-08-31 04:58:28"
"574","20155320075307-202","1","2015-08-27 03:32:21",1440671541,"C5",294577,1440966118,"2015-08-30 13:21:58"
"744","20151521031525-991","1","2015-08-27 03:32:29",1440671549,"C2",238112,1440909661,"2015-08-29 21:41:01"
"3249","20153620083607-408","1","2015-08-27 04:19:35",1440674375,"C6",73676,1440748051,"2015-08-28 00:47:31"
"275","20155303125317-749","1","2015-08-27 04:19:56",1440674396,"C4",674457,1441348853,"2015-09-03 23:40:53"
"3735","20155824015823-693","1","2015-08-27 05:28:08",1440678488,"C2",968995,1441647483,"2015-09-07 10:38:03"
"4192","20150922090902-582","3","2015-08-27 05:34:23",1440678863,"C7",344169,1441023032,"2015-08-31 05:10:32"
"3748","20155825095843-923","2","2015-08-27 06:22:19",1440681739,"C0",79908,1440761647,"2015-08-28 04:34:07"
"4893","20155822095826-155","2","2015-08-27 07:20:26",1440685226,"C8",211260,1440896486,"2015-08-29 18:01:26"
"1712","20153912093939-687","1","2015-08-27 07:20:31",1440685231,"C4",643826,1441329057,"2015-09-03 18:10:57"
"153","20154015074020-606","2","2015-08-27 07:29:55",1440685795,"C6",1036175,1441721970,"2015-09-08 07:19:30"
"5340","20151625021614-449","1","2015-08-27 07:50:54",1440687054,"C0",677510,1441364564,"2015-09-04 04:02:44"
"3034","20153711063717-524","1","2015-08-27 07:52:48",1440687168,"C5",198133,1440885301,"2015-08-29 14:55:01"
"5130","20154320094352-113","3","2015-08-27 08:54:31",1440690871,"C8",85977,1440776848,"2015-08-28 08:47:28"
"2127","20155919125917-79","2","2015-08-27 09:10:59",1440691859,"C0",96786,1440788645,"2015-08-28 12:04:05"
"1826","20154222064210-989","2","2015-08-27 09:54:48",1440694488,"C4",221779,1440916267,"2015-08-29 23:31:07"
"6266","20154716064735-828","3","2015-08-27 10:29:54",1440696594,"C8",137677,1440834271,"2015-08-29 00:44:31"
"357","20153629093635-690","3","2015-08-27 10:36:47",1440697007,"C6",850202,1441547209,"2015-09-06 06:46:49"
"4742","20152014122034-385","1","2015-08-27 10:56:52",1440698212,"C6",632763,1441330975,"2015-09-03 18:42:55"
"5623","20152813042852-20","2","2015-08-27 11:22:43",1440699763,"C0",397077,1441096840,"2015-09-01 01:40:40"
"984","20151924061918-27","2","2015-08-27 12:24:56",1440703496,"C5",140569,1440844065,"2015-08-29 03:27:45"
"1662","20153509113502-414","1","2015-08-27 12:35:10",1440704110,"C4",194851,1440898961,"2015-08-29 18:42:41"
"6014","20151514121511-340","2","2015-08-27 12:43:21",1440704601,"C8",760658,1441465259,"2015-09-05 08:00:59"
"1218","20153819103829-614","1","2015-08-27 13:01:09",1440705669,"C6",422270,1441127939,"2015-09-01 10:18:59"
"2776","20154223044243-199","2","2015-08-27 13:17:07",1440706627,"C6",55544,1440762171,"2015-08-28 04:42:51"
"4533","20154423044431-936","2","2015-08-27 13:50:14",1440708614,"C0",335143,1441043757,"2015-08-31 10:55:57"
"2834","20155308105343-910","1","2015-08-27 14:29:23",1440710963,"C8",330908,1441041871,"2015-08-31 10:24:31"
"4071","20155925095934-285","2","2015-08-27 15:12:14",1440713534,"C5",95780,1440809314,"2015-08-28 17:48:34"
"3053","20150223080232-126","2","2015-08-27 15:41:56",1440715316,"C4",186582,1440901898,"2015-08-29 19:31:38"
"2911","20150715010737-325","3","2015-08-27 15:49:39",1440715779,"C2",523261,1441239040,"2015-09-02 17:10:40"
"5719","20153521053544-115","3","2015-08-27 15:50:42",1440715842,"C8",256049,1440971891,"2015-08-30 14:58:11"
"6","20155924055911-559","1","2015-08-27 16:41:35",1440718895,"C3",254544,1440973439,"2015-08-30 15:23:59"
"1313","20150917020950-55","3","2015-08-27 16:50:28",1440719428,"C8",436819,1441156247,"2015-09-01 18:10:47"
"489","20152325032338-563","2","2015-08-27 17:18:38",1440721118,"C0",179700,1440900818,"2015-08-29 19:13:38"
"2828","20151724031732-555","1","2015-08-27 18:05:10",1440723910,"C7",421094,1441145004,"2015-09-01 15:03:24"
"3604","20151523031533-237","1","2015-08-27 20:58:03",1440734283,"C6",61025,1440795308,"2015-08-28 13:55:08"
"4082","20152507082537-2","1","2015-08-27 21:10:22",1440735022,"C8",354777,1441089799,"2015-08-31 23:43:19"
"1552","20153124063149-216","1","2015-08-27 21:47:43",1440737263,"C3",104718,1440841981,"2015-08-29 02:53:01"
"2952","20150024010045-514","3","2015-08-27 21:53:38",1440737618,"C6",291173,1441028791,"2015-08-31 06:46:31"
"2972","20154007124035-405","2","2015-08-27 22:04:42",1440738282,"C3",634321,1441372603,"2015-09-04 06:16:43"
"4715","20150121060147-159","1","2015-08-27 22:21:27",1440739287,"C8",288590,1441027877,"2015-08-31 06:31:17"
"3493","20152031042004-676","2","2015-08-27 22:44:35",1440740675,"C4",336553,1441077228,"2015-08-31 20:13:48"
"2037","20155029035009-826","1","2015-08-27 23:05:06",1440741906,"C8",361671,1441103577,"2015-09-01 03:32:57"
"1393","20152224012227-459","3","2015-08-27 23:33:55",1440743635,"C5",371786,1441115421,"2015-09-01 06:50:21"
"3833","20150316010332-387","1","2015-08-28 00:22:12",1440746532,"C2",458690,1441205222,"2015-09-02 07:47:02"
"4368","20150804090809-57","2","2015-08-28 00:40:33",1440747633,"C2",255393,1441003026,"2015-08-30 23:37:06"
"3974","20152219112242-277","1","2015-08-28 01:44:56",1440751496,"C4",371467,1441122963,"2015-09-01 08:56:03"
"3172","20154809114818-832","1","2015-08-28 02:44:15",1440755055,"C7",178773,1440933828,"2015-08-30 04:23:48"
"347","20154122034142-353","2","2015-08-28 02:46:10",1440755170,"C8",235934,1440991104,"2015-08-30 20:18:24"
"6191","20154422124407-513","1","2015-08-28 03:29:49",1440757789,"C0",242571,1441000360,"2015-08-30 22:52:40"
"3874","20152004122028-933","1","2015-08-28 03:31:00",1440757860,"C5",590029,1441347889,"2015-09-03 23:24:49"
"5720","20155114015106-386","2","2015-08-28 04:01:24",1440759684,"C6",195703,1440955387,"2015-08-30 10:23:07"
"6152","20150822040817-521","3","2015-08-28 05:46:52",1440766012,"C8",96223,1440862235,"2015-08-29 08:30:35"
"3013","20154021074026-934","1","2015-08-28 05:47:18",1440766038,"C8",299006,1441065044,"2015-08-31 16:50:44"
"3433","20153123063116-913","2","2015-08-28 06:01:34",1440766894,"C5",215109,1440982003,"2015-08-30 17:46:43"
"3450","20152102122135-146","2","2015-08-28 06:31:59",1440768719,"C2",612978,1441381697,"2015-09-04 08:48:17"
"299","20154408044436-655","2","2015-08-28 07:03:40",1440770620,"C5",846572,1441617192,"2015-09-07 02:13:12"
"4638","20152221092251-883","2","2015-08-28 07:37:33",1440772653,"C7",299241,1441071894,"2015-08-31 18:44:54"
"6164","20150527100509-549","2","2015-08-28 07:59:46",1440773986,"C6",78877,1440852863,"2015-08-29 05:54:23"
"5614","20155704015757-89","1","2015-08-28 08:03:57",1440774237,"C3",591345,1441365582,"2015-09-04 04:19:42"
"3838","20153014053026-5","1","2015-08-28 08:14:21",1440774861,"C8",770927,1441545788,"2015-09-06 06:23:08"
"4005","20153129033116-421","1","2015-08-28 08:28:36",1440775716,"C4",320830,1441096546,"2015-09-01 01:35:46"
"3664","20152225022204-845","1","2015-08-28 08:51:52",1440777112,"C2",79796,1440856908,"2015-08-29 07:01:48"
"2502","20150521040525-743","1","2015-08-28 09:13:17",1440778397,"C4",72509,1440850906,"2015-08-29 05:21:46"
"1308","20150624120647-627","3","2015-08-28 09:23:53",1440779033,"C6",502371,1441281404,"2015-09-03 04:56:44"
"4074","20154527054509-903","1","2015-08-28 09:37:41",1440779861,"C3",341944,1441121805,"2015-09-01 08:36:45"
"4574","20153317043306-904","3","2015-08-28 11:20:51",1440786051,"C8",133095,1440919146,"2015-08-30 00:19:06"
"1044","20152925102939-681","1","2015-08-28 11:41:03",1440787263,"C3",87828,1440875091,"2015-08-29 12:04:51"
"3159","20151122021140-914","1","2015-08-28 11:41:48",1440787308,"C0",63676,1440850984,"2015-08-29 05:23:04"
"2054","20155323065317-442","1","2015-08-28 11:42:57",1440787377,"C3",224690,1441012067,"2015-08-31 02:07:47"
"3261","20150907070922-234","1","2015-08-28 12:14:18",1440789258,"C0",563887,1441353145,"2015-09-04 00:52:25"
"245","20152919082940-780","2","2015-08-28 12:21:56",1440789716,"C4",395768,1441185484,"2015-09-02 02:18:04"
"5713","20150627100641-287","1","2015-08-28 12:47:15",1440791235,"C2",96034,1440887269,"2015-08-29 15:27:49"
"5223","20150024120056-588","1","2015-08-28 13:27:32",1440793652,"C3",175398,1440969050,"2015-08-30 14:10:50"
"2418","20153430083434-174","1","2015-08-28 13:29:59",1440793799,"C0",360475,1441154274,"2015-09-01 17:37:54"
"4752","20155926125912-498","2","2015-08-28 13:40:46",1440794446,"C4",87647,1440882093,"2015-08-29 14:01:33"
"2449","20150426010444-611","1","2015-08-28 13:50:58",1440795058,"C7",87787,1440882845,"2015-08-29 14:14:05"
"4860","20154120094138-417","2","2015-08-28 13:54:40",1440795280,"C0",353191,1441148471,"2015-09-01 16:01:11"
"315","20153624093600-684","1","2015-08-28 14:00:08",1440795608,"C5",379981,1441175589,"2015-09-01 23:33:09"
"3021","20153012083040-807","1","2015-08-28 14:10:37",1440796237,"C4",1402797,1442199034,"2015-09-13 19:50:34"
"1286","20151501071532-943","3","2015-08-28 14:20:59",1440796859,"C3",786109,1441582968,"2015-09-06 16:42:48"
"1612","20151518031527-459","2","2015-08-28 14:33:18",1440797598,"C6",861471,1441659069,"2015-09-07 13:51:09"
"80","20152424092415-398","2","2015-08-28 14:43:27",1440798207,"C3",182376,1440980583,"2015-08-30 17:23:03"
"5029","20152017102041-706","3","2015-08-28 15:10:25",1440799825,"C0",120973,1440920798,"2015-08-30 00:46:38"
"1053","20153024123008-70","1","2015-08-28 15:53:48",1440802428,"C5",178910,1440981338,"2015-08-30 17:35:38"
"5270","20150227060225-629","2","2015-08-28 16:19:54",1440803994,"C4",123449,1440927443,"2015-08-30 02:37:23"
"5524","20155304125320-819","1","2015-08-28 16:33:44",1440804824,"C2",260853,1441065677,"2015-08-31 17:01:17"
"367","20154330014342-384","2","2015-08-28 16:55:38",1440806138,"C8",359588,1441165726,"2015-09-01 20:48:46"
"2634","20150307050341-35","3","2015-08-28 16:58:12",1440806292,"C7",259153,1441065445,"2015-08-31 16:57:25"
"3636","20150002120037-795","1","2015-08-28 18:09:17",1440810557,"C5",283565,1441094122,"2015-09-01 00:55:22"
"1464","20150720100758-108","2","2015-08-28 18:34:05",1440812045,"C7",103081,1440915126,"2015-08-29 23:12:06"
"6283","20154201094221-490","3","2015-08-28 19:14:24",1440814464,"C7",720789,1441535253,"2015-09-06 03:27:33"
"2598","20155526015529-809","1","2015-08-28 20:04:55",1440817495,"C5",97483,1440914978,"2015-08-29 23:09:38"
"3752","20152122042102-592","3","2015-08-28 20:44:44",1440819884,"C7",267111,1441086995,"2015-08-31 22:56:35"
"1010","20152801102848-547","2","2015-08-28 20:56:56",1440820616,"C2",296311,1441116927,"2015-09-01 07:15:27"
"5374","20150906030915-616","1","2015-08-28 21:46:45",1440823605,"C3",962325,1441785930,"2015-09-09 01:05:30"
"321","20155305065314-246","1","2015-08-28 23:00:50",1440828050,"C3",255657,1441083707,"2015-08-31 22:01:47"
"5097","20155622015608-652","1","2015-08-28 23:12:24",1440828744,"C5",403772,1441232516,"2015-09-02 15:21:56"
"3626","20152012032040-682","2","2015-08-29 00:15:05",1440832505,"C0",584695,1441417200,"2015-09-04 18:40:00"
"2985","20150212030241-721","2","2015-08-29 00:55:29",1440834929,"C3",512046,1441346975,"2015-09-03 23:09:35"
"5293","20152430012458-590","1","2015-08-29 01:41:16",1440837676,"C2",364254,1441201930,"2015-09-02 06:52:10"
"5275","20155218085224-640","2","2015-08-29 02:30:33",1440840633,"C8",515127,1441355760,"2015-09-04 01:36:00"
"1760","20150224010242-67","1","2015-08-29 02:52:52",1440841972,"C8",197705,1441039677,"2015-08-31 09:47:57"
"4276","20154514114507-203","3","2015-08-29 03:26:59",1440844019,"C4",633056,1441477075,"2015-09-05 11:17:55"
"5187","20150109100114-5","3","2015-08-29 03:31:30",1440844290,"C5",213077,1441057367,"2015-08-31 14:42:47"
"3286","20150721050735-636","3","2015-08-29 05:26:45",1440851205,"C8",129830,1440981035,"2015-08-30 17:30:35"
"3025","20154212104211-65","1","2015-08-29 05:27:14",1440851234,"C4",207129,1441058363,"2015-08-31 14:59:23"
"1681","20153803043831-603","2","2015-08-29 05:50:31",1440852631,"C8",315360,1441167991,"2015-09-01 21:26:31"
"6530","20151722061712-453","1","2015-08-29 05:54:14",1440852854,"C5",301711,1441154565,"2015-09-01 17:42:45"
"5582","20155904105919-416","1","2015-08-29 05:58:49",1440853129,"C8",428394,1441281523,"2015-09-03 04:58:43"
"875","20152826112825-682","3","2015-08-29 06:23:37",1440854617,"C8",120456,1440975073,"2015-08-30 15:51:13"
"6159","20150214060215-80","3","2015-08-29 06:25:39",1440854739,"C8",567972,1441422711,"2015-09-04 20:11:51"
"5837","20150807080814-971","1","2015-08-29 06:54:54",1440856494,"C8",379280,1441235774,"2015-09-02 16:16:14"
"1092","20154627014626-335","2","2015-08-29 06:57:01",1440856621,"C0",403805,1441260426,"2015-09-02 23:07:06"
"2208","20153122113109-139","3","2015-08-29 07:00:13",1440856813,"C2",294272,1441151085,"2015-09-01 16:44:45"
"301","20150424020445-861","2","2015-08-29 07:10:43",1440857443,"C8",203579,1441061022,"2015-08-31 15:43:42"
"5167","20151709101746-425","1","2015-08-29 08:03:03",1440860583,"C5",628331,1441488914,"2015-09-05 14:35:14"
"3818","20150122110107-735","2","2015-08-29 08:11:19",1440861079,"C4",297306,1441158385,"2015-09-01 18:46:25"
"2592","20151317041326-366","1","2015-08-29 08:27:18",1440862038,"C5",784904,1441646942,"2015-09-07 10:29:02"
"5767","20151412091419-116","1","2015-08-29 08:51:47",1440863507,"C0",518231,1441381738,"2015-09-04 08:48:58"
"4936","20154623094608-73","2","2015-08-29 09:00:10",1440864010,"C7",257821,1441121831,"2015-09-01 08:37:11"
"1265","20151620061621-385","1","2015-08-29 09:00:39",1440864039,"C4",393729,1441257768,"2015-09-02 22:22:48"
"3040","20150227050213-13","1","2015-08-29 09:35:53",1440866153,"C7",73010,1440939163,"2015-08-30 05:52:43"
"3133","20150303100335-568","2","2015-08-29 09:53:19",1440867199,"C3",615523,1441482722,"2015-09-05 12:52:02"
"88","20155627105645-424","3","2015-08-29 09:58:03",1440867483,"C5",84639,1440952122,"2015-08-30 09:28:42"
"736","20150421090407-354","2","2015-08-29 10:36:25",1440869785,"C7",99534,1440969319,"2015-08-30 14:15:19"
"3539","20155813025810-185","3","2015-08-29 11:50:10",1440874210,"C4",171390,1441045600,"2015-08-31 11:26:40"
"2008","20152505102515-978","1","2015-08-29 12:13:37",1440875617,"C5",679786,1441555403,"2015-09-06 09:03:23"
"1342","20151626071648-759","1","2015-08-29 12:20:08",1440876008,"C5",138700,1441014708,"2015-08-31 02:51:48"
"4236","20150610080607-677","1","2015-08-29 13:01:43",1440878503,"C6",207417,1441085920,"2015-08-31 22:38:40"
"5797","20154518064540-758","1","2015-08-29 13:08:22",1440878902,"C3",486681,1441365583,"2015-09-04 04:19:43"
"5994","20150019010055-677","1","2015-08-29 13:11:19",1440879079,"C4",288208,1441167287,"2015-09-01 21:14:47"
"4397","20153926083902-744","2","2015-08-29 13:37:34",1440880654,"C6",277112,1441157766,"2015-09-01 18:36:06"
"6168","20150724060708-783","2","2015-08-29 13:58:50",1440881930,"C5",230151,1441112081,"2015-09-01 05:54:41"
"1254","20150329020331-802","2","2015-08-29 15:29:15",1440887355,"C4",659443,1441546798,"2015-09-06 06:39:58"
"2321","20150223110259-667","1","2015-08-29 15:41:20",1440888080,"C2",76443,1440964523,"2015-08-30 12:55:23"
"2406","20155618075600-258","1","2015-08-29 16:01:36",1440889296,"C4",122442,1441011738,"2015-08-31 02:02:18"
"5787","20152119062102-718","1","2015-08-29 16:47:35",1440892055,"C4",128799,1441020854,"2015-08-31 04:34:14"
"132","20155227095221-937","1","2015-08-29 16:54:13",1440892453,"C4",198112,1441090565,"2015-08-31 23:56:05"
"2368","20155427055429-500","1","2015-08-29 17:02:17",1440892937,"C7",84834,1440977771,"2015-08-30 16:36:11"
"3758","20150123100107-508","1","2015-08-29 17:06:32",1440893192,"C8",108785,1441001977,"2015-08-30 23:19:37"
"5669","20152826092847-177","1","2015-08-29 18:03:53",1440896633,"C5",96702,1440993335,"2015-08-30 20:55:35"
"719","20151411031453-479","2","2015-08-29 18:51:11",1440899471,"C2",522726,1441422197,"2015-09-04 20:03:17"
"793","20153603053623-213","1","2015-08-29 19:14:07",1440900847,"C5",321752,1441222599,"2015-09-02 12:36:39"
"661","20154104054114-147","1","2015-08-29 19:34:50",1440902090,"C4",605652,1441507742,"2015-09-05 19:49:02"
"2376","20151409101410-293","2","2015-08-29 20:00:38",1440903638,"C4",251884,1441155522,"2015-09-01 17:58:42"
"1496","20154311034317-220","1","2015-08-29 20:17:12",1440904632,"C8",314327,1441218959,"2015-09-02 11:35:59"
"3089","20153326053328-53","1","2015-08-29 20:20:19",1440904819,"C4",89737,1440994556,"2015-08-30 21:15:56"
"2659","20150825110832-749","1","2015-08-29 21:02:43",1440907363,"C5",437093,1441344456,"2015-09-03 22:27:36"
"202","20155531065512-853","2","2015-08-29 21:08:17",1440907697,"C3",365255,1441272952,"2015-09-03 02:35:52"
"3297","20154124024130-878","1","2015-08-29 21:28:22",1440908902,"C5",228206,1441137108,"2015-09-01 12:51:48"
"1206","20151728041704-292","1","2015-08-29 22:07:40",1440911260,"C0",107436,1441018696,"2015-08-31 03:58:16"
"5531","20150827120843-66","1","2015-08-29 22:31:37",1440912697,"C4",105087,1441017784,"2015-08-31 03:43:04"
"3951","20151322091316-1","2","2015-08-29 22:47:53",1440913673,"C8",476011,1441389684,"2015-09-04 11:01:24"
"486","20150503080511-131","2","2015-08-29 22:53:53",1440914033,"C6",383287,1441297320,"2015-09-03 09:22:00"
"5452","20153827023814-492","1","2015-08-29 23:19:00",1440915540,"C8",411778,1441327318,"2015-09-03 17:41:58"
"2412","20151624101641-279","3","2015-08-30 00:08:36",1440918516,"C8",68845,1440987361,"2015-08-30 19:16:01"
"6058","20152726012729-506","2","2015-08-30 00:30:05",1440919805,"C8",149478,1441069283,"2015-08-31 18:01:23"
"4018","20155327095347-642","1","2015-08-30 00:54:47",1440921287,"C5",75620,1440996907,"2015-08-30 21:55:07"
"2978","20154323084319-194","2","2015-08-30 01:54:55",1440924895,"C5",290148,1441215043,"2015-09-02 10:30:43"
"6127","20150914080950-53","1","2015-08-30 02:37:42",1440927462,"C5",170309,1441097771,"2015-09-01 01:56:11"
"3244","20151413091400-23","3","2015-08-30 03:07:35",1440929255,"C8",289363,1441218618,"2015-09-02 11:30:18"
"2243","20155308025321-11","1","2015-08-30 04:03:29",1440932609,"C5",930904,1441863513,"2015-09-09 22:38:33"
"5754","20151712081746-902","3","2015-08-30 05:45:31",1440938731,"C0",515355,1441454086,"2015-09-05 04:54:46"
"3176","20153115083101-873","1","2015-08-30 07:19:19",1440944359,"C6",215283,1441159642,"2015-09-01 19:07:22"
"224","20154024034000-968","2","2015-08-30 07:41:48",1440945708,"C3",244854,1441190562,"2015-09-02 03:42:42"
"3257","20155920065907-68","2","2015-08-30 08:27:29",1440948449,"C7",124186,1441072635,"2015-08-31 18:57:15"
"5831","20155631105647-912","2","2015-08-30 08:48:35",1440949715,"C6",430718,1441380433,"2015-09-04 08:27:13"
"5299","20155123015147-690","2","2015-08-30 08:50:20",1440949820,"C5",195571,1441145391,"2015-09-01 15:09:51"
"5378","20150920110938-724","2","2015-08-30 09:41:08",1440952868,"C3",429345,1441382213,"2015-09-04 08:56:53"
"5908","20153228043201-577","2","2015-08-30 10:08:01",1440954481,"C2",353520,1441308001,"2015-09-03 12:20:01"
"1365","20150326050302-149","2","2015-08-30 11:06:36",1440957996,"C7",162107,1441120103,"2015-09-01 08:08:23"
"1296","20155629035637-921","1","2015-08-30 12:04:16",1440961456,"C6",72459,1441033915,"2015-08-31 08:11:55"
"5152","20154325074316-323","2","2015-08-30 12:39:18",1440963558,"C8",224881,1441188439,"2015-09-02 03:07:19"
"4218","20150104120123-255","2","2015-08-30 13:01:47",1440964907,"C7",321432,1441286339,"2015-09-03 06:18:59"
"1479","20155524115511-739","3","2015-08-30 13:05:11",1440965111,"C6",533500,1441498611,"2015-09-05 17:16:51"
"2481","20153026053028-239","2","2015-08-30 13:40:28",1440967228,"C8",165900,1441133128,"2015-09-01 11:45:28"
"5616","20152501072548-463","3","2015-08-30 13:49:18",1440967758,"C7",361230,1441328988,"2015-09-03 18:09:48"
"6155","20150603110619-327","2","2015-08-30 14:13:58",1440969238,"C5",781353,1441750591,"2015-09-08 15:16:31"
"3967","20151722021752-58","1","2015-08-30 15:15:01",1440972901,"C5",231543,1441204444,"2015-09-02 07:34:04"
"1721","20153426033412-312","3","2015-08-30 15:33:54",1440974034,"C3",345582,1441319616,"2015-09-03 15:33:36"
"4478","20154224114240-680","1","2015-08-30 16:29:27",1440977367,"C2",535607,1441512974,"2015-09-05 21:16:14"
"1081","20153122043149-695","2","2015-08-30 17:31:43",1440981103,"C0",231598,1441212701,"2015-09-02 09:51:41"
"1678","20151326031310-457","1","2015-08-30 17:53:40",1440982420,"C8",71046,1441053466,"2015-08-31 13:37:46"
"3700","20152327092353-670","3","2015-08-30 20:08:33",1440990513,"C1",297880,1441288393,"2015-09-03 06:53:13"
"2234","20154429034402-935","3","2015-08-30 20:35:52",1440992152,"C6",103910,1441096062,"2015-09-01 01:27:42"
"2146","20150423050415-924","1","2015-08-30 21:30:31",1440995431,"C5",77597,1441073028,"2015-08-31 19:03:48"
"1641","20151624051659-955","3","2015-08-30 21:38:10",1440995890,"C6",534071,1441529961,"2015-09-06 01:59:21"
"4873","20152424062441-168","2","2015-08-30 23:15:37",1441001737,"C4",731182,1441732919,"2015-09-08 10:21:59"
"1096","20153329013347-72","2","2015-08-30 23:31:09",1441002669,"C7",61121,1441063790,"2015-08-31 16:29:50"
"552","20151024111054-335","3","2015-08-30 23:36:14",1441002974,"C8",112624,1441115598,"2015-09-01 06:53:18"
"586","20154227124221-606","1","2015-08-31 00:20:33",1441005633,"C8",150546,1441156179,"2015-09-01 18:09:39"
"2586","20151122081111-220","1","2015-08-31 01:19:11",1441009151,"C4",94110,1441103261,"2015-09-01 03:27:41"
"5936","20152318072357-176","1","2015-08-31 01:41:06",1441010466,"C5",540147,1441550613,"2015-09-06 07:43:33"
"4225","20155727045735-743","3","2015-08-31 02:27:05",1441013225,"C4",97790,1441111015,"2015-09-01 05:36:55"
"1436","20151302121348-104","1","2015-08-31 02:38:06",1441013886,"C7",274562,1441288448,"2015-09-03 06:54:08"
"2441","20150208050254-21","2","2015-08-31 03:20:28",1441016428,"C5",968927,1441985355,"2015-09-11 08:29:15"
"6483","20155707085753-292","2","2015-08-31 03:34:23",1441017263,"C0",684730,1441701993,"2015-09-08 01:46:33"
"5258","20151104081118-17","1","2015-08-31 03:45:12",1441017912,"C2",772278,1441790190,"2015-09-09 02:16:30"
"1127","20150423020418-599","2","2015-08-31 04:18:46",1441019926,"C8",328034,1441347960,"2015-09-03 23:26:00"
"3798","20155328105351-17","2","2015-08-31 05:30:13",1441024213,"C3",119891,1441144104,"2015-09-01 14:48:24"
"5087","20151822111805-247","1","2015-08-31 06:02:05",1441026125,"C5",94830,1441120955,"2015-09-01 08:22:35"
"5039","20153619053636-962","1","2015-08-31 06:17:16",1441027036,"C2",524920,1441551956,"2015-09-06 08:05:56"
"2723","20152107042148-742","1","2015-08-31 06:18:45",1441027125,"C2",679139,1441706264,"2015-09-08 02:57:44"
"2885","20151308041318-416","1","2015-08-31 06:34:33",1441028073,"C3",278925,1441306998,"2015-09-03 12:03:18"
"563","20150728080743-392","1","2015-08-31 06:54:07",1441029247,"C0",84928,1441114175,"2015-09-01 06:29:35"
"3442","20150904110945-706","1","2015-08-31 07:42:28",1441032148,"C4",714109,1441746257,"2015-09-08 14:04:17"
"3323","20155820075838-714","1","2015-08-31 07:55:23",1441032923,"C5",241907,1441274830,"2015-09-03 03:07:10"
"3195","20150429050401-796","2","2015-08-31 08:57:25",1441036645,"C2",71802,1441108447,"2015-09-01 04:54:07"
"6173","20154310044352-738","1","2015-08-31 09:48:18",1441039698,"C3",255638,1441295336,"2015-09-03 08:48:56"
"240","20152925092904-816","1","2015-08-31 10:35:56",1441042556,"C8",261206,1441303762,"2015-09-03 11:09:22"
"1809","20155528075553-143","1","2015-08-31 11:07:14",1441044434,"C3",791583,1441836017,"2015-09-09 15:00:17"
"3554","20155413065431-352","1","2015-08-31 12:00:43",1441047643,"C5",224796,1441272439,"2015-09-03 02:27:19"
"5780","20152328082316-929","1","2015-08-31 12:04:30",1441047870,"C5",136237,1441184107,"2015-09-02 01:55:07"
"2382","20152827022858-442","2","2015-08-31 12:24:18",1441049058,"C2",169060,1441218118,"2015-09-02 11:21:58"
"2948","20155730045709-115","1","2015-08-31 12:44:42",1441050282,"C2",71253,1441121535,"2015-09-01 08:32:15"
"6304","20152304092306-366","2","2015-08-31 13:22:31",1441052551,"C8",469433,1441521984,"2015-09-05 23:46:24"
"718","20153003103059-290","3","2015-08-31 14:18:50",1441055930,"C0",347553,1441403483,"2015-09-04 14:51:23"
"6441","20154305094304-138","1","2015-08-31 14:39:32",1441057172,"C0",706084,1441763256,"2015-09-08 18:47:36"
"1224","20152027102031-111","2","2015-08-31 14:45:37",1441057537,"C4",120502,1441178039,"2015-09-02 00:13:59"
"4785","20154716114727-41","2","2015-08-31 14:59:11",1441058351,"C6",163438,1441221789,"2015-09-02 12:23:09"
"5776","20155731045731-907","1","2015-08-31 15:13:16",1441059196,"C8",534429,1441593625,"2015-09-06 19:40:25"
"5041","20155027025003-704","1","2015-08-31 16:31:43",1441063903,"C8",175850,1441239753,"2015-09-02 17:22:33"
"3924","20153629103642-718","2","2015-08-31 16:37:26",1441064246,"C8",97222,1441161468,"2015-09-01 19:37:48"
"1966","20155330035349-797","1","2015-08-31 17:07:24",1441066044,"C2",90815,1441156859,"2015-09-01 18:20:59"
"2876","20150130120133-197","2","2015-08-31 18:11:49",1441069909,"C4",348377,1441418286,"2015-09-04 18:58:06"
"6251","20153529063501-322","2","2015-08-31 18:27:41",1441070861,"C4",215560,1441286421,"2015-09-03 06:20:21"
"1855","20154314044331-360","2","2015-08-31 18:31:04",1441071064,"C5",491751,1441562815,"2015-09-06 11:06:55"
"3499","20150929090940-494","1","2015-08-31 19:03:00",1441072980,"C5",104200,1441177180,"2015-09-01 23:59:40"
"1932","20150530010559-140","2","2015-08-31 19:39:48",1441075188,"C0",110029,1441185217,"2015-09-02 02:13:37"
"4449","20152027042059-327","1","2015-08-31 19:58:47",1441076327,"C7",179334,1441255661,"2015-09-02 21:47:41"
"1906","20154521044507-247","1","2015-08-31 20:25:21",1441077921,"C8",438607,1441516528,"2015-09-05 22:15:28"
"5389","20151515101538-806","1","2015-08-31 21:10:02",1441080602,"C5",177708,1441258310,"2015-09-02 22:31:50"
"766","20153516103511-94","1","2015-08-31 21:32:55",1441081975,"C6",166933,1441248908,"2015-09-02 19:55:08"
"2939","20151022031032-538","2","2015-08-31 21:39:44",1441082384,"C8",400476,1441482860,"2015-09-05 12:54:20"
"4863","20152824082829-991","3","2015-08-31 23:52:17",1441090337,"C4",220076,1441310413,"2015-09-03 13:00:13"
"5894","20153912083903-728","1","2015-09-01 00:05:51",1441091151,"C2",212151,1441303302,"2015-09-03 11:01:42"
"1921","20150707020749-480","2","2015-09-01 00:49:17",1441093757,"C2",264011,1441357768,"2015-09-04 02:09:28"
"4887","20151102061116-400","1","2015-09-01 00:51:45",1441093905,"C0",367547,1441461452,"2015-09-05 06:57:32"
"2850","20155023025023-616","3","2015-09-01 01:17:50",1441095470,"C8",104121,1441199591,"2015-09-02 06:13:11"
"4360","20152129102109-855","2","2015-09-01 01:18:09",1441095489,"C8",113310,1441208799,"2015-09-02 08:46:39"
"6541","20153828103812-353","1","2015-09-01 01:36:45",1441096605,"C2",104371,1441200976,"2015-09-02 06:36:16"
"4143","20153520013555-33","1","2015-09-01 01:48:28",1441097308,"C5",524679,1441621987,"2015-09-07 03:33:07"
"5696","20151926071934-564","3","2015-09-01 02:28:06",1441099686,"C5",721414,1441821100,"2015-09-09 10:51:40"
"2966","20150311040359-426","1","2015-09-01 03:56:20",1441104980,"C5",252963,1441357943,"2015-09-04 02:12:23"
"3682","20154928054922-765","1","2015-09-01 04:31:44",1441107104,"C4",148871,1441255975,"2015-09-02 21:52:55"
"3842","20150308080350-359","2","2015-09-01 05:00:22",1441108822,"C4",294656,1441403478,"2015-09-04 14:51:18"
"1401","20153826073859-860","3","2015-09-01 05:29:59",1441110599,"C5",455580,1441566179,"2015-09-06 12:02:59"
"5553","20153031103041-989","1","2015-09-01 05:43:12",1441111392,"C6",69151,1441180543,"2015-09-02 00:55:43"
"919","20154626024603-797","1","2015-09-01 06:17:43",1441113463,"C3",243950,1441357413,"2015-09-04 02:03:33"
"5926","20154923124957-839","2","2015-09-01 06:27:57",1441114077,"C0",251560,1441365637,"2015-09-04 04:20:37"
"5065","20151428061408-195","2","2015-09-01 06:59:23",1441115963,"C0",348315,1441464278,"2015-09-05 07:44:38"
"2934","20151917071938-502","1","2015-09-01 07:02:37",1441116157,"C4",184997,1441301154,"2015-09-03 10:25:54"
"3742","20150028060003-741","1","2015-09-01 07:18:10",1441117090,"C0",350287,1441467377,"2015-09-05 08:36:17"
"3335","20152506122555-795","2","2015-09-01 07:32:35",1441117955,"C3",613400,1441731355,"2015-09-08 09:55:55"
"1649","20153924093924-473","1","2015-09-01 07:35:52",1441118152,"C5",97684,1441215836,"2015-09-02 10:43:56"
"2704","20153310073327-373","2","2015-09-01 07:46:12",1441118772,"C8",1434393,1442553165,"2015-09-17 22:12:45"
"1791","20155627075627-902","2","2015-09-01 08:52:45",1441122765,"C8",217689,1441340454,"2015-09-03 21:20:54"
"413","20151804041847-645","3","2015-09-01 10:09:47",1441127387,"C7",266340,1441393727,"2015-09-04 12:08:47"
"889","20155217105212-400","1","2015-09-01 10:14:24",1441127664,"C5",1324044,1442451708,"2015-09-16 18:01:48"
"2312","20155431095434-843","1","2015-09-01 10:59:42",1441130382,"C4",90308,1441220690,"2015-09-02 12:04:50"
"3832","20152801052822-733","1","2015-09-01 11:14:38",1441131278,"C4",331997,1441463275,"2015-09-05 07:27:55"
"5558","20152030042019-172","3","2015-09-01 12:09:53",1441134593,"C4",157774,1441292367,"2015-09-03 07:59:27"
"4326","20150230100245-923","2","2015-09-01 13:02:20",1441137740,"C6",183575,1441321315,"2015-09-03 16:01:55"
"2004","20154722114730-650","1","2015-09-01 13:05:27",1441137927,"C5",289559,1441427486,"2015-09-04 21:31:26"
"4293","20153926103929-911","2","2015-09-01 13:17:13",1441138633,"C4",263932,1441402565,"2015-09-04 14:36:05"
"1266","20151518051530-830","1","2015-09-01 13:31:25",1441139485,"C8",239231,1441378716,"2015-09-04 07:58:36"
"1729","20155029015020-507","1","2015-09-01 13:33:20",1441139600,"C4",258180,1441397780,"2015-09-04 13:16:20"
"6509","20151230091228-162","1","2015-09-01 14:09:46",1441141786,"C8",95319,1441237105,"2015-09-02 16:38:25"
"685","20153023103028-824","2","2015-09-01 14:26:50",1441142810,"C5",866026,1442008836,"2015-09-11 15:00:36"
"256","20151622101656-331","2","2015-09-01 14:40:42",1441143642,"C5",439913,1441583555,"2015-09-06 16:52:35"
"6315","20155221075249-459","3","2015-09-01 15:07:31",1441145251,"C6",609147,1441754398,"2015-09-08 16:19:58"
"2534","20153930123905-665","1","2015-09-01 15:18:18",1441145898,"C6",182353,1441328251,"2015-09-03 17:57:31"
"5598","20150724070715-550","3","2015-09-01 15:19:07",1441145947,"C4",90089,1441236036,"2015-09-02 16:20:36"
"1958","20152030102012-63","1","2015-09-01 16:40:08",1441150808,"C0",195596,1441346404,"2015-09-03 23:00:04"
"2476","20155930115903-142","1","2015-09-01 16:53:08",1441151588,"C4",190445,1441342033,"2015-09-03 21:47:13"
"4927","20151019101012-506","1","2015-09-01 16:53:19",1441151599,"C5",546541,1441698140,"2015-09-08 00:42:20"
"4558","20152228112223-26","1","2015-09-01 16:58:03",1441151883,"C5",182870,1441334753,"2015-09-03 19:45:53"
"4433","20154629034625-561","1","2015-09-01 18:00:55",1441155655,"C5",89090,1441244745,"2015-09-02 18:45:45"
"667","20154226054229-220","2","2015-09-01 18:08:47",1441156127,"C2",519978,1441676105,"2015-09-07 18:35:05"
"4473","20150831020803-228","1","2015-09-01 18:11:05",1441156265,"C2",100982,1441257247,"2015-09-02 22:14:07"
"4003","20150831110802-88","1","2015-09-01 18:47:56",1441158476,"C2",113994,1441272470,"2015-09-03 02:27:50"
"2426","20153829073814-789","2","2015-09-01 19:55:56",1441162556,"C3",303462,1441466018,"2015-09-05 08:13:38"
"5255","20152028032005-469","2","2015-09-01 19:58:33",1441162713,"C4",181154,1441343867,"2015-09-03 22:17:47"
"4283","20152822082859-49","3","2015-09-01 20:13:47",1441163627,"C5",113286,1441276913,"2015-09-03 03:41:53"
"3125","20152630092647-226","1","2015-09-01 20:15:47",1441163747,"C7",105870,1441269617,"2015-09-03 01:40:17"
"1910","20150122090127-897","1","2015-09-01 20:18:57",1441163937,"C3",452325,1441616262,"2015-09-07 01:57:42"
"2268","20154418044437-34","2","2015-09-01 20:39:21",1441165161,"C5",174812,1441339973,"2015-09-03 21:12:53"
"2932","20154928074942-377","1","2015-09-01 21:33:28",1441168408,"C5",197513,1441365921,"2015-09-04 04:25:21"
"1527","20155627015611-22","1","2015-09-01 21:53:53",1441169633,"C5",153554,1441323187,"2015-09-03 16:33:07"
"5769","20152302122333-628","2","2015-09-01 22:18:53",1441171133,"C8",525544,1441696677,"2015-09-08 00:17:57"
"171","20154930084931-614","1","2015-09-01 22:19:52",1441171192,"C0",73807,1441244999,"2015-09-02 18:49:59"
"2378","20151612061624-150","1","2015-09-01 23:54:22",1441176862,"C7",638554,1441815416,"2015-09-09 09:16:56"
"355","20150524010519-501","2","2015-09-02 00:19:27",1441178367,"C4",91456,1441269823,"2015-09-03 01:43:43"
"5513","20155924025958-524","2","2015-09-02 01:51:38",1441183898,"C8",681740,1441865638,"2015-09-09 23:13:58"
"3711","20150030120002-677","2","2015-09-02 03:15:22",1441188922,"C5",113860,1441302782,"2015-09-03 10:53:02"
"336","20154320014344-198","1","2015-09-02 04:01:43",1441191703,"C5",538097,1441729800,"2015-09-08 09:30:00"
"4641","20155807095823-910","3","2015-09-02 04:28:31",1441193311,"C5",278326,1441471637,"2015-09-05 09:47:17"
"3936","20152229092222-160","2","2015-09-02 05:25:12",1441196712,"C5",165685,1441362397,"2015-09-04 03:26:37"
"1293","20151403071408-116","2","2015-09-02 05:31:37",1441197097,"C5",369407,1441566504,"2015-09-06 12:08:24"
"6292","20155625025623-196","3","2015-09-02 05:33:03",1441197183,"C5",82175,1441279358,"2015-09-03 04:22:38"
"4817","20155326105306-68","1","2015-09-02 06:48:04",1441201684,"C3",295049,1441496733,"2015-09-05 16:45:33"
"6543","20155726105718-69","3","2015-09-02 06:58:06",1441202286,"C5",295224,1441497510,"2015-09-05 16:58:30"
"5691","20152908112909-319","2","2015-09-02 07:16:37",1441203397,"C4",602906,1441806303,"2015-09-09 06:45:03"
"4610","20154519024544-322","False","2015-09-02 08:10:05",1441206605,"C4",202120,1441408725,"2015-09-04 16:18:45"
"4407","20151531031549-230","1","2015-09-02 09:01:31",1441209691,"C8",75171,1441284862,"2015-09-03 05:54:22"
"840","20153622113605-844","1","2015-09-02 09:38:17",1441211897,"C5",471666,1441683563,"2015-09-07 20:39:23"
"266","20154126094133-632","1","2015-09-02 10:39:27",1441215567,"C5",304137,1441519704,"2015-09-05 23:08:24"
"5828","20155922045901-406","1","2015-09-02 10:59:37",1441216777,"C3",309612,1441526389,"2015-09-06 00:59:49"
"728","20152013022053-492","2","2015-09-02 11:16:25",1441217785,"C3",245276,1441463061,"2015-09-05 07:24:21"
"5198","20152529022528-642","2","2015-09-02 11:29:40",1441218580,"C5",111684,1441330264,"2015-09-03 18:31:04"
"1109","20151730081700-38","2","2015-09-02 11:33:23",1441218803,"C3",270983,1441489786,"2015-09-05 14:49:46"
"4634","20153731113748-614","3","2015-09-02 12:16:20",1441221380,"C4",87556,1441308936,"2015-09-03 12:35:36"
"6430","20155922045952-606","2","2015-09-02 12:29:30",1441222170,"C5",133454,1441355624,"2015-09-04 01:33:44"
"2625","20152024032005-799","2","2015-09-02 14:11:56",1441228316,"C5",257837,1441486153,"2015-09-05 13:49:13"
"3769","20151212081202-125","3","2015-09-02 14:36:47",1441229807,"C8",903177,1442132984,"2015-09-13 01:29:44"
"141","20155331025312-334","1","2015-09-02 14:48:03",1441230483,"C0",57497,1441287980,"2015-09-03 06:46:20"
"497","20151217121251-526","1","2015-09-02 15:01:35",1441231295,"C0",198932,1441430227,"2015-09-04 22:17:07"
"4695","20154424014431-732","1","2015-09-02 15:38:46",1441233526,"C3",261485,1441495011,"2015-09-05 16:16:51"
"594","20155119115134-6","1","2015-09-02 16:26:12",1441236372,"C8",175154,1441411526,"2015-09-04 17:05:26"
"5817","20154124024118-504","1","2015-09-02 17:24:03",1441239843,"C8",157473,1441397316,"2015-09-04 13:08:36"
"2347","20152314062351-552","1","2015-09-02 17:27:03",1441240023,"C3",560464,1441800487,"2015-09-09 05:08:07"
"4382","20155731065708-964","2","2015-09-02 17:32:44",1441240364,"C5",105468,1441345832,"2015-09-03 22:50:32"
"1576","20151520101518-905","1","2015-09-02 17:52:58",1441241578,"C4",164380,1441405958,"2015-09-04 15:32:38"
"3715","20152731032706-323","1","2015-09-02 20:03:42",1441249422,"C7",94698,1441344120,"2015-09-03 22:22:00"
"5006","20155725035758-59","3","2015-09-02 20:30:19",1441251019,"C4",235847,1441486866,"2015-09-05 14:01:06"
"6141","20152531032502-40","2","2015-09-02 20:52:30",1441252350,"C2",96224,1441348574,"2015-09-03 23:36:14"
"4789","20151814091820-723","1","2015-09-02 20:58:35",1441252715,"C3",623145,1441875860,"2015-09-10 02:04:20"
"1596","20150116100148-276","2","2015-09-02 21:05:40",1441253140,"C4",188579,1441441719,"2015-09-05 01:28:39"
"466","20150727060728-239","1","2015-09-02 21:32:26",1441254746,"C4",464614,1441719360,"2015-09-08 06:36:00"
"1152","20152914042953-652","3","2015-09-02 22:46:47",1441259207,"C6",277369,1441536576,"2015-09-06 03:49:36"
"1281","20154630124612-292","1","2015-09-02 22:58:44",1441259924,"C2",147976,1441407900,"2015-09-04 16:05:00"
"1025","20150022040009-518","1","2015-09-02 23:31:04",1441261864,"C0",522265,1441784129,"2015-09-09 00:35:29"
"5968","20152208012227-661","3","2015-09-02 23:32:59",1441261979,"C6",274579,1441536558,"2015-09-06 03:49:18"
"3744","20152726042751-686","1","2015-09-03 00:11:57",1441264317,"C5",316323,1441580640,"2015-09-06 16:04:00"
"1397","20150628010656-511","3","2015-09-03 00:18:08",1441264688,"C5",59034,1441323722,"2015-09-03 16:42:02"
"230","20154016054052-85","1","2015-09-03 00:25:56",1441265156,"C6",186638,1441451794,"2015-09-05 04:16:34"
"86","20155721045702-819","1","2015-09-03 00:32:49",1441265569,"C4",152021,1441417590,"2015-09-04 18:46:30"
"4029","20155529095519-855","2","2015-09-03 00:47:25",1441266445,"C7",199563,1441466008,"2015-09-05 08:13:28"
"30","20153330053323-666","3","2015-09-03 01:02:13",1441267333,"C8",143065,1441410398,"2015-09-04 16:46:38"
"4390","20154529014544-620","1","2015-09-03 01:39:29",1441269569,"C8",77685,1441347254,"2015-09-03 23:14:14"
"6230","20151724061714-521","1","2015-09-03 01:52:55",1441270375,"C7",121163,1441391538,"2015-09-04 11:32:18"
"279","20155610055624-279","1","2015-09-03 02:11:51",1441271511,"C7",670761,1441942272,"2015-09-10 20:31:12"
"1147","20150823010813-63","1","2015-09-03 02:24:39",1441272279,"C7",455893,1441728172,"2015-09-08 09:02:52"
"662","20154524044508-686","1","2015-09-03 02:56:38",1441274198,"C8",162858,1441437056,"2015-09-05 00:10:56"
"3867","20150529010519-318","2","2015-09-03 03:11:19",1441275079,"C7",198180,1441473259,"2015-09-05 10:14:19"
"4454","20150501030502-599","3","2015-09-03 03:58:08",1441277888,"C0",66393,1441344281,"2015-09-03 22:24:41"
"5770","20153230033205-767","1","2015-09-03 03:59:51",1441277991,"C5",152033,1441430024,"2015-09-04 22:13:44"
"2362","20151823071855-858","2","2015-09-03 04:13:03",1441278783,"C8",469624,1441748407,"2015-09-08 14:40:07"
"1646","20152909022912-907","1","2015-09-03 06:14:52",1441286092,"C8",961748,1442247840,"2015-09-14 09:24:00"
"1874","20153204023235-178","1","2015-09-03 06:33:47",1441287227,"C2",320409,1441607636,"2015-09-06 23:33:56"
"3984","20152427042457-76","1","2015-09-03 06:40:30",1441287630,"C4",189911,1441477541,"2015-09-05 11:25:41"
"4721","20154725054747-248","2","2015-09-03 07:06:26",1441289186,"C4",488217,1441777403,"2015-09-08 22:43:23"
"4229","20150721100700-126","1","2015-09-03 07:07:45",1441289265,"C5",370815,1441660080,"2015-09-07 14:08:00"
"3881","20153519123507-498","1","2015-09-03 07:13:31",1441289611,"C5",159588,1441449199,"2015-09-05 03:33:19"
"5414","20152229062214-724","1","2015-09-03 07:16:33",1441289793,"C2",435259,1441725052,"2015-09-08 08:10:52"
"2929","20151530051543-867","3","2015-09-03 07:37:51",1441291071,"C5",155464,1441446535,"2015-09-05 02:48:55"
"6064","20153516013555-105","3","2015-09-03 09:46:10",1441298770,"C5",513805,1441812575,"2015-09-09 08:29:35"
"2538","20152527022531-64","2","2015-09-03 10:01:55",1441299715,"C2",73623,1441373338,"2015-09-04 06:28:58"
"5791","20152625082631-507","1","2015-09-03 10:31:02",1441301462,"C4",112153,1441413615,"2015-09-04 17:40:15"
"3014","20153029033048-19","2","2015-09-03 10:33:04",1441301584,"C5",51767,1441353351,"2015-09-04 00:55:51"
"4560","20150014100049-755","2","2015-09-03 10:42:24",1441302144,"C8",346099,1441648243,"2015-09-07 10:50:43"
"1699","20155530055509-649","2","2015-09-03 11:07:29",1441303649,"C8",64228,1441367877,"2015-09-04 04:57:57"
"431","20151225071221-449","2","2015-09-03 11:19:22",1441304362,"C4",113203,1441417565,"2015-09-04 18:46:05"
"5621","20152124062158-615","1","2015-09-03 12:15:40",1441307740,"C0",295074,1441602814,"2015-09-06 22:13:34"
"2253","20150701080732-301","1","2015-09-03 12:21:58",1441308118,"C4",94033,1441402151,"2015-09-04 14:29:11"
"5644","20154618044618-128","1","2015-09-03 12:22:27",1441308147,"C7",449441,1441757588,"2015-09-08 17:13:08"
"3816","20153913023914-536","2","2015-09-03 13:12:19",1441311139,"C5",258455,1441569594,"2015-09-06 12:59:54"
"1727","20153930103903-13","1","2015-09-03 13:44:35",1441313075,"C6",356732,1441669807,"2015-09-07 16:50:07"
"4587","20154314054309-806","1","2015-09-03 13:55:15",1441313715,"C8",857163,1442170878,"2015-09-13 12:01:18"
"487","20150531030537-639","1","2015-09-03 14:43:37",1441316617,"C5",367035,1441683652,"2015-09-07 20:40:52"
"2761","20154419084429-25","1","2015-09-03 15:18:35",1441318715,"C3",439882,1441758597,"2015-09-08 17:29:57"
"3677","20155102055140-273","3","2015-09-03 16:13:25",1441322005,"C0",80505,1441402510,"2015-09-04 14:35:10"
"2866","20153220023240-486","1","2015-09-03 16:35:52",1441323352,"C5",486924,1441810276,"2015-09-09 07:51:16"
"3153","20155125045126-764","1","2015-09-03 16:38:45",1441323525,"C6",776839,1442100364,"2015-09-12 16:26:04"
"2819","20154920044949-964","2","2015-09-03 16:53:01",1441324381,"C4",1209792,1442534173,"2015-09-17 16:56:13"
"5497","20155012065005-217","1","2015-09-03 17:02:29",1441324949,"C3",276792,1441601741,"2015-09-06 21:55:41"
"2000","20153728073721-430","1","2015-09-03 17:36:25",1441326985,"C3",277172,1441604157,"2015-09-06 22:35:57"
"4639","20151502121502-816","3","2015-09-03 18:16:06",1441329366,"C6",108064,1441437430,"2015-09-05 00:17:10"
"2818","20150501010554-108","1","2015-09-03 18:34:38",1441330478,"C2",96262,1441426740,"2015-09-04 21:19:00"
"3770","20155030075008-549","2","2015-09-03 19:16:12",1441332972,"C8",193382,1441526354,"2015-09-06 00:59:14"
"2198","20152825092803-463","1","2015-09-03 19:21:23",1441333283,"C4",101650,1441434933,"2015-09-04 23:35:33"
"4035","20154728024720-591","3","2015-09-03 19:27:24",1441333644,"C3",267602,1441601246,"2015-09-06 21:47:26"
"1664","20152801082834-605","1","2015-09-03 20:09:06",1441336146,"C8",107416,1441443562,"2015-09-05 01:59:22"
"4933","20155026055055-745","3","2015-09-03 20:43:03",1441338183,"C3",350764,1441688947,"2015-09-07 22:09:07"
"3937","20150801100806-862","1","2015-09-03 21:30:18",1441341018,"C8",106866,1441447884,"2015-09-05 03:11:24"
"15","20154727034733-671","2","2015-09-03 21:37:12",1441341432,"C5",89397,1441430829,"2015-09-04 22:27:09"
"2947","20154631104618-531","1","2015-09-03 21:53:18",1441342398,"C4",99740,1441442138,"2015-09-05 01:35:38"
"5163","20155130055132-838","1","2015-09-03 22:47:38",1441345658,"C2",363366,1441709024,"2015-09-08 03:43:44"
"4767","20153426023405-923","2","2015-09-04 01:09:25",1441354165,"C2",91165,1441445330,"2015-09-05 02:28:50"
"6122","20151031111040-488","2","2015-09-04 01:39:08",1441355948,"C5",155654,1441511602,"2015-09-05 20:53:22"
"2011","20154127114159-870","2","2015-09-04 02:12:31",1441357951,"C3",416929,1441774880,"2015-09-08 22:01:20"
"6093","20155523025523-457","2","2015-09-04 02:45:03",1441359903,"C8",198596,1441558499,"2015-09-06 09:54:59"
"695","20153228023246-901","2","2015-09-04 05:28:04",1441369684,"C3",190706,1441560390,"2015-09-06 10:26:30"
"1911","20150914040900-949","2","2015-09-04 05:53:14",1441371194,"C3",253922,1441625116,"2015-09-07 04:25:16"
"2564","20152225012231-425","3","2015-09-04 07:02:25",1441375345,"C2",280398,1441655743,"2015-09-07 12:55:43"
"4166","20152620032609-833","1","2015-09-04 07:32:16",1441377136,"C0",181081,1441558217,"2015-09-06 09:50:17"
"2608","20155103115100-856","2","2015-09-04 08:20:27",1441380027,"C3",73767,1441453794,"2015-09-05 04:49:54"
"2636","20150919070956-883","1","2015-09-04 08:58:07",1441382287,"C8",198413,1441580700,"2015-09-06 16:05:00"
"276","20154202014210-253","2","2015-09-04 09:11:41",1441383101,"C3",156571,1441539672,"2015-09-06 04:41:12"
"5726","20151303111344-23","1","2015-09-04 10:44:32",1441388672,"C3",84648,1441473320,"2015-09-05 10:15:20"
"4744","20154726024709-573","2","2015-09-04 10:44:43",1441388683,"C4",763054,1442151737,"2015-09-13 06:42:17"
"3476","20152228012256-73","1","2015-09-04 11:19:50",1441390790,"C6",99569,1441490359,"2015-09-05 14:59:19"
"3227","20152303052328-94","2","2015-09-04 11:28:16",1441391296,"C4",677736,1442069032,"2015-09-12 07:43:52"
"6280","20155622065626-576","1","2015-09-04 12:07:21",1441393641,"C8",228371,1441622012,"2015-09-07 03:33:32"
"7","20150229070248-397","1","2015-09-04 12:48:52",1441396132,"C4",269582,1441665714,"2015-09-07 15:41:54"
"300","20150803030838-612","2","2015-09-04 13:08:34",1441397314,"C2",79196,1441476510,"2015-09-05 11:08:30"
"1499","20153102063137-742","1","2015-09-04 13:25:45",1441398345,"C8",98824,1441497169,"2015-09-05 16:52:49"
"1132","20153227063207-318","1","2015-09-04 14:11:25",1441401085,"C8",359379,1441760464,"2015-09-08 18:01:04"
"3141","20152830052802-839","2","2015-09-04 14:27:22",1441402042,"C8",84232,1441486274,"2015-09-05 13:51:14"
"5864","20152531082521-227","1","2015-09-04 14:28:55",1441402135,"C5",183707,1441585842,"2015-09-06 17:30:42"
"871","20153103063126-891","3","2015-09-04 14:58:46",1441403926,"C3",399320,1441803246,"2015-09-09 05:54:06"
"3883","20150708090712-967","1","2015-09-04 16:41:43",1441410103,"C2",337153,1441747256,"2015-09-08 14:20:56"
"237","20153209093250-358","3","2015-09-04 17:58:00",1441414680,"C8",1138355,1442553035,"2015-09-17 22:10:35"
"493","20155024045011-587","3","2015-09-04 18:15:44",1441415744,"C0",1211311,1442627055,"2015-09-18 18:44:15"
"1639","20155727015757-542","1","2015-09-04 19:17:33",1441419453,"C2",355188,1441774641,"2015-09-08 21:57:21"
"5056","20155321115343-478","1","2015-09-04 19:45:58",1441421158,"C8",247587,1441668745,"2015-09-07 16:32:25"
"5789","20151824051853-291","1","2015-09-04 21:09:02",1441426142,"C4",321403,1441747545,"2015-09-08 14:25:45"
"3625","20150625010640-723","1","2015-09-04 21:42:04",1441428124,"C6",149154,1441577278,"2015-09-06 15:07:58"
"1504","20152128102128-573","3","2015-09-04 22:23:12",1441430592,"C6",81013,1441511605,"2015-09-05 20:53:25"
"3812","20151731021746-364","1","2015-09-04 22:36:36",1441431396,"C8",75106,1441506502,"2015-09-05 19:28:22"
"4020","20153117053105-892","1","2015-09-04 22:37:59",1441431479,"C7",224802,1441656281,"2015-09-07 13:04:41"
"5092","20155823115852-975","2","2015-09-04 22:59:59",1441432799,"C4",153781,1441586580,"2015-09-06 17:43:00"
"3453","20152202092258-284","1","2015-09-04 23:19:22",1441433962,"C8",111492,1441545454,"2015-09-06 06:17:34"
"3413","20150323050310-883","1","2015-09-04 23:21:48",1441434108,"C4",529759,1441963867,"2015-09-11 02:31:07"
"1811","20154102104114-973","2","2015-09-05 00:31:40",1441438300,"C7",111313,1441549613,"2015-09-06 07:26:53"
"6201","20150026070015-698","1","2015-09-05 01:17:46",1441441066,"C8",120493,1441561559,"2015-09-06 10:45:59"
"133","20152001022003-999","1","2015-09-05 01:24:47",1441441487,"C4",149542,1441591029,"2015-09-06 18:57:09"
"5997","20151927121927-686","3","2015-09-05 04:03:39",1441451019,"C4",249284,1441700303,"2015-09-08 01:18:23"
"6234","20150517080528-116","3","2015-09-05 04:32:14",1441452734,"C2",814403,1442267137,"2015-09-14 14:45:37"
"4837","20153130043132-951","1","2015-09-05 04:48:02",1441453682,"C5",238095,1441691777,"2015-09-07 22:56:17"
"1158","20152930102944-762","1","2015-09-05 05:19:54",1441455594,"C5",249905,1441705499,"2015-09-08 02:44:59"
"585","20155402095430-944","2","2015-09-05 05:56:37",1441457797,"C2",244927,1441702724,"2015-09-08 01:58:44"
"1392","20155428025436-507","2","2015-09-05 05:56:54",1441457814,"C5",94134,1441551948,"2015-09-06 08:05:48"
"3327","20154231024256-741","2","2015-09-05 06:04:06",1441458246,"C8",1539635,1442997881,"2015-09-23 01:44:41"
"4387","20151209111219-195","2","2015-09-05 07:26:33",1441463193,"C7",331322,1441794515,"2015-09-09 03:28:35"
"1336","20155409095404-1","1","2015-09-05 07:31:08",1441463468,"C3",290528,1441753996,"2015-09-08 16:13:16"
"756","20151625011628-348","1","2015-09-05 07:51:48",1441464708,"C6",116365,1441581073,"2015-09-06 16:11:13"
"5508","20151929081907-753","2","2015-09-05 08:23:49",1441466629,"C4",302541,1441769170,"2015-09-08 20:26:10"
"3284","20151226121233-295","2","2015-09-05 08:28:57",1441466937,"C5",121512,1441588449,"2015-09-06 18:14:09"
"6341","20151629101611-370","1","2015-09-05 08:32:07",1441467127,"C3",85508,1441552635,"2015-09-06 08:17:15"
"4790","20155125115109-261","1","2015-09-05 08:43:57",1441467837,"C4",469584,1441937421,"2015-09-10 19:10:21"
"614","20150401110417-611","1","2015-09-05 08:55:17",1441468517,"C0",168930,1441637447,"2015-09-07 07:50:47"
"3007","20155504075536-383","1","2015-09-05 09:17:34",1441469854,"C5",395674,1441865528,"2015-09-09 23:12:08"
"2086","20152120072110-350","2","2015-09-05 09:51:58",1441471918,"C5",695724,1442167642,"2015-09-13 11:07:22"
"3198","20150004030017-259","1","2015-09-05 10:07:02",1441472822,"C4",68805,1441541627,"2015-09-06 05:13:47"
"5015","20152126112132-235","1","2015-09-05 10:34:51",1441474491,"C6",861199,1442335690,"2015-09-15 09:48:10"
"1577","20155801015824-240","1","2015-09-05 11:05:59",1441476359,"C8",67051,1441543410,"2015-09-06 05:43:30"
"757","20153303063323-954","1","2015-09-05 11:53:25",1441479205,"C3",96001,1441575206,"2015-09-06 14:33:26"
"758","20152129102151-57","1","2015-09-05 12:38:00",1441481880,"C3",612969,1442094849,"2015-09-12 14:54:09"
"391","20150902120906-170","1","2015-09-05 14:02:27",1441486947,"C3",266001,1441752948,"2015-09-08 15:55:48"
"389","20150204010234-9","1","2015-09-05 14:26:38",1441488398,"C2",91444,1441579842,"2015-09-06 15:50:42"
"2675","20155504115554-356","1","2015-09-05 14:28:10",1441488490,"C0",95536,1441584026,"2015-09-06 17:00:26"
"4000","20155926045943-896","2","2015-09-05 14:30:11",1441488611,"C8",427514,1441916125,"2015-09-10 13:15:25"
"6228","20152924112938-506","3","2015-09-05 15:09:06",1441490946,"C0",466046,1441956992,"2015-09-11 00:36:32"
"5830","20153017033036-185","1","2015-09-05 16:15:36",1441494936,"C8",234900,1441729836,"2015-09-08 09:30:36"
"1068","20152125052113-381","3","2015-09-05 16:29:50",1441495790,"C8",135331,1441631121,"2015-09-07 06:05:21"
"5875","20154102014133-632","3","2015-09-05 16:30:36",1441495836,"C3",89781,1441585617,"2015-09-06 17:26:57"
"4056","20150031070053-947","1","2015-09-05 16:36:51",1441496211,"C2",466558,1441962769,"2015-09-11 02:12:49"
"221","20154930094911-931","1","2015-09-05 20:01:59",1441508519,"C5",69396,1441577915,"2015-09-06 15:18:35"
"412","20154709124756-980","1","2015-09-05 20:05:24",1441508724,"C4",629681,1442138405,"2015-09-13 03:00:05"
"701","20151001081041-702","1","2015-09-05 20:10:43",1441509043,"C0",194401,1441703444,"2015-09-08 02:10:44"
"2026","20152409032441-824","2","2015-09-05 20:44:51",1441511091,"C8",1006082,1442517173,"2015-09-17 12:12:53"
"4988","20151426091421-412","2","2015-09-05 20:51:18",1441511478,"C5",301939,1441813417,"2015-09-09 08:43:37"
"3689","20151924061907-803","1","2015-09-05 20:55:25",1441511725,"C2",538254,1442049979,"2015-09-12 02:26:19"
"1832","20150403120405-547","3","2015-09-05 21:06:35",1441512395,"C0",68450,1441580845,"2015-09-06 16:07:25"
"4920","20154303104350-928","2","2015-09-05 21:07:16",1441512436,"C7",105103,1441617539,"2015-09-07 02:18:59"
"5180","20152829022835-670","3","2015-09-05 21:32:45",1441513965,"C4",315125,1441829090,"2015-09-09 13:04:50"
"4575","20153523043519-62","1","2015-09-05 22:08:44",1441516124,"C8",163315,1441679439,"2015-09-07 19:30:39"
"5977","20153315033346-643","1","2015-09-05 22:11:15",1441516275,"C2",262607,1441778882,"2015-09-08 23:08:02"
"3637","20155619125653-865","1","2015-09-05 22:26:44",1441517204,"C3",500997,1442018201,"2015-09-11 17:36:41"
"4850","20151919051957-409","3","2015-09-05 22:27:01",1441517221,"C2",185903,1441703124,"2015-09-08 02:05:24"
"4502","20154920114956-385","1","2015-09-05 23:36:44",1441521404,"C2",512901,1442034305,"2015-09-11 22:05:05"
"2547","20151910111953-81","2","2015-09-05 23:46:10",1441521970,"C4",327311,1441849281,"2015-09-09 18:41:21"
"203","20153127113132-635","1","2015-09-06 00:01:14",1441522874,"C8",411291,1441934165,"2015-09-10 18:16:05"
"1493","20155514115538-38","1","2015-09-06 00:22:33",1441524153,"C7",277945,1441802098,"2015-09-09 05:34:58"
"2333","20150129120100-835","1","2015-09-06 00:23:42",1441524222,"C8",324681,1441848903,"2015-09-09 18:35:03"
"1363","20151004051005-26","1","2015-09-06 01:07:59",1441526879,"C8",57537,1441584416,"2015-09-06 17:06:56"
"1410","20150321010307-127","1","2015-09-06 02:19:43",1441531183,"C5",671898,1442203081,"2015-09-13 20:58:01"
"4637","20155201025239-418","2","2015-09-06 02:22:57",1441531377,"C2",193509,1441724886,"2015-09-08 08:08:06"
"2346","20150213100239-978","2","2015-09-06 02:30:02",1441531802,"C5",292349,1441824151,"2015-09-09 11:42:31"
"5663","20154729044749-19","1","2015-09-06 04:00:11",1441537211,"C5",322571,1441859782,"2015-09-09 21:36:22"
"3553","20152229062233-1","1","2015-09-06 04:33:08",1441539188,"C8",136927,1441676115,"2015-09-07 18:35:15"
"2366","20150631050638-897","2","2015-09-06 04:41:14",1441539674,"C8",67668,1441607342,"2015-09-06 23:29:02"
"5772","20151320101309-415","1","2015-09-06 04:57:23",1441540643,"C5",207122,1441747765,"2015-09-08 14:29:25"
"151","20155621045635-67","1","2015-09-06 04:59:41",1441540781,"C2",669693,1442210474,"2015-09-13 23:01:14"
"1587","20154428114412-322","1","2015-09-06 05:00:04",1441540804,"C2",376676,1441917480,"2015-09-10 13:38:00"
"6068","20153228033219-364","2","2015-09-06 05:26:37",1441542397,"C7",105894,1441648291,"2015-09-07 10:51:31"
"2056","20150226090228-180","3","2015-09-06 05:39:30",1441543170,"C0",469111,1442012281,"2015-09-11 15:58:01"
"2494","20150731120739-57","1","2015-09-06 06:39:35",1441546775,"C5",249358,1441796133,"2015-09-09 03:55:33"
"4030","20152527102521-92","2","2015-09-06 06:45:58",1441547158,"C0",850837,1442397995,"2015-09-16 03:06:35"
"3890","20150227070212-936","2","2015-09-06 06:50:57",1441547457,"C3",287775,1441835232,"2015-09-09 14:47:12"
"5109","20152622012613-387","2","2015-09-06 06:53:53",1441547633,"C2",636230,1442183863,"2015-09-13 15:37:43"
"4490","20151128091137-757","1","2015-09-06 08:09:37",1441552177,"C0",386940,1441939117,"2015-09-10 19:38:37"
"4312","20151322111353-436","3","2015-09-06 08:38:55",1441553935,"C3",643351,1442197286,"2015-09-13 19:21:26"
"2789","20152821032823-470","3","2015-09-06 09:10:51",1441555851,"C2",679874,1442235725,"2015-09-14 06:02:05"
"3157","20150001080008-525","3","2015-09-06 09:17:50",1441556270,"C5",218331,1441774601,"2015-09-08 21:56:41"
"1820","20153705113718-477","2","2015-09-06 10:12:14",1441559534,"C8",1379848,1442939382,"2015-09-22 09:29:42"
"4853","20153404063406-832","1","2015-09-06 12:44:20",1441568660,"C7",97507,1441666167,"2015-09-07 15:49:27"
"222","20155303075313-600","1","2015-09-06 13:02:17",1441569737,"C6",369518,1441939255,"2015-09-10 19:40:55"
"1273","20152431122444-914","2","2015-09-06 14:25:29",1441574729,"C0",175215,1441749944,"2015-09-08 15:05:44"
"597","20150330090357-596","2","2015-09-06 15:17:38",1441577858,"C7",89603,1441667461,"2015-09-07 16:11:01"
"175","20155922035939-710","2","2015-09-06 16:30:28",1441582228,"C5",185407,1441767635,"2015-09-08 20:00:35"
"1477","20150817020855-736","1","2015-09-06 17:26:50",1441585610,"C8",347975,1441933585,"2015-09-10 18:06:25"
"3970","20151304071316-371","2","2015-09-06 17:56:27",1441587387,"C6",211391,1441798778,"2015-09-09 04:39:38"
"2246","20154612024622-150","1","2015-09-06 18:54:59",1441590899,"C0",693331,1442284230,"2015-09-14 19:30:30"
"623","20154124044141-426","3","2015-09-06 18:57:00",1441591020,"C7",161617,1441752637,"2015-09-08 15:50:37"
"4531","20154526064518-551","2","2015-09-06 20:11:02",1441595462,"C4",895592,1442491054,"2015-09-17 04:57:34"
"6545","20152703072711-146","1","2015-09-06 20:18:40",1441595920,"C4",305489,1441901409,"2015-09-10 09:10:09"
"452","20155005035047-766","1","2015-09-06 20:42:19",1441597339,"C8",51946,1441649285,"2015-09-07 11:08:05"
"1333","20153917113956-553","3","2015-09-06 20:57:56",1441598276,"C2",880740,1442479016,"2015-09-17 01:36:56"
"3733","20151431121439-712","1","2015-09-06 21:03:18",1441598598,"C2",183373,1441781971,"2015-09-08 23:59:31"
"1017","20150301050357-768","1","2015-09-06 21:36:55",1441600615,"C0",64054,1441664669,"2015-09-07 15:24:29"
"6319","20155904105902-891","2","2015-09-06 22:26:34",1441603594,"C5",107026,1441710620,"2015-09-08 04:10:20"
"833","20155418105443-181","1","2015-09-06 22:27:48",1441603668,"C4",240455,1441844123,"2015-09-09 17:15:23"
"1592","20154504064547-329","1","2015-09-06 22:30:19",1441603819,"C0",114736,1441718555,"2015-09-08 06:22:35"
"1808","20150930040930-759","1","2015-09-06 23:03:46",1441605826,"C5",314828,1441920654,"2015-09-10 14:30:54"
"5234","20154504054501-314","2","2015-09-06 23:15:46",1441606546,"C2",64215,1441670761,"2015-09-07 17:06:01"
"5406","20151903101941-31","1","2015-09-06 23:33:50",1441607630,"C3",102283,1441709913,"2015-09-08 03:58:33"
"3817","20153705073720-86","2","2015-09-07 00:14:32",1441610072,"C5",353079,1441963151,"2015-09-11 02:19:11"
"1091","20152812122818-384","3","2015-09-07 00:39:14",1441611554,"C0",610282,1442221836,"2015-09-14 02:10:36"
"73","20151026041051-922","1","2015-09-07 00:45:29",1441611929,"C0",490639,1442102568,"2015-09-12 17:02:48"
"4492","20152131072114-536","3","2015-09-07 01:03:07",1441612987,"C8",83159,1441696146,"2015-09-08 00:09:06"
"4834","20151629101604-17","2","2015-09-07 01:10:14",1441613414,"C7",372425,1441985839,"2015-09-11 08:37:19"
"1837","20154014024032-779","3","2015-09-07 01:17:04",1441613824,"C5",253174,1441866998,"2015-09-09 23:36:38"
"1800","20155731115721-967","1","2015-09-07 03:07:17",1441620437,"C5",286498,1441906935,"2015-09-10 10:42:15"
"6256","20152129012109-280","1","2015-09-07 03:21:38",1441621298,"C2",105947,1441727245,"2015-09-08 08:47:25"
"2424","20155531015543-259","2","2015-09-07 05:00:06",1441627206,"C4",81809,1441709015,"2015-09-08 03:43:35"
"3829","20154104114100-580","2","2015-09-07 06:00:50",1441630850,"C8",119395,1441750245,"2015-09-08 15:10:45"
"438","20153109043127-486","3","2015-09-07 06:09:10",1441631350,"C2",352609,1441983959,"2015-09-11 08:05:59"
"3826","20152614032611-671","1","2015-09-07 06:23:17",1441632197,"C4",680342,1442312539,"2015-09-15 03:22:19"
"277","20153230043217-141","2","2015-09-07 06:31:33",1441632693,"C5",327578,1441960271,"2015-09-11 01:31:11"
"5403","20150501070559-328","3","2015-09-07 07:03:17",1441634597,"C6",532773,1442167370,"2015-09-13 11:02:50"
"5051","20153508053556-774","1","2015-09-07 07:03:40",1441634620,"C3",319258,1441953878,"2015-09-10 23:44:38"
"3603","20152317092314-52","1","2015-09-07 08:12:14",1441638734,"C6",301690,1441940424,"2015-09-10 20:00:24"
"5409","20153219093219-284","1","2015-09-07 08:37:44",1441640264,"C7",616675,1442256939,"2015-09-14 11:55:39"
"3992","20151631041644-215","1","2015-09-07 09:32:23",1441643543,"C4",193513,1441837056,"2015-09-09 15:17:36"
"483","20150805020849-559","1","2015-09-07 10:17:26",1441646246,"C8",405331,1442051577,"2015-09-12 02:52:57"
"4169","20152031092038-925","1","2015-09-07 11:36:29",1441650989,"C7",470193,1442121182,"2015-09-12 22:13:02"
"4919","20154704054739-174","1","2015-09-07 11:50:50",1441651850,"C2",237791,1441889641,"2015-09-10 05:54:01"
"6153","20152201082225-621","1","2015-09-07 12:37:05",1441654625,"C8",106736,1441761361,"2015-09-08 18:16:01"
"2379","20154828014849-145","1","2015-09-07 13:48:25",1441658905,"C5",431988,1442090893,"2015-09-12 13:48:13"
"620","20153318063343-519","1","2015-09-07 14:06:39",1441659999,"C4",219397,1441879396,"2015-09-10 03:03:16"
"4955","20150830030855-79","2","2015-09-07 14:14:00",1441660440,"C8",1191661,1442852101,"2015-09-21 09:15:01"
"2786","20154821044824-752","1","2015-09-07 14:19:45",1441660785,"C5",486627,1442147412,"2015-09-13 05:30:12"
"3042","20150302060320-142","3","2015-09-07 14:28:13",1441661293,"C6",462293,1442123586,"2015-09-12 22:53:06"
"1247","20153327063301-504","3","2015-09-07 14:29:33",1441661373,"C3",139856,1441801229,"2015-09-09 05:20:29"
"3118","20150605090617-10","1","2015-09-07 14:43:54",1441662234,"C6",193057,1441855291,"2015-09-09 20:21:31"
"4732","20150720100717-213","1","2015-09-07 14:49:02",1441662542,"C0",607215,1442269757,"2015-09-14 15:29:17"
"5512","20151306121325-748","2","2015-09-07 15:05:02",1441663502,"C7",779071,1442442573,"2015-09-16 15:29:33"
"5929","20153325123355-404","1","2015-09-07 15:18:31",1441664311,"C6",635246,1442299557,"2015-09-14 23:45:57"
"314","20151823061856-404","2","2015-09-07 16:36:44",1441669004,"C4",444356,1442113360,"2015-09-12 20:02:40"
"4214","20151113031115-28","1","2015-09-07 16:45:24",1441669524,"C3",692007,1442361531,"2015-09-15 16:58:51"
"4339","20154011014020-687","2","2015-09-07 16:49:48",1441669788,"C5",627821,1442297609,"2015-09-14 23:13:29"
"1344","20150904110914-670","3","2015-09-07 16:58:05",1441670285,"C4",93377,1441763662,"2015-09-08 18:54:22"
"2791","20154321074307-245","2","2015-09-07 17:10:27",1441671027,"C2",187855,1441858882,"2015-09-09 21:21:22"
"3167","20154303094318-187","3","2015-09-07 17:14:18",1441671258,"C2",124220,1441795478,"2015-09-09 03:44:38"
"5520","20154604024619-103","1","2015-09-07 17:15:31",1441671331,"C3",368319,1442039650,"2015-09-11 23:34:10"
"5188","20154828094837-453","2","2015-09-07 17:49:16",1441673356,"C4",297613,1441970969,"2015-09-11 04:29:29"
"457","20150602050643-221","3","2015-09-07 18:49:56",1441676996,"C4",62599,1441739595,"2015-09-08 12:13:15"
"3304","20154620024644-66","2","2015-09-07 18:55:14",1441677314,"C8",314022,1441991336,"2015-09-11 10:08:56"
"3069","20152422012450-156","1","2015-09-07 19:02:50",1441677770,"C0",175335,1441853105,"2015-09-09 19:45:05"
"2299","20153716123710-632","1","2015-09-07 19:40:06",1441680006,"C3",275168,1441955174,"2015-09-11 00:06:14"
"5361","20154224124203-336","1","2015-09-07 20:12:58",1441681978,"C8",176665,1441858643,"2015-09-09 21:17:23"
"3596","20150525050544-558","2","2015-09-07 21:20:40",1441686040,"C5",142312,1441828352,"2015-09-09 12:52:32"
"5913","20153703033757-677","1","2015-09-07 22:41:17",1441690877,"C4",53000,1441743877,"2015-09-08 13:24:37"
"2002","20153922113902-456","1","2015-09-08 00:01:11",1441695671,"C7",203847,1441899518,"2015-09-10 08:38:38"
"4801","20153622113627-960","2","2015-09-08 00:13:47",1441696427,"C8",285568,1441981995,"2015-09-11 07:33:15"
"1867","20154405084402-280","2","2015-09-08 01:16:35",1441700195,"C2",77451,1441777646,"2015-09-08 22:47:26"
"3385","20153406023410-438","1","2015-09-08 01:45:44",1441701944,"C0",63347,1441765291,"2015-09-08 19:21:31"
"1522","20150820090832-399","3","2015-09-08 02:52:00",1441705920,"C5",537176,1442243096,"2015-09-14 08:04:56"
"3892","20152801042854-889","1","2015-09-08 03:52:22",1441709542,"C4",279704,1441989246,"2015-09-11 09:34:06"
"5319","20153221023253-382","1","2015-09-08 05:18:32",1441714712,"C4",507313,1442222025,"2015-09-14 02:13:45"
"6550","20153229013212-110","1","2015-09-08 06:12:52",1441717972,"C5",418820,1442136792,"2015-09-13 02:33:12"
"5185","20154828034832-528","2","2015-09-08 06:54:54",1441720494,"C2",513826,1442234320,"2015-09-14 05:38:40"
"3364","20150219120223-913","1","2015-09-08 07:15:51",1441721751,"C4",548651,1442270402,"2015-09-14 15:40:02"
"3551","20154919024910-736","3","2015-09-08 10:29:25",1441733365,"C8",342483,1442075848,"2015-09-12 09:37:28"
"821","20154904074940-639","1","2015-09-08 10:42:22",1441734142,"C5",118654,1441852796,"2015-09-09 19:39:56"
"4462","20153805033854-367","3","2015-09-08 10:50:49",1441734649,"C6",241915,1441976564,"2015-09-11 06:02:44"
"5865","20153621043606-60","3","2015-09-08 10:53:45",1441734825,"C3",219237,1441954062,"2015-09-10 23:47:42"
"4315","20154102054122-35","1","2015-09-08 12:20:54",1441740054,"C2",499172,1442239226,"2015-09-14 07:00:26"
"5816","20150510040554-767","1","2015-09-08 12:25:38",1441740338,"C2",311548,1442051886,"2015-09-12 02:58:06"
"6484","20154804054850-394","1","2015-09-08 12:58:48",1441742328,"C5",164099,1441906427,"2015-09-10 10:33:47"
"3680","20155830045808-582","1","2015-09-08 13:30:58",1441744258,"C8",153034,1441897292,"2015-09-10 08:01:32"
"1484","20152127102149-247","2","2015-09-08 13:59:33",1441745973,"C5",466033,1442212006,"2015-09-13 23:26:46"
"6220","20154119074133-741","2","2015-09-08 14:04:45",1441746285,"C3",218874,1441965159,"2015-09-11 02:52:39"
"4167","20154104114100-134","2","2015-09-08 15:15:08",1441750508,"C5",714406,1442464914,"2015-09-16 21:41:54"
"3900","20150328060314-923","1","2015-09-08 16:14:50",1441754090,"C6",610916,1442365006,"2015-09-15 17:56:46"
"5986","20150701070722-706","1","2015-09-08 16:36:52",1441755412,"C2",212990,1441968402,"2015-09-11 03:46:42"
"1408","20152606102611-230","2","2015-09-08 18:01:25",1441760485,"C2",100057,1441860542,"2015-09-09 21:49:02"
"789","20150903020949-595","1","2015-09-08 18:12:22",1441761142,"C2",148851,1441909993,"2015-09-10 11:33:13"
"2139","20150404010414-57","1","2015-09-08 19:02:18",1441764138,"C3",183542,1441947680,"2015-09-10 22:01:20"
"3759","20152128042140-763","3","2015-09-08 19:43:41",1441766621,"C4",137503,1441904124,"2015-09-10 09:55:24"
"2407","20155410055413-237","2","2015-09-08 20:11:25",1441768285,"C6",418972,1442187257,"2015-09-13 16:34:17"
"3418","20155430065457-569","1","2015-09-08 20:31:29",1441769489,"C5",103324,1441872813,"2015-09-10 01:13:33"
"859","20151528041551-821","1","2015-09-08 22:21:29",1441776089,"C7",521534,1442297623,"2015-09-14 23:13:43"
"5932","20155430065423-661","3","2015-09-08 22:27:38",1441776458,"C2",277865,1442054323,"2015-09-12 03:38:43"
"6366","20154001094026-804","3","2015-09-08 23:07:06",1441778826,"C2",416450,1442195276,"2015-09-13 18:47:56"
"4856","20150001070006-104","1","2015-09-08 23:10:07",1441779007,"C5",477343,1442256350,"2015-09-14 11:45:50"
"4963","20152104032137-992","3","2015-09-08 23:56:59",1441781819,"C2",188261,1441970080,"2015-09-11 04:14:40"
"937","20155806065835-432","1","2015-09-09 00:08:27",1441782507,"C7",117296,1441899803,"2015-09-10 08:43:23"
"3753","20151506071555-282","1","2015-09-09 01:25:39",1441787139,"C2",119092,1441906231,"2015-09-10 10:30:31"
"5629","20151526081503-628","1","2015-09-09 01:31:33",1441787493,"C2",1287930,1443075423,"2015-09-23 23:17:03"
"1736","20150605090619-525","2","2015-09-09 02:45:29",1441791929,"C7",161375,1441953304,"2015-09-10 23:35:04"
"3720","20152830112817-503","2","2015-09-09 04:29:23",1441798163,"C4",119838,1441918001,"2015-09-10 13:46:41"
"2409","20154404024444-783","1","2015-09-09 05:56:26",1441803386,"C5",200151,1442003537,"2015-09-11 13:32:17"
"4611","20154519024544-322","False","2015-09-09 07:07:58",1441807678,"C4",201771,1442009449,"2015-09-11 15:10:49"
"5098","20152125062113-255","1","2015-09-09 07:17:07",1441808227,"C7",185622,1441993849,"2015-09-11 10:50:49"
"6282","20154105024125-706","2","2015-09-09 07:18:12",1441808292,"C4",428201,1442236493,"2015-09-14 06:14:53"
"527","20152524042528-383","1","2015-09-09 07:39:20",1441809560,"C6",168854,1441978414,"2015-09-11 06:33:34"
"6456","20155028065044-583","2","2015-09-09 07:43:32",1441809812,"C2",129996,1441939808,"2015-09-10 19:50:08"
"6520","20150724010736-623","1","2015-09-09 07:59:36",1441810776,"C2",170490,1441981266,"2015-09-11 07:21:06"
"5718","20150412090424-439","1","2015-09-09 08:19:18",1441811958,"C2",727842,1442539800,"2015-09-17 18:30:00"
"3545","20153129093103-446","1","2015-09-09 08:50:57",1441813857,"C3",473997,1442287854,"2015-09-14 20:30:54"
"3149","20155424115433-691","1","2015-09-09 10:17:49",1441819069,"C5",688298,1442507367,"2015-09-17 09:29:27"
"5108","20154510114523-240","1","2015-09-09 10:27:15",1441819635,"C4",369616,1442189251,"2015-09-13 17:07:31"
"2735","20154812034822-196","3","2015-09-09 10:40:50",1441820450,"C3",342964,1442163414,"2015-09-13 09:56:54"
"3444","20155628075607-90","1","2015-09-09 11:09:01",1441822141,"C0",349458,1442171599,"2015-09-13 12:13:19"
"5976","20150508040515-409","1","2015-09-09 11:40:23",1441824023,"C6",70508,1441894531,"2015-09-10 07:15:31"
"5679","20153430063422-994","1","2015-09-09 13:06:46",1441829206,"C3",126792,1441955998,"2015-09-11 00:19:58"
"5567","20155917095958-769","2","2015-09-09 13:26:28",1441830388,"C6",779665,1442610053,"2015-09-18 14:00:53"
"6548","20154522074508-296","3","2015-09-09 14:00:53",1441832453,"C5",525915,1442358368,"2015-09-15 16:06:08"
"5341","20153209083207-54","1","2015-09-09 14:54:15",1441835655,"C5",385904,1442221559,"2015-09-14 02:05:59"
"351","20153131083117-488","1","2015-09-09 15:02:44",1441836164,"C5",267029,1442103193,"2015-09-12 17:13:13"
"3679","20151908111910-929","1","2015-09-09 15:10:32",1441836632,"C5",1389341,1443225973,"2015-09-25 17:06:13"
"3162","20155024015018-365","3","2015-09-09 15:13:53",1441836833,"C8",277483,1442114316,"2015-09-12 20:18:36"
"4243","20152605082604-337","1","2015-09-09 15:46:40",1441838800,"C5",124012,1441962812,"2015-09-11 02:13:32"
"4577","20151729071748-127","1","2015-09-09 15:51:08",1441839068,"C8",731920,1442570988,"2015-09-18 03:09:48"
"2510","20155205045234-468","2","2015-09-09 16:16:10",1441840570,"C5",171708,1442012278,"2015-09-11 15:57:58"
"3287","20150001050042-811","1","2015-09-09 17:20:20",1441844420,"C7",346189,1442190609,"2015-09-13 17:30:09"
"1080","20153801033808-197","2","2015-09-09 18:52:18",1441849938,"C2",351425,1442201363,"2015-09-13 20:29:23"
"5133","20151728051728-164","2","2015-09-09 19:14:34",1441851274,"C5",347942,1442199216,"2015-09-13 19:53:36"
"4788","20153208023216-402","2","2015-09-09 19:51:18",1441853478,"C2",105542,1441959020,"2015-09-11 01:10:20"
"2734","20152108122142-303","2","2015-09-09 20:18:54",1441855134,"C5",1396716,1443251850,"2015-09-26 00:17:30"
"135","20152610052623-296","1","2015-09-09 20:47:15",1441856835,"C7",754636,1442611471,"2015-09-18 14:24:31"
"1030","20151217101212-140","1","2015-09-09 20:58:44",1441857524,"C5",588049,1442445573,"2015-09-16 16:19:33"
"3271","20153824013848-746","1","2015-09-09 21:26:47",1441859207,"C8",201497,1442060704,"2015-09-12 05:25:04"
"6259","20153605103654-343","1","2015-09-09 21:45:06",1441860306,"C8",192846,1442053152,"2015-09-12 03:19:12"
"3134","20151304011353-532","1","2015-09-09 22:02:26",1441861346,"C4",463713,1442325059,"2015-09-15 06:50:59"
"5878","20150730090701-127","3","2015-09-09 22:03:47",1441861427,"C5",455303,1442316730,"2015-09-15 04:32:10"
"5545","20151307011356-805","2","2015-09-09 22:31:52",1441863112,"C0",103138,1441966250,"2015-09-11 03:10:50"
"3662","20155929085958-172","2","2015-09-09 22:56:46",1441864606,"C2",125076,1441989682,"2015-09-11 09:41:22"
"5080","20155107095150-103","2","2015-09-09 23:59:26",1441868366,"C0",74552,1441942918,"2015-09-10 20:41:58"
"5224","20154501024521-895","1","2015-09-09 23:59:53",1441868393,"C4",103496,1441971889,"2015-09-11 04:44:49"
"1042","20150704020738-670","3","2015-09-10 00:04:56",1441868696,"C5",233919,1442102615,"2015-09-12 17:03:35"
"5575","20154601104625-869","1","2015-09-10 00:34:18",1441870458,"C7",105839,1441976297,"2015-09-11 05:58:17"
"3681","20150619070601-944","3","2015-09-10 01:04:49",1441872289,"C6",569691,1442441980,"2015-09-16 15:19:40"
"3357","20154615054634-509","2","2015-09-10 02:13:06",1441876386,"C2",273799,1442150185,"2015-09-13 06:16:25"
"5586","20153828023832-687","3","2015-09-10 02:42:52",1441878172,"C8",540130,1442418302,"2015-09-16 08:45:02"
"3170","20155807055827-460","2","2015-09-10 03:00:48",1441879248,"C3",411963,1442291211,"2015-09-14 21:26:51"
"6318","20154730074747-926","1","2015-09-10 03:43:50",1441881830,"C3",311921,1442193751,"2015-09-13 18:22:31"
"1740","20155310035300-431","1","2015-09-10 04:40:12",1441885212,"C6",886072,1442771284,"2015-09-20 10:48:04"
"4852","20152322032341-450","1","2015-09-10 04:43:17",1441885397,"C5",535197,1442420594,"2015-09-16 09:23:14"
"4299","20150906120952-835","1","2015-09-10 04:58:26",1441886306,"C5",428302,1442314608,"2015-09-15 03:56:48"
"1676","20152527092517-772","1","2015-09-10 04:59:52",1441886392,"C3",170525,1442056917,"2015-09-12 04:21:57"
"5156","20153614123621-352","3","2015-09-10 05:19:25",1441887565,"C4",329512,1442217077,"2015-09-14 00:51:17"
"5747","20150420070433-947","1","2015-09-10 05:30:42",1441888242,"C4",602923,1442491165,"2015-09-17 04:59:25"
"3888","20155922065913-325","2","2015-09-10 05:36:09",1441888569,"C5",204577,1442093146,"2015-09-12 14:25:46"
"5390","20155230075218-899","3","2015-09-10 06:11:55",1441890715,"C5",134911,1442025626,"2015-09-11 19:40:26"
"3030","20151627111655-590","1","2015-09-10 06:37:12",1441892232,"C7",553031,1442445263,"2015-09-16 16:14:23"
"4395","20153629023651-616","2","2015-09-10 07:00:39",1441893639,"C5",144204,1442037843,"2015-09-11 23:04:03"
"735","20154903014909-323","3","2015-09-10 07:43:51",1441896231,"C8",291441,1442187672,"2015-09-13 16:41:12"
"3824","20153929033958-663","1","2015-09-10 07:43:52",1441896232,"C8",504117,1442400349,"2015-09-16 03:45:49"
"2505","20150908120943-943","1","2015-09-10 07:56:17",1441896977,"C8",78797,1441975774,"2015-09-11 05:49:34"
"6145","20151225041253-640","2","2015-09-10 08:19:15",1441898355,"C5",676991,1442575346,"2015-09-18 04:22:26"
"4281","20152419032457-473","2","2015-09-10 09:10:03",1441901403,"C5",626102,1442527505,"2015-09-17 15:05:05"
"4907","20150228110224-816","1","2015-09-10 09:19:50",1441901990,"C4",159578,1442061568,"2015-09-12 05:39:28"
"5654","20155429065420-360","1","2015-09-10 09:27:05",1441902425,"C5",348655,1442251080,"2015-09-14 10:18:00"
"4959","20151029121032-170","1","2015-09-10 10:15:12",1441905312,"C5",514940,1442420252,"2015-09-16 09:17:32"
"3670","20155819015821-968","1","2015-09-10 12:01:09",1441911669,"C6",315628,1442227297,"2015-09-14 03:41:37"
"5834","20152231032211-936","3","2015-09-10 12:03:17",1441911797,"C4",426033,1442337830,"2015-09-15 10:23:50"
"858","20151808121857-411","1","2015-09-10 12:08:17",1441912097,"C5",1015120,1442927217,"2015-09-22 06:06:57"
"3338","20153228113210-234","1","2015-09-10 12:12:24",1441912344,"C7",160802,1442073146,"2015-09-12 08:52:26"
"3117","20153004123036-930","1","2015-09-10 12:14:07",1441912447,"C4",517411,1442429858,"2015-09-16 11:57:38"
"1936","20150524040536-313","1","2015-09-10 12:34:18",1441913658,"C2",590646,1442504304,"2015-09-17 08:38:24"
"730","20154727044758-903","2","2015-09-10 13:42:46",1441917766,"C2",149811,1442067577,"2015-09-12 07:19:37"
"5038","20153110103147-254","3","2015-09-10 15:06:41",1441922801,"C6",449149,1442371950,"2015-09-15 19:52:30"
"364","20150127030133-376","1","2015-09-10 15:07:08",1441922828,"C8",241987,1442164815,"2015-09-13 10:20:15"
"1270","20151217121243-265","1","2015-09-10 15:11:26",1441923086,"C3",680389,1442603475,"2015-09-18 12:11:15"
"5725","20155230025241-974","3","2015-09-10 18:57:08",1441936628,"C5",321689,1442258317,"2015-09-14 12:18:37"
"3307","20153430053418-339","3","2015-09-10 19:32:51",1441938771,"C5",319171,1442257942,"2015-09-14 12:12:22"
"4892","20151204031221-340","1","2015-09-10 19:42:53",1441939373,"C7",267316,1442206689,"2015-09-13 21:58:09"
"3696","20153816093827-264","1","2015-09-10 19:52:27",1441939947,"C8",439368,1442379315,"2015-09-15 21:55:15"
"4419","20154825014843-884","2","2015-09-10 19:59:38",1441940378,"C5",200665,1442141043,"2015-09-13 03:44:03"
"2220","20151201031214-85","1","2015-09-10 20:27:34",1441942054,"C4",434365,1442376419,"2015-09-15 21:06:59"
"606","20152208052219-435","1","2015-09-10 20:40:53",1441942853,"C4",92357,1442035210,"2015-09-11 22:20:10"
"1156","20151318021301-158","2","2015-09-10 21:13:10",1441944790,"C2",670803,1442615593,"2015-09-18 15:33:13"
"2096","20150504020535-36","1","2015-09-10 22:12:51",1441948371,"C3",273818,1442222189,"2015-09-14 02:16:29"
"992","20150921120902-568","2","2015-09-10 23:00:36",1441951236,"C7",252442,1442203678,"2015-09-13 21:07:58"
"3912","20152208042243-251","3","2015-09-10 23:08:27",1441951707,"C5",98572,1442050279,"2015-09-12 02:31:19"
"6290","20153809053851-563","1","2015-09-10 23:17:13",1441952233,"C5",53351,1442005584,"2015-09-11 14:06:24"
"3959","20154904024927-977","1","2015-09-10 23:38:12",1441953492,"C3",183375,1442136867,"2015-09-13 02:34:27"
"5662","20151108071113-261","2","2015-09-11 00:07:47",1441955267,"C5",116897,1442072164,"2015-09-12 08:36:04"
"1349","20152130082153-677","1","2015-09-11 00:15:17",1441955717,"C6",167934,1442123651,"2015-09-12 22:54:11"
"857","20151724021705-148","1","2015-09-11 01:22:13",1441959733,"C8",968444,1442928177,"2015-09-22 06:22:57"
"5648","20154003054009-197","1","2015-09-11 02:33:45",1441964025,"C5",749202,1442713227,"2015-09-19 18:40:27"
"4340","20150507120531-544","2","2015-09-11 04:16:15",1441970175,"C4",158722,1442128897,"2015-09-13 00:21:37"
"4527","20150028050007-273","2","2015-09-11 04:56:07",1441972567,"C2",429104,1442401671,"2015-09-16 04:07:51"
"954","20153701043709-900","1","2015-09-11 05:21:41",1441974101,"C2",437734,1442411835,"2015-09-16 06:57:15"
"3024","20154803014805-523","1","2015-09-11 05:33:20",1441974800,"C8",667983,1442642783,"2015-09-18 23:06:23"
"5261","20154622044617-838","2","2015-09-11 07:31:52",1441981912,"C2",242105,1442224017,"2015-09-14 02:46:57"
"2527","20155403055431-688","1","2015-09-11 08:00:10",1441983610,"C4",218513,1442202123,"2015-09-13 20:42:03"
"1211","20154514024558-986","3","2015-09-11 08:32:50",1441985570,"C5",1198406,1443183976,"2015-09-25 05:26:16"
"1941","20153807073822-145","3","2015-09-11 09:07:58",1441987678,"C2",175488,1442163166,"2015-09-13 09:52:46"
"382","20151507031539-411","3","2015-09-11 09:10:06",1441987806,"C7",333563,1442321369,"2015-09-15 05:49:29"
"127","20150426120423-659","1","2015-09-11 09:23:01",1441988581,"C5",686359,1442674940,"2015-09-19 08:02:20"
"490","20154715114704-310","1","2015-09-11 09:25:46",1441988746,"C2",332046,1442320792,"2015-09-15 05:39:52"
"1614","20154529014510-493","2","2015-09-11 10:06:10",1441991170,"C8",158580,1442149750,"2015-09-13 06:09:10"
"3925","20153515113516-627","3","2015-09-11 10:18:56",1441991936,"C8",465644,1442457580,"2015-09-16 19:39:40"
"6070","20151531051542-946","1","2015-09-11 10:24:32",1441992272,"C8",185146,1442177418,"2015-09-13 13:50:18"
"2145","20151510101536-354","2","2015-09-11 10:58:27",1441994307,"C6",88971,1442083278,"2015-09-12 11:41:18"
"5411","20153711073708-752","1","2015-09-11 11:36:05",1441996565,"C7",299193,1442295758,"2015-09-14 22:42:38"
"4876","20151326031321-981","2","2015-09-11 12:49:18",1442000958,"C8",196251,1442197209,"2015-09-13 19:20:09"
"1051","20152505052550-320","3","2015-09-11 14:00:05",1442005205,"C4",168685,1442173890,"2015-09-13 12:51:30"
"1585","20151915021949-470","1","2015-09-11 14:21:05",1442006465,"C4",333268,1442339733,"2015-09-15 10:55:33"
"3336","20151502021555-920","2","2015-09-11 14:49:45",1442008185,"C8",691606,1442699791,"2015-09-19 14:56:31"
"2365","20153103053109-344","3","2015-09-11 15:08:27",1442009307,"C0",682638,1442691945,"2015-09-19 12:45:45"
"1290","20154404044452-704","2","2015-09-11 15:15:44",1442009744,"C4",85636,1442095380,"2015-09-12 15:03:00"
"5708","20153308013340-678","2","2015-09-11 15:54:52",1442012092,"C4",89224,1442101316,"2015-09-12 16:41:56"
"4097","20155506045534-554","1","2015-09-11 16:20:40",1442013640,"C5",1036102,1443049742,"2015-09-23 16:09:02"
"650","20150930080915-526","1","2015-09-11 16:22:12",1442013732,"C4",355459,1442369191,"2015-09-15 19:06:31"
"1267","20151030111021-959","1","2015-09-11 16:39:55",1442014795,"C8",528287,1442543082,"2015-09-17 19:24:42"
"2265","20155822075801-949","1","2015-09-11 16:44:41",1442015081,"C7",634000,1442649081,"2015-09-19 00:51:21"
"4311","20153411103429-694","1","2015-09-11 18:21:12",1442020872,"C8",386629,1442407501,"2015-09-16 05:45:01"
"3269","20150608090629-720","2","2015-09-11 19:55:04",1442026504,"C8",807845,1442834349,"2015-09-21 04:19:09"
"3066","20152123032134-92","2","2015-09-11 20:09:07",1442027347,"C8",236979,1442264326,"2015-09-14 13:58:46"
"2897","20154508084534-828","1","2015-09-11 20:35:40",1442028940,"C5",100602,1442129542,"2015-09-13 00:32:22"
"1215","20155006025053-216","2","2015-09-11 20:58:07",1442030287,"C4",227017,1442257304,"2015-09-14 12:01:44"
"324","20150208060247-95","1","2015-09-11 21:39:08",1442032748,"C5",105127,1442137875,"2015-09-13 02:51:15"
"1137","20151101081129-848","1","2015-09-11 22:02:41",1442034161,"C0",783834,1442817995,"2015-09-20 23:46:35"
"5295","20153209113252-119","1","2015-09-11 22:50:28",1442037028,"C4",361482,1442398510,"2015-09-16 03:15:10"
"4232","20152816112859-104","1","2015-09-11 23:35:39",1442039739,"C3",945050,1442984789,"2015-09-22 22:06:29"
"6538","20152101122110-544","1","2015-09-12 00:31:58",1442043118,"C4",113481,1442156599,"2015-09-13 08:03:19"
"2616","20154207064238-836","1","2015-09-12 01:12:26",1442045546,"C5",137396,1442182942,"2015-09-13 15:22:22"
"3602","20152420122408-685","3","2015-09-12 01:32:28",1442046748,"C5",278300,1442325048,"2015-09-15 06:50:48"
"2230","20152405042448-474","2","2015-09-12 01:32:58",1442046778,"C2",55129,1442101907,"2015-09-12 16:51:47"
"144","20154305054350-339","1","2015-09-12 02:15:56",1442049356,"C5",274563,1442323919,"2015-09-15 06:31:59"
"5675","20155305015326-67","1","2015-09-12 02:23:50",1442049830,"C7",281712,1442331542,"2015-09-15 08:39:02"
"1378","20152531102541-22","1","2015-09-12 02:31:37",1442050297,"C4",504178,1442554475,"2015-09-17 22:34:35"
"5653","20154926104933-124","1","2015-09-12 02:40:58",1442050858,"C8",287897,1442338755,"2015-09-15 10:39:15"
"1510","20150710110737-521","1","2015-09-12 04:54:05",1442058845,"C2",75194,1442134039,"2015-09-13 01:47:19"
"6534","20152928122912-286","2","2015-09-12 05:02:00",1442059320,"C5",158646,1442217966,"2015-09-14 01:06:06"
"3618","20151017101005-541","1","2015-09-12 05:07:25",1442059645,"C5",278530,1442338175,"2015-09-15 10:29:35"
"3947","20151710031722-962","1","2015-09-12 05:21:18",1442060478,"C5",68518,1442128996,"2015-09-13 00:23:16"
"5103","20155605105623-939","1","2015-09-12 05:21:26",1442060486,"C5",194901,1442255387,"2015-09-14 11:29:47"
"5547","20154830054857-116","3","2015-09-12 06:56:30",1442066190,"C4",361351,1442427541,"2015-09-16 11:19:01"
"6022","20155107025120-910","2","2015-09-12 07:00:40",1442066440,"C0",403760,1442470200,"2015-09-16 23:10:00"
"2038","20151901101926-562","1","2015-09-12 07:13:46",1442067226,"C8",187852,1442255078,"2015-09-14 11:24:38"
"1426","20150428030425-959","2","2015-09-12 07:16:57",1442067417,"C5",158494,1442225911,"2015-09-14 03:18:31"
"6450","20153011043031-930","1","2015-09-12 08:23:23",1442071403,"C0",57172,1442128575,"2015-09-13 00:16:15"
"5498","20154311024355-911","1","2015-09-12 09:02:36",1442073756,"C0",65921,1442139677,"2015-09-13 03:21:17"
"1772","20154308124319-670","1","2015-09-12 10:17:17",1442078237,"C5",168419,1442246656,"2015-09-14 09:04:16"
"852","20150430020414-999","2","2015-09-12 11:55:38",1442084138,"C4",371828,1442455966,"2015-09-16 19:12:46"
"4301","20151729091748-733","1","2015-09-12 12:05:48",1442084748,"C6",649680,1442734428,"2015-09-20 00:33:48"
"4364","20150821110852-676","1","2015-09-12 12:25:46",1442085946,"C0",272202,1442358148,"2015-09-15 16:02:28"
"2231","20153910033927-41","1","2015-09-12 12:44:18",1442087058,"C5",946897,1443033955,"2015-09-23 11:45:55"
"2699","20155807055837-636","2","2015-09-12 13:51:33",1442091093,"C2",52147,1442143240,"2015-09-13 04:20:40"
"5417","20151725071716-115","1","2015-09-12 13:55:32",1442091332,"C6",197387,1442288719,"2015-09-14 20:45:19"
"6134","20150209060217-820","2","2015-09-12 14:31:37",1442093497,"C5",144880,1442238377,"2015-09-14 06:46:17"
"4172","20151930121913-276","2","2015-09-12 14:37:50",1442093870,"C2",1131517,1443225387,"2015-09-25 16:56:27"
"2471","20153211073233-705","1","2015-09-12 14:42:19",1442094139,"C4",112186,1442206325,"2015-09-13 21:52:05"
"284","20150328090330-172","1","2015-09-12 15:01:46",1442095306,"C3",164687,1442259993,"2015-09-14 12:46:33"
"2753","20154011054033-757","2","2015-09-12 16:51:15",1442101875,"C6",83442,1442185317,"2015-09-13 16:01:57"
"398","20154511024505-828","1","2015-09-12 18:28:28",1442107708,"C6",99803,1442207511,"2015-09-13 22:11:51"
"4563","20154208074227-295","2","2015-09-12 18:56:47",1442109407,"C8",193030,1442302437,"2015-09-15 00:33:57"
"5376","20151907121926-813","2","2015-09-12 19:38:08",1442111888,"C3",152774,1442264662,"2015-09-14 14:04:22"
"615","20153224093211-44","1","2015-09-12 19:56:34",1442112994,"C2",1679063,1443792057,"2015-10-02 06:20:57"
"5366","20150306050305-235","2","2015-09-12 20:32:38",1442115158,"C2",176991,1442292149,"2015-09-14 21:42:29"
"5218","20155206105202-711","1","2015-09-12 20:48:02",1442116082,"C0",184720,1442300802,"2015-09-15 00:06:42"
"3452","20151405051442-519","3","2015-09-12 21:11:04",1442117464,"C7",88426,1442205890,"2015-09-13 21:44:50"
"3965","20150707050739-597","2","2015-09-12 22:35:00",1442122500,"C3",150547,1442273047,"2015-09-14 16:24:07"
"3505","20151824121846-361","2","2015-09-12 22:58:04",1442123884,"C2",239994,1442363878,"2015-09-15 17:37:58"
"2329","20153823083813-827","1","2015-09-12 23:23:07",1442125387,"C3",254442,1442379829,"2015-09-15 22:03:49"
"4026","20153124123117-215","2","2015-09-12 23:36:36",1442126196,"C0",240217,1442366413,"2015-09-15 18:20:13"
"3185","20151926041922-655","1","2015-09-13 00:12:26",1442128346,"C5",845948,1442974294,"2015-09-22 19:11:34"
"5646","20151910031909-576","1","2015-09-13 01:23:09",1442132589,"C5",69680,1442202269,"2015-09-13 20:44:29"
"6011","20150904100901-193","1","2015-09-13 01:29:43",1442132983,"C7",373221,1442506204,"2015-09-17 09:10:04"
"4631","20150408020442-543","1","2015-09-13 01:33:38",1442133218,"C3",193468,1442326686,"2015-09-15 07:18:06"
"4969","20150514100544-988","2","2015-09-13 01:38:51",1442133531,"C2",365941,1442499472,"2015-09-17 07:17:52"
"4028","20152924102954-975","1","2015-09-13 01:51:03",1442134263,"C7",1071741,1443206004,"2015-09-25 11:33:24"
"3325","20151406051448-965","1","2015-09-13 01:51:56",1442134316,"C7",274714,1442409030,"2015-09-16 06:10:30"
"3608","20153211053257-976","2","2015-09-13 02:04:57",1442135097,"C4",58560,1442193657,"2015-09-13 18:20:57"
"518","20153607093625-365","1","2015-09-13 02:27:15",1442136435,"C5",246325,1442382760,"2015-09-15 22:52:40"
"3231","20152908042900-407","1","2015-09-13 02:50:36",1442137836,"C8",191448,1442329284,"2015-09-15 08:01:24"
"706","20153423063429-324","3","2015-09-13 03:37:09",1442140629,"C2",257680,1442398309,"2015-09-16 03:11:49"
"5278","20152030082047-827","2","2015-09-13 03:49:46",1442141386,"C4",170477,1442311863,"2015-09-15 03:11:03"
"5232","20154221124220-61","1","2015-09-13 05:44:04",1442148244,"C3",245263,1442393507,"2015-09-16 01:51:47"
"653","20155407095443-656","2","2015-09-13 07:53:25",1442156005,"C3",255561,1442411566,"2015-09-16 06:52:46"
"1423","20152310032333-876","2","2015-09-13 08:09:21",1442156961,"C2",77716,1442234677,"2015-09-14 05:44:37"
"3797","20153809063840-685","3","2015-09-13 08:14:12",1442157252,"C7",175666,1442332918,"2015-09-15 09:01:58"
"604","20152806082844-502","1","2015-09-13 08:18:59",1442157539,"C8",120843,1442278382,"2015-09-14 17:53:02"
"3695","20154030024055-701","3","2015-09-13 09:46:39",1442162799,"C6",148993,1442311792,"2015-09-15 03:09:52"
"3487","20155323025342-437","3","2015-09-13 10:38:22",1442165902,"C5",224885,1442390787,"2015-09-16 01:06:27"
"4241","20152028072051-354","2","2015-09-13 10:57:05",1442167025,"C8",697687,1442864712,"2015-09-21 12:45:12"
"5203","20152904062902-66","1","2015-09-13 11:03:14",1442167394,"C8",397026,1442564420,"2015-09-18 01:20:20"
"5812","20155204055205-222","3","2015-09-13 11:52:53",1442170373,"C6",429306,1442599679,"2015-09-18 11:07:59"
"6143","20153129063108-867","2","2015-09-13 13:48:17",1442177297,"C2",1322229,1443499526,"2015-09-28 21:05:26"
"4923","20155931025933-274","1","2015-09-13 14:04:56",1442178296,"C7",159989,1442338285,"2015-09-15 10:31:25"
"1842","20155703035752-285","1","2015-09-13 14:20:52",1442179252,"C7",429090,1442608342,"2015-09-18 13:32:22"
"3046","20153406083425-63","3","2015-09-13 15:07:05",1442182025,"C2",78545,1442260570,"2015-09-14 12:56:10"
"40","20155720055708-822","1","2015-09-13 15:29:48",1442183388,"C8",412952,1442596340,"2015-09-18 10:12:20"
"1052","20153604073635-88","2","2015-09-13 19:32:27",1442197947,"C4",102569,1442300516,"2015-09-15 00:01:56"
"2223","20155107125121-144","2","2015-09-13 20:04:59",1442199899,"C3",544418,1442744317,"2015-09-20 03:18:37"
"1149","20155122055108-85","1","2015-09-13 20:21:40",1442200900,"C2",238729,1442439629,"2015-09-16 14:40:29"
"6497","20152330122319-139","3","2015-09-13 20:53:43",1442202823,"C6",206704,1442409527,"2015-09-16 06:18:47"
"401","20153001123033-350","1","2015-09-13 21:05:53",1442203553,"C4",803065,1443006618,"2015-09-23 04:10:18"
"622","20155228105231-492","1","2015-09-13 21:45:25",1442205925,"C2",203082,1442409007,"2015-09-16 06:10:07"
"4103","20151928121941-484","3","2015-09-13 21:55:13",1442206513,"C5",708466,1442914979,"2015-09-22 02:42:59"
"5950","20150901040932-288","1","2015-09-13 23:03:57",1442210637,"C8",534295,1442744932,"2015-09-20 03:28:52"
"5703","20153329043300-437","2","2015-09-13 23:07:36",1442210856,"C4",439892,1442650748,"2015-09-19 01:19:08"
"2826","20155211075227-27","1","2015-09-13 23:35:57",1442212557,"C0",114705,1442327262,"2015-09-15 07:27:42"
"2275","20150808010856-926","1","2015-09-13 23:47:20",1442213240,"C3",156768,1442370008,"2015-09-15 19:20:08"
"1666","20155118075124-295","1","2015-09-14 04:41:09",1442230869,"C8",464277,1442695146,"2015-09-19 13:39:06"
"1220","20152411022428-441","1","2015-09-14 04:42:36",1442230956,"C4",112144,1442343100,"2015-09-15 11:51:40"
"4692","20154409084413-801","3","2015-09-14 05:01:29",1442232089,"C8",209318,1442441407,"2015-09-16 15:10:07"
"3424","20151127101117-321","2","2015-09-14 05:15:38",1442232938,"C4",512487,1442745425,"2015-09-20 03:37:05"
"2767","20155018105000-729","2","2015-09-14 05:36:24",1442234184,"C4",289248,1442523432,"2015-09-17 13:57:12"
"6033","20151106071138-520","2","2015-09-14 05:47:30",1442234850,"C0",343076,1442577926,"2015-09-18 05:05:26"
"2884","20151224041242-581","2","2015-09-14 06:31:30",1442237490,"C2",222441,1442459931,"2015-09-16 20:18:51"
"3081","20154010044016-420","1","2015-09-14 06:49:06",1442238546,"C8",155065,1442393611,"2015-09-16 01:53:31"
"2650","20153517023507-15","1","2015-09-14 07:17:37",1442240257,"C2",1196475,1443436732,"2015-09-28 03:38:52"
"2355","20154704084736-736","3","2015-09-14 07:21:30",1442240490,"C7",95426,1442335916,"2015-09-15 09:51:56"
"1195","20154120094127-321","3","2015-09-14 10:14:07",1442250847,"C5",605045,1442855892,"2015-09-21 10:18:12"
"980","20154315114328-382","1","2015-09-14 10:21:15",1442251275,"C2",369581,1442620856,"2015-09-18 17:00:56"
"2287","20151004081041-724","1","2015-09-14 11:05:21",1442253921,"C5",437240,1442691161,"2015-09-19 12:32:41"
"6365","20152812042819-422","2","2015-09-14 11:20:49",1442254849,"C5",77175,1442332024,"2015-09-15 08:47:04"
"4905","20150920070902-234","1","2015-09-14 11:23:32",1442255012,"C6",808945,1443063957,"2015-09-23 20:05:57"
"4480","20150913060942-503","1","2015-09-14 11:26:56",1442255216,"C6",105434,1442360650,"2015-09-15 16:44:10"
"1909","20154730114701-335","3","2015-09-14 11:54:38",1442256878,"C6",1296457,1443553335,"2015-09-29 12:02:15"
"3555","20151809121805-29","1","2015-09-14 11:57:34",1442257054,"C8",444167,1442701221,"2015-09-19 15:20:21"
"6524","20151311031311-115","1","2015-09-14 12:01:50",1442257310,"C5",82573,1442339883,"2015-09-15 10:58:03"
"3239","20150408090432-622","1","2015-09-14 12:59:50",1442260790,"C5",177506,1442438296,"2015-09-16 14:18:16"
"3000","20150929030929-812","1","2015-09-14 13:09:07",1442261347,"C2",196454,1442457801,"2015-09-16 19:43:21"
"29","20152608012606-941","1","2015-09-14 13:25:00",1442262300,"C5",172778,1442435078,"2015-09-16 13:24:38"
"168","20151109051100-693","3","2015-09-14 13:27:24",1442262444,"C4",139528,1442401972,"2015-09-16 04:12:52"
"2152","20152211122236-998","2","2015-09-14 14:38:33",1442266713,"C4",89119,1442355832,"2015-09-15 15:23:52"
"2288","20152914112948-207","1","2015-09-14 15:09:00",1442268540,"C0",671244,1442939784,"2015-09-22 09:36:24"
"1961","20153430123444-403","1","2015-09-14 15:57:40",1442271460,"C2",163522,1442434982,"2015-09-16 13:23:02"
"6003","20154909044956-518","3","2015-09-14 17:21:32",1442276492,"C4",433896,1442710388,"2015-09-19 17:53:08"
"3506","20155609015650-953","2","2015-09-14 19:01:17",1442282477,"C0",150089,1442432566,"2015-09-16 12:42:46"
"2832","20154701054735-930","2","2015-09-14 19:06:15",1442282775,"C8",225584,1442508359,"2015-09-17 09:45:59"
"2350","20154823104821-280","3","2015-09-14 20:22:29",1442287349,"C2",241906,1442529255,"2015-09-17 15:34:15"
"5930","20152007032057-494","3","2015-09-14 20:34:57",1442288097,"C5",77955,1442366052,"2015-09-15 18:14:12"
"3360","20150105120114-572","3","2015-09-14 20:54:54",1442289294,"C8",115660,1442404954,"2015-09-16 05:02:34"
"3928","20151611081603-412","2","2015-09-15 01:10:45",1442304645,"C5",106694,1442411339,"2015-09-16 06:48:59"
"1501","20154102114141-894","3","2015-09-15 01:42:42",1442306562,"C8",155323,1442461885,"2015-09-16 20:51:25"
"5744","20152513092548-480","1","2015-09-15 01:47:48",1442306868,"C4",352965,1442659833,"2015-09-19 03:50:33"
"2943","20155507025528-30","2","2015-09-15 02:36:14",1442309774,"C8",323423,1442633197,"2015-09-18 20:26:37"
"4467","20155208045228-597","3","2015-09-15 02:53:58",1442310838,"C7",277245,1442588083,"2015-09-18 07:54:43"
"4391","20153612103624-436","2","2015-09-15 03:30:32",1442313032,"C4",116824,1442429856,"2015-09-16 11:57:36"
"105","20154504024526-617","3","2015-09-15 03:39:56",1442313596,"C8",455235,1442768831,"2015-09-20 10:07:11"
"6501","20154505034517-211","1","2015-09-15 03:40:01",1442313601,"C8",410242,1442723843,"2015-09-19 21:37:23"
"5398","20152520022515-874","2","2015-09-15 04:07:28",1442315248,"C5",315619,1442630867,"2015-09-18 19:47:47"
"6252","20153605023617-415","1","2015-09-15 04:09:37",1442315377,"C5",103300,1442418677,"2015-09-16 08:51:17"
"3496","20150124040121-291","1","2015-09-15 04:37:21",1442317041,"C5",232470,1442549511,"2015-09-17 21:11:51"
"6460","20152405092403-279","1","2015-09-15 04:45:30",1442317530,"C0",282429,1442599959,"2015-09-18 11:12:39"
"6223","20153813093821-524","2","2015-09-15 04:49:17",1442317757,"C3",77728,1442395485,"2015-09-16 02:24:45"
"5660","20155812115802-110","2","2015-09-15 05:02:00",1442318520,"C5",117119,1442435639,"2015-09-16 13:33:59"
"3701","20152212012249-243","1","2015-09-15 05:52:57",1442321577,"C3",116104,1442437681,"2015-09-16 14:08:01"
"138","20152131052130-113","1","2015-09-15 05:55:41",1442321741,"C5",561893,1442883634,"2015-09-21 18:00:34"
"414","20150321080317-281","1","2015-09-15 06:38:53",1442324333,"C4",269367,1442593700,"2015-09-18 09:28:20"
"6024","20152613102657-412","2","2015-09-15 06:52:13",1442325133,"C8",79958,1442405091,"2015-09-16 05:04:51"
"3581","20155712125720-473","1","2015-09-15 07:24:40",1442327080,"C0",699505,1443026585,"2015-09-23 09:43:05"
"2462","20155011115006-613","1","2015-09-15 07:28:13",1442327293,"C2",329887,1442657180,"2015-09-19 03:06:20"
"5473","20155326035314-70","1","2015-09-15 07:54:25",1442328865,"C3",242753,1442571618,"2015-09-18 03:20:18"
"101","20150613120634-302","1","2015-09-15 08:25:08",1442330708,"C7",79757,1442410465,"2015-09-16 06:34:25"
"1162","20153113123129-802","1","2015-09-15 09:42:17",1442335337,"C5",81324,1442416661,"2015-09-16 08:17:41"
"5265","20155424095403-620","1","2015-09-15 10:36:11",1442338571,"C3",896716,1443235287,"2015-09-25 19:41:27"
"3437","20150607030612-158","1","2015-09-15 11:02:30",1442340150,"C2",225526,1442565676,"2015-09-18 01:41:16"
"3935","20152712102746-890","1","2015-09-15 11:19:37",1442341177,"C6",262311,1442603488,"2015-09-18 12:11:28"
"4819","20150612040643-903","1","2015-09-15 11:51:29",1442343089,"C0",243886,1442586975,"2015-09-18 07:36:15"
"3946","20153412033456-768","1","2015-09-15 13:02:08",1442347328,"C3",83344,1442430672,"2015-09-16 12:11:12"
"5951","20151411121401-100","1","2015-09-15 13:59:57",1442350797,"C5",175978,1442526775,"2015-09-17 14:52:55"
"5252","20154310044355-435","1","2015-09-15 14:58:07",1442354287,"C8",443436,1442797723,"2015-09-20 18:08:43"
"5047","20150105070153-470","1","2015-09-15 15:49:20",1442357360,"C2",895647,1443253007,"2015-09-26 00:36:47"
"3319","20154808094807-64","2","2015-09-15 16:10:46",1442358646,"C4",627759,1442986405,"2015-09-22 22:33:25"
"4424","20151324041323-86","1","2015-09-15 16:52:08",1442361128,"C0",271875,1442633003,"2015-09-18 20:23:23"
"2848","20154912104945-323","3","2015-09-15 16:56:02",1442361362,"C6",281177,1442642539,"2015-09-18 23:02:19"
"4330","20151931021927-541","3","2015-09-15 16:57:07",1442361427,"C8",261092,1442622519,"2015-09-18 17:28:39"
"3017","20155307075336-227","2","2015-09-15 17:29:22",1442363362,"C2",103678,1442467040,"2015-09-16 22:17:20"
"214","20150413020432-24","3","2015-09-15 18:27:54",1442366874,"C7",94301,1442461175,"2015-09-16 20:39:35"
"6391","20155911015958-174","2","2015-09-15 18:49:12",1442368152,"C5",181477,1442549629,"2015-09-17 21:13:49"
"4351","20154212104231-5","3","2015-09-15 19:18:15",1442369895,"C3",705868,1443075763,"2015-09-23 23:22:43"
"6293","20152505102537-378","3","2015-09-15 19:34:45",1442370885,"C0",448474,1442819359,"2015-09-21 00:09:19"
"3572","20154228044234-553","2","2015-09-15 19:37:12",1442371032,"C5",782839,1443153871,"2015-09-24 21:04:31"
"4042","20155023105006-119","2","2015-09-15 20:08:48",1442372928,"C2",673574,1443046502,"2015-09-23 15:15:02"
"4440","20154214064217-704","1","2015-09-15 20:19:07",1442373547,"C7",1406905,1443780452,"2015-10-02 03:07:32"
"4576","20153311123312-935","2","2015-09-15 20:23:19",1442373799,"C4",373807,1442747606,"2015-09-20 04:13:26"
"3584","20151622101630-477","1","2015-09-15 20:32:57",1442374377,"C4",703529,1443077906,"2015-09-23 23:58:26"
"4690","20154612124610-968","2","2015-09-15 21:44:17",1442378657,"C3",291487,1442670144,"2015-09-19 06:42:24"
"4669","20150313090335-839","2","2015-09-15 21:47:23",1442378843,"C8",109314,1442488157,"2015-09-17 04:09:17"
"1986","20151812081835-734","2","2015-09-15 22:05:11",1442379911,"C2",308796,1442688707,"2015-09-19 11:51:47"
"907","20153931113929-38","1","2015-09-15 22:52:29",1442382749,"C0",445460,1442828209,"2015-09-21 02:36:49"
"3879","20151912061915-319","1","2015-09-15 23:46:24",1442385984,"C5",107343,1442493327,"2015-09-17 05:35:27"
"5214","20155812045842-786","1","2015-09-16 00:20:18",1442388018,"C8",142848,1442530866,"2015-09-17 16:01:06"
"1481","20152730052714-154","2","2015-09-16 00:48:18",1442389698,"C4",176108,1442565806,"2015-09-18 01:43:26"
"3780","20153002053041-801","1","2015-09-16 01:20:09",1442391609,"C3",143921,1442535530,"2015-09-17 17:18:50"
"3619","20152414102459-200","1","2015-09-16 01:42:35",1442392955,"C5",70728,1442463683,"2015-09-16 21:21:23"
"2306","20150312030323-538","1","2015-09-16 02:09:59",1442394599,"C4",149598,1442544197,"2015-09-17 19:43:17"
"4781","20152211072240-895","1","2015-09-16 02:53:40",1442397220,"C5",207930,1442605150,"2015-09-18 12:39:10"
"5782","20152416102430-660","2","2015-09-16 03:02:16",1442397736,"C8",378838,1442776574,"2015-09-20 12:16:14"
"4711","20154826044849-501","1","2015-09-16 03:27:23",1442399243,"C8",883157,1443282400,"2015-09-26 08:46:40"
"2720","20152114022149-636","1","2015-09-16 03:34:39",1442399679,"C2",66985,1442466664,"2015-09-16 22:11:04"
"441","20150113020105-915","1","2015-09-16 05:13:44",1442405624,"C4",75853,1442481477,"2015-09-17 02:17:57"
"4612","20154519024544-322","False","2015-09-16 05:28:48",1442406528,"C4",200940,1442607468,"2015-09-18 13:17:48"
"2646","20150916010937-480","1","2015-09-16 05:32:37",1442406757,"C4",176732,1442583489,"2015-09-18 06:38:09"
"393","20153829123844-783","3","2015-09-16 06:20:23",1442409623,"C8",601557,1443011180,"2015-09-23 05:26:20"
"5120","20155302025312-112","1","2015-09-16 07:24:51",1442413491,"C3",168957,1442582448,"2015-09-18 06:20:48"
"1007","20150506060512-399","1","2015-09-16 07:53:46",1442415226,"C8",435257,1442850483,"2015-09-21 08:48:03"
"4881","20153927083928-87","1","2015-09-16 08:11:04",1442416264,"C4",550587,1442966851,"2015-09-22 17:07:31"
"6299","20152608042656-439","1","2015-09-16 08:18:28",1442416708,"C2",94556,1442511264,"2015-09-17 10:34:24"
"4417","20152304062326-36","1","2015-09-16 08:56:14",1442418974,"C3",465546,1442884520,"2015-09-21 18:15:20"
"809","20154027024014-523","1","2015-09-16 09:53:13",1442422393,"C4",244397,1442666790,"2015-09-19 05:46:30"
"3248","20153331043359-711","1","2015-09-16 10:31:19",1442424679,"C2",170080,1442594759,"2015-09-18 09:45:59"
"388","20151931031941-864","1","2015-09-16 11:58:43",1442429923,"C8",685171,1443115094,"2015-09-24 10:18:14"
"4991","20151810051808-730","1","2015-09-16 12:14:56",1442430896,"C5",62526,1442493422,"2015-09-17 05:37:02"
"6268","20153008093014-166","2","2015-09-16 13:25:56",1442435156,"C5",352671,1442787827,"2015-09-20 15:23:47"
"883","20153423043438-15","3","2015-09-16 14:29:58",1442438998,"C2",258265,1442697263,"2015-09-19 14:14:23"
"4505","20150812050828-793","3","2015-09-16 17:14:36",1442448876,"C7",49424,1442498300,"2015-09-17 06:58:20"
"6008","20153016063017-510","3","2015-09-16 18:30:31",1442453431,"C5",388802,1442842233,"2015-09-21 06:30:33"
"4762","20153804013829-884","2","2015-09-16 18:38:31",1442453911,"C0",150686,1442604597,"2015-09-18 12:29:57"
"218","20152523062510-74","2","2015-09-16 18:48:46",1442454526,"C5",264777,1442719303,"2015-09-19 20:21:43"
"1116","20152321032356-54","2","2015-09-16 19:00:02",1442455202,"C3",1129683,1443584885,"2015-09-29 20:48:05"
"1064","20154412104452-262","1","2015-09-16 19:15:57",1442456157,"C8",75253,1442531410,"2015-09-17 16:10:10"
"3910","20151913061938-878","1","2015-09-16 19:27:17",1442456837,"C0",102153,1442558990,"2015-09-17 23:49:50"
"1829","20150723060758-760","1","2015-09-16 20:40:13",1442461213,"C8",960867,1443422080,"2015-09-27 23:34:40"
"317","20152206042213-803","1","2015-09-16 20:56:29",1442462189,"C8",440228,1442902417,"2015-09-21 23:13:37"
"1731","20151124081137-232","2","2015-09-16 22:07:45",1442466465,"C2",254671,1442721136,"2015-09-19 20:52:16"
"5935","20154425114422-810","2","2015-09-16 22:16:54",1442467014,"C3",242344,1442709358,"2015-09-19 17:35:58"
"3728","20154809034821-765","1","2015-09-16 22:44:25",1442468665,"C5",314882,1442783547,"2015-09-20 14:12:27"
"5885","20155823085830-345","1","2015-09-16 23:20:29",1442470829,"C0",303617,1442774446,"2015-09-20 11:40:46"
"3356","20154509104501-59","2","2015-09-16 23:55:01",1442472901,"C0",416325,1442889226,"2015-09-21 19:33:46"
"4733","20155722095743-296","1","2015-09-17 03:32:28",1442485948,"C8",444657,1442930605,"2015-09-22 07:03:25"
"509","20155304065306-536","1","2015-09-17 03:42:10",1442486530,"C5",473768,1442960298,"2015-09-22 15:18:18"
"6316","20152113092153-515","2","2015-09-17 03:53:27",1442487207,"C3",162947,1442650154,"2015-09-19 01:09:14"
"5518","20153425093430-367","2","2015-09-17 06:06:59",1442495219,"C0",282107,1442777326,"2015-09-20 12:28:46"
"545","20150809030847-891","1","2015-09-17 06:17:30",1442495850,"C2",94189,1442590039,"2015-09-18 08:27:19"
"5287","20151727081727-53","2","2015-09-17 07:37:47",1442500667,"C7",258860,1442759527,"2015-09-20 07:32:07"
"2970","20151027121055-218","2","2015-09-17 07:41:11",1442500871,"C3",256888,1442757759,"2015-09-20 07:02:39"
"2051","20151114071159-705","3","2015-09-17 07:55:47",1442501747,"C5",130914,1442632661,"2015-09-18 20:17:41"
"3746","20150912100912-409","3","2015-09-17 08:46:40",1442504800,"C8",213524,1442718324,"2015-09-19 20:05:24"
"2869","20153812113834-265","3","2015-09-17 09:24:58",1442507098,"C5",211992,1442719090,"2015-09-19 20:18:10"
"494","20151818101826-629","3","2015-09-17 09:29:35",1442507375,"C5",863023,1443370398,"2015-09-27 09:13:18"
"2064","20153221123200-816","1","2015-09-17 10:16:18",1442510178,"C4",332094,1442842272,"2015-09-21 06:31:12"
"342","20154015034053-424","3","2015-09-17 12:31:17",1442518277,"C8",80712,1442598989,"2015-09-18 10:56:29"
"1989","20153023063031-787","1","2015-09-17 12:39:27",1442518767,"C4",607567,1443126334,"2015-09-24 13:25:34"
"4900","20155614125629-357","2","2015-09-17 12:55:06",1442519706,"C2",259117,1442778823,"2015-09-20 12:53:43"
"274","20153615013648-281","3","2015-09-17 14:45:52",1442526352,"C2",88472,1442614824,"2015-09-18 15:20:24"
"3232","20152128092124-904","3","2015-09-17 15:16:06",1442528166,"C1",291547,1442819713,"2015-09-21 00:15:13"
"2550","20152512042530-460","1","2015-09-17 15:49:18",1442530158,"C7",61404,1442591562,"2015-09-18 08:52:42"
"5528","20152815072807-909","1","2015-09-17 16:23:23",1442532203,"C7",102458,1442634661,"2015-09-18 20:51:01"
"1124","20154201074239-177","1","2015-09-17 16:41:05",1442533265,"C7",707353,1443240618,"2015-09-25 21:10:18"
"2019","20152308032332-748","2","2015-09-17 17:54:20",1442537660,"C5",262216,1442799876,"2015-09-20 18:44:36"
"1188","20152913112927-997","3","2015-09-17 19:12:33",1442542353,"C8",186693,1442729046,"2015-09-19 23:04:06"
"3620","20151705081753-773","3","2015-09-17 19:24:56",1442543096,"C7",119647,1442662743,"2015-09-19 04:39:03"
"4060","20154415114438-543","2","2015-09-17 20:02:37",1442545357,"C4",202679,1442748036,"2015-09-20 04:20:36"
"4707","20150322020344-232","2","2015-09-17 20:03:12",1442545392,"C3",283496,1442828888,"2015-09-21 02:48:08"
"1038","20155615055609-330","1","2015-09-17 20:05:49",1442545549,"C7",90290,1442635839,"2015-09-18 21:10:39"
"4784","20153213073258-209","1","2015-09-17 20:21:31",1442546491,"C3",391713,1442938204,"2015-09-22 09:10:04"
"951","20151729051759-488","1","2015-09-17 20:44:04",1442547844,"C8",330793,1442878637,"2015-09-21 16:37:17"
"5981","20154430084401-298","1","2015-09-17 20:58:25",1442548705,"C4",533088,1443081793,"2015-09-24 01:03:13"
"5641","20152205052244-453","2","2015-09-17 21:08:24",1442549304,"C8",525170,1443074474,"2015-09-23 23:01:14"
"3801","20154026094053-772","2","2015-09-17 21:17:29",1442549849,"C7",215844,1442765693,"2015-09-20 09:14:53"
"2089","20152607062650-779","1","2015-09-17 21:18:02",1442549882,"C3",305824,1442855706,"2015-09-21 10:15:06"
"5624","20154811054808-989","1","2015-09-17 21:26:56",1442550416,"C0",66441,1442616857,"2015-09-18 15:54:17"
"6195","20155314095341-355","2","2015-09-17 22:07:57",1442552877,"C4",303256,1442856133,"2015-09-21 10:22:13"
"1598","20154615114635-60","1","2015-09-17 22:10:51",1442553051,"C2",361082,1442914133,"2015-09-22 02:28:53"
"3366","20153709093741-767","1","2015-09-17 23:20:45",1442557245,"C2",92573,1442649818,"2015-09-19 01:03:38"
"2085","20151309121323-469","2","2015-09-17 23:46:51",1442558811,"C7",366404,1442925215,"2015-09-22 05:33:35"
"1387","20152931072940-294","1","2015-09-18 00:10:00",1442560200,"C8",305764,1442865964,"2015-09-21 13:06:04"
"2836","20153711033732-656","2","2015-09-18 00:44:36",1442562276,"C5",68903,1442631179,"2015-09-18 19:52:59"
"5114","20155409055424-104","1","2015-09-18 01:34:15",1442565255,"C4",485313,1443050568,"2015-09-23 16:22:48"
"4938","20150631110616-558","3","2015-09-18 03:17:36",1442571456,"C6",190885,1442762341,"2015-09-20 08:19:01"
"34","20151211081210-391","2","2015-09-18 03:20:36",1442571636,"C0",293653,1442865289,"2015-09-21 12:54:49"
"2529","20150630110633-414","1","2015-09-18 03:29:03",1442572143,"C0",538050,1443110193,"2015-09-24 08:56:33"
"5400","20152429012447-906","1","2015-09-18 03:55:33",1442573733,"C5",241978,1442815711,"2015-09-20 23:08:31"
"581","20150822040848-819","1","2015-09-18 04:20:54",1442575254,"C5",709818,1443285072,"2015-09-26 09:31:12"
"4772","20154512084511-218","2","2015-09-18 05:26:11",1442579171,"C4",454980,1443034151,"2015-09-23 11:49:11"
"787","20155815115806-862","3","2015-09-18 05:54:38",1442580878,"C0",364474,1442945352,"2015-09-22 11:09:12"
"1924","20155130025118-645","3","2015-09-18 06:00:28",1442581228,"C8",321950,1442903178,"2015-09-21 23:26:18"
"1517","20155313085338-538","3","2015-09-18 06:08:10",1442581690,"C5",211036,1442792726,"2015-09-20 16:45:26"
"6021","20151614071616-110","3","2015-09-18 06:11:58",1442581918,"C7",170871,1442752789,"2015-09-20 05:39:49"
"2631","20152724112733-858","1","2015-09-18 06:30:21",1442583021,"C0",602571,1443185592,"2015-09-25 05:53:12"
"6207","20150305110318-934","2","2015-09-18 06:56:30",1442584590,"C8",554196,1443138786,"2015-09-24 16:53:06"
"5805","20152123092103-610","1","2015-09-18 07:17:17",1442585837,"C3",1119487,1443705324,"2015-10-01 06:15:24"
"5094","20150607030644-318","1","2015-09-18 07:24:29",1442586269,"C3",1200355,1443786624,"2015-10-02 04:50:24"
"1617","20150515110551-961","1","2015-09-18 08:50:44",1442591444,"C5",418499,1443009943,"2015-09-23 05:05:43"
"447","20155012065039-980","2","2015-09-18 08:52:53",1442591573,"C8",262867,1442854440,"2015-09-21 09:54:00"
"115","20155213045249-101","1","2015-09-18 08:56:29",1442591789,"C8",80684,1442672473,"2015-09-19 07:21:13"
"5686","20151730041740-897","2","2015-09-18 09:16:40",1442593000,"C8",323268,1442916268,"2015-09-22 03:04:28"
"6380","20152111122136-527","3","2015-09-18 09:55:18",1442595318,"C5",198674,1442793992,"2015-09-20 17:06:32"
"1796","20155328055322-628","1","2015-09-18 11:31:46",1442601106,"C5",223938,1442825044,"2015-09-21 01:44:04"
"249","20153708023759-709","1","2015-09-18 12:26:59",1442604419,"C8",428070,1443032489,"2015-09-23 11:21:29"
"37","20150924120946-229","1","2015-09-18 12:47:14",1442605634,"C3",605081,1443210715,"2015-09-25 12:51:55"
"1773","20153116073142-631","2","2015-09-18 12:53:06",1442605986,"C4",96042,1442702028,"2015-09-19 15:33:48"
"3611","20151228021221-216","1","2015-09-18 13:25:17",1442607917,"C0",226447,1442834364,"2015-09-21 04:19:24"
"6167","20153304093314-219","1","2015-09-18 13:39:28",1442608768,"C8",612187,1443220955,"2015-09-25 15:42:35"
"4476","20152117012105-319","3","2015-09-18 13:43:23",1442609003,"C4",87738,1442696741,"2015-09-19 14:05:41"
"1600","20154912074929-675","3","2015-09-18 14:20:24",1442611224,"C2",541855,1443153079,"2015-09-24 20:51:19"
"5969","20153802033804-576","1","2015-09-18 14:36:04",1442612164,"C8",275736,1442887900,"2015-09-21 19:11:40"
"508","20154410124427-370","3","2015-09-18 14:39:58",1442612398,"C4",99733,1442712131,"2015-09-19 18:22:11"
"5672","20153509063553-817","3","2015-09-18 15:22:18",1442614938,"C8",697517,1443312455,"2015-09-26 17:07:35"
"2595","20150406120417-939","1","2015-09-18 16:03:25",1442617405,"C4",150164,1442767569,"2015-09-20 09:46:09"
"6196","20151406061442-733","2","2015-09-18 17:13:56",1442621636,"C3",538177,1443159813,"2015-09-24 22:43:33"
"3663","20153829013850-412","1","2015-09-18 17:21:04",1442622064,"C3",870667,1443492731,"2015-09-28 19:12:11"
"3703","20151914041904-182","1","2015-09-18 17:47:48",1442623668,"C2",175462,1442799130,"2015-09-20 18:32:10"
"2605","20152602042627-350","1","2015-09-18 19:06:11",1442628371,"C2",695992,1443324363,"2015-09-26 20:26:03"
"4545","20155216015253-395","2","2015-09-18 20:10:17",1442632217,"C4",97722,1442729939,"2015-09-19 23:18:59"
"2855","20150413080423-537","1","2015-09-18 20:17:43",1442632663,"C4",476000,1443108663,"2015-09-24 08:31:03"
"1976","20150414070459-536","3","2015-09-18 20:19:23",1442632763,"C5",131088,1442763851,"2015-09-20 08:44:11"
"6481","20150512110539-725","2","2015-09-18 20:25:11",1442633111,"C4",551972,1443185083,"2015-09-25 05:44:43"
"2478","20155012055005-718","2","2015-09-18 20:31:09",1442633469,"C8",264032,1442897501,"2015-09-21 21:51:41"
"4869","20154625064609-206","1","2015-09-18 22:28:10",1442640490,"C5",304303,1442944793,"2015-09-22 10:59:53"
"3251","20151812081845-784","2","2015-09-18 23:02:48",1442642568,"C5",190481,1442833049,"2015-09-21 03:57:29"
"415","20155126025133-294","1","2015-09-19 00:31:41",1442647901,"C4",252751,1442900652,"2015-09-21 22:44:12"
"4183","20155303125323-651","1","2015-09-19 00:32:07",1442647927,"C3",191132,1442839059,"2015-09-21 05:37:39"
"3546","20153710103741-345","1","2015-09-19 00:45:47",1442648747,"C2",371043,1443019790,"2015-09-23 07:49:50"
"1057","20152120122138-42","1","2015-09-19 02:35:18",1442655318,"C7",365260,1443020578,"2015-09-23 08:02:58"
"5190","20151829061839-838","1","2015-09-19 02:49:14",1442656154,"C8",257405,1442913559,"2015-09-22 02:19:19"
"3930","20150313110328-797","2","2015-09-19 03:57:38",1442660258,"C8",246425,1442906683,"2015-09-22 00:24:43"
"3575","20152107032156-241","1","2015-09-19 05:48:53",1442666933,"C2",334139,1443001072,"2015-09-23 02:37:52"
"1575","20151504111546-565","1","2015-09-19 06:11:17",1442668277,"C2",1277731,1443946008,"2015-10-04 01:06:48"
"1171","20152604072643-403","1","2015-09-19 07:20:03",1442672403,"C4",647800,1443320203,"2015-09-26 19:16:43"
"5709","20154217024216-818","1","2015-09-19 07:29:37",1442672977,"C3",146841,1442819818,"2015-09-21 00:16:58"
"5642","20155613105649-467","1","2015-09-19 07:41:23",1442673683,"C4",253337,1442927020,"2015-09-22 06:03:40"
"4274","20152917082955-286","3","2015-09-19 08:12:41",1442675561,"C0",171766,1442847327,"2015-09-21 07:55:27"
"96","20150713110726-288","1","2015-09-19 08:55:52",1442678152,"C8",255253,1442933405,"2015-09-22 07:50:05"
"1360","20152913042937-614","1","2015-09-19 10:19:25",1442683165,"C5",70884,1442754049,"2015-09-20 06:00:49"
"6521","20154415064447-909","1","2015-09-19 10:37:51",1442684271,"C5",379748,1443064019,"2015-09-23 20:06:59"
"1468","20153312023328-539","2","2015-09-19 10:38:23",1442684303,"C7",84385,1442768688,"2015-09-20 10:04:48"
"5687","20153007093004-81","3","2015-09-19 11:23:04",1442686984,"C5",521790,1443208774,"2015-09-25 12:19:34"
"4058","20155612065603-160","2","2015-09-19 11:27:39",1442687259,"C3",207032,1442894291,"2015-09-21 20:58:11"
"2717","20153611093610-113","2","2015-09-19 12:56:10",1442692570,"C2",351600,1443044170,"2015-09-23 14:36:10"
"5945","20150813060851-608","2","2015-09-19 14:04:09",1442696649,"C6",91153,1442787802,"2015-09-20 15:23:22"
"6189","20154529064528-757","3","2015-09-19 14:22:27",1442697747,"C7",263117,1442960864,"2015-09-22 15:27:44"
"4966","20150008080048-814","2","2015-09-19 14:24:56",1442697896,"C5",121681,1442819577,"2015-09-21 00:12:57"
"2553","20151310101330-91","1","2015-09-19 15:43:36",1442702616,"C4",265802,1442968418,"2015-09-22 17:33:38"
"1114","20153317113300-397","1","2015-09-19 15:50:48",1442703048,"C4",188268,1442891316,"2015-09-21 20:08:36"
"5914","20155309035345-751","2","2015-09-19 16:05:51",1442703951,"C6",144121,1442848072,"2015-09-21 08:07:52"
"2074","20154309084354-984","1","2015-09-19 16:20:57",1442704857,"C5",297141,1443001998,"2015-09-23 02:53:18"
"2639","20154930064934-59","2","2015-09-19 16:53:06",1442706786,"C8",882106,1443588892,"2015-09-29 21:54:52"
"1739","20154510014516-824","1","2015-09-19 17:01:40",1442707300,"C5",98673,1442805973,"2015-09-20 20:26:13"
"3525","20152310012347-406","2","2015-09-19 18:02:43",1442710963,"C4",99292,1442810255,"2015-09-20 21:37:35"
"6437","20153612033615-297","1","2015-09-19 18:09:43",1442711383,"C0",76751,1442788134,"2015-09-20 15:28:54"
"673","20155508075512-365","1","2015-09-19 18:39:44",1442713184,"C2",458434,1443171618,"2015-09-25 02:00:18"
"436","20151401121438-732","3","2015-09-19 20:25:28",1442719528,"C3",792325,1443511853,"2015-09-29 00:30:53"
"1556","20152424032429-194","2","2015-09-19 21:00:34",1442721634,"C4",323795,1443045429,"2015-09-23 14:57:09"
"2138","20152606032633-640","1","2015-09-19 22:52:45",1442728365,"C2",574986,1443303351,"2015-09-26 14:35:51"
"823","20155317085330-284","2","2015-09-19 23:11:34",1442729494,"C8",112142,1442841636,"2015-09-21 06:20:36"
"3848","20150802060812-197","2","2015-09-19 23:35:40",1442730940,"C4",526256,1443257196,"2015-09-26 01:46:36"
"2770","20150901120957-839","1","2015-09-19 23:54:44",1442732084,"C3",610841,1443342925,"2015-09-27 01:35:25"
"3969","20152516042528-805","2","2015-09-20 00:02:40",1442732560,"C5",423576,1443156136,"2015-09-24 21:42:16"
"3029","20152310122351-816","3","2015-09-20 00:29:27",1442734167,"C5",102642,1442836809,"2015-09-21 05:00:09"
"555","20155518055520-844","3","2015-09-20 00:57:16",1442735836,"C2",55858,1442791694,"2015-09-20 16:28:14"
"4277","20150024040008-576","3","2015-09-20 01:05:31",1442736331,"C7",325589,1443061920,"2015-09-23 19:32:00"
"6463","20151716101753-304","1","2015-09-20 01:11:35",1442736695,"C8",156411,1442893106,"2015-09-21 20:38:26"
"5205","20150010070052-300","2","2015-09-20 02:36:28",1442741788,"C2",106017,1442847805,"2015-09-21 08:03:25"
"1531","20153106033136-478","1","2015-09-20 03:52:08",1442746328,"C0",145954,1442892282,"2015-09-21 20:24:42"
"1339","20155316115321-402","3","2015-09-20 04:28:49",1442748529,"C8",159464,1442907993,"2015-09-22 00:46:33"
"2303","20155905015919-324","1","2015-09-20 04:57:25",1442750245,"C5",180498,1442930743,"2015-09-22 07:05:43"
"3054","20154612084611-217","3","2015-09-20 05:03:35",1442750615,"C6",112974,1442863589,"2015-09-21 12:26:29"
"3828","20151821101831-698","1","2015-09-20 06:45:25",1442756725,"C6",429869,1443186594,"2015-09-25 06:09:54"
"5529","20150413100443-728","3","2015-09-20 07:02:45",1442757765,"C2",593882,1443351647,"2015-09-27 04:00:47"
"2282","20151713071733-979","1","2015-09-20 07:19:55",1442758795,"C0",302471,1443061266,"2015-09-23 19:21:06"
"3783","20153707123722-164","1","2015-09-20 07:30:16",1442759416,"C7",552387,1443311803,"2015-09-26 16:56:43"
"808","20151013101006-462","1","2015-09-20 08:09:18",1442761758,"C0",74694,1442836452,"2015-09-21 04:54:12"
"5606","20151212011243-975","1","2015-09-20 08:19:33",1442762373,"C4",96230,1442858603,"2015-09-21 11:03:23"
"3332","20151313041349-276","1","2015-09-20 09:12:26",1442765546,"C6",579517,1443345063,"2015-09-27 02:11:03"
"4962","20150020090018-839","1","2015-09-20 09:14:42",1442765682,"C6",446544,1443212226,"2015-09-25 13:17:06"
"2404","20155417095454-820","3","2015-09-20 11:08:12",1442772492,"C0",263598,1443036090,"2015-09-23 12:21:30"
"1260","20155019025025-685","1","2015-09-20 11:18:03",1442773083,"C4",73658,1442846741,"2015-09-21 07:45:41"
"4621","20152322072348-123","1","2015-09-20 11:18:05",1442773085,"C8",359951,1443133036,"2015-09-24 15:17:16"
"6499","20151904021905-805","1","2015-09-20 11:22:59",1442773379,"C7",1035626,1443809005,"2015-10-02 11:03:25"
"4126","20153402053419-365","1","2015-09-20 11:34:10",1442774050,"C4",601713,1443375763,"2015-09-27 10:42:43"
"5868","20154212114258-729","1","2015-09-20 11:36:48",1442774208,"C7",98690,1442872898,"2015-09-21 15:01:38"
"1238","20154105044140-645","1","2015-09-20 12:18:34",1442776714,"C2",426738,1443203452,"2015-09-25 10:50:52"
"6004","20153911083955-135","1","2015-09-20 12:25:35",1442777135,"C8",113020,1442890155,"2015-09-21 19:49:15"
"6453","20153925033936-464","2","2015-09-20 12:53:12",1442778792,"C0",279552,1443058344,"2015-09-23 18:32:24"
"1317","20154411024426-868","2","2015-09-20 12:54:20",1442778860,"C2",110142,1442889002,"2015-09-21 19:30:02"
"501","20151116071131-16","1","2015-09-20 13:02:55",1442779375,"C2",183342,1442962717,"2015-09-22 15:58:37"
"4285","20152416092443-318","2","2015-09-20 13:37:17",1442781437,"C4",180377,1442961814,"2015-09-22 15:43:34"
"2941","20153115023128-580","1","2015-09-20 14:27:14",1442784434,"C8",61678,1442846112,"2015-09-21 07:35:12"
"5313","20154216084221-101","3","2015-09-20 14:31:57",1442784717,"C2",380622,1443165339,"2015-09-25 00:15:39"
"4366","20154211074259-773","1","2015-09-20 14:33:47",1442784827,"C6",133708,1442918535,"2015-09-22 03:42:15"
"4627","20150412010421-959","1","2015-09-20 17:10:04",1442794204,"C4",100849,1442895053,"2015-09-21 21:10:53"
"2358","20151814071826-934","1","2015-09-20 17:17:37",1442794657,"C5",79193,1442873850,"2015-09-21 15:17:30"
"874","20153808113851-534","2","2015-09-20 17:31:43",1442795503,"C8",528986,1443324489,"2015-09-26 20:28:09"
"1454","20155310105320-51","2","2015-09-20 18:50:22",1442800222,"C8",510146,1443310368,"2015-09-26 16:32:48"
"1207","20152612022619-830","1","2015-09-20 19:36:59",1442803019,"C8",354920,1443157939,"2015-09-24 22:12:19"
"5722","20155012015018-20","2","2015-09-20 20:01:08",1442804468,"C8",71345,1442875813,"2015-09-21 15:50:13"
"3918","20155530075533-622","2","2015-09-20 21:12:38",1442808758,"C8",372445,1443181203,"2015-09-25 04:40:03"
"1624","20154309104322-867","2","2015-09-20 22:38:02",1442813882,"C8",198656,1443012538,"2015-09-23 05:48:58"
"3097","20155810015814-86","3","2015-09-20 22:56:34",1442814994,"C0",448150,1443263144,"2015-09-26 03:25:44"
"2283","20152711122705-744","2","2015-09-20 23:01:05",1442815265,"C8",116520,1442931785,"2015-09-22 07:23:05"
"2041","20150609060600-167","1","2015-09-20 23:03:44",1442815424,"C3",126433,1442941857,"2015-09-22 10:10:57"
"4929","20155707045739-291","1","2015-09-20 23:06:53",1442815613,"C5",163622,1442979235,"2015-09-22 20:33:55"
"2091","20154114014105-799","1","2015-09-21 00:34:02",1442820842,"C5",185859,1443006701,"2015-09-23 04:11:41"
"6125","20153125013133-452","1","2015-09-21 01:07:23",1442822843,"C8",457630,1443280473,"2015-09-26 08:14:33"
"925","20154213094240-842","1","2015-09-21 01:08:18",1442822898,"C5",94334,1442917232,"2015-09-22 03:20:32"
"4001","20150719050720-439","1","2015-09-21 01:25:40",1442823940,"C5",58150,1442882090,"2015-09-21 17:34:50"
"5927","20152827102844-258","1","2015-09-21 01:31:09",1442824269,"C8",425549,1443249818,"2015-09-25 23:43:38"
"4409","20154229064247-967","1","2015-09-21 02:39:37",1442828377,"C2",986305,1443814682,"2015-10-02 12:38:02"
"98","20154027074029-955","1","2015-09-21 02:43:57",1442828637,"C5",267776,1443096413,"2015-09-24 05:06:53"
"5921","20153727113719-945","3","2015-09-21 02:56:29",1442829389,"C8",425750,1443255139,"2015-09-26 01:12:19"
"3395","20154903014907-481","2","2015-09-21 03:33:07",1442831587,"C4",189780,1443021367,"2015-09-23 08:16:07"
"1011","20155615125621-835","1","2015-09-21 04:04:34",1442833474,"C8",69499,1442902973,"2015-09-21 23:22:53"
"5020","20152618022623-126","1","2015-09-21 05:17:33",1442837853,"C2",113135,1442950988,"2015-09-22 12:43:08"
"2516","20151813061817-670","2","2015-09-21 05:48:57",1442839737,"C8",137888,1442977625,"2015-09-22 20:07:05"
"2122","20154810124843-713","3","2015-09-21 05:49:25",1442839765,"C2",514806,1443354571,"2015-09-27 04:49:31"
"2645","20153831073821-785","1","2015-09-21 05:49:57",1442839797,"C6",301316,1443141113,"2015-09-24 17:31:53"
"1236","20153914023919-152","1","2015-09-21 05:55:43",1442840143,"C8",81912,1442922055,"2015-09-22 04:40:55"
"1850","20155815105829-773","1","2015-09-21 06:15:01",1442841301,"C2",250696,1443091997,"2015-09-24 03:53:17"
"1008","20150020040021-389","2","2015-09-21 06:43:11",1442842991,"C3",52970,1442895961,"2015-09-21 21:26:01"
"4552","20152609102611-783","1","2015-09-21 06:57:29",1442843849,"C3",528954,1443372803,"2015-09-27 09:53:23"
"1734","20152515062540-976","2","2015-09-21 07:28:58",1442845738,"C5",261099,1443106837,"2015-09-24 08:00:37"
"5499","20155205025245-653","3","2015-09-21 07:43:24",1442846604,"C4",452213,1443298817,"2015-09-26 13:20:17"
"2499","20154223104254-46","1","2015-09-21 07:50:50",1442847050,"C4",1247638,1444094688,"2015-10-05 18:24:48"
"3113","20150115010131-543","1","2015-09-21 08:55:34",1442850934,"C2",71949,1442922883,"2015-09-22 04:54:43"
"4347","20153218103248-711","2","2015-09-21 09:03:44",1442851424,"C4",253856,1443105280,"2015-09-24 07:34:40"
"3722","20155110075150-591","1","2015-09-21 09:57:58",1442854678,"C6",454546,1443309224,"2015-09-26 16:13:44"
"4253","20151804051810-974","1","2015-09-21 10:08:34",1442855314,"C5",481008,1443336322,"2015-09-26 23:45:22"
"292","20151118061145-872","2","2015-09-21 12:31:12",1442863872,"C3",93989,1442957861,"2015-09-22 14:37:41"
"4279","20154220044203-784","1","2015-09-21 12:38:01",1442864281,"C2",71758,1442936039,"2015-09-22 08:33:59"
"6102","20153829053832-818","2","2015-09-21 13:05:20",1442865920,"C4",581151,1443447071,"2015-09-28 06:31:11"
"2737","20153206063215-204","1","2015-09-21 13:36:31",1442867791,"C8",571408,1443439199,"2015-09-28 04:19:59"
"3966","20153207093226-553","1","2015-09-21 16:07:52",1442876872,"C5",558818,1443435690,"2015-09-28 03:21:30"
"5821","20155427045428-734","1","2015-09-21 16:54:25",1442879665,"C5",308571,1443188236,"2015-09-25 06:37:16"
"215","20153022123027-88","2","2015-09-21 17:18:39",1442881119,"C2",372756,1443253875,"2015-09-26 00:51:15"
"716","20153317113343-810","1","2015-09-21 17:19:31",1442881171,"C4",366348,1443247519,"2015-09-25 23:05:19"
"1200","20154713024750-774","1","2015-09-21 17:42:54",1442882574,"C4",350852,1443233426,"2015-09-25 19:10:26"
"3429","20152119022156-795","1","2015-09-21 18:48:11",1442886491,"C5",62925,1442949416,"2015-09-22 12:16:56"
"3420","20152518072549-657","3","2015-09-21 19:58:53",1442890733,"C0",372848,1443263581,"2015-09-26 03:33:01"
"2703","20151911021956-775","1","2015-09-21 20:40:20",1442893220,"C3",780453,1443673673,"2015-09-30 21:27:53"
"3582","20150918060923-118","1","2015-09-21 21:41:19",1442896879,"C3",315116,1443211995,"2015-09-25 13:13:15"
"2825","20153413023435-625","1","2015-09-21 22:39:20",1442900360,"C5",240095,1443140455,"2015-09-24 17:20:55"
"6474","20150821020810-335","3","2015-09-21 23:53:40",1442904820,"C6",452255,1443357075,"2015-09-27 05:31:15"
"1680","20152724062710-421","1","2015-09-22 00:31:26",1442907086,"C2",645332,1443552418,"2015-09-29 11:46:58"
"4828","20155516015509-611","2","2015-09-22 00:38:29",1442907509,"C4",58825,1442966334,"2015-09-22 16:58:54"
"2422","20150920090938-107","1","2015-09-22 00:39:38",1442907578,"C5",352575,1443260153,"2015-09-26 02:35:53"
"3749","20150314050311-620","2","2015-09-22 01:25:25",1442910325,"C5",855962,1443766287,"2015-10-01 23:11:27"
"75","20150419080423-232","1","2015-09-22 01:55:11",1442912111,"C2",118524,1443030635,"2015-09-23 10:50:35"
"3266","20153903123925-684","1","2015-09-22 01:58:29",1442912309,"C0",535193,1443447502,"2015-09-28 06:38:22"
"2100","20154217124209-940","2","2015-09-22 04:03:11",1442919791,"C7",200431,1443120222,"2015-09-24 11:43:42"
"2620","20154906114942-746","3","2015-09-22 04:10:15",1442920215,"C7",150537,1443070752,"2015-09-23 21:59:12"
"4213","20154209104204-174","2","2015-09-22 05:22:44",1442924564,"C5",157720,1443082284,"2015-09-24 01:11:24"
"429","20150613110621-217","1","2015-09-22 05:43:57",1442925837,"C5",429582,1443355419,"2015-09-27 05:03:39"
"6403","20152406112431-687","1","2015-09-22 06:47:21",1442929641,"C5",682885,1443612526,"2015-09-30 04:28:46"
"4618","20154419024438-705","1","2015-09-22 07:14:05",1442931245,"C2",77389,1443008634,"2015-09-23 04:43:54"
"2222","20152713112722-565","2","2015-09-22 07:44:28",1442933068,"C5",254742,1443187810,"2015-09-25 06:30:10"
"3875","20154115124102-576","3","2015-09-22 08:40:50",1442936450,"C6",544798,1443481248,"2015-09-28 16:00:48"
"6464","20151006031044-506","1","2015-09-22 08:49:00",1442936940,"C6",169937,1443106877,"2015-09-24 08:01:17"
"3006","20150622030637-276","1","2015-09-22 09:00:49",1442937649,"C4",885484,1443823133,"2015-10-02 14:58:53"
"4511","20151713061726-223","1","2015-09-22 09:38:38",1442939918,"C6",131612,1443071530,"2015-09-23 22:12:10"
"6340","20154719064707-283","2","2015-09-22 10:08:57",1442941737,"C7",135655,1443077392,"2015-09-23 23:49:52"
"3383","20150922110914-684","2","2015-09-22 10:50:19",1442944219,"C8",535453,1443479672,"2015-09-28 15:34:32"
"4890","20150931010941-247","1","2015-09-22 11:04:36",1442945076,"C8",378659,1443323735,"2015-09-26 20:15:35"
"1579","20153606103657-307","1","2015-09-22 11:25:31",1442946331,"C7",197902,1443144233,"2015-09-24 18:23:53"
"4667","20155318045300-137","3","2015-09-22 11:49:00",1442947740,"C4",163680,1443111420,"2015-09-24 09:17:00"
"3836","20155910095936-211","1","2015-09-22 12:09:09",1442948949,"C4",348191,1443297140,"2015-09-26 12:52:20"
"4209","20154517084514-625","2","2015-09-22 12:36:56",1442950616,"C6",520717,1443471333,"2015-09-28 13:15:33"
"4529","20153128063145-895","2","2015-09-22 12:38:44",1442950724,"C5",311717,1443262441,"2015-09-26 03:14:01"
"361","20155603105654-700","2","2015-09-22 13:08:24",1442952504,"C6",274915,1443227419,"2015-09-25 17:30:19"
"4328","20155613065652-38","1","2015-09-22 16:35:06",1442964906,"C2",116042,1443080948,"2015-09-24 00:49:08"
"4512","20152705082730-727","1","2015-09-22 17:39:09",1442968749,"C8",214557,1443183306,"2015-09-25 05:15:06"
"4928","20152616072652-905","2","2015-09-22 17:59:28",1442969968,"C5",185452,1443155420,"2015-09-24 21:30:20"
"1864","20152520062536-43","1","2015-09-22 18:33:24",1442972004,"C2",216468,1443188472,"2015-09-25 06:41:12"
"5243","20154107074130-137","2","2015-09-22 18:49:10",1442972950,"C8",802892,1443775842,"2015-10-02 01:50:42"
"4930","20154509114531-556","1","2015-09-22 19:32:01",1442975521,"C5",383730,1443359251,"2015-09-27 06:07:31"
"4251","20150814050807-728","1","2015-09-22 19:39:28",1442975968,"C4",233427,1443209395,"2015-09-25 12:29:55"
"5166","20152220102228-66","3","2015-09-22 20:09:32",1442977772,"C5",104012,1443081784,"2015-09-24 01:03:04"
"2967","20154818114859-137","3","2015-09-22 21:31:09",1442982669,"C2",190265,1443172934,"2015-09-25 02:22:14"
"5165","20153014083025-418","3","2015-09-22 22:05:07",1442984707,"C7",105726,1443090433,"2015-09-24 03:27:13"
"4808","20154412014428-448","1","2015-09-22 22:09:14",1442984954,"C2",447143,1443432097,"2015-09-28 02:21:37"
"3494","20152718102756-727","1","2015-09-22 22:25:40",1442985940,"C7",438152,1443424092,"2015-09-28 00:08:12"
"3653","20150001090048-374","1","2015-09-22 23:36:43",1442990203,"C8",373391,1443363594,"2015-09-27 07:19:54"
"3328","20151820091811-842","3","2015-09-23 00:31:57",1442993517,"C3",113813,1443107330,"2015-09-24 08:08:50"
"4266","20155913095938-39","1","2015-09-23 02:05:06",1442999106,"C5",439241,1443438347,"2015-09-28 04:05:47"
"4978","20152616112648-695","2","2015-09-23 03:40:06",1443004806,"C6",96133,1443100939,"2015-09-24 06:22:19"
"3552","20152020042020-267","1","2015-09-23 05:16:47",1443010607,"C4",73129,1443083736,"2015-09-24 01:35:36"
"6116","20151120081141-291","3","2015-09-23 05:41:13",1443012073,"C8",125086,1443137159,"2015-09-24 16:25:59"
"2541","20153317093349-531","2","2015-09-23 05:57:51",1443013071,"C4",252721,1443265792,"2015-09-26 04:09:52"
"1157","20153523113541-168","2","2015-09-23 06:11:01",1443013861,"C3",332365,1443346226,"2015-09-27 02:30:26"
"2773","20154218124259-772","2","2015-09-23 08:18:59",1443021539,"C8",208080,1443229619,"2015-09-25 18:06:59"
"3329","20154614094653-955","1","2015-09-23 08:46:31",1443023191,"C8",386989,1443410180,"2015-09-27 20:16:20"
"4613","20154519024544-322","False","2015-09-23 08:53:26",1443023606,"C4",202608,1443226214,"2015-09-25 17:10:14"
"3865","20151726111704-117","1","2015-09-23 10:11:01",1443028261,"C5",805079,1443833340,"2015-10-02 17:49:00"
"503","20152618062642-81","2","2015-09-23 12:30:50",1443036650,"C4",453848,1443490498,"2015-09-28 18:34:58"
"2488","20154227054208-498","1","2015-09-23 12:50:08",1443037808,"C8",998736,1444036544,"2015-10-05 02:15:44"
"536","20153723093753-818","3","2015-09-23 12:52:41",1443037961,"C0",336261,1443374222,"2015-09-27 10:17:02"
"3260","20152128122117-954","2","2015-09-23 13:43:51",1443041031,"C5",321622,1443362653,"2015-09-27 07:04:13"
"5597","20152615012610-377","2","2015-09-23 14:36:22",1443044182,"C0",347706,1443391888,"2015-09-27 15:11:28"
"3792","20152819112852-444","2","2015-09-23 15:01:48",1443045708,"C5",714397,1443760105,"2015-10-01 21:28:25"
"3795","20154615034637-382","1","2015-09-23 15:59:17",1443049157,"C8",138392,1443187549,"2015-09-25 06:25:49"
"3280","20150506080545-327","1","2015-09-23 17:06:36",1443053196,"C4",597093,1443650289,"2015-09-30 14:58:09"
"2113","20154322044336-436","2","2015-09-23 17:20:39",1443054039,"C7",395289,1443449328,"2015-09-28 07:08:48"
"607","20152225082250-866","2","2015-09-23 18:02:18",1443056538,"C0",652346,1443708884,"2015-10-01 07:14:44"
"409","20153016083036-762","2","2015-09-23 18:27:27",1443058047,"C3",213537,1443271584,"2015-09-26 05:46:24"
"946","20155417095405-70","3","2015-09-23 18:38:29",1443058709,"C5",183288,1443241997,"2015-09-25 21:33:17"
"993","20153114113153-521","2","2015-09-23 20:08:09",1443064089,"C4",101072,1443165161,"2015-09-25 00:12:41"
"439","20155405055439-901","1","2015-09-23 20:30:27",1443065427,"C4",782274,1443847701,"2015-10-02 21:48:21"
"6508","20151117101107-46","2","2015-09-23 21:01:13",1443067273,"C5",462258,1443529531,"2015-09-29 05:25:31"
"6369","20154703104737-748","3","2015-09-23 21:14:13",1443068053,"C0",882798,1443950851,"2015-10-04 02:27:31"
"4691","20151521021511-720","2","2015-09-23 21:53:19",1443070399,"C4",200288,1443270687,"2015-09-26 05:31:27"
"5210","20155301055312-754","2","2015-09-23 21:54:53",1443070493,"C0",656243,1443726736,"2015-10-01 12:12:16"
"410","20155606045620-205","2","2015-09-23 22:21:56",1443072116,"C8",744168,1443816284,"2015-10-02 13:04:44"
"5574","20155729115754-235","2","2015-09-24 00:14:26",1443078866,"C5",275524,1443354390,"2015-09-27 04:46:30"
"419","20154511094545-173","1","2015-09-24 00:34:47",1443080087,"C4",545071,1443625158,"2015-09-30 07:59:18"
"1706","20155129125114-867","1","2015-09-24 00:55:44",1443081344,"C7",244830,1443326174,"2015-09-26 20:56:14"
"860","20152716082703-974","1","2015-09-24 01:08:39",1443082119,"C3",221632,1443303751,"2015-09-26 14:42:31"
"3778","20151711061722-116","2","2015-09-24 03:03:28",1443089008,"C5",370522,1443459530,"2015-09-28 09:58:50"
"2728","20153119123113-587","3","2015-09-24 04:40:50",1443094850,"C8",440311,1443535161,"2015-09-29 06:59:21"
"6343","20151715111719-318","1","2015-09-24 05:31:58",1443097918,"C5",252293,1443350211,"2015-09-27 03:36:51"
"2938","20153806113852-538","2","2015-09-24 05:32:20",1443097940,"C5",191651,1443289591,"2015-09-26 10:46:31"
"1636","20151018091033-267","1","2015-09-24 07:26:27",1443104787,"C4",256077,1443360864,"2015-09-27 06:34:24"
"4342","20151804081822-193","3","2015-09-24 07:37:54",1443105474,"C8",862786,1443968260,"2015-10-04 07:17:40"
"2709","20151010011010-902","3","2015-09-24 07:48:16",1443106096,"C6",198381,1443304477,"2015-09-26 14:54:37"
"6130","20155221115237-739","1","2015-09-24 07:50:19",1443106219,"C7",122331,1443228550,"2015-09-25 17:49:10"
"2342","20152718042732-411","2","2015-09-24 09:09:38",1443110978,"C3",164042,1443275020,"2015-09-26 06:43:40"
"2033","20154420054435-183","1","2015-09-24 10:10:37",1443114637,"C3",159181,1443273818,"2015-09-26 06:23:38"
"5213","20153515113535-847","3","2015-09-24 11:29:19",1443119359,"C2",111032,1443230391,"2015-09-25 18:19:51"
"4227","20150305100328-487","3","2015-09-24 12:25:10",1443122710,"C6",721417,1443844127,"2015-10-02 20:48:47"
"4207","20153218053206-183","1","2015-09-24 13:06:18",1443125178,"C0",251226,1443376404,"2015-09-27 10:53:24"
"2204","20154610094644-926","2","2015-09-24 13:14:49",1443125689,"C8",244417,1443370106,"2015-09-27 09:08:26"
"6526","20150223050200-237","3","2015-09-24 13:32:40",1443126760,"C2",344030,1443470790,"2015-09-28 13:06:30"
"5419","20155710035705-492","1","2015-09-24 15:59:08",1443135548,"C5",403241,1443538789,"2015-09-29 07:59:49"
"2530","20155608095652-395","3","2015-09-24 17:21:43",1443140503,"C5",469697,1443610200,"2015-09-30 03:50:00"
"5441","20150303040325-976","1","2015-09-24 17:51:55",1443142315,"C3",260130,1443402445,"2015-09-27 18:07:25"
"5027","20155411105414-764","2","2015-09-24 17:59:02",1443142742,"C3",382896,1443525638,"2015-09-29 04:20:38"
"2132","20151026091044-859","2","2015-09-24 18:25:30",1443144330,"C7",362698,1443507028,"2015-09-28 23:10:28"
"3466","20155318115321-937","2","2015-09-24 18:36:30",1443144990,"C2",542589,1443687579,"2015-10-01 01:19:39"
"1276","20154224024243-441","1","2015-09-24 19:00:53",1443146453,"C4",767470,1443913923,"2015-10-03 16:12:03"
"2807","20150107050116-884","2","2015-09-24 19:27:40",1443148060,"C7",593712,1443741772,"2015-10-01 16:22:52"
"3635","20151528071513-888","1","2015-09-24 20:35:18",1443152118,"C8",340115,1443492233,"2015-09-28 19:03:53"
"2637","20150819010811-13","2","2015-09-24 21:03:08",1443153788,"C5",153499,1443307287,"2015-09-26 15:41:27"
"5548","20154702074759-377","1","2015-09-24 21:04:08",1443153848,"C7",278367,1443432215,"2015-09-28 02:23:35"
"5564","20153228093241-330","2","2015-09-24 23:58:55",1443164335,"C7",340682,1443505017,"2015-09-28 22:36:57"
"2149","20150419120407-235","3","2015-09-25 00:05:49",1443164749,"C6",79217,1443243966,"2015-09-25 22:06:06"
"4203","20150322090352-662","1","2015-09-25 03:10:43",1443175843,"C0",79337,1443255180,"2015-09-26 01:13:00"
"6309","20154316094311-12","1","2015-09-25 03:32:31",1443177151,"C4",94420,1443271571,"2015-09-26 05:46:11"
"5207","20154114064153-342","2","2015-09-25 03:45:29",1443177929,"C2",117477,1443295406,"2015-09-26 12:23:26"
"4630","20155716015705-26","3","2015-09-25 04:37:07",1443181027,"C5",372001,1443553028,"2015-09-29 11:57:08"
"2955","20150022080040-235","2","2015-09-25 06:25:22",1443187522,"C3",84494,1443272016,"2015-09-26 05:53:36"
"4120","20152920072900-597","2","2015-09-25 06:36:06",1443188166,"C2",214413,1443402579,"2015-09-27 18:09:39"
"5298","20153202063212-217","2","2015-09-25 07:30:34",1443191434,"C7",284386,1443475820,"2015-09-28 14:30:20"
"6339","20153717033736-717","2","2015-09-25 07:32:59",1443191579,"C8",94589,1443286168,"2015-09-26 09:49:28"
"2548","20152001012016-668","3","2015-09-25 07:50:56",1443192656,"C5",591530,1443784186,"2015-10-02 04:09:46"
"3835","20151919011904-725","3","2015-09-25 08:03:59",1443193439,"C8",99899,1443293338,"2015-09-26 11:48:58"
"5704","20150816050832-772","1","2015-09-25 08:10:15",1443193815,"C2",745303,1443939118,"2015-10-03 23:11:58"
"746","20155723025744-648","2","2015-09-25 09:27:10",1443198430,"C5",76483,1443274913,"2015-09-26 06:41:53"
"3628","20155319025303-151","2","2015-09-25 09:47:30",1443199650,"C7",55563,1443255213,"2015-09-26 01:13:33"
"6121","20150822100824-378","2","2015-09-25 11:06:48",1443204408,"C5",367638,1443572046,"2015-09-29 17:14:06"
"313","20153908033947-597","1","2015-09-25 11:15:11",1443204911,"C6",1134954,1444339865,"2015-10-08 14:31:05"
"1033","20152824092833-430","3","2015-09-25 12:39:08",1443209948,"C2",97835,1443307783,"2015-09-26 15:49:43"
"5874","20153909063916-316","3","2015-09-25 13:09:52",1443211792,"C5",468612,1443680404,"2015-09-30 23:20:04"
"3273","20150320040327-383","2","2015-09-25 14:19:33",1443215973,"C4",141922,1443357895,"2015-09-27 05:44:55"
"570","20150723120718-938","3","2015-09-25 14:25:12",1443216312,"C4",181074,1443397386,"2015-09-27 16:43:06"
"383","20155210105230-671","1","2015-09-25 14:28:12",1443216492,"C4",1329114,1444545606,"2015-10-10 23:40:06"
"1919","20151521051522-169","2","2015-09-25 14:37:52",1443217072,"C8",67230,1443284302,"2015-09-26 09:18:22"
"707","20155905015950-850","1","2015-09-25 15:11:17",1443219077,"C4",577429,1443796506,"2015-10-02 07:35:06"
"5591","20155819125825-141","1","2015-09-25 15:31:11",1443220271,"C3",263783,1443484054,"2015-09-28 16:47:34"
"553","20150315110303-677","1","2015-09-25 16:00:59",1443222059,"C5",440938,1443662997,"2015-09-30 18:29:57"
"5506","20150213050220-905","3","2015-09-25 17:24:05",1443227045,"C5",346035,1443573080,"2015-09-29 17:31:20"
"3012","20154911044919-82","1","2015-09-25 18:13:47",1443230027,"C4",173524,1443403551,"2015-09-27 18:25:51"
"365","20153227023219-8","2","2015-09-25 18:44:29",1443231869,"C8",504146,1443736015,"2015-10-01 14:46:55"
"2771","20155120125158-102","1","2015-09-25 19:32:54",1443234774,"C5",1050607,1444285381,"2015-10-07 23:23:01"
"1347","20152130122123-358","2","2015-09-25 20:09:23",1443236963,"C7",252720,1443489683,"2015-09-28 18:21:23"
"1458","20152715082740-609","2","2015-09-25 20:21:52",1443237712,"C3",453426,1443691138,"2015-10-01 02:18:58"
"5942","20151113061129-478","3","2015-09-25 20:57:37",1443239857,"C4",1129846,1444369703,"2015-10-08 22:48:23"
"451","20151824101808-298","2","2015-09-25 21:20:25",1443241225,"C2",126137,1443367362,"2015-09-27 08:22:42"
"2088","20154304074340-809","1","2015-09-25 21:27:04",1443241624,"C6",310634,1443552258,"2015-09-29 11:44:18"
"2069","20151219101232-863","3","2015-09-25 22:13:53",1443244433,"C0",187227,1443431660,"2015-09-28 02:14:20"
"1192","20151417021426-33","3","2015-09-25 22:44:11",1443246251,"C2",240595,1443486846,"2015-09-28 17:34:06"
"4951","20153322063335-503","3","2015-09-25 23:23:56",1443248636,"C4",106607,1443355243,"2015-09-27 05:00:43"
"1032","20150605090601-376","2","2015-09-25 23:30:23",1443249023,"C8",889931,1444138954,"2015-10-06 06:42:34"
"5948","20150802090823-595","1","2015-09-25 23:53:59",1443250439,"C4",255042,1443505481,"2015-09-28 22:44:41"
"961","20150114010135-879","1","2015-09-26 00:28:01",1443252481,"C2",495793,1443748274,"2015-10-01 18:11:14"
"1876","20151617021606-104","1","2015-09-26 00:50:47",1443253847,"C5",104183,1443358030,"2015-09-27 05:47:10"
"1002","20150815100834-958","1","2015-09-26 03:15:23",1443262523,"C7",897487,1444160010,"2015-10-06 12:33:30"
"1167","20154020024025-608","3","2015-09-26 03:56:31",1443264991,"C3",68538,1443333529,"2015-09-26 22:58:49"
"3199","20152229022224-672","1","2015-09-26 04:48:03",1443268083,"C3",340677,1443608760,"2015-09-30 03:26:00"
"2201","20150904060937-392","1","2015-09-26 05:51:47",1443271907,"C5",271390,1443543297,"2015-09-29 09:14:57"
"3358","20151426091431-80","2","2015-09-26 06:03:12",1443272592,"C0",1133903,1444406495,"2015-10-09 09:01:35"
"847","20150518090550-442","3","2015-09-26 08:01:58",1443279718,"C4",343684,1443623402,"2015-09-30 07:30:02"
"5762","20153520093506-281","2","2015-09-26 09:15:20",1443284120,"C3",258607,1443542727,"2015-09-29 09:05:27"
"5334","20155320035314-794","3","2015-09-26 09:18:18",1443284298,"C4",70672,1443354970,"2015-09-27 04:56:10"
"4556","20153424073437-874","2","2015-09-26 09:50:01",1443286201,"C5",90462,1443376663,"2015-09-27 10:57:43"
"4289","20150517010521-33","3","2015-09-26 10:44:06",1443289446,"C2",109875,1443399321,"2015-09-27 17:15:21"
"3639","20155220055213-805","2","2015-09-26 11:38:09",1443292689,"C4",247978,1443540667,"2015-09-29 08:31:07"
"2593","20154619054642-211","2","2015-09-26 14:17:31",1443302251,"C4",84607,1443386858,"2015-09-27 13:47:38"
"4050","20153701113748-789","1","2015-09-26 14:26:36",1443302796,"C6",361688,1443664484,"2015-09-30 18:54:44"
"1334","20154414024455-447","1","2015-09-26 15:30:01",1443306601,"C2",346502,1443653103,"2015-09-30 15:45:03"
"1316","20154610014621-394","2","2015-09-26 16:37:46",1443310666,"C0",198955,1443509621,"2015-09-28 23:53:41"
"6447","20153306013342-878","3","2015-09-26 18:08:01",1443316081,"C7",631837,1443947918,"2015-10-04 01:38:38"
"3478","20150912060916-518","1","2015-09-26 19:17:48",1443320268,"C2",826714,1444146982,"2015-10-06 08:56:22"
"803","20151822031835-962","2","2015-09-26 19:40:57",1443321657,"C5",180671,1443502328,"2015-09-28 21:52:08"
"3806","20154925074924-66","1","2015-09-26 19:44:20",1443321860,"C7",783728,1444105588,"2015-10-05 21:26:28"
"3004","20154805074832-890","2","2015-09-26 20:51:22",1443325882,"C8",265910,1443591792,"2015-09-29 22:43:12"
"3457","20150127010131-864","3","2015-09-26 21:52:09",1443329529,"C4",374834,1443704363,"2015-10-01 05:59:23"
"5928","20153817093840-341","1","2015-09-26 22:47:49",1443332869,"C7",389261,1443722130,"2015-10-01 10:55:30"
"4814","20151119111132-408","3","2015-09-27 00:00:50",1443337250,"C5",325479,1443662729,"2015-09-30 18:25:29"
"5680","20155215095214-503","1","2015-09-27 00:23:41",1443338621,"C4",334229,1443672850,"2015-09-30 21:14:10"
"4735","20154207114257-472","1","2015-09-27 01:34:20",1443342860,"C4",624269,1443967129,"2015-10-04 06:58:49"
"3498","20151604091656-972","1","2015-09-27 04:04:45",1443351885,"C5",1046467,1444398352,"2015-10-09 06:45:52"
"149","20150221090256-672","1","2015-09-27 04:18:15",1443352695,"C8",71617,1443424312,"2015-09-28 00:11:52"
"462","20154913114917-875","1","2015-09-27 04:40:35",1443354035,"C6",197313,1443551348,"2015-09-29 11:29:08"
"972","20154819014855-670","2","2015-09-27 05:24:49",1443356689,"C4",94422,1443451111,"2015-09-28 07:38:31"
"6114","20153125073143-771","2","2015-09-27 06:18:37",1443359917,"C3",168414,1443528331,"2015-09-29 05:05:31"
"3193","20154822054838-865","1","2015-09-27 07:01:48",1443362508,"C8",78638,1443441146,"2015-09-28 04:52:26"
"417","20154211024216-107","3","2015-09-27 07:54:16",1443365656,"C6",1119120,1444484776,"2015-10-10 06:46:16"
"936","20154108014126-563","1","2015-09-27 08:56:22",1443369382,"C6",537862,1443907244,"2015-10-03 14:20:44"
"2533","20153117093131-820","1","2015-09-27 08:58:05",1443369485,"C7",123142,1443492627,"2015-09-28 19:10:27"
"5852","20154817054816-243","3","2015-09-27 09:11:54",1443370314,"C8",416509,1443786823,"2015-10-02 04:53:43"
"4573","20150419050423-187","1","2015-09-27 09:15:55",1443370555,"C7",331546,1443702101,"2015-10-01 05:21:41"
"6416","20153319053331-895","1","2015-09-27 09:43:35",1443372215,"C4",331502,1443703717,"2015-10-01 05:48:37"
"4770","20151625031626-950","2","2015-09-27 11:43:53",1443379433,"C7",315383,1443694816,"2015-10-01 03:20:16"
"4254","20154525014533-946","1","2015-09-27 12:37:07",1443382627,"C4",168694,1443551321,"2015-09-29 11:28:41"
"3374","20150117070118-157","1","2015-09-27 12:47:24",1443383244,"C5",294922,1443678166,"2015-09-30 22:42:46"
"45","20154719104700-710","3","2015-09-27 13:40:37",1443386437,"C7",100231,1443486668,"2015-09-28 17:31:08"
"753","20153128063125-623","1","2015-09-27 13:50:05",1443387005,"C8",523664,1443910669,"2015-10-03 15:17:49"
"2691","20153931093915-91","1","2015-09-27 14:30:33",1443389433,"C7",335754,1443725187,"2015-10-01 11:46:27"
"5436","20155719075702-802","1","2015-09-27 14:36:16",1443389776,"C5",357577,1443747353,"2015-10-01 17:55:53"
"3431","20151225091237-930","1","2015-09-27 15:19:47",1443392387,"C5",793090,1444185477,"2015-10-06 19:37:57"
"3282","20152123052127-127","2","2015-09-27 16:45:05",1443397505,"C3",343418,1443740923,"2015-10-01 16:08:43"
"6236","20154825044833-35","3","2015-09-27 16:50:25",1443397825,"C7",86456,1443484281,"2015-09-28 16:51:21"
"3278","20155425085454-29","1","2015-09-27 16:52:40",1443397960,"C8",100733,1443498693,"2015-09-28 20:51:33"
"921","20152518012558-924","2","2015-09-27 17:23:41",1443399821,"C4",791863,1444191684,"2015-10-06 21:21:24"
"3009","20155722115704-142","1","2015-09-27 19:43:28",1443408208,"C4",65712,1443473920,"2015-09-28 13:58:40"
"1191","20152310082337-650","1","2015-09-27 19:59:07",1443409147,"C8",215790,1443624937,"2015-09-30 07:55:37"
"3165","20150110030105-67","3","2015-09-27 21:26:04",1443414364,"C7",595757,1444010121,"2015-10-04 18:55:21"
"2715","20151215011211-758","1","2015-09-27 22:23:24",1443417804,"C5",152839,1443570643,"2015-09-29 16:50:43"
"1953","20154512044556-370","2","2015-09-28 00:14:12",1443424452,"C5",165362,1443589814,"2015-09-29 22:10:14"
"1968","20153119113110-269","1","2015-09-28 01:34:52",1443429292,"C5",247274,1443676566,"2015-09-30 22:16:06"
"182","20150417010430-97","1","2015-09-28 03:47:00",1443437220,"C8",183390,1443620610,"2015-09-30 06:43:30"
"1604","20155024015031-756","3","2015-09-28 04:00:55",1443438055,"C3",373578,1443811633,"2015-10-02 11:47:13"
"4356","20150625070608-126","1","2015-09-28 04:51:16",1443441076,"C4",125554,1443566630,"2015-09-29 15:43:50"
"2206","20154220054254-247","3","2015-09-28 05:53:49",1443444829,"C2",92665,1443537494,"2015-09-29 07:38:14"
"6245","20154922094908-595","1","2015-09-28 05:58:32",1443445112,"C0",1060988,1444506100,"2015-10-10 12:41:40"
"6479","20150913060926-359","1","2015-09-28 06:07:42",1443445662,"C8",185128,1443630790,"2015-09-30 09:33:10"
"2252","20151814091851-213","1","2015-09-28 06:16:23",1443446183,"C8",599326,1444045509,"2015-10-05 04:45:09"
"2731","20150111090110-546","2","2015-09-28 06:26:58",1443446818,"C4",973764,1444420582,"2015-10-09 12:56:22"
"2790","20154019064052-72","2","2015-09-28 06:38:27",1443447507,"C0",111065,1443558572,"2015-09-29 13:29:32"
"6420","20151019021027-10","2","2015-09-28 07:04:49",1443449089,"C7",376031,1443825120,"2015-10-02 15:32:00"
"5550","20150818100801-621","3","2015-09-28 08:13:58",1443453238,"C8",122451,1443575689,"2015-09-29 18:14:49"
"1644","20152724022701-346","1","2015-09-28 08:24:10",1443453850,"C5",107943,1443561793,"2015-09-29 14:23:13"
"6013","20154330024325-110","1","2015-09-28 08:47:43",1443455263,"C6",414043,1443869306,"2015-10-03 03:48:26"
"2163","20155825105841-374","1","2015-09-28 08:57:03",1443455823,"C8",125951,1443581774,"2015-09-29 19:56:14"
"5544","20155131115159-825","3","2015-09-28 10:02:54",1443459774,"C5",344665,1443804439,"2015-10-02 09:47:19"
"2759","20150926060947-3","1","2015-09-28 11:29:48",1443464988,"C0",192001,1443656989,"2015-09-30 16:49:49"
"1753","20155116095155-952","2","2015-09-28 12:12:37",1443467557,"C3",348414,1443815971,"2015-10-02 12:59:31"
"5551","20151007041045-624","1","2015-09-28 12:48:37",1443469717,"C2",225284,1443695001,"2015-10-01 03:23:21"
"2248","20155726045730-46","1","2015-09-28 13:08:38",1443470918,"C4",79534,1443550452,"2015-09-29 11:14:12"
"5317","20153126123126-309","3","2015-09-28 15:26:33",1443479193,"C2",183307,1443662500,"2015-09-30 18:21:40"
"675","20153422023401-747","1","2015-09-28 16:00:03",1443481203,"C2",261781,1443742984,"2015-10-01 16:43:04"
"5490","20152822052837-707","2","2015-09-28 17:38:11",1443487091,"C2",518974,1444006065,"2015-10-04 17:47:45"
"5947","20151829071820-420","2","2015-09-28 18:01:12",1443488472,"C4",375796,1443864268,"2015-10-03 02:24:28"
"350","20155002095022-451","2","2015-09-28 18:57:07",1443491827,"C8",455841,1443947668,"2015-10-04 01:34:28"
"4246","20150307010338-210","2","2015-09-28 19:08:41",1443492521,"C0",262329,1443754850,"2015-10-01 20:00:50"
"1513","20154823124859-777","3","2015-09-28 19:44:50",1443494690,"C5",152317,1443647007,"2015-09-30 14:03:27"
"1733","20152922082911-839","2","2015-09-28 20:14:57",1443496497,"C3",560746,1444057243,"2015-10-05 08:00:43"
"1534","20150908120959-737","2","2015-09-28 20:41:02",1443498062,"C0",586221,1444084283,"2015-10-05 15:31:23"
"2191","20154525094552-398","1","2015-09-28 20:48:01",1443498481,"C3",99643,1443598124,"2015-09-30 00:28:44"
"5766","20151817041849-523","2","2015-09-28 21:21:10",1443500470,"C5",322847,1443823317,"2015-10-02 15:01:57"
"3122","20152912062950-917","1","2015-09-28 21:46:22",1443501982,"C5",179674,1443681656,"2015-09-30 23:40:56"
"4517","20150103070112-250","3","2015-09-28 22:02:16",1443502936,"C4",276758,1443779694,"2015-10-02 02:54:54"
"1891","20155823065837-106","1","2015-09-28 23:11:12",1443507072,"C8",98071,1443605143,"2015-09-30 02:25:43"
"1885","20150326120302-265","1","2015-09-28 23:47:53",1443509273,"C5",71697,1443580970,"2015-09-29 19:42:50"
"3369","20155126045131-960","1","2015-09-28 23:55:09",1443509709,"C5",99109,1443608818,"2015-09-30 03:26:58"
"2058","20153726083749-370","1","2015-09-29 00:11:05",1443510665,"C7",114398,1443625063,"2015-09-30 07:57:43"
"2816","20155022025040-869","3","2015-09-29 01:16:04",1443514564,"C6",92654,1443607218,"2015-09-30 03:00:18"
"481","20155115045123-3","1","2015-09-29 01:22:07",1443514927,"C0",576922,1444091849,"2015-10-05 17:37:29"
"2487","20154811074853-707","3","2015-09-29 01:22:26",1443514946,"C4",510671,1444025617,"2015-10-04 23:13:37"
"6211","20152013052027-811","2","2015-09-29 02:38:03",1443519483,"C3",443152,1443962635,"2015-10-04 05:43:55"
"643","20153524043531-670","1","2015-09-29 03:07:26",1443521246,"C8",76703,1443597949,"2015-09-30 00:25:49"
"3463","20150902060920-793","2","2015-09-29 03:58:00",1443524280,"C7",714760,1444239040,"2015-10-07 10:30:40"
"2298","20153123093148-981","1","2015-09-29 04:09:38",1443524978,"C8",99814,1443624792,"2015-09-30 07:53:12"
"2655","20152926122925-922","1","2015-09-29 04:23:19",1443525799,"C8",115017,1443640816,"2015-09-30 12:20:16"
"3348","20154402034422-248","1","2015-09-29 04:43:57",1443527037,"C8",710225,1444237262,"2015-10-07 10:01:02"
"3822","20154027054037-715","1","2015-09-29 05:00:43",1443528043,"C5",63603,1443591646,"2015-09-29 22:40:46"
"2557","20150819030822-252","2","2015-09-29 05:18:56",1443529136,"C8",414317,1443943453,"2015-10-04 00:24:13"
"1445","20151412081447-295","1","2015-09-29 06:22:07",1443532927,"C5",517555,1444050482,"2015-10-05 06:08:02"
"2523","20151727021712-641","1","2015-09-29 06:26:04",1443533164,"C5",72266,1443605430,"2015-09-30 02:30:30"
"1063","20154114094103-483","1","2015-09-29 06:47:28",1443534448,"C4",183655,1443718103,"2015-10-01 09:48:23"
"2686","20153725113714-643","2","2015-09-29 06:56:53",1443535013,"C5",109593,1443644606,"2015-09-30 13:23:26"
"1012","20151619111656-337","2","2015-09-29 06:59:23",1443535163,"C3",121221,1443656384,"2015-09-30 16:39:44"
"843","20150728030708-412","1","2015-09-29 07:36:28",1443537388,"C2",342220,1443879608,"2015-10-03 06:40:08"
"2851","20150421060449-866","2","2015-09-29 08:27:35",1443540455,"C8",349883,1443890338,"2015-10-03 09:38:58"
"1212","20152927012946-631","2","2015-09-29 10:09:48",1443546588,"C6",160802,1443707390,"2015-10-01 06:49:50"
"3880","20150409100421-849","2","2015-09-29 12:37:41",1443555461,"C8",347440,1443902901,"2015-10-03 13:08:21"
"1070","20151028071020-362","1","2015-09-29 13:10:24",1443557424,"C6",108004,1443665428,"2015-09-30 19:10:28"
"2889","20150230070206-829","1","2015-09-29 13:27:57",1443558477,"C7",373593,1443932070,"2015-10-03 21:14:30"
"257","20154719114724-517","2","2015-09-29 13:50:00",1443559800,"C5",435678,1443995478,"2015-10-04 14:51:18"
"3425","20152227062258-532","2","2015-09-29 13:56:42",1443560202,"C2",100012,1443660214,"2015-09-30 17:43:34"
"2501","20154230094206-93","1","2015-09-29 14:26:06",1443561966,"C5",372720,1443934686,"2015-10-03 21:58:06"
"870","20155420115417-321","1","2015-09-29 15:19:13",1443565153,"C2",768337,1444333490,"2015-10-08 12:44:50"
"5380","20153325073343-313","1","2015-09-29 15:31:24",1443565884,"C6",374261,1443940145,"2015-10-03 23:29:05"
"5537","20153828093806-862","2","2015-09-29 17:23:34",1443572614,"C0",114328,1443686942,"2015-10-01 01:09:02"
"4830","20154125084143-150","3","2015-09-29 18:04:57",1443575097,"C8",189697,1443764794,"2015-10-01 22:46:34"
"1118","20152224022226-330","1","2015-09-29 18:10:53",1443575453,"C0",445707,1444021160,"2015-10-04 21:59:20"
"6237","20150925030923-872","2","2015-09-29 18:50:47",1443577847,"C0",179442,1443757289,"2015-10-01 20:41:29"
"534","20154419114439-303","1","2015-09-29 18:54:23",1443578063,"C5",111223,1443689286,"2015-10-01 01:48:06"
"2838","20150021050036-788","3","2015-09-29 19:02:44",1443578564,"C6",87316,1443665880,"2015-09-30 19:18:00"
"4381","20154725014705-617","2","2015-09-29 19:20:13",1443579613,"C8",182794,1443762407,"2015-10-01 22:06:47"
"3438","20151624061651-753","1","2015-09-29 20:07:11",1443582431,"C2",451460,1444033891,"2015-10-05 01:31:31"
"6271","20151825051820-653","3","2015-09-29 20:29:16",1443583756,"C4",44632,1443628388,"2015-09-30 08:53:08"
"862","20150018080022-664","1","2015-09-29 20:57:13",1443585433,"C7",110779,1443696212,"2015-10-01 03:43:32"
"2614","20152611022615-260","1","2015-09-29 21:29:52",1443587392,"C4",608431,1444195823,"2015-10-06 22:30:23"
"271","20151425091439-648","2","2015-09-29 22:47:56",1443592076,"C6",394397,1443986473,"2015-10-04 12:21:13"
"5975","20155511125500-140","1","2015-09-29 23:14:36",1443593676,"C2",868647,1444462323,"2015-10-10 00:32:03"
"3105","20152519102554-161","2","2015-09-30 00:48:58",1443599338,"C4",114473,1443713811,"2015-10-01 08:36:51"
"6535","20151302071301-31","3","2015-09-30 00:55:22",1443599722,"C4",342363,1443942085,"2015-10-04 00:01:25"
"3033","20152919062956-312","2","2015-09-30 01:13:35",1443600815,"C2",310473,1443911288,"2015-10-03 15:28:08"
"280","20154826064823-183","1","2015-09-30 02:48:41",1443606521,"C4",812574,1444419095,"2015-10-09 12:31:35"
"3811","20152027052026-10","3","2015-09-30 03:08:30",1443607710,"C8",104042,1443711752,"2015-10-01 08:02:32"
"5643","20154027114042-147","1","2015-09-30 03:22:44",1443608564,"C3",114661,1443723225,"2015-10-01 11:13:45"
"3274","20151623041644-600","1","2015-09-30 07:29:47",1443623387,"C6",573183,1444196570,"2015-10-06 22:42:50"
"5085","20155711025756-499","3","2015-09-30 07:55:48",1443624948,"C0",230896,1443855844,"2015-10-03 00:04:04"
"5099","20152420032414-663","1","2015-09-30 08:05:02",1443625502,"C7",93072,1443718574,"2015-10-01 09:56:14"
"5659","20155916085912-350","3","2015-09-30 08:24:08",1443626648,"C5",820537,1444447185,"2015-10-09 20:19:45"
"4178","20150605090648-40","1","2015-09-30 08:55:29",1443628529,"C2",691103,1444319632,"2015-10-08 08:53:52"
"4614","20154519024544-322","False","2015-09-30 09:17:17",1443629837,"C4",202733,1443832570,"2015-10-02 17:36:10"
"2229","20155227055231-464","3","2015-09-30 12:04:49",1443639889,"C6",238338,1443878227,"2015-10-03 06:17:07"
"1955","20152820102827-437","3","2015-09-30 12:26:43",1443641203,"C6",108887,1443750090,"2015-10-01 18:41:30"
"5248","20150327030331-456","1","2015-09-30 12:54:25",1443642865,"C4",83818,1443726683,"2015-10-01 12:11:23"
"4960","20151026061007-244","1","2015-09-30 14:33:42",1443648822,"C6",375815,1444024637,"2015-10-04 22:57:17"
"6288","20155724045747-509","2","2015-09-30 14:44:27",1443649467,"C8",102080,1443751547,"2015-10-01 19:05:47"
"2413","20151625041658-913","2","2015-09-30 14:52:11",1443649931,"C6",426913,1444076844,"2015-10-05 13:27:24"
"2667","20150729110716-839","1","2015-09-30 15:15:07",1443651307,"C0",101271,1443752578,"2015-10-01 19:22:58"
"1514","20152115122135-105","3","2015-09-30 15:18:56",1443651536,"C7",186663,1443838199,"2015-10-02 19:09:59"
"1951","20153624113634-748","2","2015-09-30 16:38:19",1443656299,"C0",178835,1443835134,"2015-10-02 18:18:54"
"5877","20151919061903-547","1","2015-09-30 16:56:07",1443657367,"C4",123578,1443780945,"2015-10-02 03:15:45"
"3055","20150816110851-751","2","2015-09-30 17:36:51",1443659811,"C6",154110,1443813921,"2015-10-02 12:25:21"
"4250","20155015115025-738","3","2015-09-30 17:39:30",1443659970,"C7",188135,1443848105,"2015-10-02 21:55:05"
"251","20155512045556-420","3","2015-09-30 18:19:16",1443662356,"C2",529825,1444192181,"2015-10-06 21:29:41"
"3871","20151011051048-783","1","2015-09-30 18:22:39",1443662559,"C7",182879,1443845438,"2015-10-02 21:10:38"
"5111","20151923031917-617","1","2015-09-30 19:43:10",1443667390,"C2",620633,1444288023,"2015-10-08 00:07:03"
"1000","20152529062500-596","2","2015-09-30 21:31:06",1443673866,"C6",140766,1443814632,"2015-10-02 12:37:12"
"5823","20153910063931-835","2","2015-10-01 01:32:43",1443688363,"C5",224499,1443912862,"2015-10-03 15:54:22"
"1817","20151823021836-870","3","2015-10-01 01:54:45",1443689685,"C7",92367,1443782052,"2015-10-02 03:34:12"
"2654","20153027033021-889","2","2015-10-01 02:08:21",1443690501,"C5",99160,1443789661,"2015-10-02 05:41:01"
"3032","20152523012506-74","1","2015-10-01 03:39:46",1443695986,"C3",82010,1443777996,"2015-10-02 02:26:36"
"2540","20153329123327-162","1","2015-10-01 04:10:25",1443697825,"C5",71309,1443769134,"2015-10-01 23:58:54"
"331","20154717034744-602","3","2015-10-01 04:24:08",1443698648,"C6",146073,1443844721,"2015-10-02 20:58:41"
"5577","20151925041908-320","3","2015-10-01 04:43:29",1443699809,"C8",450723,1444150532,"2015-10-06 09:55:32"
"3446","20154928014949-969","1","2015-10-01 06:25:17",1443705917,"C8",116264,1443822181,"2015-10-02 14:43:01"
"2032","20154515054556-394","2","2015-10-01 06:30:55",1443706255,"C5",956957,1444663212,"2015-10-12 08:20:12"
"3513","20150314060301-241","3","2015-10-01 07:56:11",1443711371,"C5",737795,1444449166,"2015-10-09 20:52:46"
"4883","20152925062903-447","1","2015-10-01 07:58:55",1443711535,"C2",261896,1443973431,"2015-10-04 08:43:51"
"2068","20153023073030-973","1","2015-10-01 08:27:48",1443713268,"C8",99234,1443812502,"2015-10-02 12:01:42"
"2316","20154212084212-789","1","2015-10-01 08:41:03",1443714063,"C5",617133,1444331196,"2015-10-08 12:06:36"
"5291","20150427050456-122","1","2015-10-01 09:53:48",1443718428,"C8",45676,1443764104,"2015-10-01 22:35:04"
"5053","20151024091033-928","2","2015-10-01 10:30:35",1443720635,"C5",87086,1443807721,"2015-10-02 10:42:01"
"4699","20155310085325-400","2","2015-10-01 11:42:21",1443724941,"C7",260648,1443985589,"2015-10-04 12:06:29"
"6233","20155823045848-67","2","2015-10-01 11:47:33",1443725253,"C8",134505,1443859758,"2015-10-03 01:09:18"
"6418","20155626055623-547","1","2015-10-01 12:35:53",1443728153,"C3",412770,1444140923,"2015-10-06 07:15:23"
"5869","20153901053918-352","1","2015-10-01 12:39:34",1443728374,"C2",321752,1444050126,"2015-10-05 06:02:06"
"2839","20155429055432-113","1","2015-10-01 12:49:04",1443728944,"C4",154472,1443883416,"2015-10-03 07:43:36"
"3866","20151225051248-279","2","2015-10-01 13:13:40",1443730420,"C4",252026,1443982446,"2015-10-04 11:14:06"
"3622","20153115083129-294","2","2015-10-01 13:39:44",1443731984,"C2",466965,1444198949,"2015-10-06 23:22:29"
"6066","20155203015220-852","3","2015-10-01 13:50:07",1443732607,"C3",345581,1444078188,"2015-10-05 13:49:48"
"1645","20151423061421-949","2","2015-10-01 14:13:33",1443734013,"C5",359976,1444093989,"2015-10-05 18:13:09"
"2668","20155328085310-805","2","2015-10-01 15:02:31",1443736951,"C6",281361,1444018312,"2015-10-04 21:11:52"
"4482","20153613083644-306","1","2015-10-01 15:38:04",1443739084,"C4",197560,1443936644,"2015-10-03 22:30:44"
"5955","20150329030356-86","1","2015-10-01 16:17:54",1443741474,"C4",177238,1443918712,"2015-10-03 17:31:52"
"5284","20152012122057-909","3","2015-10-01 16:51:49",1443743509,"C2",236836,1443980345,"2015-10-04 10:39:05"
"4909","20150411050432-27","1","2015-10-01 17:22:47",1443745367,"C8",345819,1444091186,"2015-10-05 17:26:26"
"267","20155711115749-167","1","2015-10-01 19:03:09",1443751389,"C6",888790,1444640179,"2015-10-12 01:56:19"
"1457","20153710073725-591","2","2015-10-01 19:57:54",1443754674,"C8",265547,1444020221,"2015-10-04 21:43:41"
"6224","20152504102537-658","2","2015-10-01 20:46:58",1443757618,"C7",338583,1444096201,"2015-10-05 18:50:01"
"3895","20152328102355-953","1","2015-10-01 20:50:28",1443757828,"C6",296793,1444054621,"2015-10-05 07:17:01"
"2411","20155024105051-288","3","2015-10-01 20:54:21",1443758061,"C4",213670,1443971731,"2015-10-04 08:15:31"
"739","20150229120212-565","1","2015-10-01 21:15:30",1443759330,"C3",205998,1443965328,"2015-10-04 06:28:48"
"4619","20150828050833-517","1","2015-10-01 21:35:06",1443760506,"C5",91731,1443852237,"2015-10-02 23:03:57"
"5123","20150930110949-443","1","2015-10-01 22:23:09",1443763389,"C0",350650,1444114039,"2015-10-05 23:47:19"
"1744","20150419110400-987","2","2015-10-01 23:23:10",1443766990,"C8",154450,1443921440,"2015-10-03 18:17:20"
"4555","20151727121757-443","1","2015-10-01 23:35:41",1443767741,"C5",193132,1443960873,"2015-10-04 05:14:33"
"3174","20152027062057-241","2","2015-10-02 00:09:37",1443769777,"C5",204860,1443974637,"2015-10-04 09:03:57"
"3459","20151521021503-834","1","2015-10-02 03:08:01",1443780481,"C5",455189,1444235670,"2015-10-07 09:34:30"
"3148","20153923093923-432","3","2015-10-02 04:20:06",1443784806,"C8",108349,1443893155,"2015-10-03 10:25:55"
"4829","20155330055334-238","3","2015-10-02 04:20:38",1443784838,"C4",350303,1444135141,"2015-10-06 05:39:01"
"3247","20155304085320-560","1","2015-10-02 05:26:29",1443788789,"C3",343827,1444132616,"2015-10-06 04:56:56"
"1969","20155923115946-322","2","2015-10-02 06:21:56",1443792116,"C0",378665,1444170781,"2015-10-06 15:33:01"
"1875","20150117100126-822","2","2015-10-02 06:32:16",1443792736,"C8",641725,1444434461,"2015-10-09 16:47:41"
"130","20154928114954-255","1","2015-10-02 06:37:06",1443793026,"C5",375654,1444168680,"2015-10-06 14:58:00"
"3659","20153517113533-488","2","2015-10-02 06:57:43",1443794263,"C8",255866,1444050129,"2015-10-05 06:02:09"
"146","20152224062251-834","2","2015-10-02 07:11:23",1443795083,"C4",86764,1443881847,"2015-10-03 07:17:27"
"6469","20152721082747-925","1","2015-10-02 07:43:17",1443796997,"C5",135390,1443932387,"2015-10-03 21:19:47"
"1448","20150811080802-300","3","2015-10-02 08:11:39",1443798699,"C2",259231,1444057930,"2015-10-05 08:12:10"
"6493","20153425023446-675","1","2015-10-02 08:58:53",1443801533,"C5",83521,1443885054,"2015-10-03 08:10:54"
"5151","20155925115933-802","2","2015-10-02 10:48:51",1443808131,"C0",200186,1444008317,"2015-10-04 18:25:17"
"5990","20154324014310-391","1","2015-10-02 11:19:48",1443809988,"C4",97514,1443907502,"2015-10-03 14:25:02"
"2372","20154927084908-110","2","2015-10-02 12:57:33",1443815853,"C4",446905,1444262758,"2015-10-07 17:05:58"
"2917","20151428061409-269","1","2015-10-02 13:05:11",1443816311,"C7",185131,1444001442,"2015-10-04 16:30:42"
"4267","20150218020235-744","2","2015-10-02 14:36:04",1443821764,"C8",173087,1443994851,"2015-10-04 14:40:51"
"4282","20154815114839-956","1","2015-10-02 14:39:27",1443821967,"C6",184881,1444006848,"2015-10-04 18:00:48"
"4911","20154323124336-960","3","2015-10-02 15:01:51",1443823311,"C8",1228539,1445051850,"2015-10-16 20:17:30"
"4543","20155726125730-585","1","2015-10-02 16:47:14",1443829634,"C5",66523,1443896157,"2015-10-03 11:15:57"
"6160","20154626064612-785","1","2015-10-02 17:07:56",1443830876,"C4",739063,1444569939,"2015-10-11 06:25:39"
"1594","20150722010749-2","1","2015-10-02 17:24:51",1443831891,"C0",439711,1444271602,"2015-10-07 19:33:22"
"1997","20154817014854-170","2","2015-10-02 19:48:54",1443840534,"C7",146400,1443986934,"2015-10-04 12:28:54"
"1381","20151623111631-719","1","2015-10-02 20:03:35",1443841415,"C5",101153,1443942568,"2015-10-04 00:09:28"
"3331","20151628071608-385","3","2015-10-02 20:05:36",1443841536,"C5",195884,1444037420,"2015-10-05 02:30:20"
"484","20155017105034-330","2","2015-10-02 22:59:38",1443851978,"C4",167468,1444019446,"2015-10-04 21:30:46"
"1870","20155122115118-223","1","2015-10-03 00:58:22",1443859102,"C4",113903,1443973005,"2015-10-04 08:36:45"
"3846","20155922085938-836","1","2015-10-03 02:03:26",1443863006,"C2",132204,1443995210,"2015-10-04 14:46:50"
"886","20152013102004-55","1","2015-10-03 02:03:56",1443863036,"C4",849116,1444712152,"2015-10-12 21:55:52"
"3861","20150326040316-459","1","2015-10-03 03:43:40",1443869020,"C2",186808,1444055828,"2015-10-05 07:37:08"
"5883","20151925101910-391","2","2015-10-03 04:06:28",1443870388,"C6",111473,1443981861,"2015-10-04 11:04:21"
"1154","20151204111220-934","2","2015-10-03 04:09:47",1443870587,"C7",275583,1444146170,"2015-10-06 08:42:50"
"5138","20155611055631-743","2","2015-10-03 04:21:02",1443871262,"C0",264553,1444135815,"2015-10-06 05:50:15"
"4688","20150223100216-408","2","2015-10-03 04:24:32",1443871472,"C4",105467,1443976939,"2015-10-04 09:42:19"
"1085","20151526091530-569","1","2015-10-03 04:38:15",1443872295,"C5",196055,1444068350,"2015-10-05 11:05:50"
"2251","20153622093633-893","2","2015-10-03 05:04:33",1443873873,"C4",451560,1444325433,"2015-10-08 10:30:33"
"4656","20152723022703-590","1","2015-10-03 05:41:43",1443876103,"C1",1097660,1444973763,"2015-10-15 22:36:03"
"5904","20150326110322-354","2","2015-10-03 08:54:34",1443887674,"C6",99512,1443987186,"2015-10-04 12:33:06"
"820","20152826012855-73","3","2015-10-03 09:43:43",1443890623,"C0",197096,1444087719,"2015-10-05 16:28:39"
"181","20155204055234-952","3","2015-10-03 10:25:09",1443893109,"C8",1567111,1445460220,"2015-10-21 13:43:40"
"6301","20151103031107-509","1","2015-10-03 10:32:11",1443893531,"C2",656708,1444550239,"2015-10-11 00:57:19"
"23","20151829011833-716","1","2015-10-03 11:17:33",1443896253,"C1",949190,1444845443,"2015-10-14 10:57:23"
"6045","20150215070210-159","1","2015-10-03 11:18:05",1443896285,"C7",224365,1444120650,"2015-10-06 01:37:30"
"4521","20153712113749-782","1","2015-10-03 11:28:50",1443896930,"C5",259123,1444156053,"2015-10-06 11:27:33"
"2453","20153524023526-802","3","2015-10-03 11:41:10",1443897670,"C2",109592,1444007262,"2015-10-04 18:07:42"
"953","20155431125412-835","3","2015-10-03 11:58:20",1443898700,"C0",789464,1444688164,"2015-10-12 15:16:04"
"4298","20154824124832-402","2","2015-10-03 12:40:17",1443901217,"C2",111015,1444012232,"2015-10-04 19:30:32"
"4249","20151502121513-669","1","2015-10-03 13:22:07",1443903727,"C6",893469,1444797196,"2015-10-13 21:33:16"
"6457","20150229070254-204","1","2015-10-03 13:28:21",1443904101,"C4",368727,1444272828,"2015-10-07 19:53:48"
"760","20151619091608-327","2","2015-10-03 14:57:09",1443909429,"C5",175723,1444085152,"2015-10-05 15:45:52"
"2733","20154421054430-525","1","2015-10-03 16:32:57",1443915177,"C2",147501,1444062678,"2015-10-05 09:31:18"
"4111","20153201013211-268","3","2015-10-03 16:37:39",1443915459,"C2",681791,1444597250,"2015-10-11 14:00:50"
"2808","20152819022855-141","1","2015-10-03 17:05:22",1443917122,"C7",1018643,1444935765,"2015-10-15 12:02:45"
"1539","20151812031807-51","1","2015-10-03 17:17:19",1443917839,"C5",607184,1444525023,"2015-10-10 17:57:03"
"2048","20150028030051-590","3","2015-10-03 17:20:03",1443918003,"C5",445536,1444363539,"2015-10-08 21:05:39"
"5549","20150206070250-791","1","2015-10-03 17:25:08",1443918308,"C6",395023,1444313331,"2015-10-08 07:08:51"
"6273","20154025084030-323","2","2015-10-03 17:40:20",1443919220,"C5",361795,1444281015,"2015-10-07 22:10:15"
"3533","20151121121131-715","3","2015-10-03 19:30:22",1443925822,"C4",354377,1444280199,"2015-10-07 21:56:39"
"6367","20154829024816-982","2","2015-10-03 19:45:48",1443926748,"C2",363452,1444290200,"2015-10-08 00:43:20"
"4536","20152717052750-615","3","2015-10-03 20:18:08",1443928688,"C7",696309,1444624997,"2015-10-11 21:43:17"
"3092","20154524034503-939","3","2015-10-03 21:00:39",1443931239,"C0",99567,1444030806,"2015-10-05 00:40:06"
"687","20155030125002-922","3","2015-10-03 21:04:14",1443931454,"C2",96284,1444027738,"2015-10-04 23:48:58"
"4758","20150430090433-512","2","2015-10-03 21:51:29",1443934289,"C2",707752,1444642041,"2015-10-12 02:27:21"
"5191","20153321073305-157","2","2015-10-03 22:10:49",1443935449,"C8",544732,1444480181,"2015-10-10 05:29:41"
"1235","20153220073240-457","2","2015-10-03 22:27:58",1443936478,"C2",392306,1444328784,"2015-10-08 11:26:24"
"4510","20152621062629-429","2","2015-10-03 22:40:33",1443937233,"C5",539092,1444476325,"2015-10-10 04:25:25"
"3384","20154316024349-453","2","2015-10-03 22:57:46",1443938266,"C2",596691,1444534957,"2015-10-10 20:42:37"
"1194","20155928015947-290","2","2015-10-03 23:29:26",1443940166,"C3",155393,1444095559,"2015-10-05 18:39:19"
"6162","20153721073748-885","1","2015-10-03 23:47:53",1443941273,"C8",219001,1444160274,"2015-10-06 12:37:54"
"1420","20155929045919-954","2","2015-10-04 00:08:25",1443942505,"C3",1016582,1444959087,"2015-10-15 18:31:27"
"1789","20151314011311-1","3","2015-10-04 00:35:51",1443944151,"C2",545120,1444489271,"2015-10-10 08:01:11"
"6146","20153925063909-84","3","2015-10-04 00:45:31",1443944731,"C2",378191,1444322922,"2015-10-08 09:48:42"
"4775","20152501062522-694","2","2015-10-04 00:45:34",1443944734,"C4",119406,1444064140,"2015-10-05 09:55:40"
"1148","20152620092652-624","2","2015-10-04 02:36:05",1443951365,"C4",169279,1444120644,"2015-10-06 01:37:24"
"4043","20153730063725-217","1","2015-10-04 03:14:18",1443953658,"C7",430259,1444383917,"2015-10-09 02:45:17"
"4740","20152524122527-579","1","2015-10-04 03:15:11",1443953711,"C4",118712,1444072423,"2015-10-05 12:13:43"
"4101","20152006062007-464","2","2015-10-04 03:35:59",1443954959,"C6",301169,1444256128,"2015-10-07 15:15:28"
"2769","20153902113957-47","3","2015-10-04 03:48:59",1443955739,"C5",72271,1444028010,"2015-10-04 23:53:30"
"4500","20151904071915-758","2","2015-10-04 04:27:48",1443958068,"C7",286857,1444244925,"2015-10-07 12:08:45"
"385","20155826025824-717","2","2015-10-04 07:08:28",1443967708,"C5",331502,1444299210,"2015-10-08 03:13:30"
"3982","20152927082906-285","1","2015-10-04 08:36:55",1443973015,"C8",86467,1444059482,"2015-10-05 08:38:02"
"5802","20151729051737-48","1","2015-10-04 08:59:01",1443974341,"C5",134028,1444108369,"2015-10-05 22:12:49"
"2361","20150429100402-347","1","2015-10-04 10:41:36",1443980496,"C5",217127,1444197623,"2015-10-06 23:00:23"
"117","20152631082611-613","2","2015-10-04 11:06:52",1443982012,"C7",803663,1444785675,"2015-10-13 18:21:15"
"5842","20153430033444-725","2","2015-10-04 11:59:20",1443985160,"C4",166338,1444151498,"2015-10-06 10:11:38"
"5049","20151128111144-648","2","2015-10-04 12:24:45",1443986685,"C7",74683,1444061368,"2015-10-05 09:09:28"
"6322","20154623014627-670","2","2015-10-04 12:47:46",1443988066,"C5",517897,1444505963,"2015-10-10 12:39:23"
"591","20152325042329-787","1","2015-10-04 13:30:05",1443990605,"C3",255732,1444246337,"2015-10-07 12:32:17"
"1452","20155525115508-896","2","2015-10-04 14:22:31",1443993751,"C3",112349,1444106100,"2015-10-05 21:35:00"
"6334","20153912103945-821","2","2015-10-04 14:42:30",1443994950,"C8",383073,1444378023,"2015-10-09 01:07:03"
"5858","20150026120010-942","2","2015-10-04 14:43:24",1443995004,"C0",350497,1444345501,"2015-10-08 16:05:01"
"996","20155526065554-981","1","2015-10-04 15:11:34",1443996694,"C2",360470,1444357164,"2015-10-08 19:19:24"
"2325","20150627110636-691","2","2015-10-04 15:44:12",1443998652,"C5",412482,1444411134,"2015-10-09 10:18:54"
"4749","20151526081527-704","2","2015-10-04 16:28:02",1444001282,"C2",102965,1444104247,"2015-10-05 21:04:07"
"63","20154018024040-960","1","2015-10-04 17:12:32",1444003952,"C5",581416,1444585368,"2015-10-11 10:42:48"
"5919","20151914101910-853","2","2015-10-04 18:26:35",1444008395,"C7",251035,1444259430,"2015-10-07 16:10:30"
"905","20153030073006-385","2","2015-10-04 18:31:38",1444008698,"C8",192646,1444201344,"2015-10-07 00:02:24"
"3899","20150328070359-611","1","2015-10-04 19:46:51",1444013211,"C3",80596,1444093807,"2015-10-05 18:10:07"
"3340","20155229035205-191","2","2015-10-04 19:59:31",1444013971,"C0",223423,1444237394,"2015-10-07 10:03:14"
"612","20154824034835-889","2","2015-10-04 20:13:50",1444014830,"C8",175983,1444190813,"2015-10-06 21:06:53"
"5058","20152028092031-391","2","2015-10-04 20:19:31",1444015171,"C3",278970,1444294141,"2015-10-08 01:49:01"
"4537","20152610092600-874","1","2015-10-04 20:25:27",1444015527,"C7",301881,1444317408,"2015-10-08 08:16:48"
"2121","20155419015446-344","1","2015-10-04 21:12:14",1444018334,"C5",165281,1444183615,"2015-10-06 19:06:55"
"3129","20153613033606-451","2","2015-10-04 21:17:33",1444018653,"C0",611629,1444630282,"2015-10-11 23:11:22"
"4045","20151929021932-254","1","2015-10-04 22:33:57",1444023237,"C8",92333,1444115570,"2015-10-06 00:12:50"
"2221","20152130032113-173","2","2015-10-04 22:50:34",1444024234,"C4",372561,1444396795,"2015-10-09 06:19:55"
"3976","20150824070825-886","3","2015-10-04 23:43:58",1444027438,"C0",307911,1444335349,"2015-10-08 13:15:49"
"5666","20151118101124-666","3","2015-10-05 00:06:28",1444028788,"C5",179063,1444207851,"2015-10-07 01:50:51"
"5532","20151912111905-652","1","2015-10-05 02:15:13",1444036513,"C5",977284,1445013797,"2015-10-16 09:43:17"
"5835","20151107021135-737","3","2015-10-05 04:10:59",1444043459,"C5",340452,1444383911,"2015-10-09 02:45:11"
"4628","20153305023343-499","2","2015-10-05 04:38:17",1444045097,"C5",365182,1444410279,"2015-10-09 10:04:39"
"1742","20153329043333-913","1","2015-10-05 04:41:51",1444045311,"C6",79283,1444124594,"2015-10-06 02:43:14"
"998","20152226092250-865","1","2015-10-05 06:57:18",1444053438,"C4",384434,1444437872,"2015-10-09 17:44:32"
"3654","20150530120541-89","1","2015-10-05 07:30:09",1444055409,"C2",207734,1444263143,"2015-10-07 17:12:23"
"3743","20155826055856-580","1","2015-10-05 08:46:24",1444059984,"C6",762656,1444822640,"2015-10-14 04:37:20"
"1105","20151229111259-568","1","2015-10-05 09:25:38",1444062338,"C2",170653,1444232991,"2015-10-07 08:49:51"
"6139","20153425083416-909","1","2015-10-05 09:32:04",1444062724,"C3",289156,1444351880,"2015-10-08 17:51:20"
"3561","20152328112352-194","1","2015-10-05 12:33:17",1444073597,"C2",86995,1444160592,"2015-10-06 12:43:12"
"4291","20154925034909-164","2","2015-10-05 12:58:59",1444075139,"C8",170758,1444245897,"2015-10-07 12:24:57"
"5681","20151826041854-598","1","2015-10-05 13:09:15",1444075755,"C2",255407,1444331162,"2015-10-08 12:06:02"
"2289","20155128015133-316","1","2015-10-05 14:14:53",1444079693,"C6",410575,1444490268,"2015-10-10 08:17:48"
"1483","20150009040035-292","1","2015-10-05 14:48:59",1444081739,"C3",280263,1444362002,"2015-10-08 20:40:02"
"5699","20151821011808-722","1","2015-10-05 15:07:02",1444082822,"C0",608067,1444690889,"2015-10-12 16:01:29"
"4509","20150818060847-607","1","2015-10-05 15:09:28",1444082968,"C3",214463,1444297431,"2015-10-08 02:43:51"
"895","20152317102301-124","3","2015-10-05 16:03:23",1444086203,"C3",990346,1445076549,"2015-10-17 03:09:09"
"1117","20154821124817-368","1","2015-10-05 17:54:44",1444092884,"C7",434043,1444526927,"2015-10-10 18:28:47"
"5566","20155225085241-468","2","2015-10-05 18:08:32",1444093712,"C4",128193,1444221905,"2015-10-07 05:45:05"
"4416","20153824093852-393","1","2015-10-05 18:25:08",1444094708,"C2",122747,1444217455,"2015-10-07 04:30:55"
"3087","20155231105239-338","2","2015-10-05 18:31:03",1444095063,"C6",508584,1444603647,"2015-10-11 15:47:27"
"1962","20152529072547-796","2","2015-10-05 21:33:05",1444105985,"C3",189746,1444295731,"2015-10-08 02:15:31"
"1400","20151729021748-498","2","2015-10-05 21:51:33",1444107093,"C7",60625,1444167718,"2015-10-06 14:41:58"
"4755","20155310125342-214","2","2015-10-05 23:08:12",1444111692,"C8",439374,1444551066,"2015-10-11 01:11:06"
"3606","20150108060137-927","2","2015-10-05 23:32:39",1444113159,"C4",342266,1444455425,"2015-10-09 22:37:05"
"5652","20152028112022-449","1","2015-10-06 00:14:16",1444115656,"C5",325617,1444441273,"2015-10-09 18:41:13"
"5423","20155326075351-224","3","2015-10-06 00:56:42",1444118202,"C7",119853,1444238055,"2015-10-07 10:14:15"
"1606","20153024013035-807","3","2015-10-06 01:42:08",1444120928,"C7",408077,1444529005,"2015-10-10 19:03:25"
"2405","20152925012926-304","2","2015-10-06 01:43:50",1444121030,"C4",454032,1444575062,"2015-10-11 07:51:02"
"3303","20152215092206-481","1","2015-10-06 03:56:06",1444128966,"C0",893955,1445022921,"2015-10-16 12:15:21"
"3264","20154812074833-507","2","2015-10-06 04:16:49",1444130209,"C5",257612,1444387821,"2015-10-09 03:50:21"
"5459","20155029085047-891","3","2015-10-06 05:10:34",1444133434,"C7",467141,1444600575,"2015-10-11 14:56:15"
"3576","20150625040628-192","1","2015-10-06 05:13:43",1444133623,"C8",182247,1444315870,"2015-10-08 07:51:10"
"303","20153231063236-320","3","2015-10-06 05:18:20",1444133900,"C4",388243,1444522143,"2015-10-10 17:09:03"
"6374","20150414050436-933","1","2015-10-06 05:28:28",1444134508,"C5",232379,1444366887,"2015-10-08 22:01:27"
"2887","20155228015220-418","2","2015-10-06 06:40:36",1444138836,"C4",332648,1444471484,"2015-10-10 03:04:44"
"6112","20152230022253-963","1","2015-10-06 06:45:01",1444139101,"C8",245464,1444384565,"2015-10-09 02:56:05"
"1122","20155127035102-451","2","2015-10-06 07:22:38",1444141358,"C2",106728,1444248086,"2015-10-07 13:01:26"
"5145","20151628111650-794","2","2015-10-06 08:03:22",1444143802,"C4",419749,1444563551,"2015-10-11 04:39:11"
"1322","20154529104539-756","1","2015-10-06 09:31:15",1444149075,"C7",66704,1444215779,"2015-10-07 04:02:59"
"4349","20154911094955-742","1","2015-10-06 09:48:34",1444150114,"C4",1073817,1445223931,"2015-10-18 20:05:31"
"745","20154303064359-839","1","2015-10-06 10:03:50",1444151030,"C5",954397,1445105427,"2015-10-17 11:10:27"
"1956","20150327050342-760","1","2015-10-06 10:12:24",1444151544,"C4",250974,1444402518,"2015-10-09 07:55:18"
"6272","20153707073715-128","2","2015-10-06 10:20:59",1444152059,"C3",984028,1445136087,"2015-10-17 19:41:27"
"6278","20155026015014-82","1","2015-10-06 11:20:25",1444155625,"C7",504773,1444660398,"2015-10-12 07:33:18"
"3279","20150326110308-543","1","2015-10-06 11:28:36",1444156116,"C4",108191,1444264307,"2015-10-07 17:31:47"
"950","20152627032636-64","3","2015-10-06 11:29:16",1444156156,"C2",430220,1444586376,"2015-10-11 10:59:36"
"989","20150108060104-840","1","2015-10-06 12:58:52",1444161532,"C5",814756,1444976288,"2015-10-15 23:18:08"
"246","20150230110247-212","3","2015-10-06 13:59:59",1444165199,"C3",264516,1444429715,"2015-10-09 15:28:35"
"1506","20153217013250-235","1","2015-10-06 16:57:54",1444175874,"C3",236272,1444412146,"2015-10-09 10:35:46"
"6131","20155420055422-20","1","2015-10-06 17:26:28",1444177588,"C5",690363,1444867951,"2015-10-14 17:12:31"
"3850","20150726120703-149","2","2015-10-06 18:00:21",1444179621,"C2",295066,1444474687,"2015-10-10 03:58:07"
"1863","20153412033403-441","1","2015-10-06 19:05:15",1444183515,"C2",930384,1445113899,"2015-10-17 13:31:39"
"4986","20150826030836-996","1","2015-10-06 19:37:32",1444185452,"C4",110017,1444295469,"2015-10-08 02:11:09"
"2617","20150016070037-632","3","2015-10-06 19:42:33",1444185753,"C7",253388,1444439141,"2015-10-09 18:05:41"
"4896","20155525025528-862","2","2015-10-06 22:38:49",1444196329,"C5",326067,1444522396,"2015-10-10 17:13:16"
"4002","20154725064714-647","2","2015-10-07 00:04:50",1444201490,"C0",461382,1444662872,"2015-10-12 08:14:32"
"4287","20151913061921-545","2","2015-10-07 01:09:39",1444205379,"C4",293574,1444498953,"2015-10-10 10:42:33"
"6032","20155930055927-156","2","2015-10-07 02:42:48",1444210968,"C4",183267,1444394235,"2015-10-09 05:37:15"
"5710","20150805040827-754","3","2015-10-07 03:42:11",1444214531,"C2",340003,1444554534,"2015-10-11 02:08:54"
"4643","20150029020040-164","1","2015-10-07 03:56:28",1444215388,"C7",72772,1444288160,"2015-10-08 00:09:20"
"4354","20154427014449-383","2","2015-10-07 05:08:16",1444219696,"C5",277669,1444497365,"2015-10-10 10:16:05"
"66","20152508082517-666","1","2015-10-07 05:20:54",1444220454,"C5",738991,1444959445,"2015-10-15 18:37:25"
"1912","20151719031705-396","1","2015-10-07 05:53:50",1444222430,"C5",507135,1444729565,"2015-10-13 02:46:05"
"4895","20154827014803-602","3","2015-10-07 05:54:03",1444222443,"C5",278520,1444500963,"2015-10-10 11:16:03"
"53","20150429080444-356","3","2015-10-07 06:26:46",1444224406,"C4",342661,1444567067,"2015-10-11 05:37:47"
"3570","20155426015439-228","3","2015-10-07 07:59:31",1444229971,"C7",515356,1444745327,"2015-10-13 07:08:47"
"807","20153515033550-824","1","2015-10-07 08:12:46",1444230766,"C5",234277,1444465043,"2015-10-10 01:17:23"
"4615","20154519024544-322","False","2015-10-07 08:48:16",1444232896,"C4",202554,1444435450,"2015-10-09 17:04:10"
"3095","20154719084741-65","3","2015-10-07 08:52:17",1444233137,"C5",518492,1444751629,"2015-10-13 08:53:49"
"3448","20152930122926-301","3","2015-10-07 10:27:11",1444238831,"C4",199155,1444437986,"2015-10-09 17:46:26"
"1897","20153914123920-944","1","2015-10-07 12:06:08",1444244768,"C3",248151,1444492919,"2015-10-10 09:01:59"
"5581","20152923092919-201","1","2015-10-07 13:20:46",1444249246,"C7",731143,1444980389,"2015-10-16 00:26:29"
"4662","20155120055142-403","1","2015-10-07 14:00:41",1444251641,"C4",590477,1444842118,"2015-10-14 10:01:58"
"1918","20151529051508-917","1","2015-10-07 14:09:27",1444252167,"C4",680059,1444932226,"2015-10-15 11:03:46"
"743","20150729080703-389","1","2015-10-07 14:25:13",1444253113,"C5",356945,1444610058,"2015-10-11 17:34:18"
"1929","20152729052719-451","1","2015-10-07 14:26:15",1444253175,"C4",419842,1444673017,"2015-10-12 11:03:37"
"3043","20153230023251-365","1","2015-10-07 19:48:40",1444272520,"C7",89107,1444361627,"2015-10-08 20:33:47"
"4925","20151617021605-748","1","2015-10-07 19:57:21",1444273041,"C5",874238,1445147279,"2015-10-17 22:47:59"
"2683","20152606012640-366","1","2015-10-07 21:04:40",1444277080,"C4",338235,1444615315,"2015-10-11 19:01:55"
"2492","20150825120831-381","1","2015-10-07 22:04:46",1444280686,"C0",357525,1444638211,"2015-10-12 01:23:31"
"3766","20151810061830-545","1","2015-10-08 00:01:54",1444287714,"C5",798868,1445086582,"2015-10-17 05:56:22"
"4052","20153928053902-838","1","2015-10-08 01:43:02",1444293782,"C5",770430,1445064212,"2015-10-16 23:43:32"
"5501","20152320082354-550","3","2015-10-08 01:59:45",1444294785,"C5",510717,1444805502,"2015-10-13 23:51:42"
"4987","20155921075955-560","1","2015-10-08 02:28:17",1444296497,"C4",206986,1444503483,"2015-10-10 11:58:03"
"2892","20152720032733-633","1","2015-10-08 04:31:09",1444303869,"C5",189477,1444493346,"2015-10-10 09:09:06"
"2987","20152327072324-277","2","2015-10-08 05:30:04",1444307404,"C4",117950,1444425354,"2015-10-09 14:15:54"
"2629","20150420080400-256","3","2015-10-08 05:36:45",1444307805,"C8",309273,1444617078,"2015-10-11 19:31:18"
"1567","20150228100235-385","2","2015-10-08 11:17:07",1444328227,"C0",434236,1444762463,"2015-10-13 11:54:23"
"2574","20150506040523-403","1","2015-10-08 11:21:15",1444328475,"C4",392536,1444721011,"2015-10-13 00:23:31"
"1446","20152620062633-528","1","2015-10-08 13:21:36",1444335696,"C7",225729,1444561425,"2015-10-11 04:03:45"
"1519","20150027100028-509","1","2015-10-08 14:15:58",1444338958,"C3",520590,1444859548,"2015-10-14 14:52:28"
"4187","20152824022826-397","3","2015-10-08 18:06:32",1444352792,"C5",611343,1444964135,"2015-10-15 19:55:35"
"5040","20154129044136-415","1","2015-10-08 22:23:34",1444368214,"C8",399059,1444767273,"2015-10-13 13:14:33"
"3904","20155820055809-845","1","2015-10-09 00:28:00",1444375680,"C4",526197,1444901877,"2015-10-15 02:37:57"
"5887","20151026061040-488","1","2015-10-09 00:50:18",1444377018,"C5",551989,1444929007,"2015-10-15 10:10:07"
"4205","20150628060613-79","1","2015-10-09 00:59:09",1444377549,"C0",515768,1444893317,"2015-10-15 00:15:17"
"6105","20151020021029-947","1","2015-10-09 01:21:57",1444378917,"C2",199436,1444578353,"2015-10-11 08:45:53"
"636","20155221125213-371","1","2015-10-09 02:19:49",1444382389,"C4",189657,1444572046,"2015-10-11 07:00:46"
"3305","20154916014936-45","2","2015-10-09 03:09:16",1444385356,"C3",974390,1445359746,"2015-10-20 09:49:06"
"6308","20154617094613-518","2","2015-10-09 03:13:32",1444385612,"C3",268177,1444653789,"2015-10-12 05:43:09"
"4815","20153426113440-126","3","2015-10-09 03:31:25",1444386685,"C5",156315,1444543000,"2015-10-10 22:56:40"
"3949","20153429063446-548","2","2015-10-09 03:51:26",1444387886,"C8",170840,1444558726,"2015-10-11 03:18:46"
"797","20154728124707-118","1","2015-10-09 06:09:33",1444396173,"C7",463273,1444859446,"2015-10-14 14:50:46"
"2445","20153605033626-803","2","2015-10-09 09:11:35",1444407095,"C2",971503,1445378598,"2015-10-20 15:03:18"
"6281","20154929104953-761","1","2015-10-09 09:58:17",1444409897,"C2",107613,1444517510,"2015-10-10 15:51:50"
"2862","20151808071821-441","3","2015-10-09 10:21:34",1444411294,"C5",384199,1444795493,"2015-10-13 21:04:53"
"5428","20153714053753-627","3","2015-10-09 10:24:09",1444411449,"C5",266747,1444678196,"2015-10-12 12:29:56"
"974","20151422101430-872","1","2015-10-09 10:43:26",1444412606,"C2",518617,1444931223,"2015-10-15 10:47:03"
"6010","20153425113451-606","2","2015-10-09 11:27:16",1444415236,"C3",172735,1444587971,"2015-10-11 11:26:11"
"1605","20151814061817-293","1","2015-10-09 12:14:11",1444418051,"C2",311622,1444729673,"2015-10-13 02:47:53"
"1361","20154219084210-14","3","2015-10-09 13:06:03",1444421163,"C2",249119,1444670282,"2015-10-12 10:18:02"
"4523","20155727045729-105","2","2015-10-09 15:16:14",1444428974,"C8",529875,1444958849,"2015-10-15 18:27:29"
"3475","20150829080813-483","2","2015-10-09 15:32:53",1444429973,"C8",127240,1444557213,"2015-10-11 02:53:33"
"1288","20152121052117-267","2","2015-10-09 17:03:33",1444435413,"C5",777068,1445212481,"2015-10-18 16:54:41"
"4676","20150601040632-151","2","2015-10-09 17:13:07",1444435987,"C8",657439,1445093426,"2015-10-17 07:50:26"
"3511","20153723123726-448","2","2015-10-09 17:32:58",1444437178,"C0",700066,1445137244,"2015-10-17 20:00:44"
"5705","20151929031948-686","2","2015-10-09 17:55:28",1444438528,"C8",710348,1445148876,"2015-10-17 23:14:36"
"1417","20150513120548-43","3","2015-10-09 18:14:40",1444439680,"C5",324076,1444763756,"2015-10-13 12:15:56"
"1028","20150528090539-210","1","2015-10-09 23:23:54",1444458234,"C8",200379,1444658613,"2015-10-12 07:03:33"
"3209","20154525044559-95","1","2015-10-10 03:47:23",1444474043,"C4",416428,1444890471,"2015-10-14 23:27:51"
"1415","20150713100753-416","1","2015-10-10 05:03:21",1444478601,"C2",289316,1444767917,"2015-10-13 13:25:17"
"3334","20150025100041-260","3","2015-10-10 05:32:32",1444480352,"C0",426637,1444906989,"2015-10-15 04:03:09"
"4591","20155606085604-918","1","2015-10-10 05:37:24",1444480644,"C3",365710,1444846354,"2015-10-14 11:12:34"
"262","20151530031532-48","1","2015-10-10 07:06:02",1444485962,"C3",278210,1444764172,"2015-10-13 12:22:52"
"4122","20154024084056-354","2","2015-10-10 09:10:48",1444493448,"C5",173024,1444666472,"2015-10-12 09:14:32"
"1226","20152231092234-568","1","2015-10-10 09:29:14",1444494554,"C5",876400,1445370954,"2015-10-20 12:55:54"
"5599","20151026051047-171","1","2015-10-10 11:16:23",1444500983,"C5",396112,1444897095,"2015-10-15 01:18:15"
"4112","20150630080609-634","1","2015-10-10 11:57:37",1444503457,"C2",444536,1444947993,"2015-10-15 15:26:33"
"4633","20151523091527-511","1","2015-10-10 12:08:07",1444504087,"C8",295832,1444799919,"2015-10-13 22:18:39"
"4939","20151522061542-891","2","2015-10-10 14:39:06",1444513146,"C0",528468,1445041614,"2015-10-16 17:26:54"
"99","20153915033947-108","1","2015-10-10 16:12:27",1444518747,"C8",968072,1445486819,"2015-10-21 21:06:59"
"4460","20150822080830-143","3","2015-10-10 17:12:44",1444522364,"C4",793927,1445316291,"2015-10-19 21:44:51"
"4518","20154616084623-195","1","2015-10-10 17:57:59",1444525079,"C2",263337,1444788416,"2015-10-13 19:06:56"
"3843","20150818120801-625","2","2015-10-10 18:14:36",1444526076,"C4",274685,1444800761,"2015-10-13 22:32:41"
"5388","20152419102424-497","1","2015-10-10 20:07:10",1444532830,"C8",1399738,1445932568,"2015-10-27 00:56:08"
"443","20151529051506-307","2","2015-10-10 20:34:36",1444534476,"C6",160395,1444694871,"2015-10-12 17:07:51"
"6197","20152229052214-773","3","2015-10-10 20:43:01",1444534981,"C8",520121,1445055102,"2015-10-16 21:11:42"
"5402","20153710013742-178","3","2015-10-10 23:39:58",1444545598,"C4",328517,1444874115,"2015-10-14 18:55:15"
"5373","20150323090352-23","2","2015-10-11 00:07:12",1444547232,"C5",190375,1444737607,"2015-10-13 05:00:07"
"1599","20155123085147-286","1","2015-10-11 00:17:49",1444547869,"C4",217766,1444765635,"2015-10-13 12:47:15"
"5937","20150002080017-383","1","2015-10-11 00:29:29",1444548569,"C2",93819,1444642388,"2015-10-12 02:33:08"
"5189","20151129121122-794","1","2015-10-11 03:07:02",1444558022,"C8",200828,1444758850,"2015-10-13 10:54:10"
"2219","20153717013727-315","1","2015-10-11 05:35:19",1444566919,"C3",255584,1444822503,"2015-10-14 04:35:03"
"2784","20154423044409-968","2","2015-10-11 06:43:53",1444571033,"C2",189898,1444760931,"2015-10-13 11:28:51"
"4875","20150230100237-163","1","2015-10-11 07:38:21",1444574301,"C3",470872,1445045173,"2015-10-16 18:26:13"
"3349","20155306085328-467","1","2015-10-11 08:50:03",1444578603,"C8",604759,1445183362,"2015-10-18 08:49:22"
"6012","20150205110228-447","2","2015-10-11 12:18:19",1444591099,"C5",444993,1445036092,"2015-10-16 15:54:52"
"145","20150826010800-879","1","2015-10-11 14:41:34",1444599694,"C4",951202,1445550896,"2015-10-22 14:54:56"
"6466","20154606024636-543","1","2015-10-11 14:58:01",1444600681,"C8",86537,1444687218,"2015-10-12 15:00:18"
"3932","20151822111847-102","3","2015-10-11 15:45:58",1444603558,"C4",619433,1445222991,"2015-10-18 19:49:51"
"5288","20154804124824-880","1","2015-10-11 16:22:24",1444605744,"C6",534940,1445140684,"2015-10-17 20:58:04"
"1145","20150221010241-26","3","2015-10-11 16:47:46",1444607266,"C5",631415,1445238681,"2015-10-19 00:11:21"
"2495","20152325092328-229","1","2015-10-11 20:46:31",1444621591,"C5",474461,1445096052,"2015-10-17 08:34:12"
"2264","20152629042632-481","1","2015-10-11 21:45:20",1444625120,"C6",622388,1445247508,"2015-10-19 02:38:28"
"3093","20153404113443-239","1","2015-10-11 22:43:47",1444628627,"C6",80618,1444709245,"2015-10-12 21:07:25"
"4119","20152616062617-515","1","2015-10-11 22:50:29",1444629029,"C5",699636,1445328665,"2015-10-20 01:11:05"
"3224","20153113033133-51","1","2015-10-11 23:15:21",1444630521,"C5",1223514,1445854035,"2015-10-26 03:07:15"
"59","20154314084327-265","2","2015-10-11 23:16:07",1444630567,"C0",298145,1444928712,"2015-10-15 10:05:12"
"3128","20150017040038-392","1","2015-10-12 01:44:53",1444639493,"C8",421731,1445061224,"2015-10-16 22:53:44"
"3723","20150406120449-237","1","2015-10-12 01:47:21",1444639641,"C2",718969,1445358610,"2015-10-20 09:30:10"
"4843","20153029123049-92","2","2015-10-12 04:04:14",1444647854,"C0",156115,1444803969,"2015-10-13 23:26:09"
"3259","20151118041143-934","2","2015-10-12 04:22:07",1444648927,"C5",923478,1445572405,"2015-10-22 20:53:25"
"2390","20153714093734-926","2","2015-10-12 04:53:18",1444650798,"C8",725792,1445376590,"2015-10-20 14:29:50"
"582","20155815115859-161","3","2015-10-12 05:01:39",1444651299,"C3",288470,1444939769,"2015-10-15 13:09:29"
"2747","20155325095328-933","2","2015-10-12 06:01:36",1444654896,"C5",181861,1444836757,"2015-10-14 08:32:37"
"3352","20153521033534-609","3","2015-10-12 07:09:02",1444658942,"C2",223001,1444881943,"2015-10-14 21:05:43"
"2835","20153109123110-337","2","2015-10-12 08:23:31",1444663411,"C2",244341,1444907752,"2015-10-15 04:15:52"
"682","20150122060138-185","3","2015-10-12 10:04:04",1444669444,"C5",871273,1445540717,"2015-10-22 12:05:17"
"5829","20153628113615-827","2","2015-10-12 10:36:25",1444671385,"C8",603005,1445274390,"2015-10-19 10:06:30"
"1179","20154030094027-816","1","2015-10-12 13:42:53",1444682573,"C7",525673,1445208246,"2015-10-18 15:44:06"
"6325","20150827060827-565","1","2015-10-12 14:06:23",1444683983,"C2",571868,1445255851,"2015-10-19 04:57:31"
"4765","20153728063706-624","2","2015-10-12 16:01:40",1444690900,"C5",1313182,1446004082,"2015-10-27 20:48:02"
"1404","20151716021749-651","2","2015-10-12 16:12:10",1444691530,"C3",704523,1445396053,"2015-10-20 19:54:13"
"2585","20151229041207-285","2","2015-10-12 16:32:31",1444692751,"C7",160632,1444853383,"2015-10-14 13:09:43"
"1939","20153726053749-107","1","2015-10-12 17:46:37",1444697197,"C5",691464,1445388661,"2015-10-20 17:51:01"
"3482","20151520061516-982","2","2015-10-12 18:21:43",1444699303,"C7",216043,1444915346,"2015-10-15 06:22:26"
"3180","20151128121126-103","3","2015-10-12 21:55:49",1444712149,"C5",177809,1444889958,"2015-10-14 23:19:18"
"5281","20153724063727-843","2","2015-10-13 00:55:27",1444722927,"C6",202635,1444925562,"2015-10-15 09:12:42"
"6436","20155701025733-561","1","2015-10-13 01:58:05",1444726685,"C3",447754,1445174439,"2015-10-18 06:20:39"
"81","20150419090434-489","1","2015-10-13 03:49:16",1444733356,"C5",293526,1445026882,"2015-10-16 13:21:22"
"5018","20155617075624-163","1","2015-10-13 07:04:59",1444745099,"C8",448663,1445193762,"2015-10-18 11:42:42"
"2313","20151229121216-715","1","2015-10-13 07:30:34",1444746634,"C8",596349,1445342983,"2015-10-20 05:09:43"
"2213","20150322080331-384","1","2015-10-13 07:33:18",1444746798,"C5",258941,1445005739,"2015-10-16 07:28:59"
"5231","20152528012515-626","3","2015-10-13 15:15:07",1444774507,"C4",162824,1444937331,"2015-10-15 12:28:51"
"6504","20155927105908-127","2","2015-10-13 15:19:02",1444774742,"C4",465998,1445240740,"2015-10-19 00:45:40"
"2566","20153922083923-991","3","2015-10-13 15:36:49",1444775809,"C4",262778,1445038587,"2015-10-16 16:36:27"
"4415","20152223052251-513","2","2015-10-13 15:55:12",1444776912,"C2",574247,1445351159,"2015-10-20 07:25:59"
"4465","20152803072816-844","2","2015-10-13 17:40:56",1444783256,"C0",436595,1445219851,"2015-10-18 18:57:31"
"1310","20151030061038-897","2","2015-10-13 17:53:50",1444784030,"C3",388464,1445172494,"2015-10-18 05:48:14"
"42","20151712061733-488","1","2015-10-13 18:27:54",1444786074,"C6",130221,1444916295,"2015-10-15 06:38:15"
"2716","20150908020926-913","2","2015-10-13 21:04:54",1444795494,"C2",715916,1445511410,"2015-10-22 03:56:50"
"2912","20150730040705-133","2","2015-10-13 21:19:37",1444796377,"C5",142744,1444939121,"2015-10-15 12:58:41"
"5043","20152909092941-524","1","2015-10-13 22:21:01",1444800061,"C0",195940,1444996001,"2015-10-16 04:46:41"
"444","20151119091154-119","3","2015-10-13 23:38:39",1444804719,"C0",1068915,1445873634,"2015-10-26 08:33:54"
"1762","20152102052154-22","3","2015-10-14 00:37:24",1444808244,"C2",509790,1445318034,"2015-10-19 22:13:54"
"5571","20154427034432-511","3","2015-10-14 00:49:38",1444808978,"C6",235851,1445044829,"2015-10-16 18:20:29"
"2311","20151328011351-370","1","2015-10-14 01:11:29",1444810289,"C5",191294,1445001583,"2015-10-16 06:19:43"
"1126","20155823095855-582","1","2015-10-14 01:44:03",1444812243,"C8",892354,1445704597,"2015-10-24 09:36:37"
"4616","20154519024544-322","False","2015-10-14 04:20:31",1444821631,"C4",200379,1445022010,"2015-10-16 12:00:10"
"4240","20154711074751-689","2","2015-10-14 08:42:55",1444837375,"C5",356813,1445194188,"2015-10-18 11:49:48"
"2351","20155022025025-894","2","2015-10-14 11:26:09",1444847169,"C4",269792,1445116961,"2015-10-17 14:22:41"
"6061","20153510103519-730","2","2015-10-14 12:15:11",1444850111,"C5",367949,1445218060,"2015-10-18 18:27:40"
"6140","20154027024025-199","1","2015-10-14 13:37:37",1444855057,"C2",183129,1445038186,"2015-10-16 16:29:46"
"4463","20155126015101-584","2","2015-10-14 14:59:47",1444859987,"C4",779663,1445639650,"2015-10-23 15:34:10"
"4569","20151712061745-29","3","2015-10-14 16:16:42",1444864602,"C7",311193,1445175795,"2015-10-18 06:43:15"
"2576","20154917054928-183","3","2015-10-14 16:47:30",1444866450,"C8",332726,1445199176,"2015-10-18 13:12:56"
"2308","20152702072702-121","1","2015-10-14 18:24:12",1444872252,"C8",538115,1445410367,"2015-10-20 23:52:47"
"289","20152727122724-538","1","2015-10-14 18:34:21",1444872861,"C5",496939,1445369800,"2015-10-20 12:36:40"
"1663","20151526061504-680","3","2015-10-14 18:57:18",1444874238,"C0",800467,1445674705,"2015-10-24 01:18:25"
"751","20150426100413-9","2","2015-10-14 18:58:39",1444874319,"C5",793633,1445667952,"2015-10-23 23:25:52"
"1547","20151108081116-912","2","2015-10-14 23:54:11",1444892051,"C5",452425,1445344476,"2015-10-20 05:34:36"
"5845","20152608092613-41","1","2015-10-14 23:56:13",1444892173,"C8",451800,1445343973,"2015-10-20 05:26:13"
"2185","20153123073146-272","1","2015-10-15 02:54:14",1444902854,"C5",269164,1445172018,"2015-10-18 05:40:18"
"1685","20153030113019-64","1","2015-10-15 05:35:33",1444912533,"C4",637357,1445549890,"2015-10-22 14:38:10"
"4010","20152218072255-716","1","2015-10-15 05:41:22",1444912882,"C2",775569,1445688451,"2015-10-24 05:07:31"
"4514","20153607113603-801","3","2015-10-15 07:51:07",1444920667,"C5",408713,1445329380,"2015-10-20 01:23:00"
"4434","20154124124106-525","2","2015-10-15 09:43:04",1444927384,"C3",257674,1445185058,"2015-10-18 09:17:38"
"1054","20155002115040-685","1","2015-10-15 15:27:19",1444948039,"C2",1136199,1446084238,"2015-10-28 19:03:58"
"1992","20154830034853-516","3","2015-10-15 16:15:17",1444950917,"C2",831798,1445782715,"2015-10-25 07:18:35"
"1416","20150231010233-845","1","2015-10-15 17:00:53",1444953653,"C7",940100,1445893753,"2015-10-26 14:09:13"
"1325","20151803011812-57","2","2015-10-15 18:25:56",1444958756,"C6",455908,1445414664,"2015-10-21 01:04:24"
"854","20154023044028-20","1","2015-10-15 20:05:17",1444964717,"C0",655927,1445620644,"2015-10-23 10:17:24"
"2318","20152723032741-851","1","2015-10-15 22:00:20",1444971620,"C8",657537,1445629157,"2015-10-23 12:39:17"
"1651","20155526085516-0","2","2015-10-15 22:23:52",1444973032,"C4",563372,1445536404,"2015-10-22 10:53:24"
"2693","20150018100013-569","1","2015-10-16 03:31:08",1444991468,"C2",342265,1445333733,"2015-10-20 02:35:33"
"5090","20155026105032-380","1","2015-10-16 04:41:30",1444995690,"C5",243694,1445239384,"2015-10-19 00:23:04"
"2429","20155514055529-108","1","2015-10-16 07:11:15",1445004675,"C7",772078,1445776753,"2015-10-25 05:39:13"
"5764","20152827022817-16","1","2015-10-16 08:18:35",1445008715,"C8",613974,1445622689,"2015-10-23 10:51:29"
"945","20155705095723-561","1","2015-10-16 13:29:35",1445027375,"C4",507876,1445535251,"2015-10-22 10:34:11"
"282","20153916083923-377","1","2015-10-16 15:53:53",1445036033,"C2",374010,1445410043,"2015-10-20 23:47:23"
"3745","20153220113237-70","2","2015-10-16 16:39:55",1445038795,"C5",1647746,1446686541,"2015-11-04 17:22:21"
"2066","20154728014746-613","1","2015-10-16 18:28:58",1445045338,"C4",196509,1445241847,"2015-10-19 01:04:07"
"3318","20150822100826-928","1","2015-10-16 19:00:01",1445047201,"C5",300785,1445347986,"2015-10-20 06:33:06"
"3675","20153126033132-596","1","2015-10-16 22:39:13",1445060353,"C8",250523,1445310876,"2015-10-19 20:14:36"
"3629","20154809044835-78","1","2015-10-16 23:44:10",1445064250,"C5",1225505,1446289755,"2015-10-31 04:09:15"
"1304","20153625063605-688","1","2015-10-17 01:49:25",1445071765,"C2",570250,1445642015,"2015-10-23 16:13:35"
"3605","20153927063907-823","3","2015-10-17 01:51:39",1445071899,"C5",213844,1445285743,"2015-10-19 13:15:43"
"3633","20151707111715-550","2","2015-10-17 02:13:31",1445073211,"C0",118768,1445191979,"2015-10-18 11:12:59"
"3809","20150119090129-183","1","2015-10-17 05:07:15",1445083635,"C4",1202573,1446286208,"2015-10-31 03:10:08"
"3008","20155110085148-525","2","2015-10-17 05:10:00",1445083800,"C6",530582,1445614382,"2015-10-23 08:33:02"
"2452","20151902091944-855","3","2015-10-17 05:37:52",1445085472,"C4",819136,1445904608,"2015-10-26 17:10:08"
"35","20151521051524-864","1","2015-10-17 09:11:40",1445098300,"C2",316768,1445415068,"2015-10-21 01:11:08"
"3646","20154821024838-295","2","2015-10-17 10:32:52",1445103172,"C7",318722,1445421894,"2015-10-21 03:04:54"
"1328","20152129052143-619","3","2015-10-17 14:04:17",1445115857,"C3",771677,1445887534,"2015-10-26 12:25:34"
"603","20155806065852-717","3","2015-10-17 15:15:16",1445120116,"C5",446523,1445566639,"2015-10-22 19:17:19"
"3804","20152911042945-827","3","2015-10-17 16:05:05",1445123105,"C3",826760,1445949865,"2015-10-27 05:44:25"
"3436","20155015015017-670","2","2015-10-18 01:21:57",1445156517,"C3",400900,1445557417,"2015-10-22 16:43:37"
"2240","20151917051906-622","3","2015-10-18 02:14:02",1445159642,"C2",328012,1445487654,"2015-10-21 21:20:54"
"3229","20155415055448-117","1","2015-10-18 04:09:03",1445166543,"C0",69885,1445236428,"2015-10-18 23:33:48"
"5259","20152816102821-282","1","2015-10-18 05:21:20",1445170880,"C7",1157597,1446328477,"2015-10-31 14:54:37"
"128","20154104064113-956","2","2015-10-18 14:31:38",1445203898,"C8",1312375,1446516273,"2015-11-02 18:04:33"
"2878","20153824023857-53","3","2015-10-18 17:20:10",1445214010,"C5",680239,1445894249,"2015-10-26 14:17:29"
"3788","20152815012824-971","1","2015-10-18 18:26:02",1445217962,"C4",792494,1446010456,"2015-10-27 22:34:16"
"4973","20154319074317-573","3","2015-10-18 20:37:12",1445225832,"C8",510407,1445736239,"2015-10-24 18:23:59"
"1827","20155827025824-481","1","2015-10-18 22:49:23",1445233763,"C2",263237,1445497000,"2015-10-21 23:56:40"
"5256","20153329083354-580","1","2015-10-18 23:50:10",1445237410,"C0",212072,1445449482,"2015-10-21 10:44:42"
"1839","20152130042105-824","1","2015-10-19 03:12:25",1445249545,"C2",534085,1445783630,"2015-10-25 07:33:50"
"3705","20155223065200-218","2","2015-10-19 03:59:52",1445252392,"C5",614309,1445866701,"2015-10-26 06:38:21"
"2203","20153829013813-529","2","2015-10-19 04:19:01",1445253541,"C2",242064,1445495605,"2015-10-21 23:33:25"
"6390","20150522100502-509","3","2015-10-19 04:19:20",1445253560,"C7",330294,1445583854,"2015-10-23 00:04:14"
"5088","20155821065833-503","3","2015-10-19 05:54:09",1445259249,"C5",301917,1445561166,"2015-10-22 17:46:06"
"6335","20152006072036-68","3","2015-10-19 06:45:02",1445262302,"C8",530438,1445792740,"2015-10-25 10:05:40"
"4131","20153112033150-305","2","2015-10-19 09:03:01",1445270581,"C2",453353,1445723934,"2015-10-24 14:58:54"
"5856","20155703045756-537","1","2015-10-19 10:49:00",1445276940,"C2",828833,1446105773,"2015-10-29 01:02:53"
"3958","20154026104009-242","2","2015-10-19 12:53:53",1445284433,"C3",584203,1445868636,"2015-10-26 07:10:36"
"2014","20151327101317-796","2","2015-10-19 14:05:14",1445288714,"C4",273531,1445562245,"2015-10-22 18:04:05"
"6107","20152512052534-249","2","2015-10-19 15:09:26",1445292566,"C0",398579,1445691145,"2015-10-24 05:52:25"
"4640","20153224043258-562","2","2015-10-19 15:11:06",1445292666,"C3",604186,1445896852,"2015-10-26 15:00:52"
"5211","20152725052758-524","2","2015-10-19 17:32:28",1445301148,"C5",691290,1445992438,"2015-10-27 17:33:58"
"114","20155723035703-81","1","2015-10-19 17:45:35",1445301935,"C0",951214,1446253149,"2015-10-30 17:59:09"
"3717","20155326015327-562","2","2015-10-19 19:57:59",1445309879,"C4",251134,1445561013,"2015-10-22 17:43:33"
"4908","20153119013102-317","1","2015-10-20 04:52:12",1445341932,"C2",760810,1446102742,"2015-10-29 00:12:22"
"1938","20150322060343-331","1","2015-10-20 06:27:45",1445347665,"C5",345806,1445693471,"2015-10-24 06:31:11"
"54","20150215060225-774","1","2015-10-20 13:01:18",1445371278,"C7",818219,1446189497,"2015-10-30 00:18:17"
"6392","20155501015527-544","2","2015-10-20 16:21:03",1445383263,"C5",530292,1445913555,"2015-10-26 19:39:15"
"3293","20155411025401-133","3","2015-10-20 20:00:17",1445396417,"C0",758297,1446154714,"2015-10-29 14:38:34"
"3775","20155024105003-765","2","2015-10-20 22:25:52",1445405152,"C5",709507,1446114659,"2015-10-29 03:30:59"
"587","20151328101312-818","2","2015-10-20 23:51:38",1445410298,"C5",278558,1445688856,"2015-10-24 05:14:16"
"714","20152610012616-238","1","2015-10-21 01:54:00",1445417640,"C4",437608,1445855248,"2015-10-26 03:27:28"
"579","20151726101752-323","2","2015-10-21 02:16:40",1445419000,"C3",935991,1446354991,"2015-10-31 22:16:31"
"4617","20154519024544-322","False","2015-10-21 07:24:16",1445437456,"C4",201910,1445639366,"2015-10-23 15:29:26"
"1984","20152414122415-656","2","2015-10-21 08:35:30",1445441730,"C4",454725,1445896455,"2015-10-26 14:54:15"
"6208","20155124095132-430","1","2015-10-21 08:43:09",1445442189,"C4",332671,1445774860,"2015-10-25 05:07:40"
"5998","20152801072801-74","1","2015-10-21 10:10:39",1445447439,"C4",1383794,1446831233,"2015-11-06 09:33:53"
"6547","20152119112147-519","1","2015-10-21 10:55:31",1445450131,"C5",345403,1445795534,"2015-10-25 10:52:14"
"4284","20151028061026-297","3","2015-10-21 12:31:02",1445455862,"C6",1227806,1446683668,"2015-11-04 16:34:28"
"4564","20152928102926-60","1","2015-10-21 14:27:58",1445462878,"C2",250189,1445713067,"2015-10-24 11:57:47"
"5024","20150030070026-128","1","2015-10-21 15:30:23",1445466623,"C8",263571,1445730194,"2015-10-24 16:43:14"
"6532","20150829050830-287","3","2015-10-21 17:42:25",1445474545,"C8",916247,1446390792,"2015-11-01 07:13:12"
"6077","20153421053409-684","1","2015-10-21 23:03:15",1445493795,"C1",435291,1445929086,"2015-10-26 23:58:06"
"2648","20150518080515-636","3","2015-10-22 00:25:31",1445498731,"C5",363752,1445862483,"2015-10-26 05:28:03"
"2531","20153330083330-845","3","2015-10-22 01:23:15",1445502195,"C4",267855,1445770050,"2015-10-25 03:47:30"
"6248","20150419080453-269","2","2015-10-22 01:40:14",1445503214,"C0",78707,1445581921,"2015-10-22 23:32:01"
"3119","20154801084801-486","2","2015-10-22 03:34:33",1445510073,"C4",883249,1446393322,"2015-11-01 07:55:22"
"3509","20154524124536-93","2","2015-10-22 04:19:03",1445512743,"C7",265423,1445778166,"2015-10-25 06:02:46"
"2394","20150430100459-528","2","2015-10-22 05:38:18",1445517498,"C8",269257,1445786755,"2015-10-25 08:25:55"
"513","20154125074157-46","3","2015-10-22 06:03:12",1445518992,"C8",1001055,1446520047,"2015-11-02 19:07:27"
"977","20152628112645-216","2","2015-10-22 06:03:49",1445519029,"C4",256778,1445775807,"2015-10-25 05:23:27"
"403","20155705085705-756","2","2015-10-22 08:58:33",1445529513,"C2",507611,1446037124,"2015-10-28 05:58:44"
"2812","20154402044412-377","1","2015-10-22 11:29:30",1445538570,"C7",477902,1446016472,"2015-10-28 00:14:32"
"1432","20155602075606-537","1","2015-10-22 15:12:06",1445551926,"C7",620880,1446172806,"2015-10-29 19:40:06"
"5888","20150009060037-852","1","2015-10-22 17:14:26",1445559266,"C7",919147,1446478413,"2015-11-02 07:33:33"
"5220","20155706065753-746","1","2015-10-22 20:51:00",1445572260,"C0",957541,1446529801,"2015-11-02 21:50:01"
"2591","20155419125408-510","1","2015-10-23 01:13:14",1445587994,"C7",796278,1446384272,"2015-11-01 05:24:32"
"1489","20150019040039-358","1","2015-10-23 01:23:11",1445588591,"C6",695419,1446284010,"2015-10-31 02:33:30"
"3152","20155221125229-19","3","2015-10-23 01:34:53",1445589293,"C6",454024,1446043317,"2015-10-28 07:41:57"
"4305","20150615070645-876","2","2015-10-23 01:40:30",1445589630,"C7",362625,1445952255,"2015-10-27 06:24:15"
"2692","20152025062036-525","1","2015-10-23 02:55:32",1445594132,"C5",635662,1446229794,"2015-10-30 11:29:54"
"3037","20151117051123-614","1","2015-10-23 16:31:15",1445643075,"C2",1209256,1446852331,"2015-11-06 15:25:31"
"3526","20154916064951-160","1","2015-10-23 21:55:48",1445662548,"C5",464451,1446126999,"2015-10-29 06:56:39"
"2682","20154117064148-969","1","2015-10-23 22:34:45",1445664885,"C2",452511,1446117396,"2015-10-29 04:16:36"
"3166","20151703081723-858","2","2015-10-24 00:05:19",1445670319,"C7",625268,1446295587,"2015-10-31 05:46:27"
"3800","20153326083315-407","2","2015-10-24 07:41:34",1445697694,"C4",345157,1446042851,"2015-10-28 07:34:11"
"6035","20151019081015-655","1","2015-10-24 08:20:31",1445700031,"C3",378077,1446078108,"2015-10-28 17:21:48"
"3387","20153713053720-934","3","2015-10-24 08:50:14",1445701814,"C5",1637082,1447338896,"2015-11-12 06:34:56"
"1705","20153820063840-304","2","2015-10-24 14:00:10",1445720410,"C2",988030,1446708440,"2015-11-04 23:27:20"
"1803","20153819053827-500","3","2015-10-24 17:09:57",1445731797,"C6",1396515,1447128312,"2015-11-09 20:05:12"
"1896","20150411120416-183","1","2015-10-24 22:00:06",1445749206,"C8",535850,1446285056,"2015-10-31 02:50:56"
"3211","20151905111924-469","2","2015-10-24 23:10:43",1445753443,"C3",610897,1446364340,"2015-11-01 00:52:20"
"4968","20153307023355-407","1","2015-10-24 23:40:14",1445755214,"C4",584797,1446340011,"2015-10-31 18:06:51"
"2964","20154328044302-517","2","2015-10-25 01:54:44",1445763284,"C7",848478,1446611762,"2015-11-03 20:36:02"
"6287","20151825061809-937","1","2015-10-25 14:21:04",1445808064,"C5",374425,1446182489,"2015-10-29 22:21:29"
"3120","20151926031950-628","1","2015-10-25 15:17:10",1445811430,"C8",501088,1446312518,"2015-10-31 10:28:38"
"349","20151131081108-573","1","2015-10-25 16:47:58",1445816878,"C8",956602,1446773480,"2015-11-05 17:31:20"
"5194","20151927071926-369","3","2015-10-25 18:06:49",1445821609,"C7",351149,1446172758,"2015-10-29 19:39:18"
"6009","20154721064725-145","1","2015-10-25 18:13:07",1445821987,"C3",992914,1446814901,"2015-11-06 05:01:41"
"2695","20152004112056-852","1","2015-10-25 20:22:25",1445829745,"C4",634127,1446463872,"2015-11-02 03:31:12"
"2606","20154712024716-747","2","2015-10-25 22:36:44",1445837804,"C5",1137521,1446975325,"2015-11-08 01:35:25"
"5063","20150829080825-567","2","2015-10-25 23:20:01",1445840401,"C3",622437,1446462838,"2015-11-02 03:13:58"
"4195","20154719114738-807","2","2015-10-26 03:39:11",1445855951,"C3",452499,1446308450,"2015-10-31 09:20:50"
"2841","20151412031428-824","3","2015-10-26 07:38:33",1445870313,"C2",1304435,1447174748,"2015-11-10 08:59:08"
"703","20152407072413-469","3","2015-10-26 07:49:32",1445870972,"C4",605017,1446475989,"2015-11-02 06:53:09"
"4269","20153319103344-890","1","2015-10-26 11:16:16",1445883376,"C2",75919,1445959295,"2015-10-27 08:21:35"
"5447","20154917034903-850","1","2015-10-26 13:49:19",1445892559,"C5",420302,1446312861,"2015-10-31 10:34:21"
"4140","20152326012317-940","1","2015-10-26 14:35:38",1445895338,"C8",1136163,1447031501,"2015-11-08 17:11:41"
"3455","20151505021556-896","1","2015-10-26 17:54:29",1445907269,"C2",631359,1446538628,"2015-11-03 00:17:08"
"6378","20153424023413-34","3","2015-10-26 21:59:32",1445921972,"C2",199519,1446121491,"2015-10-29 05:24:51"
"4194","20151301091306-345","2","2015-10-27 02:22:26",1445937746,"C8",687680,1446625426,"2015-11-04 00:23:46"
"1538","20152527072503-929","1","2015-10-27 03:32:34",1445941954,"C7",368293,1446310247,"2015-10-31 09:50:47"
"4859","20153624043623-472","2","2015-10-27 06:03:12",1445950992,"C4",221209,1446172201,"2015-10-29 19:30:01"
"2466","20150022110023-715","2","2015-10-27 06:27:36",1445952456,"C5",1194919,1447147375,"2015-11-10 01:22:55"
"3391","20152215082220-506","2","2015-10-27 11:04:44",1445969084,"C4",519792,1446488876,"2015-11-02 10:27:56"
"1164","20150201030237-485","1","2015-10-27 17:55:03",1445993703,"C5",692678,1446686381,"2015-11-04 17:19:41"
"2115","20152515012543-659","1","2015-10-27 19:47:07",1446000427,"C2",1825842,1447826269,"2015-11-17 21:57:49"
"5587","20154723074706-99","1","2015-10-28 01:29:38",1446020978,"C3",709969,1446730947,"2015-11-05 05:42:27"
"3729","20151818111845-978","2","2015-10-28 02:14:26",1446023666,"C4",201373,1446225039,"2015-10-30 10:10:39"
"2095","20150805070853-118","3","2015-10-28 05:40:29",1446036029,"C4",906537,1446942566,"2015-11-07 16:29:26"
"777","20151329111354-725","1","2015-10-28 07:27:42",1446042462,"C2",356004,1446398466,"2015-11-01 09:21:06"
"6557","20152823032832-378","2","2015-10-28 17:26:00",1446078360,"C0",54881,1446133241,"2015-10-29 08:40:41"
"1777","20152918022901-486","1","2015-10-28 20:59:47",1446091187,"C4",443723,1446534910,"2015-11-02 23:15:10"
"3451","20153125013101-836","2","2015-10-28 21:08:13",1446091693,"C7",617448,1446709141,"2015-11-04 23:39:01"
"815","20155917095957-221","2","2015-10-28 23:37:07",1446100627,"C8",718286,1446818913,"2015-11-06 06:08:33"
"2719","20153720123722-777","2","2015-10-29 00:22:34",1446103354,"C0",750489,1446853843,"2015-11-06 15:50:43"
"3609","20151704091740-106","2","2015-10-29 00:54:52",1446105292,"C4",590229,1446695521,"2015-11-04 19:52:01"
"511","20155123115132-660","2","2015-10-29 02:00:40",1446109240,"C8",1537474,1447646714,"2015-11-15 20:05:14"
"595","20152030022022-687","2","2015-10-29 02:42:57",1446111777,"C4",351965,1446463742,"2015-11-02 03:29:02"
"4110","20151207101219-530","2","2015-10-29 05:30:27",1446121827,"C5",559486,1446681313,"2015-11-04 15:55:13"
"5183","20151822031808-265","1","2015-10-29 09:32:01",1446136321,"C8",453719,1446590040,"2015-11-03 14:34:00"
"5487","20152822092858-860","3","2015-10-29 09:33:31",1446136411,"C7",86439,1446222850,"2015-10-30 09:34:10"
"2484","20150317060312-681","2","2015-10-29 11:30:55",1446143455,"C7",521209,1446664664,"2015-11-04 11:17:44"
"6232","20150323050332-513","3","2015-10-29 15:14:00",1446156840,"C3",443404,1446600244,"2015-11-03 17:24:04"
"5768","20152611072627-207","3","2015-10-30 00:04:21",1446188661,"C4",1402358,1447591019,"2015-11-15 04:36:59"
"1059","20154324094311-697","2","2015-10-30 10:51:13",1446227473,"C5",261241,1446488714,"2015-11-02 10:25:14"
"6405","20153815033847-524","3","2015-10-30 12:01:43",1446231703,"C4",484372,1446716075,"2015-11-05 01:34:35"
"6519","20151308101333-914","2","2015-10-30 17:39:40",1446251980,"C0",1028281,1447280261,"2015-11-11 14:17:41"
"1824","20154225024250-848","1","2015-10-30 19:39:14",1446259154,"C6",506964,1446766118,"2015-11-05 15:28:38"
"3196","20153629053647-857","1","2015-10-30 20:57:29",1446263849,"C6",448407,1446712256,"2015-11-05 00:30:56"
"2472","20150829070856-319","1","2015-10-31 04:33:32",1446291212,"C7",306164,1446597376,"2015-11-03 16:36:16"
"4361","20152428112426-434","3","2015-10-31 04:46:29",1446291989,"C5",78441,1446370430,"2015-11-01 01:33:50"
"1793","20154518094547-315","1","2015-10-31 08:12:19",1446304339,"C0",463699,1446768038,"2015-11-05 16:00:38"
"605","20153026083032-587","1","2015-10-31 09:08:40",1446307720,"C5",217144,1446524864,"2015-11-02 20:27:44"
"1851","20150818120815-803","1","2015-10-31 09:50:29",1446310229,"C5",529562,1446839791,"2015-11-06 11:56:31"
"4134","20152130102130-760","2","2015-10-31 12:59:45",1446321585,"C0",383985,1446705570,"2015-11-04 22:39:30"
"106","20153527083531-898","1","2015-10-31 19:26:59",1446344819,"C2",372086,1446716905,"2015-11-05 01:48:25"
"3102","20151825091848-82","3","2015-10-31 19:53:42",1446346422,"C3",185498,1446531920,"2015-11-02 22:25:20"
"5285","20151224101227-56","1","2015-11-01 00:40:39",1446363639,"C6",987882,1447351521,"2015-11-12 10:05:21"
"1107","20152528092556-30","2","2015-11-01 04:19:02",1446380342,"C4",110262,1446490604,"2015-11-02 10:56:44"
"515","20155821075857-972","2","2015-11-01 07:52:57",1446393177,"C3",476820,1446869997,"2015-11-06 20:19:57"
"928","20155913015944-240","1","2015-11-01 15:06:05",1446419165,"C0",605883,1447025048,"2015-11-08 15:24:08"
"5729","20153612043649-569","3","2015-11-01 16:45:05",1446425105,"C3",875312,1447300417,"2015-11-11 19:53:37"
"5695","20154912084901-166","2","2015-11-01 17:21:31",1446427291,"C7",622050,1447049341,"2015-11-08 22:09:01"
"5795","20151823041807-23","3","2015-11-02 00:49:35",1446454175,"C0",101486,1446555661,"2015-11-03 05:01:01"
"768","20152328122311-696","1","2015-11-02 02:16:15",1446459375,"C7",1495592,1447954967,"2015-11-19 09:42:47"
"1447","20152924032913-724","1","2015-11-02 07:50:17",1446479417,"C3",1087808,1447567225,"2015-11-14 22:00:25"
"6244","20155627045658-136","2","2015-11-02 08:37:30",1446482250,"C8",440576,1446922826,"2015-11-07 11:00:26"
"1873","20154623114627-225","1","2015-11-02 09:15:21",1446484521,"C0",286178,1446770699,"2015-11-05 16:44:59"
"3612","20151713111750-937","1","2015-11-02 13:26:54",1446499614,"C6",541418,1447041032,"2015-11-08 19:50:32"
"1505","20155127065120-711","3","2015-11-02 15:03:20",1446505400,"C2",392940,1446898340,"2015-11-07 04:12:20"
"5025","20152722082711-239","3","2015-11-02 15:20:01",1446506401,"C2",510110,1447016511,"2015-11-08 13:01:51"
"2780","20151404081429-288","1","2015-11-03 02:05:57",1446545157,"C4",1315286,1447860443,"2015-11-18 07:27:23"
"811","20150815060824-848","1","2015-11-03 04:37:08",1446554228,"C3",604532,1447158760,"2015-11-10 04:32:40"
"4554","20155926125956-991","3","2015-11-03 08:20:49",1446567649,"C7",849779,1447417428,"2015-11-13 04:23:48"
"2705","20152230072211-448","3","2015-11-03 11:42:21",1446579741,"C4",805030,1447384771,"2015-11-12 19:19:31"
"5901","20150227100257-879","2","2015-11-04 01:00:52",1446627652,"C2",847525,1447475177,"2015-11-13 20:26:17"
"1881","20151516041514-25","2","2015-11-04 10:21:50",1446661310,"C6",270666,1446931976,"2015-11-07 13:32:56"
"3108","20152217112251-421","3","2015-11-05 06:46:59",1446734819,"C4",527581,1447262400,"2015-11-11 09:20:00"
"302","20153230113243-759","1","2015-11-05 07:36:25",1446737785,"C8",253911,1446991696,"2015-11-08 06:08:16"
"4804","20151620061659-448","3","2015-11-05 08:34:27",1446741267,"C3",174281,1446915548,"2015-11-07 08:59:08"
"826","20152229012216-958","2","2015-11-05 09:10:16",1446743416,"C6",530880,1447274296,"2015-11-11 12:38:16"
"6262","20152126012150-343","3","2015-11-05 10:19:10",1446747550,"C3",431080,1447178630,"2015-11-10 10:03:50"
"1398","20154428114434-818","2","2015-11-05 12:50:10",1446756610,"C2",411342,1447167952,"2015-11-10 07:05:52"
"5407","20153023123036-30","3","2015-11-05 22:13:08",1446790388,"C5",804019,1447594407,"2015-11-15 05:33:27"
"4012","20155817085826-736","1","2015-11-05 23:01:14",1446793274,"C0",535971,1447329245,"2015-11-12 03:54:05"
"1959","20155121015151-176","1","2015-11-06 03:33:09",1446809589,"C5",1313626,1448123215,"2015-11-21 08:26:55"
"1227","20153825123835-385","1","2015-11-06 04:07:43",1446811663,"C8",897164,1447708827,"2015-11-16 13:20:27"
"4714","20151312011312-740","1","2015-11-06 06:19:47",1446819587,"C2",1441085,1448260672,"2015-11-22 22:37:52"
"2063","20153209073227-920","1","2015-11-06 12:58:53",1446843533,"C7",719198,1447562731,"2015-11-14 20:45:31"
"1613","20153124013107-263","1","2015-11-06 13:44:01",1446846241,"C5",375858,1447222099,"2015-11-10 22:08:19"
"5496","20153031083006-993","1","2015-11-06 19:47:51",1446868071,"C3",187555,1447055626,"2015-11-08 23:53:46"
"3683","20151622081618-495","1","2015-11-06 19:57:53",1446868673,"C8",1322419,1448191092,"2015-11-22 03:18:12"
"64","20153424013401-207","1","2015-11-07 02:32:35",1446892355,"C8",586757,1447479112,"2015-11-13 21:31:52"
"6044","20152520042545-155","3","2015-11-07 05:09:30",1446901770,"C7",587175,1447488945,"2015-11-14 00:15:45"
"4004","20150110060107-684","1","2015-11-07 16:43:39",1446943419,"C3",631669,1447575088,"2015-11-15 00:11:28"
"1947","20150927090926-427","3","2015-11-07 17:28:16",1446946096,"C8",715186,1447661282,"2015-11-16 00:08:02"
"6006","20154902034953-35","3","2015-11-07 18:42:30",1446950550,"C2",1199251,1448149801,"2015-11-21 15:50:01"
"1022","20151909051914-299","1","2015-11-07 20:01:32",1446955292,"C7",865482,1447820774,"2015-11-17 20:26:14"
"5665","20152902112948-976","2","2015-11-08 06:30:06",1446993006,"C5",166806,1447159812,"2015-11-10 04:50:12"
"2923","20154727064700-998","3","2015-11-08 10:09:30",1447006170,"C2",1214850,1448221020,"2015-11-22 11:37:00"
"6183","20151518011531-224","1","2015-11-08 12:28:35",1447014515,"C0",1220498,1448235013,"2015-11-22 15:30:13"
"927","20150826020806-485","2","2015-11-08 13:12:54",1447017174,"C5",140436,1447157610,"2015-11-10 04:13:30"
"6295","20154127034153-72","1","2015-11-09 05:55:44",1447077344,"C2",526233,1447603577,"2015-11-15 08:06:17"
"3782","20153223033200-444","3","2015-11-09 07:47:44",1447084064,"C5",180568,1447264632,"2015-11-11 09:57:12"
"4149","20150122100139-218","1","2015-11-09 09:27:07",1447090027,"C5",518591,1447608618,"2015-11-15 09:30:18"
"4503","20153319093327-65","2","2015-11-09 09:59:19",1447091959,"C5",551444,1447643403,"2015-11-15 19:10:03"
"1529","20150606090649-896","1","2015-11-09 10:50:33",1447095033,"C0",692428,1447787461,"2015-11-17 11:11:01"
"1841","20150509110550-759","1","2015-11-09 11:33:37",1447097617,"C2",383381,1447480998,"2015-11-13 22:03:18"
"2169","20153118113152-842","2","2015-11-09 12:35:28",1447101328,"C5",897327,1447998655,"2015-11-19 21:50:55"
"5091","20151131021149-695","3","2015-11-09 15:07:13",1447110433,"C5",261508,1447371941,"2015-11-12 15:45:41"
"5746","20155921125901-834","1","2015-11-09 16:10:33",1447114233,"C4",606956,1447721189,"2015-11-16 16:46:29"
"352","20153923083952-869","1","2015-11-09 21:31:52",1447133512,"C4",513840,1447647352,"2015-11-15 20:15:52"
"126","20152231122207-586","1","2015-11-10 12:43:19",1447188199,"C4",289624,1447477823,"2015-11-13 21:10:23"
"3059","20150004120029-367","2","2015-11-10 12:44:05",1447188245,"C2",724377,1447912622,"2015-11-18 21:57:02"
"2756","20155114055130-358","1","2015-11-10 16:10:05",1447200605,"C0",1468445,1448669050,"2015-11-27 16:04:10"
"3441","20153127083119-859","1","2015-11-10 22:46:59",1447224419,"C8",771308,1447995727,"2015-11-19 21:02:07"
"3485","20153728033704-530","2","2015-11-11 02:46:00",1447238760,"C4",145867,1447384627,"2015-11-12 19:17:07"
"244","20150806110838-706","1","2015-11-11 03:32:58",1447241578,"C8",1135732,1448377310,"2015-11-24 07:01:50"
"1913","20155328095345-887","1","2015-11-11 13:49:05",1447278545,"C8",763864,1448042409,"2015-11-20 10:00:09"
"3996","20153730083758-789","2","2015-11-12 00:36:56",1447317416,"C0",527134,1447844550,"2015-11-18 03:02:30"
"3449","20153328033312-600","3","2015-11-13 01:39:35",1447407575,"C5",943769,1448351344,"2015-11-23 23:49:04"
"3392","20155523065557-761","2","2015-11-13 14:59:25",1447455565,"C2",554876,1448010441,"2015-11-20 01:07:21"
"3190","20150928020950-296","1","2015-11-13 20:00:14",1447473614,"C5",499878,1447973492,"2015-11-19 14:51:32"
"5649","20153618053610-340","1","2015-11-13 22:27:12",1447482432,"C7",1459466,1448941898,"2015-11-30 19:51:38"
"5730","20150825040833-548","2","2015-11-14 02:20:01",1447496401,"C4",534236,1448030637,"2015-11-20 06:43:57"
"1366","20153519093544-845","1","2015-11-14 02:26:56",1447496816,"C6",936834,1448433650,"2015-11-24 22:40:50"
"4313","20151114111101-450","1","2015-11-15 13:26:25",1447622785,"C7",766932,1448389717,"2015-11-24 10:28:37"
"572","20151826011805-225","2","2015-11-15 14:16:10",1447625770,"C8",865417,1448491187,"2015-11-25 14:39:47"
"176","20155426035428-177","2","2015-11-16 09:18:16",1447694296,"C7",626604,1448320900,"2015-11-23 15:21:40"
"5952","20151431051408-107","1","2015-11-16 21:09:04",1447736944,"C5",833812,1448570756,"2015-11-26 12:45:56"
"4624","20150420010418-650","1","2015-11-17 13:45:46",1447796746,"C3",961961,1448758707,"2015-11-28 16:58:27"
"3823","20154216034256-486","2","2015-11-17 15:18:37",1447802317,"C2",765563,1448567880,"2015-11-26 11:58:00"
"2809","20152211042208-883","1","2015-11-18 04:40:12",1447850412,"C4",833812,1448684224,"2015-11-27 20:17:04"
"6023","20155706095759-642","1","2015-11-18 05:07:30",1447852050,"C5",899053,1448751103,"2015-11-28 14:51:43"
"1847","20152513062528-584","1","2015-11-18 05:20:08",1447852808,"C3",712760,1448565568,"2015-11-26 11:19:28"
"5876","20153113023123-668","2","2015-11-18 10:06:27",1447869987,"C2",711263,1448581250,"2015-11-26 15:40:50"
"505","20150027080052-161","3","2015-11-18 13:07:37",1447880857,"C8",902961,1448783818,"2015-11-28 23:56:58"
"3907","20153528073554-422","1","2015-11-18 13:23:54",1447881834,"C4",553860,1448435694,"2015-11-24 23:14:54"
"621","20153925023956-683","2","2015-11-18 15:33:39",1447889619,"C2",667489,1448557108,"2015-11-26 08:58:28"
"1582","20151426021455-333","1","2015-11-18 16:40:52",1447893652,"C7",510173,1448403825,"2015-11-24 14:23:45"
"3591","20154903114941-837","1","2015-11-19 07:15:26",1447946126,"C6",273189,1448219315,"2015-11-22 11:08:35"
"2684","20153226043220-886","1","2015-11-19 09:28:11",1447954091,"C8",663393,1448617484,"2015-11-27 01:44:44"
"2871","20151814051808-820","3","2015-11-19 14:21:48",1447971708,"C8",1196260,1449167968,"2015-12-03 10:39:28"
"264","20151201121236-41","1","2015-11-19 16:13:08",1447978388,"C3",1190254,1449168642,"2015-12-03 10:50:42"
"1005","20155223045209-786","2","2015-11-19 16:16:17",1447978577,"C2",615781,1448594358,"2015-11-26 19:19:18"
"5732","20155705025759-63","1","2015-11-20 10:34:53",1448044493,"C6",2417169,1450461662,"2015-12-18 10:01:02"
"5354","20150327030347-941","1","2015-11-20 21:16:19",1448082979,"C5",586444,1448669423,"2015-11-27 16:10:23"
"2909","20153622103648-402","3","2015-11-21 18:53:53",1448160833,"C8",1043485,1449204318,"2015-12-03 20:45:18"
"343","20155819065837-382","2","2015-11-22 10:07:01",1448215621,"C5",792072,1449007693,"2015-12-01 14:08:13"
"1495","20152023042040-26","2","2015-11-23 00:05:05",1448265905,"C3",1127695,1449393600,"2015-12-06 01:20:00"
"4519","20151427031411-974","2","2015-11-23 22:21:15",1448346075,"C2",619253,1448965328,"2015-12-01 02:22:08"
"4070","20151125121147-666","1","2015-11-24 06:02:20",1448373740,"C7",871537,1449245277,"2015-12-04 08:07:57"
"5841","20152418062434-209","1","2015-11-24 09:50:50",1448387450,"C2",725597,1449113047,"2015-12-02 19:24:07"
"4124","20151127051117-574","1","2015-11-24 12:51:29",1448398289,"C6",1279602,1449677891,"2015-12-09 08:18:11"
"6267","20155430015455-513","3","2015-11-25 08:35:35",1448469335,"C5",937655,1449406990,"2015-12-06 05:03:10"
"4426","20150516050501-365","2","2015-11-25 14:41:15",1448491275,"C4",863282,1449354557,"2015-12-05 14:29:17"
"2497","20152227062255-337","2","2015-11-26 00:09:43",1448525383,"C3",645651,1449171034,"2015-12-03 11:30:34"
"2099","20152207062244-430","2","2015-11-26 09:44:49",1448559889,"C8",867145,1449427034,"2015-12-06 10:37:14"
"957","20154529034521-219","1","2015-11-29 21:36:41",1448861801,"C4",661885,1449523686,"2015-12-07 13:28:06"
"3898","20151613061634-340","2","2015-11-30 00:47:49",1448873269,"C8",289815,1449163084,"2015-12-03 09:18:04"
"5254","20151617081652-70","1","2015-11-30 12:18:28",1448914708,"C4",1471062,1450385770,"2015-12-17 12:56:10"
"1828","20150712070713-541","2","2015-11-30 21:55:45",1448949345,"C7",983216,1449932561,"2015-12-12 07:02:41"
"3396","20150930030938-661","3","2015-12-01 01:50:39",1448963439,"C0",758923,1449722362,"2015-12-09 20:39:22"
"532","20155528055554-549","2","2015-12-01 08:53:46",1448988826,"C2",687584,1449676410,"2015-12-09 07:53:30"
"1077","20153120063140-521","1","2015-12-02 21:45:30",1449121530,"C7",539090,1449660620,"2015-12-09 03:30:20"
"94","20150614110632-795","3","2015-12-03 06:06:12",1449151572,"C8",324716,1449476288,"2015-12-07 00:18:08"
"2065","20154023084052-167","1","2015-12-04 09:20:47",1449249647,"C8",190559,1449440206,"2015-12-06 14:16:46"
"1557","20154525114509-293","1","2015-12-04 19:39:33",1449286773,"C2",760008,1450046781,"2015-12-13 14:46:21"
"3624","20153309103304-690","1","2015-12-04 21:48:44",1449294524,"C8",1450420,1450744944,"2015-12-21 16:42:24"
"2802","20152329072302-894","1","2015-12-05 01:41:17",1449308477,"C8",1207185,1450515662,"2015-12-19 01:01:02"
"564","20154826034855-575","1","2015-12-05 06:06:07",1449324367,"C2",752079,1450076446,"2015-12-13 23:00:46"
"3376","20153829013810-820","1","2015-12-05 07:43:56",1449330236,"C8",1207078,1450537314,"2015-12-19 07:01:54"
"4590","20153428083457-4","1","2015-12-06 03:41:18",1449402078,"C8",1232283,1450634361,"2015-12-20 09:59:21"
"4964","20155617035648-789","1","2015-12-06 05:51:52",1449409912,"C2",612472,1450022384,"2015-12-13 07:59:44"
"3530","20154119024105-829","2","2015-12-06 11:49:41",1449431381,"C6",1122086,1450553467,"2015-12-19 11:31:07"
"2977","20152829012800-488","3","2015-12-08 09:15:12",1449594912,"C4",754554,1450349466,"2015-12-17 02:51:06"
"4872","20151525031532-107","1","2015-12-08 09:20:01",1449595201,"C7",1293467,1450888668,"2015-12-23 08:37:48"
"2643","20152710122745-528","1","2015-12-08 21:54:51",1449640491,"C3",1486518,1451127009,"2015-12-26 02:50:09"
"1554","20154904064902-300","1","2015-12-10 16:15:02",1449792902,"C8",110472,1449903374,"2015-12-11 22:56:14"
"5042","20150916030932-958","1","2015-12-11 11:13:16",1449861196,"C5",1825232,1451686428,"2016-01-01 14:13:48"
"427","20152629012651-157","3","2015-12-11 11:30:43",1449862243,"C7",1283176,1451145419,"2015-12-26 07:56:59"
"6314","20155826055855-744","2","2015-12-12 13:15:37",1449954937,"C8",948486,1450903423,"2015-12-23 12:43:43"
"708","20154326044353-158","3","2015-12-12 15:29:53",1449962993,"C0",950280,1450913273,"2015-12-23 15:27:53"
"4759","20150414060406-461","2","2015-12-13 03:48:06",1450007286,"C2",1306230,1451313516,"2015-12-28 06:38:36"
"5610","20154629064615-476","1","2015-12-15 03:49:18",1450180158,"C3",195969,1450376127,"2015-12-17 10:15:27"
"5799","20151509081503-433","3","2015-12-18 00:33:41",1450427621,"C8",374959,1450802580,"2015-12-22 08:43:00"
"4235","20155822105810-579","2","2015-12-18 20:46:26",1450500386,"C6",944462,1451444848,"2015-12-29 19:07:28"
"4201","20154125074116-47","1","2015-12-18 21:06:20",1450501580,"C5",913688,1451415268,"2015-12-29 10:54:28"
"3863","20153917053945-907","1","2015-12-20 08:26:21",1450628781,"C2",75332,1450704113,"2015-12-21 05:21:53"
"1982","20152218122219-545","2","2015-12-21 10:09:20",1450721360,"C4",251221,1450972581,"2015-12-24 07:56:21"
"2421","20150613010619-88","3","2015-12-22 13:09:40",1450818580,"C5",864543,1451683123,"2016-01-01 13:18:43"
"3123","20152404012417-940","1","2015-12-24 01:03:31",1450947811,"C2",1364222,1452312033,"2016-01-08 20:00:33"
"1901","20153628063656-228","3","2015-12-25 08:06:26",1451059586,"C4",864598,1451924184,"2016-01-04 08:16:24"
"4809","20153310103325-597","3","2015-12-26 20:11:19",1451189479,"C3",1708782,1452898261,"2016-01-15 14:51:01"
"4090","20150319090350-88","1","2015-12-29 00:42:46",1451378566,"C2",1242848,1452621414,"2016-01-12 09:56:54"
"24","20151408071436-141","1","2015-12-29 01:47:32",1451382452,"C2",1207597,1452590049,"2016-01-12 01:14:09"
"1927","20151828111836-799","1","2015-12-30 12:39:36",1451507976,"C4",88830,1451596806,"2015-12-31 13:20:06"
"6156","20151622071609-320","1","2016-01-06 12:33:38",1452112418,"C5",1694207,1453806625,"2016-01-26 03:10:25"
"6347","20160506090520-274","2","2016-01-08 18:00:06",1452304806,"C0",102443,1452407249,"2016-01-09 22:27:29"
"2582","20151821081800-795","1","2016-01-11 06:19:52",1452521992,"C3",1209164,1453731156,"2016-01-25 06:12:36"
"2172","20154430034428-915","1","2016-01-11 21:44:11",1452577451,"C2",2040169,1454617620,"2016-02-04 12:27:00"
"1309","20151415031434-50","1","2016-01-21 02:15:56",1453371356,"C4",1573726,1454945082,"2016-02-08 07:24:42"
"1001","20163708103702-555","2","2016-01-21 09:34:32",1453397672,"C5",559725,1453957397,"2016-01-27 21:03:17"
"2748","20165519125545-196","2","2016-01-25 20:47:39",1453783659,"C2",78102,1453861761,"2016-01-26 18:29:21"
"2353","20151815091854-333","1","2016-02-01 04:06:22",1454328382,"C5",1499306,1455827688,"2016-02-18 12:34:48"
"5765","20161915061905-937","2","2016-02-02 15:05:54",1454454354,"C4",226687,1454681041,"2016-02-05 06:04:01"
"1193","20162716112747-330","1","2016-02-03 05:34:51",1454506491,"C5",191753,1454698244,"2016-02-05 10:50:44"
"4037","20162209102238-93","2","2016-02-13 20:26:59",1455424019,"C4",127287,1455551306,"2016-02-15 07:48:26"
"2155","20154828034832-761","2","2016-02-17 20:57:36",1455771456,"C5",1536368,1457307824,"2016-03-06 15:43:44"
"4958","20154625114655-96","1","2016-02-23 04:31:53",1456230713,"C8",2625814,1458856527,"2016-03-24 14:55:27"
"4223","20154604064624-746","1","2016-02-24 20:22:21",1456374141,"C3",2525451,1458899592,"2016-03-25 02:53:12"
"5579","20164124024135-223","3","2016-02-25 17:01:09",1456448469,"C4",94774,1456543243,"2016-02-26 19:20:43"
"3421","20160020030000-577","2","2016-02-26 04:33:15",1456489995,"C5",160265,1456650260,"2016-02-28 01:04:20"
"2831","20165222105209-198","1","2016-02-27 16:54:29",1456620869,"C8",90748,1456711617,"2016-02-28 18:06:57"
"5386","20164124024115-14","1","2016-03-03 00:41:55",1456994515,"C5",414905,1457409420,"2016-03-07 19:57:00"
"3808","20164701124736-81","1","2016-03-04 02:05:39",1457085939,"C4",73561,1457159500,"2016-03-04 22:31:40"
"838","20155723045734-820","1","2016-03-05 13:57:19",1457215039,"C4",1301279,1458516318,"2016-03-20 16:25:18"
"47","20162904122951-717","1","2016-03-09 05:37:33",1457530653,"C0",203631,1457734284,"2016-03-11 14:11:24"
"6489","20161412121444-732","1","2016-03-13 09:13:09",1457885589,"C0",71905,1457957494,"2016-03-14 05:11:34"
"191","20160411030412-40","1","2016-03-14 19:19:30",1458008370,"C4",1388259,1459396629,"2016-03-30 20:57:09"
"6123","20161503081526-237","1","2016-03-15 12:28:54",1458070134,"C2",131051,1458201185,"2016-03-17 00:53:05"
"48","20162904122951-717","False","2016-03-16 06:10:39",1458133839,"C0",202965,1458336804,"2016-03-18 14:33:24"
"2090","20164504064540-547","1","2016-03-19 10:18:24",1458407904,"C8",652582,1459060486,"2016-03-26 23:34:46"
"2256","20163007043005-603","3","2016-03-19 20:29:41",1458444581,"C3",1047576,1459492157,"2016-03-31 23:29:17"
"2496","20165117045137-283","1","2016-03-21 02:20:33",1458552033,"C5",146668,1458698701,"2016-03-22 19:05:01"
"49","20162904122951-717","False","2016-03-23 06:01:29",1458738089,"C0",204763,1458942852,"2016-03-25 14:54:12"
"780","20165624125612-641","2","2016-03-26 20:54:55",1459050895,"C6",201523,1459252418,"2016-03-29 04:53:38"
"3268","20163125083158-7","2","2016-03-27 15:38:56",1459118336,"C5",99209,1459217545,"2016-03-28 19:12:25"
"50","20162904122951-717","False","2016-03-30 05:12:52",1459339972,"C0",202951,1459542923,"2016-04-01 13:35:23"
"51","20162904122951-717","False","2016-04-06 05:18:50",1459945130,"C0",202754,1460147884,"2016-04-08 13:38:04"
"4849","20161605081629-930","1","2016-04-09 05:01:57",1460203317,"C7",166964,1460370281,"2016-04-11 03:24:41"
"920","20165206045258-573","1","2016-04-10 05:04:24",1460289864,"C8",151543,1460441407,"2016-04-11 23:10:07"
"4912","20165701055728-629","1","2016-04-10 17:25:44",1460334344,"C4",96962,1460431306,"2016-04-11 20:21:46"
"5072","20162810052858-571","2","2016-04-12 08:44:46",1460475886,"C5",70674,1460546560,"2016-04-13 04:22:40"
"52","20162904122951-717","False","2016-04-13 05:49:43",1460551783,"C0",203710,1460755493,"2016-04-15 14:24:53"
"1673","20165904095931-786","2","2016-04-13 14:08:11",1460581691,"C5",99065,1460680756,"2016-04-14 17:39:16"
"1279","20163014013040-441","1","2016-04-16 08:41:30",1460821290,"C4",77725,1460899015,"2016-04-17 06:16:55"
"1603","20164707014735-384","2","2016-04-16 13:25:08",1460838308,"C2",258751,1461097059,"2016-04-19 13:17:39"
"4697","20161308031352-805","3","2016-04-18 20:51:40",1461037900,"C7",442134,1461480034,"2016-04-23 23:40:34"
"4357","20163403093427-432","2","2016-04-19 03:08:27",1461060507,"C4",453080,1461513587,"2016-04-24 08:59:47"
"2979","20162115092102-471","1","2016-04-21 01:29:35",1461227375,"C4",163371,1461390746,"2016-04-22 22:52:26"
"4854","20164712064702-854","2","2016-04-23 09:59:07",1461430747,"C8",192385,1461623132,"2016-04-25 15:25:32"
"3075","20164021074031-924","1","2016-04-23 16:05:17",1461452717,"C8",101543,1461554260,"2016-04-24 20:17:40"
"4810","20161731021739-422","3","2016-04-29 18:03:15",1461978195,"C5",314892,1462293087,"2016-05-03 09:31:27"
"6048","20165001065047-958","1","2016-05-02 11:57:46",1462215466,"C4",104819,1462320285,"2016-05-03 17:04:45"
"2343","20161928071944-220","2","2016-05-02 22:01:26",1462251686,"C7",199251,1462450937,"2016-05-05 05:22:17"
"2520","20161130121138-137","2","2016-05-03 08:45:22",1462290322,"C7",123412,1462413734,"2016-05-04 19:02:14"
"647","20161227011258-480","1","2016-05-03 19:50:22",1462330222,"C3",180748,1462510970,"2016-05-05 22:02:50"
"5327","20163301093354-99","2","2016-05-04 07:33:44",1462372424,"C4",251990,1462624414,"2016-05-07 05:33:34"
"752","20162226032206-214","1","2016-05-05 12:34:57",1462476897,"C4",109653,1462586550,"2016-05-06 19:02:30"
"4091","20160402010438-874","2","2016-05-05 13:03:29",1462478609,"C6",259131,1462737740,"2016-05-08 13:02:20"
"4216","20161501071504-180","3","2016-05-05 15:02:20",1462485740,"C3",186818,1462672558,"2016-05-07 18:55:58"
"689","20162302072339-398","1","2016-05-05 15:37:09",1462487829,"C4",96270,1462584099,"2016-05-06 18:21:39"
"4015","20162616092636-320","1","2016-05-07 08:19:24",1462634364,"C6",301728,1462936092,"2016-05-10 20:08:12"
"1350","20161405101442-940","2","2016-05-07 11:56:06",1462647366,"C4",89442,1462736808,"2016-05-08 12:46:48"
"5073","20160003020009-483","1","2016-05-07 22:31:19",1462685479,"C5",188135,1462873614,"2016-05-10 02:46:54"
"386","20163001013040-715","3","2016-05-08 01:08:26",1462694906,"C7",80038,1462774944,"2016-05-08 23:22:24"
"2315","20162403012456-660","1","2016-05-08 05:13:48",1462709628,"C0",201266,1462910894,"2016-05-10 13:08:14"
"87","20162113102146-554","1","2016-05-08 15:06:34",1462745194,"C5",272136,1463017330,"2016-05-11 18:42:10"
"3985","20161207031252-328","2","2016-05-08 16:37:16",1462750636,"C6",91464,1462842100,"2016-05-09 18:01:40"
"3217","20162204092243-393","2","2016-05-08 17:11:13",1462752673,"C7",186855,1462939528,"2016-05-10 21:05:28"
"6302","20165202075235-678","1","2016-05-08 18:00:21",1462755621,"C5",277433,1463033054,"2016-05-11 23:04:14"
"802","20162502012517-879","2","2016-05-08 19:07:34",1462759654,"C7",76991,1462836645,"2016-05-09 16:30:45"
"4226","20162104032146-897","3","2016-05-08 21:56:26",1462769786,"C3",184640,1462954426,"2016-05-11 01:13:46"
"541","20163403103449-145","3","2016-05-09 02:37:10",1462786630,"C8",69963,1462856593,"2016-05-09 22:03:13"
"2958","20164806024852-900","1","2016-05-09 04:13:20",1462792400,"C2",110534,1462902934,"2016-05-10 10:55:34"
"5535","20165807025851-835","3","2016-05-09 04:52:47",1462794767,"C2",68218,1462862985,"2016-05-09 23:49:45"
"5360","20162305022327-418","3","2016-05-09 09:52:45",1462812765,"C4",109786,1462922551,"2016-05-10 16:22:31"
"5525","20162807032803-741","2","2016-05-09 11:29:37",1462818577,"C6",158494,1462977071,"2016-05-11 07:31:11"
"397","20163806093805-983","1","2016-05-09 20:51:19",1462852279,"C0",299594,1463151873,"2016-05-13 08:04:33"
"691","20164407054454-328","3","2016-05-09 22:47:18",1462859238,"C4",63648,1462922886,"2016-05-10 16:28:06"
"2360","20163702083732-163","1","2016-05-10 03:40:22",1462876822,"C5",336685,1463213507,"2016-05-14 01:11:47"
"5113","20162308022340-411","3","2016-05-10 06:34:22",1462887262,"C4",144642,1463031904,"2016-05-11 22:45:04"
"405","20162703112728-345","1","2016-05-10 09:57:13",1462899433,"C4",199795,1463099228,"2016-05-12 17:27:08"
"2028","20162406112415-657","1","2016-05-10 10:25:39",1462901139,"C6",342084,1463243223,"2016-05-14 09:27:03"
"3082","20165703075701-962","1","2016-05-10 12:08:54",1462907334,"C4",88559,1462995893,"2016-05-11 12:44:53"
"478","20163904013912-769","2","2016-05-10 18:12:19",1462929139,"C2",534787,1463463926,"2016-05-16 22:45:26"
"935","20162806092859-620","2","2016-05-11 00:42:49",1462952569,"C8",80086,1463032655,"2016-05-11 22:57:35"
"4200","20160909040905-953","1","2016-05-11 07:13:01",1462975981,"C8",70318,1463046299,"2016-05-12 02:44:59"
"1711","20164708074730-603","2","2016-05-11 12:32:09",1462995129,"C4",92093,1463087222,"2016-05-12 14:07:02"
"5798","20163508033551-791","1","2016-05-11 14:51:03",1463003463,"C4",85504,1463088967,"2016-05-12 14:36:07"
"877","20161706051756-373","2","2016-05-11 20:34:38",1463024078,"C4",221901,1463245979,"2016-05-14 10:12:59"
"6363","20164006104039-266","3","2016-05-12 01:57:02",1463043422,"C5",69569,1463112991,"2016-05-12 21:16:31"
"986","20160301010333-533","2","2016-05-12 04:08:05",1463051285,"C4",114784,1463166069,"2016-05-13 12:01:09"
"598","20164508064519-442","1","2016-05-12 05:34:13",1463056453,"C3",113778,1463170231,"2016-05-13 13:10:31"
"4723","20163309073335-602","2","2016-05-12 08:44:53",1463067893,"C6",263478,1463331371,"2016-05-15 09:56:11"
"5379","20163108043103-996","3","2016-05-12 09:56:17",1463072177,"C0",160957,1463233134,"2016-05-14 06:38:54"
"5002","20163607053650-333","1","2016-05-12 16:18:59",1463095139,"C0",61047,1463156186,"2016-05-13 09:16:26"
"4652","20161001071044-510","1","2016-05-12 23:38:44",1463121524,"C2",126210,1463247734,"2016-05-14 10:42:14"
"4423","20161205051258-519","3","2016-05-13 09:01:42",1463155302,"C5",330862,1463486164,"2016-05-17 04:56:04"
"4458","20160311050309-656","2","2016-05-13 10:14:21",1463159661,"C4",49424,1463209085,"2016-05-13 23:58:05"
"6471","20160709060739-448","1","2016-05-13 12:33:37",1463168017,"C7",184379,1463352396,"2016-05-15 15:46:36"
"6238","20165712035713-404","3","2016-05-14 01:25:41",1463214341,"C2",60254,1463274595,"2016-05-14 18:09:55"
"2150","20165005045015-818","1","2016-05-14 03:32:05",1463221925,"C5",364855,1463586780,"2016-05-18 08:53:00"
"5005","20160306010354-831","2","2016-05-14 06:36:26",1463232986,"C2",333976,1463566962,"2016-05-18 03:22:42"
"3388","20164212054245-135","1","2016-05-14 12:58:47",1463255927,"C5",77881,1463333808,"2016-05-15 10:36:48"
"3761","20160311050306-89","1","2016-05-14 14:43:25",1463262205,"C4",250819,1463513024,"2016-05-17 12:23:44"
"4173","20161508121511-970","2","2016-05-14 17:04:47",1463270687,"C6",89296,1463359983,"2016-05-15 17:53:03"
"5985","20163207073234-8","2","2016-05-14 19:16:31",1463278591,"C0",215679,1463494270,"2016-05-17 07:11:10"
"1027","20165710015727-667","2","2016-05-14 20:31:07",1463283067,"C3",184610,1463467677,"2016-05-16 23:47:57"
"764","20165706065721-811","1","2016-05-15 01:33:21",1463301201,"C2",94770,1463395971,"2016-05-16 03:52:51"
"4650","20161412101451-978","1","2016-05-15 13:32:58",1463344378,"C0",271087,1463615465,"2016-05-18 16:51:05"
"4132","20160414060432-270","1","2016-05-15 21:47:40",1463374060,"C2",142988,1463517048,"2016-05-17 13:30:48"
"4063","20161507081502-674","2","2016-05-16 05:52:20",1463403140,"C4",384519,1463787659,"2016-05-20 16:40:59"
"5311","20163810043842-166","2","2016-05-16 06:07:24",1463404044,"C7",68646,1463472690,"2016-05-17 01:11:30"
"4764","20161903071919-851","2","2016-05-16 06:14:59",1463404499,"C2",1119340,1464523839,"2016-05-29 05:10:39"
"338","20161604061614-874","1","2016-05-16 08:57:47",1463414267,"C5",348831,1463763098,"2016-05-20 09:51:38"
"3594","20162101102134-434","3","2016-05-16 10:40:08",1463420408,"C0",185302,1463605710,"2016-05-18 14:08:30"
"6336","20165510115511-114","2","2016-05-16 15:05:21",1463436321,"C4",264905,1463701226,"2016-05-19 16:40:26"
"4016","20163413023412-159","1","2016-05-16 21:23:16",1463458996,"C7",141872,1463600868,"2016-05-18 12:47:48"
"358","20160604020620-396","1","2016-05-17 01:50:52",1463475052,"C7",539536,1464014588,"2016-05-23 07:43:08"
"4807","20163909093927-432","1","2016-05-17 07:40:33",1463496033,"C0",342033,1463838066,"2016-05-21 06:41:06"
"1274","20164607104629-486","1","2016-05-17 08:03:04",1463497384,"C6",854195,1464351579,"2016-05-27 05:19:39"
"4980","20164713014745-616","1","2016-05-17 13:39:13",1463517553,"C5",172544,1463690097,"2016-05-19 13:34:57"
"3559","20161211061224-16","1","2016-05-17 15:54:54",1463525694,"C8",276675,1463802369,"2016-05-20 20:46:09"
"4779","20161213101216-677","1","2016-05-17 17:53:37",1463532817,"C2",373281,1463906098,"2016-05-22 01:34:58"
"3026","20165112105109-897","2","2016-05-17 20:28:15",1463542095,"C3",155542,1463697637,"2016-05-19 15:40:37"
"2702","20161615021657-872","3","2016-05-18 03:04:39",1463565879,"C5",72954,1463638833,"2016-05-18 23:20:33"
"2867","20164308024330-236","3","2016-05-18 09:14:58",1463588098,"C7",422144,1464010242,"2016-05-23 06:30:42"
"1601","20164314024337-465","1","2016-05-18 10:33:23",1463592803,"C6",330586,1463923389,"2016-05-22 06:23:09"
"2539","20162809102817-777","1","2016-05-18 13:07:44",1463602064,"C5",262389,1463864453,"2016-05-21 14:00:53"
"5322","20162612072638-753","1","2016-05-18 16:44:41",1463615081,"C5",183961,1463799042,"2016-05-20 19:50:42"
"1848","20164624094605-617","2","2016-05-18 18:30:13",1463621413,"C4",263131,1463884544,"2016-05-21 19:35:44"
"5557","20163314053345-713","3","2016-05-18 19:34:50",1463625290,"C8",70573,1463695863,"2016-05-19 15:11:03"
"1268","20162317022350-38","1","2016-05-18 23:53:56",1463640836,"C5",60303,1463701139,"2016-05-19 16:38:59"
"2013","20165704055721-696","1","2016-05-19 00:43:33",1463643813,"C3",411324,1464055137,"2016-05-23 18:58:57"
"3876","20163707033759-413","1","2016-05-19 00:57:49",1463644669,"C0",140570,1463785239,"2016-05-20 16:00:39"
"1884","20161611051626-58","2","2016-05-19 01:47:38",1463647658,"C4",403434,1464051092,"2016-05-23 17:51:32"
"4231","20161805081816-21","1","2016-05-19 03:38:37",1463654317,"C7",170403,1463824720,"2016-05-21 02:58:40"
"1140","20161214011208-135","1","2016-05-19 04:47:45",1463658465,"C0",57391,1463715856,"2016-05-19 20:44:16"
"3550","20165408055453-259","3","2016-05-19 09:11:17",1463674277,"C2",306328,1463980605,"2016-05-22 22:16:45"
"6518","20160317100339-729","1","2016-05-19 09:40:41",1463676041,"C2",85711,1463761752,"2016-05-20 09:29:12"
"4746","20165813015832-479","2","2016-05-19 15:38:12",1463697492,"C8",104876,1463802368,"2016-05-20 20:46:08"
"6529","20165911025927-470","1","2016-05-19 16:26:36",1463700396,"C4",232143,1463932539,"2016-05-22 08:55:39"
"1794","20162316122341-349","1","2016-05-19 16:57:14",1463702234,"C2",275613,1463977847,"2016-05-22 21:30:47"
"5356","20160412100403-624","1","2016-05-19 17:28:58",1463704138,"C0",631495,1464335633,"2016-05-27 00:53:53"
"1461","20164516124536-165","1","2016-05-19 20:36:57",1463715417,"C3",95827,1463811244,"2016-05-20 23:14:04"
"6555","20165313095326-823","1","2016-05-19 20:37:30",1463715450,"C5",278522,1463993972,"2016-05-23 01:59:32"
"3909","20163909083952-107","3","2016-05-19 21:01:16",1463716876,"C7",454242,1464171118,"2016-05-25 03:11:58"
"3252","20162014082012-197","1","2016-05-19 22:13:20",1463721200,"C4",481988,1464203188,"2016-05-25 12:06:28"
"4275","20161106011142-596","2","2016-05-20 10:56:46",1463767006,"C7",600752,1464367758,"2016-05-27 09:49:18"
"4334","20165710075759-354","1","2016-05-20 14:43:03",1463780583,"C5",444152,1464224735,"2016-05-25 18:05:35"
"3768","20163922113927-867","3","2016-05-20 18:37:14",1463794634,"C0",349181,1464143815,"2016-05-24 19:36:55"
"3311","20160219110233-416","1","2016-05-20 19:08:36",1463796516,"C4",115563,1463912079,"2016-05-22 03:14:39"
"4011","20164201094203-125","1","2016-05-21 00:45:47",1463816747,"C4",211978,1464028725,"2016-05-23 11:38:45"
"696","20161618071617-763","2","2016-05-21 02:17:27",1463822247,"C0",120635,1463942882,"2016-05-22 11:48:02"
"1904","20160813020801-597","2","2016-05-21 03:44:43",1463827483,"C6",108967,1463936450,"2016-05-22 10:00:50"
"2674","20160011040054-612","1","2016-05-21 05:00:02",1463832002,"C5",412174,1464244176,"2016-05-25 23:29:36"
"3121","20162911092915-817","2","2016-05-21 06:37:33",1463837853,"C4",284566,1464122419,"2016-05-24 13:40:19"
"6117","20161418061406-876","2","2016-05-21 08:58:25",1463846305,"C3",269059,1464115364,"2016-05-24 11:42:44"
"2427","20161917061915-322","2","2016-05-21 15:06:05",1463868365,"C3",377210,1464245575,"2016-05-25 23:52:55"
"781","20164810074837-368","2","2016-05-21 16:55:47",1463874947,"C8",196646,1464071593,"2016-05-23 23:33:13"
"5509","20165305015329-885","1","2016-05-21 20:25:37",1463887537,"C0",175741,1464063278,"2016-05-23 21:14:38"
"3051","20161818071801-292","1","2016-05-22 01:14:31",1463904871,"C3",107930,1464012801,"2016-05-23 07:13:21"
"455","20160109120154-984","3","2016-05-22 01:24:24",1463905464,"C0",542475,1464447939,"2016-05-28 08:05:39"
"4562","20165911075945-393","1","2016-05-22 01:58:58",1463907538,"C4",132679,1464040217,"2016-05-23 14:50:17"
"6015","20165907125955-871","2","2016-05-22 03:42:55",1463913775,"C5",420860,1464334635,"2016-05-27 00:37:15"
"2454","20163410053456-4","2","2016-05-22 05:48:11",1463921291,"C4",331465,1464252756,"2016-05-26 01:52:36"
"2906","20162106052135-91","1","2016-05-22 06:23:26",1463923406,"C5",447637,1464371043,"2016-05-27 10:44:03"
"1346","20161112031156-198","2","2016-05-22 08:46:44",1463932004,"C0",280296,1464212300,"2016-05-25 14:38:20"
"6026","20165320125359-334","1","2016-05-22 11:40:09",1463942409,"C6",168370,1464110779,"2016-05-24 10:26:19"
"4304","20162612082614-132","2","2016-05-22 14:38:09",1463953089,"C8",177263,1464130352,"2016-05-24 15:52:32"
"4993","20160615090601-72","2","2016-05-22 19:45:28",1463971528,"C8",91881,1464063409,"2016-05-23 21:16:49"
"6059","20162203102237-41","1","2016-05-22 22:50:37",1463982637,"C5",210810,1464193447,"2016-05-25 09:24:07"
"6476","20162921042944-446","3","2016-05-22 23:18:06",1463984286,"C3",55451,1464039737,"2016-05-23 14:42:17"
"1878","20165319125305-907","1","2016-05-23 01:34:03",1463992443,"C7",152429,1464144872,"2016-05-24 19:54:32"
"1100","20165814095833-724","2","2016-05-23 05:00:54",1464004854,"C0",253247,1464258101,"2016-05-26 03:21:41"
"5480","20160711110708-553","2","2016-05-23 05:34:48",1464006888,"C0",508430,1464515318,"2016-05-29 02:48:38"
"2886","20160418080421-476","2","2016-05-23 07:01:43",1464012103,"C2",428242,1464440345,"2016-05-28 05:59:05"
"2610","20160102010124-415","3","2016-05-23 14:09:04",1464037744,"C7",259780,1464297524,"2016-05-26 14:18:44"
"3648","20165920055941-216","1","2016-05-23 22:15:02",1464066902,"C0",274521,1464341423,"2016-05-27 02:30:23"
"2465","20161414041441-290","3","2016-05-24 01:22:07",1464078127,"C0",405223,1464483350,"2016-05-28 17:55:50"
"6551","20164319034355-175","2","2016-05-24 01:43:19",1464079399,"C5",190782,1464270181,"2016-05-26 06:43:01"
"5175","20162706102701-37","3","2016-05-24 03:43:40",1464086620,"C4",510333,1464596953,"2016-05-30 01:29:13"
"2258","20162409062454-857","2","2016-05-24 03:52:21",1464087141,"C7",554121,1464641262,"2016-05-30 13:47:42"
"4477","20162323112359-854","1","2016-05-24 10:17:10",1464110230,"C0",82391,1464192621,"2016-05-25 09:10:21"
"1121","20160508120500-362","1","2016-05-24 22:59:55",1464155995,"C8",284339,1464440334,"2016-05-28 05:58:54"
"5182","20163217053256-155","1","2016-05-25 02:13:34",1464167614,"C0",318019,1464485633,"2016-05-28 18:33:53"
"4684","20164222054243-411","3","2016-05-25 02:54:40",1464170080,"C4",68639,1464238719,"2016-05-25 21:58:39"
"3512","20163223093205-573","1","2016-05-25 05:06:13",1464177973,"C4",78424,1464256397,"2016-05-26 02:53:17"
"2257","20161507051513-138","2","2016-05-25 06:20:05",1464182405,"C4",216556,1464398961,"2016-05-27 18:29:21"
"6115","20162621032632-655","1","2016-05-25 07:17:56",1464185876,"C0",105428,1464291304,"2016-05-26 12:35:04"
"1182","20163419063429-101","3","2016-05-25 10:15:24",1464196524,"C8",106331,1464302855,"2016-05-26 15:47:35"
"1023","20165116035154-472","1","2016-05-25 12:52:34",1464205954,"C0",95855,1464301809,"2016-05-26 15:30:09"
"2432","20160715040757-420","2","2016-05-25 15:34:22",1464215662,"C8",172397,1464388059,"2016-05-27 15:27:39"
"6051","20164618094655-835","1","2016-05-25 15:49:35",1464216575,"C2",78320,1464294895,"2016-05-26 13:34:55"
"600","20165119025134-664","1","2016-05-25 20:19:02",1464232742,"C3",76864,1464309606,"2016-05-26 17:40:06"
"1653","20165213105244-282","3","2016-05-25 20:30:12",1464233412,"C7",535724,1464769136,"2016-06-01 01:18:56"
"4170","20165716115733-899","1","2016-05-26 07:47:09",1464274029,"C6",848976,1465123005,"2016-06-05 03:36:45"
"6455","20164724114712-44","2","2016-05-26 17:48:38",1464310118,"C5",97243,1464407361,"2016-05-27 20:49:21"
"1403","20161612071621-912","1","2016-05-26 18:31:02",1464312662,"C7",178583,1464491245,"2016-05-28 20:07:25"
"2503","20161929031920-756","1","2016-05-26 19:46:15",1464317175,"C2",335545,1464652720,"2016-05-30 16:58:40"
"5351","20162824122829-498","1","2016-05-26 23:26:21",1464330381,"C2",106136,1464436517,"2016-05-28 04:55:17"
"655","20165723055733-60","1","2016-05-27 00:03:11",1464332591,"C4",140569,1464473160,"2016-05-28 15:06:00"
"3558","20161421031451-792","1","2016-05-27 06:45:23",1464356723,"C5",243916,1464600639,"2016-05-30 02:30:39"
"6427","20164912044955-331","1","2016-05-27 14:59:20",1464386360,"C7",184195,1464570555,"2016-05-29 18:09:15"
"1222","20162222042259-769","1","2016-05-27 16:00:45",1464390045,"C4",430666,1464820711,"2016-06-01 15:38:31"
"1738","20161625021649-105","2","2016-05-27 16:41:07",1464392467,"C5",90729,1464483196,"2016-05-28 17:53:16"
"5405","20163015053019-83","2","2016-05-28 01:18:13",1464423493,"C5",532437,1464955930,"2016-06-03 05:12:10"
"4857","20160521040514-90","1","2016-05-28 04:03:20",1464433400,"C0",187162,1464620562,"2016-05-30 08:02:42"
"6136","20165824065853-160","1","2016-05-28 04:14:11",1464434051,"C4",167859,1464601910,"2016-05-30 02:51:50"
"2853","20162925012937-610","2","2016-05-28 16:06:24",1464476784,"C4",268607,1464745391,"2016-05-31 18:43:11"
"3507","20161318071302-141","2","2016-05-29 01:08:53",1464509333,"C5",309517,1464818850,"2016-06-01 15:07:30"
"624","20162114082157-230","1","2016-05-29 02:50:38",1464515438,"C2",182303,1464697741,"2016-05-31 05:29:01"
"6142","20162027042012-940","1","2016-05-29 08:26:28",1464535588,"C1",144376,1464679964,"2016-05-31 00:32:44"
"4994","20165927105911-596","1","2016-05-29 08:46:39",1464536799,"C8",82424,1464619223,"2016-05-30 07:40:23"
"2572","20161226101220-113","1","2016-05-29 15:25:14",1464560714,"C5",92658,1464653372,"2016-05-30 17:09:32"
"2584","20164715104741-924","1","2016-05-29 16:16:51",1464563811,"C8",245870,1464809681,"2016-06-01 12:34:41"
"2044","20163414033416-878","3","2016-05-29 18:23:34",1464571414,"C2",186594,1464758008,"2016-05-31 22:13:28"
"56","20164026084027-353","2","2016-05-29 18:51:54",1464573114,"C4",98629,1464671743,"2016-05-30 22:15:43"
"827","20162515022503-709","1","2016-05-30 01:28:08",1464596888,"C8",249877,1464846765,"2016-06-01 22:52:45"
"375","20165429105417-811","3","2016-05-30 10:38:55",1464629935,"C4",85478,1464715413,"2016-05-31 10:23:33"
"152","20164926124930-922","1","2016-05-30 13:55:00",1464641700,"C3",349530,1464991230,"2016-06-03 15:00:30"
"3849","20164220094251-139","1","2016-05-30 13:59:27",1464641967,"C4",293132,1464935099,"2016-06-02 23:24:59"
"3031","20162425062418-198","1","2016-05-30 14:54:12",1464645252,"C8",231297,1464876549,"2016-06-02 07:09:09"
"390","20163402063435-850","1","2016-05-30 14:55:12",1464645312,"C7",349891,1464995203,"2016-06-03 16:06:43"
"514","20164115024151-5","1","2016-05-30 18:00:12",1464656412,"C7",186843,1464843255,"2016-06-01 21:54:15"
"4181","20161121021106-144","1","2016-05-30 20:03:57",1464663837,"C2",266257,1464930094,"2016-06-02 22:01:34"
"4022","20160728090757-429","1","2016-05-31 01:41:19",1464684079,"C2",116201,1464800280,"2016-06-01 09:58:00"
"2111","20160809090856-701","1","2016-05-31 02:06:23",1464685583,"C4",267921,1464953504,"2016-06-03 04:31:44"
"3763","20164726074710-213","2","2016-05-31 04:36:46",1464694606,"C8",210288,1464904894,"2016-06-02 15:01:34"
"5871","20163724093730-240","3","2016-05-31 04:43:58",1464695038,"C4",83884,1464778922,"2016-06-01 04:02:02"
"845","20155517055510-758","2","2016-05-31 06:03:40",1464699820,"C2",2751891,1467451711,"2016-07-02 02:28:31"
"4261","20160624070637-743","2","2016-05-31 08:15:06",1464707706,"C7",86987,1464794693,"2016-06-01 08:24:53"
"2536","20160124090148-920","1","2016-05-31 11:58:30",1464721110,"C5",307701,1465028811,"2016-06-04 01:26:51"
"4153","20165529085512-11","1","2016-05-31 14:56:30",1464731790,"C0",194478,1464926268,"2016-06-02 20:57:48"
"4324","20160326030315-917","2","2016-05-31 16:20:24",1464736824,"C5",145543,1464882367,"2016-06-02 08:46:07"
"2630","20162421092429-563","1","2016-05-31 16:39:07",1464737947,"C5",127154,1464865101,"2016-06-02 03:58:21"
"2618","20161623011642-809","1","2016-05-31 21:33:17",1464755597,"C8",144199,1464899796,"2016-06-02 13:36:36"
"2098","20162629082608-704","1","2016-06-01 00:11:16",1464765076,"C5",114754,1464879830,"2016-06-02 08:03:50"
"4642","20160017030016-746","2","2016-06-01 01:40:49",1464770449,"C4",416011,1465186460,"2016-06-05 21:14:20"
"6005","20163314053328-67","3","2016-06-01 01:51:07",1464771067,"C2",499553,1465270620,"2016-06-06 20:37:00"
"4421","20160529040522-408","1","2016-06-01 02:14:56",1464772496,"C2",104687,1464877183,"2016-06-02 07:19:43"
"3638","20162125082144-48","3","2016-06-01 07:30:26",1464791426,"C7",300861,1465092287,"2016-06-04 19:04:47"
"5825","20164622114647-721","3","2016-06-01 07:42:26",1464792146,"C4",283113,1465075259,"2016-06-04 14:20:59"
"4645","20160419080431-102","1","2016-06-01 09:15:13",1464797713,"C4",375814,1465173527,"2016-06-05 17:38:47"
"1113","20164216084251-215","1","2016-06-01 16:59:39",1464825579,"C8",706104,1465531683,"2016-06-09 21:08:03"
"3980","20164128104138-234","1","2016-06-01 17:53:28",1464828808,"C4",185755,1465014563,"2016-06-03 21:29:23"
"2107","20161613031621-889","1","2016-06-01 18:19:43",1464830383,"C4",236086,1465066469,"2016-06-04 11:54:29"
"630","20164115054120-679","1","2016-06-02 01:02:44",1464854564,"C6",249214,1465103778,"2016-06-04 22:16:18"
"474","20165815125818-188","1","2016-06-02 01:48:18",1464857298,"C3",189375,1465046673,"2016-06-04 06:24:33"
"4792","20162511082549-862","2","2016-06-02 06:37:04",1464874624,"C7",210475,1465085099,"2016-06-04 17:04:59"
"1745","20161918041903-606","1","2016-06-02 08:39:52",1464881992,"C5",181207,1465063199,"2016-06-04 10:59:59"
"3047","20162015042050-853","1","2016-06-02 12:41:16",1464896476,"C7",771013,1465667489,"2016-06-11 10:51:29"
"956","20162217032244-108","2","2016-06-02 19:15:40",1464920140,"C5",174547,1465094687,"2016-06-04 19:44:47"
"3073","20161006051036-393","2","2016-06-02 22:46:21",1464932781,"C7",336135,1465268916,"2016-06-06 20:08:36"
"3673","20162104082115-909","1","2016-06-03 01:30:44",1464942644,"C8",366767,1465309411,"2016-06-07 07:23:31"
"3187","20162027072034-172","2","2016-06-03 15:08:34",1464991714,"C4",79110,1465070824,"2016-06-04 13:07:04"
"5128","20164718044740-123","1","2016-06-03 18:03:48",1465002228,"C2",173371,1465175599,"2016-06-05 18:13:19"
"3903","20165024055011-688","3","2016-06-03 22:47:01",1465019221,"C5",440905,1465460126,"2016-06-09 01:15:26"
"4393","20164028114031-155","1","2016-06-03 23:43:59",1465022639,"C3",70226,1465092865,"2016-06-04 19:14:25"
"5626","20163922093934-985","1","2016-06-04 00:03:59",1465023839,"C8",217733,1465241572,"2016-06-06 12:32:52"
"681","20161410101407-777","3","2016-06-04 00:34:23",1465025663,"C5",265652,1465291315,"2016-06-07 02:21:55"
"5116","20162119092147-990","2","2016-06-04 15:16:17",1465078577,"C2",467890,1465546467,"2016-06-10 01:14:27"
"6171","20161927041946-363","3","2016-06-04 17:26:03",1465086363,"C7",99311,1465185674,"2016-06-05 21:01:14"
"832","20161912121924-319","1","2016-06-04 20:18:28",1465096708,"C7",287992,1465384700,"2016-06-08 04:18:20"
"5637","20163630103646-440","3","2016-06-05 00:22:44",1465111364,"C5",68794,1465180158,"2016-06-05 19:29:18"
"6307","20164028104033-812","3","2016-06-05 00:30:31",1465111831,"C5",93514,1465205345,"2016-06-06 02:29:05"
"6470","20161711061704-241","1","2016-06-05 07:20:08",1465136408,"C6",270473,1465406881,"2016-06-08 10:28:01"
"2604","20161010091000-835","3","2016-06-05 10:39:42",1465148382,"C7",250198,1465398580,"2016-06-08 08:09:40"
"1647","20162706052712-821","2","2016-06-05 19:56:24",1465181784,"C5",325119,1465506903,"2016-06-09 14:15:03"
"6082","20162828032836-807","2","2016-06-05 23:35:45",1465194945,"C0",240143,1465435088,"2016-06-08 18:18:08"
"2567","20161222121219-49","1","2016-06-06 03:59:15",1465210755,"C5",158302,1465369057,"2016-06-07 23:57:37"
"1066","20163125113148-504","2","2016-06-06 07:04:13",1465221853,"C8",204149,1465426002,"2016-06-08 15:46:42"
"6326","20161905071929-794","2","2016-06-06 09:38:37",1465231117,"C2",1148564,1466379681,"2016-06-19 16:41:21"
"6386","20162627082628-314","1","2016-06-06 17:09:32",1465258172,"C4",111923,1465370095,"2016-06-08 00:14:55"
"930","20165001065044-854","2","2016-06-07 09:45:18",1465317918,"C7",458182,1465776100,"2016-06-12 17:01:40"
"754","20162325052301-988","2","2016-06-09 03:44:51",1465469091,"C2",178130,1465647221,"2016-06-11 05:13:41"
"5519","20162125032104-263","2","2016-06-09 04:11:16",1465470676,"C5",418604,1465889280,"2016-06-14 00:28:00"
"648","20163020083029-640","1","2016-06-09 04:46:14",1465472774,"C7",190505,1465663279,"2016-06-11 09:41:19"
"5946","20160920120951-598","1","2016-06-09 12:38:39",1465501119,"C7",247104,1465748223,"2016-06-12 09:17:03"
"5530","20164020014058-615","2","2016-06-10 09:22:54",1465575774,"C2",256988,1465832762,"2016-06-13 08:46:02"
"1799","20161319081321-100","3","2016-06-10 22:57:21",1465624641,"C4",279120,1465903761,"2016-06-14 04:29:21"
"1229","20164826104846-825","1","2016-06-12 04:35:43",1465731343,"C7",206631,1465937974,"2016-06-14 13:59:34"
"1709","20161326101328-758","1","2016-06-12 05:25:12",1465734312,"C4",181438,1465915750,"2016-06-14 07:49:10"
"3535","20161224031222-354","1","2016-06-12 10:17:03",1465751823,"C8",231983,1465983806,"2016-06-15 02:43:26"
"6415","20164728074737-670","1","2016-06-13 08:54:51",1465833291,"C2",198062,1466031353,"2016-06-15 15:55:53"
"55","20160902060942-509","2","2016-06-13 19:32:12",1465871532,"C6",612825,1466484357,"2016-06-20 21:45:57"
"2656","20162214052214-931","2","2016-06-14 17:17:09",1465949829,"C8",535619,1466485448,"2016-06-20 22:04:08"
"3296","20162701122721-624","3","2016-06-14 21:22:24",1465964544,"C7",425967,1466390511,"2016-06-19 19:41:51"
"5903","20164923044905-91","3","2016-06-15 06:09:05",1465996145,"C0",243600,1466239745,"2016-06-18 01:49:05"
"4211","20161103061131-806","1","2016-06-15 14:07:18",1466024838,"C5",534821,1466559659,"2016-06-21 18:40:59"
"596","20160424070451-587","1","2016-06-16 02:02:01",1466067721,"C8",393806,1466461527,"2016-06-20 15:25:27"
"3160","20161907081910-516","1","2016-06-16 07:31:01",1466087461,"C7",383679,1466471140,"2016-06-20 18:05:40"
"1818","20160618010659-729","2","2016-06-17 02:07:14",1466154434,"C8",510483,1466664917,"2016-06-22 23:55:17"
"1570","20163527043543-724","1","2016-06-17 06:30:47",1466170247,"C3",222263,1466392510,"2016-06-19 20:15:10"
"3136","20165709095721-17","1","2016-06-17 18:13:36",1466212416,"C5",1133125,1467345541,"2016-06-30 20:59:01"
"592","20161228061242-834","1","2016-06-17 22:24:58",1466227498,"C3",223292,1466450790,"2016-06-20 12:26:30"
"5494","20164927034958-905","1","2016-06-18 05:45:53",1466253953,"C8",266365,1466520318,"2016-06-21 07:45:18"
"3517","20163116093107-139","1","2016-06-19 17:30:50",1466382650,"C5",423769,1466806419,"2016-06-24 15:13:39"
"3104","20164717114725-131","2","2016-06-21 08:15:40",1466522140,"C4",430185,1466952325,"2016-06-26 07:45:25"
"485","20162310042305-75","1","2016-06-21 10:32:32",1466530352,"C7",400863,1466931215,"2016-06-26 01:53:35"
"1963","20165117075149-247","1","2016-06-22 04:28:43",1466594923,"C3",1032738,1467627661,"2016-07-04 03:21:01"
"476","20162701092754-587","1","2016-06-26 13:38:16",1466973496,"C8",693346,1467666842,"2016-07-04 14:14:02"
"2670","20164006084004-327","2","2016-06-27 05:08:52",1467029332,"C4",560016,1467589348,"2016-07-03 16:42:28"
"6528","20164622054644-414","2","2016-06-27 15:55:20",1467068120,"C0",443388,1467511508,"2016-07-02 19:05:08"
"6177","20162224012201-227","1","2016-06-27 19:30:05",1467081005,"C4",422812,1467503817,"2016-07-02 16:56:57"
"1359","20163118113139-316","1","2016-06-28 11:39:13",1467139153,"C2",506122,1467645275,"2016-07-04 08:14:35"
"5192","20160418080457-245","1","2016-06-29 15:21:45",1467238905,"C2",522144,1467761049,"2016-07-05 16:24:09"
"762","20160723050724-51","2","2016-07-02 17:05:25",1467504325,"C2",863983,1468368308,"2016-07-12 17:05:08"
"6428","20161515101514-592","1","2016-07-02 19:56:14",1467514574,"C2",278804,1467793378,"2016-07-06 01:22:58"
"914","20164101114139-473","3","2016-07-05 11:41:06",1467744066,"C3",802281,1468546347,"2016-07-14 18:32:27"
"1115","20165105115138-773","1","2016-07-06 23:25:14",1467872714,"C7",599824,1468472538,"2016-07-13 22:02:18"
"5253","20162506102549-845","1","2016-07-08 09:22:35",1467994955,"C5",777058,1468772013,"2016-07-17 09:13:33"
"1950","20164108104158-541","2","2016-07-10 03:28:38",1468146518,"C6",677150,1468823668,"2016-07-17 23:34:28"
"2696","20164808054840-252","1","2016-07-10 09:29:06",1468168146,"C3",773318,1468941464,"2016-07-19 08:17:44"
"1389","20165621125656-604","1","2016-07-10 19:16:49",1468203409,"C5",620399,1468823808,"2016-07-17 23:36:48"
"4208","20161523061558-393","1","2016-07-12 23:03:04",1468389784,"C7",486714,1468876498,"2016-07-18 14:14:58"
"4584","20163108093145-941","1","2016-07-14 07:12:33",1468505553,"C7",642272,1469147825,"2016-07-21 17:37:05"
"5734","20155705025759-63","1","2016-07-20 22:48:18",1469080098,"C3",2090507,1471170605,"2016-08-14 03:30:05"
"1893","20164322074326-978","1","2016-07-25 02:33:21",1469439201,"C3",787285,1470226486,"2016-08-03 05:14:46"
"5733","20155705025759-63","1","2016-07-28 03:25:29",1469701529,"C2",2410670,1472112199,"2016-08-25 01:03:19"
"6511","20162213012243-861","1","2016-07-31 18:54:19",1470016459,"C5",977928,1470994387,"2016-08-12 02:33:07"
"5306","20162823012818-280","2","2016-08-04 13:30:33",1470342633,"C7",700815,1471043448,"2016-08-12 16:10:48"
"2662","20165407095430-165","1","2016-08-21 14:04:30",1471813470,"C4",1146675,1472960145,"2016-09-03 20:35:45"
"5735","20155705025759-63","1","2016-09-19 21:36:59",1474346219,"C5",2040237,1476386456,"2016-10-13 12:20:56"
"5743","20155705025759-63","1","2018-07-18 06:21:29",1531920089,"C2",1490585,1533410674,"2018-08-04 12:24:34"
"5736","20155705025759-63","1","2018-10-14 16:31:23",1539559883,"C0",2789958,1542349841,"2018-11-15 22:30:41"
"5737","20155705025759-63","1","2019-02-14 11:30:39",1550172639,"C2",2915779,1553088418,"2019-03-20 06:26:58"
"5738","20155705025759-63","1","2019-06-22 04:20:53",1561202453,"C6",2605326,1563807779,"2019-07-22 08:02:59"
"5741","20155705025759-63","1","2020-06-26 10:28:53",1593192533,"C0",2575017,1595767550,"2020-07-26 05:45:50"
"5739","20155705025759-63","1","2020-12-17 06:35:29",1608215729,"C3",3011625,1611227354,"2021-01-21 03:09:14"
"5742","20155705025759-63","1","2021-03-02 05:53:43",1614693223,"C4",2830496,1617523719,"2021-04-04 01:08:39"
"5740","20155705025759-63","1","2021-03-12 14:38:59",1615588739,"C4",3034121,1618622860,"2021-04-16 18:27:40"
