"","car.id","car.type","startDatetime","startTimestamp","gate.name","duration","endTimestamp","endDatetime"
"6384","20155101065139-549",1,"2015-05-01 07:59:00",1430492340,"C0",83460,1430575800,"2015-05-02 07:10:00"
"4751","20153601073650-751",3,"2015-05-01 08:37:00",1430494620,"C2",357420,1430852040,"2015-05-05 11:54:00"
"5307","20153601093644-33",1,"2015-05-01 10:10:00",1430500200,"C3",115320,1430615520,"2015-05-02 18:12:00"
"2357","20155201095259-137",1,"2015-05-01 10:19:00",1430500740,"C8",302820,1430803560,"2015-05-04 22:26:00"
"1990","20155701105733-580",1,"2015-05-01 11:23:00",1430504580,"C5",346500,1430851080,"2015-05-05 11:38:00"
"1987","20154401104416-538",3,"2015-05-01 11:46:00",1430505960,"C2",67680,1430573640,"2015-05-02 06:34:00"
"2732","20155801105820-248",2,"2015-05-01 11:58:00",1430506680,"C5",151500,1430658180,"2015-05-03 06:03:00"
"763","20154001044056-714",3,"2015-05-01 17:44:00",1430527440,"C0",249300,1430776740,"2015-05-04 14:59:00"
"3426","20155401045441-227",2,"2015-05-01 18:06:00",1430528760,"C3",63240,1430592000,"2015-05-02 11:40:00"
"5785","20152102062100-389",2,"2015-05-02 07:34:00",1430577240,"C7",364500,1430941740,"2015-05-06 12:49:00"
"4270","20154002074031-133",1,"2015-05-02 08:36:00",1430580960,"C6",199200,1430780160,"2015-05-04 15:56:00"
"5526","20154702084758-168",1,"2015-05-02 09:10:00",1430583000,"C5",478380,1431061380,"2015-05-07 22:03:00"
"4157","20151902111913-640",3,"2015-05-02 12:09:00",1430593740,"C8",602400,1431196140,"2015-05-09 11:29:00"
"6090","20153002013028-298",3,"2015-05-02 13:57:00",1430600220,"C4",75600,1430675820,"2015-05-03 10:57:00"
"6144","20152602012639-340",3,"2015-05-02 14:09:00",1430600940,"C0",372420,1430973360,"2015-05-06 21:36:00"
"3964","20151202021230-956",2,"2015-05-02 14:41:00",1430602860,"C4",445140,1431048000,"2015-05-07 18:20:00"
"2292","20153602023647-120",2,"2015-05-02 15:43:00",1430606580,"C3",174240,1430780820,"2015-05-04 16:07:00"
"4698","20152002042015-193",3,"2015-05-02 16:43:00",1430610180,"C8",78780,1430688960,"2015-05-03 14:36:00"
"1438","20151903071934-939",1,"2015-05-03 07:30:00",1430663400,"C3",782160,1431445560,"2015-05-12 08:46:00"
"5242","20153603073614-148",1,"2015-05-03 07:56:00",1430664960,"C5",257820,1430922780,"2015-05-06 07:33:00"
"926","20154003074050-280",1,"2015-05-03 08:51:00",1430668260,"C0",944700,1431612960,"2015-05-14 07:16:00"
"1431","20151503091545-22",1,"2015-05-03 09:22:00",1430670120,"C8",679860,1431349980,"2015-05-11 06:13:00"
"1161","20150703110736-237",1,"2015-05-03 11:34:00",1430678040,"C5",241920,1430919960,"2015-05-06 06:46:00"
"3135","20155803105858-900",2,"2015-05-03 11:37:00",1430678220,"C2",201540,1430879760,"2015-05-05 19:36:00"
"4921","20153003023054-91",3,"2015-05-03 15:38:00",1430692680,"C0",83580,1430776260,"2015-05-04 14:51:00"
"6332","20153203033255-977",1,"2015-05-03 15:55:00",1430693700,"C4",190680,1430884380,"2015-05-05 20:53:00"
"5427","20153203033246-681",1,"2015-05-03 16:14:00",1430694840,"C0",75240,1430770080,"2015-05-04 13:08:00"
"3404","20155103035116-592",1,"2015-05-03 16:19:00",1430695140,"C4",970200,1431665340,"2015-05-14 21:49:00"
"2724","20155003035017-260",1,"2015-05-03 16:22:00",1430695320,"C5",91920,1430787240,"2015-05-04 17:54:00"
"6037","20152503032527-873",1,"2015-05-03 16:32:00",1430695920,"C0",240540,1430936460,"2015-05-06 11:21:00"
"107","20155403055431-257",3,"2015-05-03 18:43:00",1430703780,"C7",74400,1430778180,"2015-05-04 15:23:00"
"3469","20153604113610-711",3,"2015-05-04 12:36:00",1430768160,"C8",589140,1431357300,"2015-05-11 08:15:00"
"960","20151604011635-266",2,"2015-05-04 14:16:00",1430774160,"C3",362100,1431136260,"2015-05-08 18:51:00"
"742","20150204020258-450",2,"2015-05-04 15:08:00",1430777280,"C8",363720,1431141000,"2015-05-08 20:10:00"
"1687","20155604035654-479",2,"2015-05-04 16:59:00",1430783940,"C2",153000,1430936940,"2015-05-06 11:29:00"
"6124","20150104050128-43",2,"2015-05-04 17:16:00",1430784960,"C0",601920,1431386880,"2015-05-11 16:28:00"
"2166","20151805061831-133",1,"2015-05-05 07:36:00",1430836560,"C0",567480,1431404040,"2015-05-11 21:14:00"
"1494","20152705082700-328",1,"2015-05-05 08:48:00",1430840880,"C8",214200,1431055080,"2015-05-07 20:18:00"
"2106","20150905090932-101",2,"2015-05-05 09:49:00",1430844540,"C7",351720,1431196260,"2015-05-09 11:31:00"
"5337","20154105104122-644",2,"2015-05-05 11:34:00",1430850840,"C5",292320,1431143160,"2015-05-08 20:46:00"
"3342","20155705125721-407",3,"2015-05-05 13:22:00",1430857320,"C5",423240,1431280560,"2015-05-10 10:56:00"
"5430","20150605040618-478",1,"2015-05-05 17:08:00",1430870880,"C4",333000,1431203880,"2015-05-09 13:38:00"
"5251","20152606062618-786",1,"2015-05-06 06:47:00",1430920020,"C5",314880,1431234900,"2015-05-09 22:15:00"
"6512","20154506074517-446",1,"2015-05-06 08:08:00",1430924880,"C5",278340,1431203220,"2015-05-09 13:27:00"
"1720","20153906013912-384",2,"2015-05-06 13:46:00",1430945160,"C8",1811580,1432756740,"2015-05-27 12:59:00"
"5383","20151006031050-832",1,"2015-05-06 15:26:00",1430951160,"C7",683640,1431634800,"2015-05-14 13:20:00"
"3651","20152807082801-714",1,"2015-05-07 09:04:00",1431014640,"C2",109380,1431124020,"2015-05-08 15:27:00"
"5035","20154407084406-55",3,"2015-05-07 09:08:00",1431014880,"C8",428220,1431443100,"2015-05-12 08:05:00"
"161","20154807104818-336",1,"2015-05-07 10:53:00",1431021180,"C2",94680,1431115860,"2015-05-08 13:11:00"
"2714","20154707104714-7",1,"2015-05-07 11:08:00",1431022080,"C5",453240,1431475320,"2015-05-12 17:02:00"
"3359","20151807111855-648",3,"2015-05-07 11:46:00",1431024360,"C5",363180,1431387540,"2015-05-11 16:39:00"
"947","20152907112958-34",2,"2015-05-07 12:07:00",1431025620,"C2",74280,1431099900,"2015-05-08 08:45:00"
"1801","20153507023544-222",1,"2015-05-07 14:56:00",1431035760,"C7",186840,1431222600,"2015-05-09 18:50:00"
"5777","20150207050247-410",3,"2015-05-07 17:21:00",1431044460,"C6",437520,1431481980,"2015-05-12 18:53:00"
"3567","20151807041812-701",1,"2015-05-07 17:28:00",1431044880,"C3",357000,1431401880,"2015-05-11 20:38:00"
"6425","20151507051530-305",1,"2015-05-07 17:48:00",1431046080,"C8",496320,1431542400,"2015-05-13 11:40:00"
"4376","20152608082640-6",1,"2015-05-08 09:25:00",1431102300,"C5",101640,1431203940,"2015-05-09 13:39:00"
"1964","20155608095633-284",1,"2015-05-08 10:18:00",1431105480,"C5",533040,1431638520,"2015-05-14 14:22:00"
"5330","20153008103024-792",1,"2015-05-08 11:30:00",1431109800,"C4",297300,1431407100,"2015-05-11 22:05:00"
"4780","20155308075334-739",1,"2015-05-08 11:31:00",1431109860,"C4",209220,1431319080,"2015-05-10 21:38:00"
"4401","20154008114008-610",1,"2015-05-08 11:52:00",1431111120,"C3",118020,1431229140,"2015-05-09 20:39:00"
"6253","20154908114938-83",1,"2015-05-08 12:24:00",1431113040,"C6",195240,1431308280,"2015-05-10 18:38:00"
"136","20151308081312-606",1,"2015-05-08 13:42:00",1431117720,"C2",248280,1431366000,"2015-05-11 10:40:00"
"3401","20152908012941-964",2,"2015-05-08 13:51:00",1431118260,"C5",148980,1431267240,"2015-05-10 07:14:00"
"3747","20152708012754-464",2,"2015-05-08 14:11:00",1431119460,"C2",326580,1431446040,"2015-05-12 08:54:00"
"1046","20150608040651-249",2,"2015-05-08 16:41:00",1431128460,"C5",861720,1431990180,"2015-05-18 16:03:00"
"201","20153108053146-433",1,"2015-05-08 18:35:00",1431135300,"C3",93000,1431228300,"2015-05-09 20:25:00"
"4369","20150309080352-837",2,"2015-05-09 08:32:00",1431185520,"C8",300420,1431485940,"2015-05-12 19:59:00"
"4703","20152009082046-820",1,"2015-05-09 09:14:00",1431188040,"C5",183420,1431371460,"2015-05-11 12:11:00"
"1795","20155909085910-596",1,"2015-05-09 09:21:00",1431188460,"C4",2195340,1433383800,"2015-06-03 19:10:00"
"4586","20151709091702-944",1,"2015-05-09 10:08:00",1431191280,"C4",727080,1431918360,"2015-05-17 20:06:00"
"941","20150309100312-290",1,"2015-05-09 10:28:00",1431192480,"C4",178020,1431370500,"2015-05-11 11:55:00"
"2991","20153109123109-53",1,"2015-05-09 13:13:00",1431202380,"C2",111480,1431313860,"2015-05-10 20:11:00"
"6002","20155809125852-460",2,"2015-05-09 13:31:00",1431203460,"C0",358740,1431562200,"2015-05-13 17:10:00"
"1630","20152209012245-920",2,"2015-05-09 13:53:00",1431204780,"C0",276180,1431480960,"2015-05-12 18:36:00"
"4799","20155509125554-329",2,"2015-05-09 14:01:00",1431205260,"C8",145620,1431350880,"2015-05-11 06:28:00"
"2743","20152309042350-396",2,"2015-05-09 17:00:00",1431216000,"C7",102720,1431318720,"2015-05-10 21:32:00"
"1139","20155009055024-626",2,"2015-05-09 17:53:00",1431219180,"C6",353760,1431572940,"2015-05-13 20:09:00"
"5822","20150409050412-493",2,"2015-05-09 18:10:00",1431220200,"C2",142620,1431362820,"2015-05-11 09:47:00"
"2868","20155910065938-444",1,"2015-05-10 07:06:00",1431266760,"C8",101700,1431368460,"2015-05-11 11:21:00"
"4700","20154510064550-279",2,"2015-05-10 07:20:00",1431267600,"C3",175200,1431442800,"2015-05-12 08:00:00"
"1558","20151810071802-340",2,"2015-05-10 07:46:00",1431269160,"C4",277020,1431546180,"2015-05-13 12:43:00"
"2168","20150910080953-624",2,"2015-05-10 08:37:00",1431272220,"C5",198600,1431470820,"2015-05-12 15:47:00"
"5615","20150410110411-548",1,"2015-05-10 11:06:00",1431281160,"C6",195600,1431476760,"2015-05-12 17:26:00"
"4673","20153010103013-306",2,"2015-05-10 11:08:00",1431281280,"C2",110820,1431392100,"2015-05-11 17:55:00"
"3844","20154410124411-337",1,"2015-05-10 13:52:00",1431291120,"C0",172140,1431463260,"2015-05-12 13:41:00"
"5474","20153410023431-149",3,"2015-05-10 15:45:00",1431297900,"C6",146760,1431444660,"2015-05-12 08:31:00"
"795","20150911060947-468",3,"2015-05-11 06:43:00",1431351780,"C8",273060,1431624840,"2015-05-14 10:34:00"
"1652","20155911075946-694",2,"2015-05-11 08:36:00",1431358560,"C7",193980,1431552540,"2015-05-13 14:29:00"
"122","20154911084948-971",3,"2015-05-11 09:31:00",1431361860,"C0",113940,1431475800,"2015-05-12 17:10:00"
"2040","20153311093300-612",1,"2015-05-11 09:39:00",1431362340,"C4",360600,1431722940,"2015-05-15 13:49:00"
"1371","20155411105423-23",2,"2015-05-11 11:38:00",1431369480,"C8",162060,1431531540,"2015-05-13 08:39:00"
"5847","20154011114039-253",1,"2015-05-11 12:03:00",1431370980,"C5",949380,1432320360,"2015-05-22 11:46:00"
"2559","20152411112403-168",1,"2015-05-11 12:33:00",1431372780,"C8",1043520,1432416300,"2015-05-23 14:25:00"
"2482","20152011032039-149",1,"2015-05-11 16:06:00",1431385560,"C8",182340,1431567900,"2015-05-13 18:45:00"
"3853","20154211054209-984",2,"2015-05-11 18:53:00",1431395580,"C0",406620,1431802200,"2015-05-16 11:50:00"
"5357","20151412071422-498",1,"2015-05-12 08:12:00",1431443520,"C2",285960,1431729480,"2015-05-15 15:38:00"
"931","20153912113932-996",2,"2015-05-12 11:54:00",1431456840,"C7",123660,1431580500,"2015-05-13 22:15:00"
"4508","20150412120454-71",1,"2015-05-12 12:39:00",1431459540,"C6",83940,1431543480,"2015-05-13 11:58:00"
"5634","20152712012750-549",1,"2015-05-12 13:30:00",1431462600,"C6",543120,1432005720,"2015-05-18 20:22:00"
"1787","20151812011836-943",1,"2015-05-12 14:20:00",1431465600,"C7",257040,1431722640,"2015-05-15 13:44:00"
"2512","20155812035804-861",1,"2015-05-12 16:15:00",1431472500,"C7",524280,1431996780,"2015-05-18 17:53:00"
"6388","20151312041350-13",2,"2015-05-12 16:35:00",1431473700,"C5",240480,1431714180,"2015-05-15 11:23:00"
"3948","20151312051315-26",2,"2015-05-12 17:19:00",1431476340,"C8",89580,1431565920,"2015-05-13 18:12:00"
"5382","20151112051139-269",3,"2015-05-12 18:02:00",1431478920,"C4",92280,1431571200,"2015-05-13 19:40:00"
"4594","20154612054651-827",2,"2015-05-12 18:07:00",1431479220,"C5",750120,1432229340,"2015-05-21 10:29:00"
"3492","20155612055615-47",3,"2015-05-12 18:59:00",1431482340,"C5",484980,1431967320,"2015-05-18 09:42:00"
"2117","20155313065344-641",1,"2015-05-13 07:46:00",1431528360,"C5",104100,1431632460,"2015-05-14 12:41:00"
"3411","20152813082845-836",1,"2015-05-13 09:11:00",1431533460,"C2",165480,1431698940,"2015-05-15 07:09:00"
"2148","20151613111653-93",1,"2015-05-13 12:17:00",1431544620,"C7",461880,1432006500,"2015-05-18 20:35:00"
"2956","20154913014902-715",2,"2015-05-13 14:25:00",1431552300,"C0",505980,1432058280,"2015-05-19 10:58:00"
"384","20151613031640-694",1,"2015-05-13 16:23:00",1431559380,"C5",353940,1431913320,"2015-05-17 18:42:00"
"4944","20150413050443-129",2,"2015-05-13 17:33:00",1431563580,"C5",314880,1431878460,"2015-05-17 09:01:00"
"3460","20154713054724-651",1,"2015-05-13 18:24:00",1431566640,"C2",49380,1431616020,"2015-05-14 08:07:00"
"423","20153514093535-484",1,"2015-05-14 09:43:00",1431621780,"C8",466620,1432088400,"2015-05-19 19:20:00"
"1172","20153114093106-881",1,"2015-05-14 10:00:00",1431622800,"C5",180720,1431803520,"2015-05-16 12:12:00"
"1940","20153314113313-788",3,"2015-05-14 11:39:00",1431628740,"C2",70560,1431699300,"2015-05-15 07:15:00"
"6088","20154314114311-549",2,"2015-05-14 12:42:00",1431632520,"C2",336540,1431969060,"2015-05-18 10:11:00"
"2434","20154514124545-947",1,"2015-05-14 13:39:00",1431635940,"C5",501600,1432137540,"2015-05-20 08:59:00"
"6264","20154414124412-684",1,"2015-05-14 13:51:00",1431636660,"C6",450660,1432087320,"2015-05-19 19:02:00"
"6448","20153014023000-132",2,"2015-05-14 14:53:00",1431640380,"C5",58200,1431698580,"2015-05-15 07:03:00"
"4522","20155414015450-986",1,"2015-05-14 14:58:00",1431640680,"C3",54660,1431695340,"2015-05-15 06:09:00"
"6091","20152114052147-25",2,"2015-05-14 17:58:00",1431651480,"C3",184140,1431835620,"2015-05-16 21:07:00"
"5089","20151015061023-821",1,"2015-05-15 07:08:00",1431698880,"C4",467220,1432166100,"2015-05-20 16:55:00"
"6554","20153215073237-222",3,"2015-05-15 07:55:00",1431701700,"C5",253920,1431955620,"2015-05-18 06:27:00"
"1767","20152615072606-62",2,"2015-05-15 08:21:00",1431703260,"C5",136260,1431839520,"2015-05-16 22:12:00"
"1251","20154215074223-266",1,"2015-05-15 08:28:00",1431703680,"C8",114720,1431818400,"2015-05-16 16:20:00"
"1204","20150115090150-109",2,"2015-05-15 10:00:00",1431709200,"C8",123840,1431833040,"2015-05-16 20:24:00"
"2446","20151415091432-219",2,"2015-05-15 10:28:00",1431710880,"C7",127980,1431838860,"2015-05-16 22:01:00"
"3039","20153615103638-158",3,"2015-05-15 11:11:00",1431713460,"C2",298560,1432012020,"2015-05-18 22:07:00"
"4264","20155815125820-398",1,"2015-05-15 13:30:00",1431721800,"C4",617340,1432339140,"2015-05-22 16:59:00"
"2386","20150115010107-702",2,"2015-05-15 13:59:00",1431723540,"C2",74880,1431798420,"2015-05-16 10:47:00"
"1710","20152815032843-542",3,"2015-05-15 15:53:00",1431730380,"C5",787080,1432517460,"2015-05-24 18:31:00"
"5269","20155115055136-775",1,"2015-05-15 18:53:00",1431741180,"C6",481980,1432223160,"2015-05-21 08:46:00"
"6119","20152016092004-862",2,"2015-05-16 09:40:00",1431794400,"C5",282720,1432077120,"2015-05-19 16:12:00"
"2619","20155016105014-878",2,"2015-05-16 11:11:00",1431799860,"C6",266640,1432066500,"2015-05-19 13:15:00"
"2290","20150516120527-450",2,"2015-05-16 12:57:00",1431806220,"C4",120240,1431926460,"2015-05-17 22:21:00"
"6065","20155516015501-914",2,"2015-05-16 14:00:00",1431810000,"C2",169260,1431979260,"2015-05-18 13:01:00"
"2094","20150416040445-103",1,"2015-05-16 16:14:00",1431818040,"C3",242940,1432060980,"2015-05-19 11:43:00"
"340","20153316033329-899",2,"2015-05-16 16:22:00",1431818520,"C8",183360,1432001880,"2015-05-18 19:18:00"
"1482","20152816052835-878",1,"2015-05-16 17:55:00",1431824100,"C5",139740,1431963840,"2015-05-18 08:44:00"
"6382","20153417063456-447",3,"2015-05-17 07:26:00",1431872760,"C5",82140,1431954900,"2015-05-18 06:15:00"
"1619","20155417065430-542",1,"2015-05-17 07:46:00",1431873960,"C8",475260,1432349220,"2015-05-22 19:47:00"
"3074","20151617071647-820",3,"2015-05-17 07:49:00",1431874140,"C2",275580,1432149720,"2015-05-20 12:22:00"
"3061","20155417065446-3",3,"2015-05-17 07:52:00",1431874320,"C8",123180,1431997500,"2015-05-18 18:05:00"
"25","20152917072906-13",2,"2015-05-17 08:04:00",1431875040,"C3",526800,1432401840,"2015-05-23 10:24:00"
"6039","20151017091042-992",1,"2015-05-17 09:13:00",1431879180,"C6",133560,1432012740,"2015-05-18 22:19:00"
"924","20155517095500-40",1,"2015-05-17 10:02:00",1431882120,"C8",176940,1432059060,"2015-05-19 11:11:00"
"3725","20150617090658-734",1,"2015-05-17 10:13:00",1431882780,"C0",197040,1432079820,"2015-05-19 16:57:00"
"4580","20151717101752-508",1,"2015-05-17 10:44:00",1431884640,"C5",252000,1432136640,"2015-05-20 08:44:00"
"3179","20150817100809-138",2,"2015-05-17 11:12:00",1431886320,"C3",81060,1431967380,"2015-05-18 09:43:00"
"5455","20150317010343-76",2,"2015-05-17 13:34:00",1431894840,"C4",156720,1432051560,"2015-05-19 09:06:00"
"2153","20150117010157-104",2,"2015-05-17 14:00:00",1431896400,"C4",180000,1432076400,"2015-05-19 16:00:00"
"1769","20153817023856-742",2,"2015-05-17 15:02:00",1431900120,"C8",74940,1431975060,"2015-05-18 11:51:00"
"406","20155517035538-277",1,"2015-05-17 16:57:00",1431907020,"C0",324180,1432231200,"2015-05-21 11:00:00"
"1026","20155717055748-249",1,"2015-05-17 18:59:00",1431914340,"C4",73140,1431987480,"2015-05-18 15:18:00"
"5141","20153618073639-900",1,"2015-05-18 08:03:00",1431961380,"C4",197220,1432158600,"2015-05-20 14:50:00"
"1497","20150818010852-458",1,"2015-05-18 13:38:00",1431981480,"C3",118800,1432100280,"2015-05-19 22:38:00"
"2327","20152018052046-592",1,"2015-05-18 17:42:00",1431996120,"C4",102060,1432098180,"2015-05-19 22:03:00"
"2047","20152019082054-582",2,"2015-05-19 09:25:00",1432052700,"C4",514080,1432566780,"2015-05-25 08:13:00"
"5274","20152919092946-526",1,"2015-05-19 09:37:00",1432053420,"C4",962460,1433015880,"2015-05-30 12:58:00"
"1143","20151319101335-59",2,"2015-05-19 10:48:00",1432057680,"C0",86340,1432144020,"2015-05-20 10:47:00"
"1844","20150419110442-824",3,"2015-05-19 12:04:00",1432062240,"C3",87780,1432150020,"2015-05-20 12:27:00"
"260","20153719023744-10",1,"2015-05-19 15:03:00",1432072980,"C5",370320,1432443300,"2015-05-23 21:55:00"
"3727","20155719035725-878",1,"2015-05-19 16:05:00",1432076700,"C4",250560,1432327260,"2015-05-22 13:41:00"
"4904","20150719050740-812",1,"2015-05-19 17:41:00",1432082460,"C2",774480,1432856940,"2015-05-28 16:49:00"
"2545","20155519055512-566",1,"2015-05-19 18:12:00",1432084320,"C6",59700,1432144020,"2015-05-20 10:47:00"
"496","20153620073655-119",1,"2015-05-20 08:07:00",1432134420,"C8",282240,1432416660,"2015-05-23 14:31:00"
"1581","20150820080854-186",1,"2015-05-20 08:37:00",1432136220,"C5",441000,1432577220,"2015-05-25 11:07:00"
"6025","20154820084851-636",3,"2015-05-20 09:11:00",1432138260,"C5",126540,1432264800,"2015-05-21 20:20:00"
"5022","20154820094833-789",1,"2015-05-20 10:51:00",1432144260,"C5",125820,1432270080,"2015-05-21 21:48:00"
"4089","20153120113117-670",2,"2015-05-20 12:21:00",1432149660,"C4",499980,1432649640,"2015-05-26 07:14:00"
"3674","20150020030052-644",2,"2015-05-20 15:07:00",1432159620,"C4",66840,1432226460,"2015-05-21 09:41:00"
"2777","20154620024622-348",2,"2015-05-20 15:17:00",1432160220,"C8",447060,1432607280,"2015-05-25 19:28:00"
"1715","20152120032144-608",2,"2015-05-20 15:52:00",1432162320,"C5",426480,1432588800,"2015-05-25 14:20:00"
"2181","20155020035009-541",3,"2015-05-20 15:55:00",1432162500,"C2",614760,1432777260,"2015-05-27 18:41:00"
"3516","20155520035557-954",1,"2015-05-20 17:09:00",1432166940,"C7",585120,1432752060,"2015-05-27 11:41:00"
"4726","20155020055005-112",1,"2015-05-20 18:49:00",1432172940,"C0",53820,1432226760,"2015-05-21 09:46:00"
"1573","20150621060618-266",3,"2015-05-21 06:13:00",1432213980,"C8",221640,1432435620,"2015-05-23 19:47:00"
"2698","20155221085210-381",2,"2015-05-21 08:59:00",1432223940,"C4",274740,1432498680,"2015-05-24 13:18:00"
"234","20150821090834-726",2,"2015-05-21 09:15:00",1432224900,"C8",273540,1432498440,"2015-05-24 13:14:00"
"4704","20151121091142-55",2,"2015-05-21 09:33:00",1432225980,"C8",268740,1432494720,"2015-05-24 12:12:00"
"3362","20154321084329-326",3,"2015-05-21 09:37:00",1432226220,"C8",193140,1432419360,"2015-05-23 15:16:00"
"2849","20151521111559-556",2,"2015-05-21 11:42:00",1432233720,"C4",251520,1432485240,"2015-05-24 09:34:00"
"2015","20151521011559-569",2,"2015-05-21 13:26:00",1432239960,"C3",270720,1432510680,"2015-05-24 16:38:00"
"6506","20152421032440-973",1,"2015-05-21 16:18:00",1432250280,"C5",91140,1432341420,"2015-05-22 17:37:00"
"4406","20154222064254-555",1,"2015-05-22 07:12:00",1432303920,"C3",354540,1432658460,"2015-05-26 09:41:00"
"521","20153622093615-832",1,"2015-05-22 10:12:00",1432314720,"C2",78780,1432393500,"2015-05-23 08:05:00"
"5560","20151822101852-375",3,"2015-05-22 10:27:00",1432315620,"C4",472680,1432788300,"2015-05-27 21:45:00"
"1093","20154822094857-448",2,"2015-05-22 10:32:00",1432315920,"C8",1160220,1433476140,"2015-06-04 20:49:00"
"4889","20150722110719-792",1,"2015-05-22 12:09:00",1432321740,"C2",118740,1432440480,"2015-05-23 21:08:00"
"5967","20153622113653-407",1,"2015-05-22 12:20:00",1432322400,"C8",249720,1432572120,"2015-05-25 09:42:00"
"422","20153422113416-107",1,"2015-05-22 12:39:00",1432323540,"C3",438540,1432762080,"2015-05-27 14:28:00"
"5873","20153622123619-566",2,"2015-05-22 13:34:00",1432326840,"C0",69240,1432396080,"2015-05-23 08:48:00"
"3350","20155322125316-320",2,"2015-05-22 13:54:00",1432328040,"C2",78120,1432406160,"2015-05-23 11:36:00"
"2721","20155422015444-143",2,"2015-05-22 14:17:00",1432329420,"C8",82920,1432412340,"2015-05-23 13:19:00"
"524","20152022032029-340",1,"2015-05-22 15:22:00",1432333320,"C6",103140,1432436460,"2015-05-23 20:01:00"
"4761","20155222025248-836",1,"2015-05-22 15:23:00",1432333380,"C8",423540,1432756920,"2015-05-27 13:02:00"
"663","20155922025905-519",2,"2015-05-22 15:32:00",1432333920,"C4",656940,1432990860,"2015-05-30 06:01:00"
"1169","20151422031406-22",1,"2015-05-22 15:34:00",1432334040,"C5",488520,1432822560,"2015-05-28 07:16:00"
"5179","20155522035520-589",2,"2015-05-22 16:47:00",1432338420,"C5",65340,1432403760,"2015-05-23 10:56:00"
"2205","20151022041004-148",1,"2015-05-22 17:02:00",1432339320,"C5",182520,1432521840,"2015-05-24 19:44:00"
"3145","20155622035604-568",2,"2015-05-22 17:02:00",1432339320,"C3",168480,1432507800,"2015-05-24 15:50:00"
"4783","20154823064844-637",2,"2015-05-23 07:21:00",1432390860,"C0",182640,1432573500,"2015-05-25 10:05:00"
"1071","20150823070821-824",2,"2015-05-23 07:42:00",1432392120,"C3",453420,1432845540,"2015-05-28 13:39:00"
"535","20155023065015-612",3,"2015-05-23 08:06:00",1432393560,"C2",126660,1432520220,"2015-05-24 19:17:00"
"3156","20152423082429-73",3,"2015-05-23 08:54:00",1432396440,"C4",178740,1432575180,"2015-05-25 10:33:00"
"2874","20154023084059-267",2,"2015-05-23 09:03:00",1432396980,"C5",168120,1432565100,"2015-05-25 07:45:00"
"21","20152923082949-398",1,"2015-05-23 09:21:00",1432398060,"C5",186480,1432584540,"2015-05-25 13:09:00"
"958","20152623092639-730",1,"2015-05-23 10:28:00",1432402080,"C2",245580,1432647660,"2015-05-26 06:41:00"
"4841","20154423124442-224",2,"2015-05-23 13:24:00",1432412640,"C7",623220,1433035860,"2015-05-30 18:31:00"
"506","20152923012904-916",3,"2015-05-23 13:52:00",1432414320,"C5",761100,1433175420,"2015-06-01 09:17:00"
"3016","20150123020103-717",2,"2015-05-23 14:08:00",1432415280,"C8",526320,1432941600,"2015-05-29 16:20:00"
"5301","20152323032339-44",2,"2015-05-23 15:57:00",1432421820,"C2",243780,1432665600,"2015-05-26 11:40:00"
"1822","20152823042801-343",1,"2015-05-23 16:34:00",1432424040,"C2",627420,1433051460,"2015-05-30 22:51:00"
"2500","20153023033057-365",1,"2015-05-23 16:40:00",1432424400,"C2",87780,1432512180,"2015-05-24 17:03:00"
"5728","20152523042522-538",3,"2015-05-23 17:22:00",1432426920,"C4",86820,1432513740,"2015-05-24 17:29:00"
"3979","20151924061922-35",1,"2015-05-24 06:35:00",1432474500,"C7",225000,1432699500,"2015-05-26 21:05:00"
"1201","20150324080316-784",1,"2015-05-24 08:10:00",1432480200,"C4",207660,1432687860,"2015-05-26 17:51:00"
"2184","20150624080656-470",1,"2015-05-24 08:13:00",1432480380,"C8",864420,1433344800,"2015-06-03 08:20:00"
"1548","20150124080152-145",1,"2015-05-24 08:56:00",1432482960,"C6",287640,1432770600,"2015-05-27 16:50:00"
"6095","20154824104802-646",3,"2015-05-24 11:37:00",1432492620,"C7",350400,1432843020,"2015-05-28 12:57:00"
"4028","20152924102954-975",1,"2015-05-24 11:44:00",1432493040,"C7",1071720,1433564760,"2015-06-05 21:26:00"
"1633","20155824115842-88",2,"2015-05-24 12:31:00",1432495860,"C6",261480,1432757340,"2015-05-27 13:09:00"
"213","20155724025730-431",1,"2015-05-24 15:18:00",1432505880,"C6",441840,1432947720,"2015-05-29 18:02:00"
"5899","20151324031316-217",1,"2015-05-24 15:37:00",1432507020,"C8",100440,1432607460,"2015-05-25 19:31:00"
"6482","20152924032915-517",1,"2015-05-24 16:19:00",1432509540,"C6",282780,1432792320,"2015-05-27 22:52:00"
"1675","20153024043021-679",1,"2015-05-24 17:15:00",1432512900,"C6",176280,1432689180,"2015-05-26 18:13:00"
"2976","20153024043032-864",1,"2015-05-24 17:26:00",1432513560,"C3",50160,1432563720,"2015-05-25 07:22:00"
"4782","20151025101044-367",1,"2015-05-25 11:04:00",1432577040,"C5",110880,1432687920,"2015-05-26 17:52:00"
"4121","20153725123729-641",1,"2015-05-25 13:08:00",1432584480,"C2",277860,1432862340,"2015-05-28 18:19:00"
"5980","20152625012610-60",1,"2015-05-25 13:40:00",1432586400,"C0",590040,1433176440,"2015-06-01 09:34:00"
"5121","20154625034642-17",3,"2015-05-25 16:46:00",1432597560,"C2",359880,1432957440,"2015-05-29 20:44:00"
"1440","20152025052053-433",2,"2015-05-25 17:22:00",1432599720,"C6",51420,1432651140,"2015-05-26 07:39:00"
"6426","20153426063448-128",3,"2015-05-26 06:51:00",1432648260,"C0",104580,1432752840,"2015-05-27 11:54:00"
"4193","20155926065906-435",1,"2015-05-26 07:25:00",1432650300,"C5",216900,1432867200,"2015-05-28 19:40:00"
"172","20154026084019-504",1,"2015-05-26 08:47:00",1432655220,"C8",256320,1432911540,"2015-05-29 07:59:00"
"82","20150526090547-123",3,"2015-05-26 09:18:00",1432657080,"C3",345120,1433002200,"2015-05-30 09:10:00"
"5209","20154926084915-416",2,"2015-05-26 09:39:00",1432658340,"C8",467460,1433125800,"2015-05-31 19:30:00"
"2658","20152026112029-817",1,"2015-05-26 12:26:00",1432668360,"C2",168240,1432836600,"2015-05-28 11:10:00"
"2511","20153226123245-963",1,"2015-05-26 12:46:00",1432669560,"C7",520500,1433190060,"2015-06-01 13:21:00"
"1895","20151126011144-948",2,"2015-05-26 14:15:00",1432674900,"C5",116160,1432791060,"2015-05-27 22:31:00"
"4446","20154126024152-89",1,"2015-05-26 15:12:00",1432678320,"C4",361860,1433040180,"2015-05-30 19:43:00"
"2824","20151026031053-559",1,"2015-05-26 15:59:00",1432681140,"C7",103800,1432784940,"2015-05-27 20:49:00"
"4300","20153227063240-542",1,"2015-05-27 06:56:00",1432734960,"C7",522960,1433257920,"2015-06-02 08:12:00"
"205","20155927065901-324",1,"2015-05-27 07:28:00",1432736880,"C4",272400,1433009280,"2015-05-30 11:08:00"
"5749","20153927083939-140",1,"2015-05-27 09:03:00",1432742580,"C8",100560,1432843140,"2015-05-28 12:59:00"
"1275","20150027100037-189",2,"2015-05-27 11:01:00",1432749660,"C5",126420,1432876080,"2015-05-28 22:08:00"
"5401","20155227105245-707",2,"2015-05-27 11:21:00",1432750860,"C8",114300,1432865160,"2015-05-28 19:06:00"
"196","20151627121622-355",1,"2015-05-27 13:16:00",1432757760,"C8",110100,1432867860,"2015-05-28 19:51:00"
"334","20152227022219-923",1,"2015-05-27 14:47:00",1432763220,"C5",250200,1433013420,"2015-05-30 12:17:00"
"5225","20151328121327-774",1,"2015-05-28 12:40:00",1432842000,"C8",115680,1432957680,"2015-05-29 20:48:00"
"2579","20155228125229-86",3,"2015-05-28 14:10:00",1432847400,"C0",261120,1433108520,"2015-05-31 14:42:00"
"288","20150028030041-325",1,"2015-05-28 15:56:00",1432853760,"C6",449940,1433303700,"2015-06-02 20:55:00"
"4935","20150028040010-50",3,"2015-05-28 16:23:00",1432855380,"C4",149220,1433004600,"2015-05-30 09:50:00"
"4651","20151928041922-215",3,"2015-05-28 16:53:00",1432857180,"C4",193860,1433051040,"2015-05-30 22:44:00"
"4024","20150929070904-711",2,"2015-05-29 07:20:00",1432909200,"C3",273600,1433182800,"2015-06-01 11:20:00"
"2192","20151029071053-279",1,"2015-05-29 07:42:00",1432910520,"C5",106140,1433016660,"2015-05-30 13:11:00"
"710","20153029093029-8",2,"2015-05-29 09:35:00",1432917300,"C2",286620,1433203920,"2015-06-01 17:12:00"
"1530","20154129084107-872",1,"2015-05-29 09:41:00",1432917660,"C0",84780,1433002440,"2015-05-30 09:14:00"
"4067","20154729084718-7",2,"2015-05-29 09:53:00",1432918380,"C7",210960,1433129340,"2015-05-31 20:29:00"
"3652","20152029102006-584",3,"2015-05-29 10:55:00",1432922100,"C6",213180,1433135280,"2015-05-31 22:08:00"
"5365","20152729102731-508",1,"2015-05-29 11:11:00",1432923060,"C8",274380,1433197440,"2015-06-01 15:24:00"
"1660","20152729112721-705",2,"2015-05-29 12:02:00",1432926120,"C6",713760,1433639880,"2015-06-06 18:18:00"
"2766","20151029121011-173",1,"2015-05-29 13:16:00",1432930560,"C2",89340,1433019900,"2015-05-30 14:05:00"
"6193","20151329121310-651",2,"2015-05-29 13:20:00",1432930800,"C0",103560,1433034360,"2015-05-30 18:06:00"
"5125","20155629125653-788",2,"2015-05-29 14:02:00",1432933320,"C4",594420,1433527740,"2015-06-05 11:09:00"
"2374","20150329010340-772",2,"2015-05-29 14:05:00",1432933500,"C3",272700,1433206200,"2015-06-01 17:50:00"
"5538","20153829013822-10",1,"2015-05-29 14:09:00",1432933740,"C2",331680,1433265420,"2015-06-02 10:17:00"
"3740","20155329045346-171",1,"2015-05-29 17:17:00",1432945020,"C5",49140,1432994160,"2015-05-30 06:56:00"
"1414","20150030060046-176",3,"2015-05-30 06:26:00",1432992360,"C5",307740,1433300100,"2015-06-02 19:55:00"
"5359","20154230064213-204",3,"2015-05-30 07:10:00",1432995000,"C4",82560,1433077560,"2015-05-31 06:06:00"
"6517","20155930075904-615",2,"2015-05-30 08:12:00",1432998720,"C7",84300,1433083020,"2015-05-31 07:37:00"
"97","20154130084155-739",2,"2015-05-30 09:14:00",1433002440,"C4",118920,1433121360,"2015-05-31 18:16:00"
"1858","20155930095901-918",1,"2015-05-30 11:00:00",1433008800,"C2",437820,1433446620,"2015-06-04 12:37:00"
"3399","20155130115135-673",1,"2015-05-30 12:26:00",1433013960,"C2",116880,1433130840,"2015-05-31 20:54:00"
"1602","20153730113759-10",3,"2015-05-30 12:36:00",1433014560,"C5",101760,1433116320,"2015-05-31 16:52:00"
"2931","20155630025632-929",2,"2015-05-30 15:30:00",1433025000,"C2",155820,1433180820,"2015-06-01 10:47:00"
"1","20152930032938-338",1,"2015-05-30 16:19:00",1433027940,"C8",243660,1433271600,"2015-06-02 12:00:00"
"1131","20152231072249-788",2,"2015-05-31 07:40:00",1433083200,"C6",112920,1433196120,"2015-06-01 15:02:00"
"3503","20151431071428-170",1,"2015-05-31 07:49:00",1433083740,"C2",345300,1433429040,"2015-06-04 07:44:00"
"1916","20152731112735-564",1,"2015-05-31 11:42:00",1433097720,"C7",350760,1433448480,"2015-06-04 13:08:00"
"2854","20152031112006-199",3,"2015-05-31 11:45:00",1433097900,"C5",427260,1433525160,"2015-06-05 10:26:00"
"2154","20151431111405-813",1,"2015-05-31 11:47:00",1433098020,"C0",69480,1433167500,"2015-06-01 07:05:00"
"5701","20153031113006-452",1,"2015-05-31 12:33:00",1433100780,"C8",90600,1433191380,"2015-06-01 13:43:00"
"2959","20153831123814-376",2,"2015-05-31 13:21:00",1433103660,"C2",196260,1433299920,"2015-06-02 19:52:00"
"1031","20153831033841-860",1,"2015-05-31 15:59:00",1433113140,"C5",495480,1433608620,"2015-06-06 09:37:00"
"6375","20150231050204-372",2,"2015-05-31 17:59:00",1433120340,"C8",357540,1433477880,"2015-06-04 21:18:00"
"5815","20153801063806-347",1,"2015-06-01 06:43:00",1433166180,"C2",1322760,1434488940,"2015-06-16 14:09:00"
"5593","20150501060550-176",3,"2015-06-01 07:10:00",1433167800,"C6",353340,1433521140,"2015-06-05 09:19:00"
"2896","20151801061858-931",1,"2015-06-01 07:15:00",1433168100,"C3",283680,1433451780,"2015-06-04 14:03:00"
"2304","20151201071206-107",3,"2015-06-01 08:10:00",1433171400,"C8",221160,1433392560,"2015-06-03 21:36:00"
"2128","20150201080212-913",2,"2015-06-01 09:05:00",1433174700,"C5",204720,1433379420,"2015-06-03 17:57:00"
"2227","20155301085312-76",1,"2015-06-01 09:19:00",1433175540,"C4",349560,1433525100,"2015-06-05 10:25:00"
"5585","20151201081219-907",2,"2015-06-01 09:20:00",1433175600,"C6",216300,1433391900,"2015-06-03 21:25:00"
"1702","20155501085548-717",2,"2015-06-01 09:26:00",1433175960,"C2",199320,1433375280,"2015-06-03 16:48:00"
"6179","20155301085317-34",1,"2015-06-01 09:37:00",1433176620,"C8",189720,1433366340,"2015-06-03 14:19:00"
"2176","20153601093619-939",1,"2015-06-01 10:30:00",1433179800,"C8",245280,1433425080,"2015-06-04 06:38:00"
"565","20155801095814-110",2,"2015-06-01 10:49:00",1433180940,"C4",114480,1433295420,"2015-06-02 18:37:00"
"3344","20152801112857-221",3,"2015-06-01 12:06:00",1433185560,"C3",167400,1433352960,"2015-06-03 10:36:00"
"4739","20151701121746-803",1,"2015-06-01 13:20:00",1433190000,"C6",325740,1433515740,"2015-06-05 07:49:00"
"6289","20151401011424-950",1,"2015-06-01 13:37:00",1433191020,"C8",259380,1433450400,"2015-06-04 13:40:00"
"997","20154701124730-552",1,"2015-06-01 13:44:00",1433191440,"C4",324540,1433515980,"2015-06-05 07:53:00"
"3272","20155501015552-358",1,"2015-06-01 14:23:00",1433193780,"C4",403140,1433596920,"2015-06-06 06:22:00"
"2727","20155801025816-705",2,"2015-06-01 15:21:00",1433197260,"C5",100380,1433297640,"2015-06-02 19:14:00"
"2779","20151201031215-712",1,"2015-06-01 15:37:00",1433198220,"C7",73920,1433272140,"2015-06-02 12:09:00"
"1037","20151601031653-102",1,"2015-06-01 15:38:00",1433198280,"C7",85620,1433283900,"2015-06-02 15:25:00"
"5283","20152501032517-581",2,"2015-06-01 15:49:00",1433198940,"C5",261840,1433460780,"2015-06-04 16:33:00"
"1880","20152901032906-564",1,"2015-06-01 16:03:00",1433199780,"C8",54180,1433253960,"2015-06-02 07:06:00"
"1923","20152201042213-827",1,"2015-06-01 17:27:00",1433204820,"C5",341820,1433546640,"2015-06-05 16:24:00"
"381","20153801053802-368",2,"2015-06-01 18:04:00",1433207040,"C4",262500,1433469540,"2015-06-04 18:59:00"
"5559","20154302064319-564",2,"2015-06-02 06:54:00",1433253240,"C3",121200,1433374440,"2015-06-03 16:34:00"
"982","20153502063548-280",1,"2015-06-02 07:01:00",1433253660,"C4",100680,1433354340,"2015-06-03 10:59:00"
"2370","20153402063455-599",1,"2015-06-02 07:04:00",1433253840,"C2",197400,1433451240,"2015-06-04 13:54:00"
"2642","20155202065231-630",1,"2015-06-02 07:14:00",1433254440,"C7",530040,1433784480,"2015-06-08 10:28:00"
"2669","20154102064127-486",2,"2015-06-02 07:16:00",1433254560,"C3",141780,1433396340,"2015-06-03 22:39:00"
"3150","20151202071233-557",1,"2015-06-02 07:35:00",1433255700,"C4",268980,1433524680,"2015-06-05 10:18:00"
"5456","20150002070024-376",2,"2015-06-02 07:36:00",1433255760,"C0",302100,1433557860,"2015-06-05 19:31:00"
"3197","20155802065857-168",2,"2015-06-02 07:49:00",1433256540,"C8",201840,1433458380,"2015-06-04 15:53:00"
"27","20154602084650-633",1,"2015-06-02 09:15:00",1433261700,"C8",597000,1433858700,"2015-06-09 07:05:00"
"841","20151102091154-662",2,"2015-06-02 09:17:00",1433261820,"C2",339120,1433600940,"2015-06-06 07:29:00"
"310","20152302082313-686",1,"2015-06-02 09:36:00",1433262960,"C2",106440,1433369400,"2015-06-03 15:10:00"
"1390","20154502084556-629",2,"2015-06-02 09:37:00",1433263020,"C4",258480,1433521500,"2015-06-05 09:25:00"
"1758","20155402085412-825",1,"2015-06-02 09:52:00",1433263920,"C6",295560,1433559480,"2015-06-05 19:58:00"
"3586","20155102095112-902",3,"2015-06-02 10:26:00",1433265960,"C0",79140,1433345100,"2015-06-03 08:25:00"
"2236","20152202102255-946",1,"2015-06-02 10:41:00",1433266860,"C0",473700,1433740560,"2015-06-07 22:16:00"
"4481","20150102100120-757",2,"2015-06-02 11:01:00",1433268060,"C5",127740,1433395800,"2015-06-03 22:30:00"
"1223","20153002103029-92",2,"2015-06-02 11:03:00",1433268180,"C4",122940,1433391120,"2015-06-03 21:12:00"
"5863","20155902105925-30",3,"2015-06-02 11:27:00",1433269620,"C5",167040,1433436660,"2015-06-04 09:51:00"
"2685","20152802112850-57",1,"2015-06-02 11:35:00",1433270100,"C4",94860,1433364960,"2015-06-03 13:56:00"
"3036","20154102114109-572",2,"2015-06-02 11:47:00",1433270820,"C8",165480,1433436300,"2015-06-04 09:45:00"
"4884","20152602112608-911",2,"2015-06-02 11:52:00",1433271120,"C3",159540,1433430660,"2015-06-04 08:11:00"
"4585","20153002113049-336",2,"2015-06-02 11:56:00",1433271360,"C8",107400,1433378760,"2015-06-03 17:46:00"
"1291","20151302111323-649",2,"2015-06-02 12:01:00",1433271660,"C8",106680,1433378340,"2015-06-03 17:39:00"
"1688","20150102120151-257",1,"2015-06-02 12:07:00",1433272020,"C2",161760,1433433780,"2015-06-04 09:03:00"
"5410","20151002121039-700",1,"2015-06-02 12:34:00",1433273640,"C5",426120,1433699760,"2015-06-07 10:56:00"
"2580","20154802114807-830",1,"2015-06-02 12:46:00",1433274360,"C4",284700,1433559060,"2015-06-05 19:51:00"
"5783","20153002123026-8",3,"2015-06-02 13:30:00",1433277000,"C7",248400,1433525400,"2015-06-05 10:30:00"
"1806","20153202123219-728",3,"2015-06-02 13:36:00",1433277360,"C0",205620,1433482980,"2015-06-04 22:43:00"
"2225","20154102124124-992",2,"2015-06-02 13:36:00",1433277360,"C5",69060,1433346420,"2015-06-03 08:47:00"
"4062","20154502014508-491",1,"2015-06-02 13:47:00",1433278020,"C6",103500,1433381520,"2015-06-03 18:32:00"
"5611","20151602021614-218",1,"2015-06-02 14:18:00",1433279880,"C6",421320,1433701200,"2015-06-07 11:20:00"
"3363","20151802021836-315",2,"2015-06-02 15:24:00",1433283840,"C2",91800,1433375640,"2015-06-03 16:54:00"
"2078","20150802030830-611",1,"2015-06-02 15:41:00",1433284860,"C5",263640,1433548500,"2015-06-05 16:55:00"
"1062","20151602031658-446",3,"2015-06-02 16:10:00",1433286600,"C8",154140,1433440740,"2015-06-04 10:59:00"
"2707","20155102045121-443",1,"2015-06-02 17:05:00",1433289900,"C0",81720,1433371620,"2015-06-03 15:47:00"
"933","20155302045335-245",1,"2015-06-02 17:20:00",1433290800,"C5",63960,1433354760,"2015-06-03 11:06:00"
"2006","20151202051249-156",3,"2015-06-02 17:38:00",1433291880,"C4",47400,1433339280,"2015-06-03 06:48:00"
"3799","20155602045653-926",1,"2015-06-02 18:00:00",1433293200,"C5",436080,1433729280,"2015-06-07 19:08:00"
"2444","20150203060210-288",1,"2015-06-03 06:58:00",1433339880,"C8",439320,1433779200,"2015-06-08 09:00:00"
"3972","20152603062609-710",2,"2015-06-03 06:59:00",1433339940,"C0",434220,1433774160,"2015-06-08 07:36:00"
"247","20152703062723-570",1,"2015-06-03 07:03:00",1433340180,"C2",117300,1433457480,"2015-06-04 15:38:00"
"4515","20150803060828-975",3,"2015-06-03 07:12:00",1433340720,"C5",208260,1433548980,"2015-06-05 17:03:00"
"5115","20154003064021-184",2,"2015-06-03 07:42:00",1433342520,"C0",112560,1433455080,"2015-06-04 14:58:00"
"165","20151503071547-841",1,"2015-06-03 08:23:00",1433344980,"C8",84600,1433429580,"2015-06-04 07:53:00"
"5424","20152603072628-94",1,"2015-06-03 08:26:00",1433345160,"C4",84960,1433430120,"2015-06-04 08:02:00"
"577","20154303074351-681",1,"2015-06-03 08:41:00",1433346060,"C3",464760,1433810820,"2015-06-08 17:47:00"
"6331","20153903083921-101",1,"2015-06-03 09:01:00",1433347260,"C4",91440,1433438700,"2015-06-04 10:25:00"
"4844","20150503080543-310",1,"2015-06-03 09:05:00",1433347500,"C2",260880,1433608380,"2015-06-06 09:33:00"
"712","20153203093248-618",1,"2015-06-03 09:57:00",1433350620,"C5",542220,1433892840,"2015-06-09 16:34:00"
"1411","20155203095227-377",2,"2015-06-03 10:21:00",1433352060,"C5",112440,1433464500,"2015-06-04 17:35:00"
"211","20153403093425-594",1,"2015-06-03 10:29:00",1433352540,"C7",97920,1433450460,"2015-06-04 13:41:00"
"5671","20150603100608-37",3,"2015-06-03 10:30:00",1433352600,"C5",685560,1434038160,"2015-06-11 08:56:00"
"5178","20155803095829-960",3,"2015-06-03 10:34:00",1433352840,"C0",177360,1433530200,"2015-06-05 11:50:00"
"1551","20151403101418-295",2,"2015-06-03 11:12:00",1433355120,"C8",380640,1433735760,"2015-06-07 20:56:00"
"5958","20151303111300-96",1,"2015-06-03 11:45:00",1433357100,"C7",286020,1433643120,"2015-06-06 19:12:00"
"2820","20151403111404-688",2,"2015-06-03 11:50:00",1433357400,"C6",182340,1433539740,"2015-06-05 14:29:00"
"4027","20151403121420-600",2,"2015-06-03 12:43:00",1433360580,"C4",286380,1433646960,"2015-06-06 20:16:00"
"4268","20155203125254-748",3,"2015-06-03 13:25:00",1433363100,"C8",146700,1433509800,"2015-06-05 06:10:00"
"3301","20152703012746-542",1,"2015-06-03 14:00:00",1433365200,"C0",92160,1433457360,"2015-06-04 15:36:00"
"5292","20152203012222-575",1,"2015-06-03 14:00:00",1433365200,"C0",95460,1433460660,"2015-06-04 16:31:00"
"6020","20153603023614-793",1,"2015-06-03 14:59:00",1433368740,"C5",441120,1433809860,"2015-06-08 17:31:00"
"3205","20150103020130-343",1,"2015-06-03 15:04:00",1433369040,"C4",624000,1433993040,"2015-06-10 20:24:00"
"129","20152603032638-774",1,"2015-06-03 16:17:00",1433373420,"C5",177900,1433551320,"2015-06-05 17:42:00"
"2999","20150003040042-47",1,"2015-06-03 17:07:00",1433376420,"C3",97860,1433474280,"2015-06-04 20:18:00"
"2797","20154203044240-260",1,"2015-06-03 17:18:00",1433377080,"C7",612420,1433989500,"2015-06-10 19:25:00"
"783","20153203053218-362",3,"2015-06-03 18:23:00",1433380980,"C6",87300,1433468280,"2015-06-04 18:38:00"
"4786","20150104060101-478",2,"2015-06-04 06:21:00",1433424060,"C8",225720,1433649780,"2015-06-06 21:03:00"
"1314","20155304065335-775",1,"2015-06-04 07:31:00",1433428260,"C2",137640,1433565900,"2015-06-05 21:45:00"
"1908","20152504072503-198",2,"2015-06-04 07:44:00",1433429040,"C7",280620,1433709660,"2015-06-07 13:41:00"
"4648","20154404074423-76",1,"2015-06-04 08:15:00",1433430900,"C8",257700,1433688600,"2015-06-07 07:50:00"
"5369","20154704074710-516",2,"2015-06-04 08:32:00",1433431920,"C8",619140,1434051060,"2015-06-11 12:31:00"
"1183","20150304080318-31",1,"2015-06-04 08:36:00",1433432160,"C2",296760,1433728920,"2015-06-07 19:02:00"
"2783","20151104091103-487",2,"2015-06-04 09:16:00",1433434560,"C2",123240,1433557800,"2015-06-05 19:30:00"
"6305","20153704083744-741",3,"2015-06-04 09:37:00",1433435820,"C5",175920,1433611740,"2015-06-06 10:29:00"
"5674","20155004085057-252",3,"2015-06-04 09:50:00",1433436600,"C0",178440,1433615040,"2015-06-06 11:24:00"
"4833","20152004092005-697",2,"2015-06-04 10:19:00",1433438340,"C8",189360,1433627700,"2015-06-06 14:55:00"
"4941","20152304102334-555",1,"2015-06-04 10:30:00",1433439000,"C4",290460,1433729460,"2015-06-07 19:11:00"
"1790","20155804095839-242",3,"2015-06-04 10:59:00",1433440740,"C7",106140,1433546880,"2015-06-05 16:28:00"
"2657","20152504102542-990",3,"2015-06-04 11:29:00",1433442540,"C5",105360,1433547900,"2015-06-05 16:45:00"
"440","20153704113707-880",1,"2015-06-04 12:03:00",1433444580,"C4",626820,1434071400,"2015-06-11 18:10:00"
"1615","20150304120307-360",1,"2015-06-04 12:59:00",1433447940,"C6",632100,1434080040,"2015-06-11 20:34:00"
"108","20151104121158-643",2,"2015-06-04 13:12:00",1433448720,"C2",406200,1433854920,"2015-06-09 06:02:00"
"5371","20155004125004-492",1,"2015-06-04 13:17:00",1433449020,"C8",83040,1433532060,"2015-06-05 12:21:00"
"3684","20155504125520-496",2,"2015-06-04 13:29:00",1433449740,"C4",77640,1433527380,"2015-06-05 11:03:00"
"3796","20152204012203-647",2,"2015-06-04 13:32:00",1433449920,"C3",258480,1433708400,"2015-06-07 13:20:00"
"4353","20152004012053-387",2,"2015-06-04 13:34:00",1433450040,"C7",250020,1433700060,"2015-06-07 11:01:00"
"4296","20152704012752-116",3,"2015-06-04 14:00:00",1433451600,"C0",112320,1433563920,"2015-06-05 21:12:00"
"1155","20153704013734-599",1,"2015-06-04 14:13:00",1433452380,"C0",77880,1433530260,"2015-06-05 11:51:00"
"1586","20153804023854-460",2,"2015-06-04 14:46:00",1433454360,"C4",157140,1433611500,"2015-06-06 10:25:00"
"2765","20154204024204-803",1,"2015-06-04 14:47:00",1433454420,"C2",515520,1433969940,"2015-06-10 13:59:00"
"2456","20152404022405-329",3,"2015-06-04 14:51:00",1433454660,"C3",62880,1433517540,"2015-06-05 08:19:00"
"2430","20151004021051-72",1,"2015-06-04 15:06:00",1433455560,"C4",96540,1433552100,"2015-06-05 17:55:00"
"3409","20155804015811-880",1,"2015-06-04 15:06:00",1433455560,"C4",797760,1434253320,"2015-06-13 20:42:00"
"2341","20151404031404-378",2,"2015-06-04 15:21:00",1433456460,"C4",313680,1433770140,"2015-06-08 06:29:00"
"6499","20151904021905-805",1,"2015-06-04 15:30:00",1433457000,"C7",1035600,1434492600,"2015-06-16 15:10:00"
"3734","20150804030847-490",1,"2015-06-04 16:01:00",1433458860,"C7",245040,1433703900,"2015-06-07 12:05:00"
"4456","20152904032905-433",1,"2015-06-04 16:03:00",1433458980,"C8",503280,1433962260,"2015-06-10 11:51:00"
"5931","20151604031616-721",3,"2015-06-04 16:04:00",1433459040,"C8",337560,1433796600,"2015-06-08 13:50:00"
"4596","20153504033551-486",1,"2015-06-04 16:06:00",1433459160,"C5",187440,1433646600,"2015-06-06 20:10:00"
"5542","20153504033505-27",3,"2015-06-04 16:12:00",1433459520,"C2",185400,1433644920,"2015-06-06 19:42:00"
"473","20150404040434-742",3,"2015-06-04 16:20:00",1433460000,"C0",354660,1433814660,"2015-06-08 18:51:00"
"3044","20150104040106-481",1,"2015-06-04 16:29:00",1433460540,"C4",669000,1434129540,"2015-06-12 10:19:00"
"2981","20151304041354-441",1,"2015-06-04 16:40:00",1433461200,"C4",71400,1433532600,"2015-06-05 12:30:00"
"5716","20152004042018-896",3,"2015-06-04 16:52:00",1433461920,"C6",180000,1433641920,"2015-06-06 18:52:00"
"3477","20153504043512-341",3,"2015-06-04 17:00:00",1433462400,"C7",142860,1433605260,"2015-06-06 08:41:00"
"4551","20153104043113-656",2,"2015-06-04 17:42:00",1433464920,"C7",50940,1433515860,"2015-06-05 07:51:00"
"4488","20150404050454-793",1,"2015-06-04 18:04:00",1433466240,"C6",321300,1433787540,"2015-06-08 11:19:00"
"5956","20152404052454-43",1,"2015-06-04 18:13:00",1433466780,"C6",414180,1433880960,"2015-06-09 13:16:00"
"702","20155904055905-326",2,"2015-06-04 18:31:00",1433467860,"C7",170040,1433637900,"2015-06-06 17:45:00"
"3288","20152104052130-587",2,"2015-06-04 18:33:00",1433467980,"C2",174120,1433642100,"2015-06-06 18:55:00"
"156","20150305060300-527",1,"2015-06-05 06:25:00",1433510700,"C5",526020,1434036720,"2015-06-11 08:32:00"
"463","20150205070257-697",2,"2015-06-05 07:26:00",1433514360,"C8",105420,1433619780,"2015-06-06 12:43:00"
"769","20154405064401-508",2,"2015-06-05 07:31:00",1433514660,"C8",127080,1433641740,"2015-06-06 18:49:00"
"1478","20152005072047-527",2,"2015-06-05 07:46:00",1433515560,"C8",628260,1434143820,"2015-06-12 14:17:00"
"3669","20155605065613-54",2,"2015-06-05 07:56:00",1433516160,"C6",569700,1434085860,"2015-06-11 22:11:00"
"2599","20154005074031-234",1,"2015-06-05 08:19:00",1433517540,"C0",79380,1433596920,"2015-06-06 06:22:00"
"4943","20154505074523-130",1,"2015-06-05 08:20:00",1433517600,"C5",110940,1433628540,"2015-06-06 15:09:00"
"2018","20151905081937-688",1,"2015-06-05 08:47:00",1433519220,"C4",196560,1433715780,"2015-06-07 15:23:00"
"3178","20152005082009-82",2,"2015-06-05 08:58:00",1433519880,"C0",88980,1433608860,"2015-06-06 09:41:00"
"3245","20151305081322-814",1,"2015-06-05 09:05:00",1433520300,"C4",264300,1433784600,"2015-06-08 10:30:00"
"5604","20152305092355-533",2,"2015-06-05 09:38:00",1433522280,"C7",392580,1433914860,"2015-06-09 22:41:00"
"6473","20154305084350-216",2,"2015-06-05 09:43:00",1433522580,"C5",522120,1434044700,"2015-06-11 10:45:00"
"2479","20153005093039-50",1,"2015-06-05 10:05:00",1433523900,"C8",180960,1433704860,"2015-06-07 12:21:00"
"1784","20152005092056-151",2,"2015-06-05 10:18:00",1433524680,"C8",554220,1434078900,"2015-06-11 20:15:00"
"4383","20152805102823-890",1,"2015-06-05 10:49:00",1433526540,"C8",95580,1433622120,"2015-06-06 13:22:00"
"90","20153705093703-55",2,"2015-06-05 10:53:00",1433526780,"C2",366960,1433893740,"2015-06-09 16:49:00"
"5110","20152505102539-470",3,"2015-06-05 11:38:00",1433529480,"C2",621300,1434150780,"2015-06-12 16:13:00"
"6444","20152705112755-32",2,"2015-06-05 12:05:00",1433531100,"C2",174000,1433705100,"2015-06-07 12:25:00"
"6055","20150505110546-631",1,"2015-06-05 12:09:00",1433531340,"C2",430800,1433962140,"2015-06-10 11:49:00"
"4787","20151105121120-955",3,"2015-06-05 12:36:00",1433532960,"C5",185220,1433718180,"2015-06-07 16:03:00"
"654","20154705124714-48",2,"2015-06-05 13:13:00",1433535180,"C3",90240,1433625420,"2015-06-06 14:17:00"
"4982","20153505123531-2",1,"2015-06-05 13:35:00",1433536500,"C3",343200,1433879700,"2015-06-09 12:55:00"
"2920","20150805010805-339",1,"2015-06-05 13:37:00",1433536620,"C0",179940,1433716560,"2015-06-07 15:36:00"
"502","20155605125623-741",3,"2015-06-05 13:49:00",1433537340,"C5",185820,1433723160,"2015-06-07 17:26:00"
"1372","20151205011253-317",2,"2015-06-05 14:06:00",1433538360,"C4",377580,1433915940,"2015-06-09 22:59:00"
"2918","20152305022313-514",1,"2015-06-05 14:50:00",1433541000,"C8",525000,1434066000,"2015-06-11 16:40:00"
"2945","20154505014505-202",2,"2015-06-05 14:56:00",1433541360,"C6",804960,1434346320,"2015-06-14 22:32:00"
"6377","20154005024056-186",3,"2015-06-05 15:13:00",1433542380,"C3",956940,1434499320,"2015-06-16 17:02:00"
"6558","20154005024018-445",1,"2015-06-05 15:22:00",1433542920,"C0",284760,1433827680,"2015-06-08 22:28:00"
"5732","20155705025759-63",1,"2015-06-05 15:29:00",1433543340,"C6",2417160,1435960500,"2015-07-03 14:55:00"
"5364","20151905031957-601",1,"2015-06-05 15:40:00",1433544000,"C7",320940,1433864940,"2015-06-09 08:49:00"
"1648","20150305030327-986",1,"2015-06-05 15:41:00",1433544060,"C3",1049100,1434593160,"2015-06-17 19:06:00"
"5475","20152905032910-293",1,"2015-06-05 15:49:00",1433544540,"C7",715440,1434259980,"2015-06-13 22:33:00"
"1526","20155305035315-90",3,"2015-06-05 16:05:00",1433545500,"C3",138720,1433684220,"2015-06-07 06:37:00"
"326","20155805025842-634",1,"2015-06-05 16:06:00",1433545560,"C0",406500,1433952060,"2015-06-10 09:01:00"
"5636","20151505041552-201",1,"2015-06-05 16:33:00",1433547180,"C0",87540,1433634720,"2015-06-06 16:52:00"
"6398","20154405034405-591",1,"2015-06-05 16:39:00",1433547540,"C3",75300,1433622840,"2015-06-06 13:34:00"
"4363","20151305041331-383",1,"2015-06-05 16:46:00",1433547960,"C8",684960,1434232920,"2015-06-13 15:02:00"
"1262","20155205045211-58",1,"2015-06-05 17:28:00",1433550480,"C7",102720,1433653200,"2015-06-06 22:00:00"
"5449","20152305052333-803",2,"2015-06-05 17:35:00",1433550900,"C3",350880,1433901780,"2015-06-09 19:03:00"
"772","20151106061100-410",1,"2015-06-06 07:28:00",1433600880,"C0",431640,1434032520,"2015-06-11 07:22:00"
"2554","20155106065150-500",1,"2015-06-06 07:44:00",1433601840,"C5",139380,1433741220,"2015-06-07 22:27:00"
"5263","20153606073656-187",1,"2015-06-06 08:06:00",1433603160,"C3",383040,1433986200,"2015-06-10 18:30:00"
"5204","20155706075734-63",2,"2015-06-06 08:20:00",1433604000,"C5",354480,1433958480,"2015-06-10 10:48:00"
"5793","20150706080728-516",3,"2015-06-06 08:39:00",1433605140,"C2",82140,1433687280,"2015-06-07 07:28:00"
"628","20154606074613-942",2,"2015-06-06 08:47:00",1433605620,"C5",289200,1433894820,"2015-06-09 17:07:00"
"677","20154306084336-628",2,"2015-06-06 09:14:00",1433607240,"C3",1643820,1435251060,"2015-06-25 09:51:00"
"2105","20152106092143-261",1,"2015-06-06 09:27:00",1433608020,"C2",165780,1433773800,"2015-06-08 07:30:00"
"1917","20154106094112-225",1,"2015-06-06 09:51:00",1433609460,"C3",160380,1433769840,"2015-06-08 06:24:00"
"2542","20151506091506-255",2,"2015-06-06 09:53:00",1433609580,"C1",548220,1434157800,"2015-06-12 18:10:00"
"395","20155106085152-545",1,"2015-06-06 09:54:00",1433609640,"C2",159660,1433769300,"2015-06-08 06:15:00"
"955","20154706084700-54",2,"2015-06-06 09:55:00",1433609700,"C2",87660,1433697360,"2015-06-07 10:16:00"
"1708","20154606094659-402",1,"2015-06-06 10:09:00",1433610540,"C7",88140,1433698680,"2015-06-07 10:38:00"
"2451","20152206102254-44",2,"2015-06-06 10:39:00",1433612340,"C7",520260,1434132600,"2015-06-12 11:10:00"
"2140","20152706102715-95",2,"2015-06-06 10:53:00",1433613180,"C5",1020780,1434633960,"2015-06-18 06:26:00"
"671","20151006101058-57",1,"2015-06-06 11:03:00",1433613780,"C4",179580,1433793360,"2015-06-08 12:56:00"
"1295","20151406101448-508",2,"2015-06-06 11:07:00",1433614020,"C5",113280,1433727300,"2015-06-07 18:35:00"
"5973","20150806110818-449",1,"2015-06-06 11:44:00",1433616240,"C2",796560,1434412800,"2015-06-15 17:00:00"
"750","20150206110209-450",2,"2015-06-06 12:00:00",1433617200,"C3",334500,1433951700,"2015-06-10 08:55:00"
"4539","20154506114531-504",3,"2015-06-06 12:11:00",1433617860,"C7",70560,1433688420,"2015-06-07 07:47:00"
"5839","20153706113731-583",3,"2015-06-06 12:31:00",1433619060,"C8",497340,1434116400,"2015-06-12 06:40:00"
"19","20151106121113-182",2,"2015-06-06 12:37:00",1433619420,"C8",364920,1433984340,"2015-06-10 17:59:00"
"3707","20150106120154-473",2,"2015-06-06 13:02:00",1433620920,"C5",89820,1433710740,"2015-06-07 13:59:00"
"6429","20150006010020-419",1,"2015-06-06 13:08:00",1433621280,"C4",105780,1433727060,"2015-06-07 18:31:00"
"2988","20150606010609-786",1,"2015-06-06 13:11:00",1433621460,"C2",271380,1433892840,"2015-06-09 16:34:00"
"2314","20153706123730-475",2,"2015-06-06 13:12:00",1433621520,"C8",1219800,1434841320,"2015-06-20 16:02:00"
"5471","20155306125304-711",2,"2015-06-06 13:28:00",1433622480,"C0",169200,1433791680,"2015-06-08 12:28:00"
"3078","20153606123604-841",1,"2015-06-06 13:32:00",1433622720,"C4",90120,1433712840,"2015-06-07 14:34:00"
"157","20153906123947-442",1,"2015-06-06 13:35:00",1433622900,"C7",240960,1433863860,"2015-06-09 08:31:00"
"851","20154906014956-369",1,"2015-06-06 13:56:00",1433624160,"C2",103140,1433727300,"2015-06-07 18:35:00"
"5855","20153906013936-263",3,"2015-06-06 13:58:00",1433624280,"C6",239160,1433863440,"2015-06-09 08:24:00"
"1377","20155606015608-991",3,"2015-06-06 14:08:00",1433624880,"C3",367020,1433991900,"2015-06-10 20:05:00"
"174","20153206033243-388",2,"2015-06-06 15:39:00",1433630340,"C4",185580,1433815920,"2015-06-08 19:12:00"
"6515","20151506031529-885",3,"2015-06-06 15:55:00",1433631300,"C7",155220,1433786520,"2015-06-08 11:02:00"
"4314","20150606030611-107",2,"2015-06-06 16:07:00",1433632020,"C5",102360,1433734380,"2015-06-07 20:33:00"
"5961","20155006035017-391",3,"2015-06-06 16:16:00",1433632560,"C5",610140,1434242700,"2015-06-13 17:45:00"
"2837","20153706033723-432",3,"2015-06-06 16:37:00",1433633820,"C3",582540,1434216360,"2015-06-13 10:26:00"
"1725","20150806040856-166",2,"2015-06-06 17:00:00",1433635200,"C5",55320,1433690520,"2015-06-07 08:22:00"
"6540","20150806040859-207",1,"2015-06-06 17:13:00",1433635980,"C2",317160,1433953140,"2015-06-10 09:19:00"
"4345","20152506042511-712",2,"2015-06-06 17:24:00",1433636640,"C2",397440,1434034080,"2015-06-11 07:48:00"
"5706","20153906043929-561",1,"2015-06-06 17:36:00",1433637360,"C8",408900,1434046260,"2015-06-11 11:11:00"
"1765","20154806044809-982",3,"2015-06-06 17:38:00",1433637480,"C4",69660,1433707140,"2015-06-07 12:59:00"
"5003","20154406044427-579",1,"2015-06-06 17:39:00",1433637540,"C3",340080,1433977620,"2015-06-10 16:07:00"
"5554","20152106052156-327",1,"2015-06-06 18:09:00",1433639340,"C6",1167600,1434806940,"2015-06-20 06:29:00"
"188","20151007061036-970",2,"2015-06-07 06:35:00",1433684100,"C5",361860,1434045960,"2015-06-11 11:06:00"
"5345","20150907060938-780",2,"2015-06-07 06:43:00",1433684580,"C6",144420,1433829000,"2015-06-08 22:50:00"
"2309","20150507060531-534",1,"2015-06-07 06:46:00",1433684760,"C0",1859280,1435544040,"2015-06-28 19:14:00"
"948","20152807062821-864",1,"2015-06-07 06:54:00",1433685240,"C5",269400,1433954640,"2015-06-10 09:44:00"
"3219","20152907062931-133",2,"2015-06-07 07:02:00",1433685720,"C5",108780,1433794500,"2015-06-08 13:15:00"
"4017","20152707062703-3",2,"2015-06-07 07:05:00",1433685900,"C0",108840,1433794740,"2015-06-08 13:19:00"
"4191","20153907063953-451",2,"2015-06-07 07:05:00",1433685900,"C5",92460,1433778360,"2015-06-08 08:46:00"
"5137","20154607064650-344",3,"2015-06-07 07:09:00",1433686140,"C5",103920,1433790060,"2015-06-08 12:01:00"
"5032","20153307063313-327",1,"2015-06-07 07:39:00",1433687940,"C5",389040,1434076980,"2015-06-11 19:43:00"
"6169","20152107072157-137",1,"2015-06-07 07:47:00",1433688420,"C8",344340,1434032760,"2015-06-11 07:26:00"
"5451","20150907070951-183",1,"2015-06-07 08:09:00",1433689740,"C6",211560,1433901300,"2015-06-09 18:55:00"
"5909","20153007073050-177",1,"2015-06-07 08:35:00",1433691300,"C0",616800,1434308100,"2015-06-14 11:55:00"
"4871","20153407083404-897",1,"2015-06-07 08:39:00",1433691540,"C2",1036980,1434728520,"2015-06-19 08:42:00"
"4308","20154507074526-430",1,"2015-06-07 08:51:00",1433692260,"C2",133920,1433826180,"2015-06-08 22:03:00"
"1632","20150907080945-381",1,"2015-06-07 08:57:00",1433692620,"C8",364140,1434056760,"2015-06-11 14:06:00"
"2900","20153007083052-124",1,"2015-06-07 09:10:00",1433693400,"C0",334260,1434027660,"2015-06-11 06:01:00"
"5159","20151307081300-707",1,"2015-06-07 09:18:00",1433693880,"C5",510780,1434204660,"2015-06-13 07:11:00"
"1569","20151307091345-782",1,"2015-06-07 09:23:00",1433694180,"C3",871980,1434566160,"2015-06-17 11:36:00"
"700","20154207084222-772",1,"2015-06-07 09:44:00",1433695440,"C5",115320,1433810760,"2015-06-08 17:46:00"
"1670","20152907092902-279",2,"2015-06-07 10:00:00",1433696400,"C5",1211520,1434907920,"2015-06-21 10:32:00"
"4950","20150007090049-931",2,"2015-06-07 10:08:00",1433696880,"C2",609000,1434305880,"2015-06-14 11:18:00"
"4880","20155507095534-53",3,"2015-06-07 10:27:00",1433698020,"C7",187380,1433885400,"2015-06-09 14:30:00"
"520","20154007094039-158",1,"2015-06-07 10:31:00",1433698260,"C4",457020,1434155280,"2015-06-12 17:28:00"
"460","20152307102329-186",1,"2015-06-07 10:44:00",1433699040,"C5",456840,1434155880,"2015-06-12 17:38:00"
"4516","20151807101827-295",2,"2015-06-07 10:49:00",1433699340,"C4",158400,1433857740,"2015-06-09 06:49:00"
"5556","20150007110022-413",2,"2015-06-07 11:06:00",1433700360,"C2",543600,1434243960,"2015-06-13 18:06:00"
"2573","20152707102734-863",3,"2015-06-07 11:24:00",1433701440,"C4",91080,1433792520,"2015-06-08 12:42:00"
"4498","20155107105141-423",2,"2015-06-07 11:24:00",1433701440,"C2",378960,1434080400,"2015-06-11 20:40:00"
"6495","20152607102647-573",1,"2015-06-07 11:26:00",1433701560,"C4",103140,1433804700,"2015-06-08 16:05:00"
"5755","20152607112632-973",2,"2015-06-07 11:32:00",1433701920,"C2",246900,1433948820,"2015-06-10 08:07:00"
"3678","20151807121828-117",2,"2015-06-07 12:48:00",1433706480,"C2",436320,1434142800,"2015-06-12 14:00:00"
"2109","20152207122235-665",2,"2015-06-07 12:50:00",1433706600,"C5",77940,1433784540,"2015-06-08 10:29:00"
"270","20153407123403-76",2,"2015-06-07 13:07:00",1433707620,"C2",258360,1433965980,"2015-06-10 12:53:00"
"1978","20150307120319-340",2,"2015-06-07 13:16:00",1433708160,"C3",65040,1433773200,"2015-06-08 07:20:00"
"1993","20153307123351-488",1,"2015-06-07 13:29:00",1433708940,"C8",158520,1433867460,"2015-06-09 09:31:00"
"5454","20154307124353-199",1,"2015-06-07 13:34:00",1433709240,"C7",844680,1434553920,"2015-06-17 08:12:00"
"6247","20154107124133-326",2,"2015-06-07 13:37:00",1433709420,"C5",589020,1434298440,"2015-06-14 09:14:00"
"3667","20153907123907-228",1,"2015-06-07 13:43:00",1433709780,"C3",288360,1433998140,"2015-06-10 21:49:00"
"2673","20153507013548-133",3,"2015-06-07 14:04:00",1433711040,"C4",674760,1434385800,"2015-06-15 09:30:00"
"5066","20150607010649-553",2,"2015-06-07 14:24:00",1433712240,"C2",233400,1433945640,"2015-06-10 07:14:00"
"3221","20153307023326-161",2,"2015-06-07 14:40:00",1433713200,"C8",1028520,1434741720,"2015-06-19 12:22:00"
"3643","20154307024334-228",1,"2015-06-07 14:53:00",1433713980,"C3",317040,1434031020,"2015-06-11 06:57:00"
"3858","20154407024412-194",1,"2015-06-07 15:20:00",1433715600,"C0",240180,1433955780,"2015-06-10 10:03:00"
"2022","20153107033139-406",3,"2015-06-07 15:54:00",1433717640,"C4",91320,1433808960,"2015-06-08 17:16:00"
"2613","20155307025311-47",1,"2015-06-07 15:54:00",1433717640,"C2",162300,1433879940,"2015-06-09 12:59:00"
"1593","20155407025401-645",1,"2015-06-07 15:56:00",1433717760,"C4",84840,1433802600,"2015-06-08 15:30:00"
"4034","20150707040715-238",1,"2015-06-07 16:34:00",1433720040,"C5",64320,1433784360,"2015-06-08 10:26:00"
"3691","20152507042535-456",1,"2015-06-07 16:50:00",1433721000,"C5",660060,1434381060,"2015-06-15 08:11:00"
"616","20155007045010-724",2,"2015-06-07 17:13:00",1433722380,"C5",243720,1433966100,"2015-06-10 12:55:00"
"839","20152507042512-111",1,"2015-06-07 17:23:00",1433722980,"C3",146520,1433869500,"2015-06-09 10:05:00"
"5267","20155707045718-181",2,"2015-06-07 17:24:00",1433723040,"C5",168300,1433891340,"2015-06-09 16:09:00"
"2772","20152507042553-806",1,"2015-06-07 17:28:00",1433723280,"C4",51000,1433774280,"2015-06-08 07:38:00"
"4238","20150807050820-790",1,"2015-06-07 17:37:00",1433723820,"C8",883140,1434606960,"2015-06-17 22:56:00"
"1890","20151707051709-188",2,"2015-06-07 17:48:00",1433724480,"C4",238380,1433962860,"2015-06-10 12:01:00"
"3856","20155907055958-889",2,"2015-06-07 18:07:00",1433725620,"C4",170280,1433895900,"2015-06-09 17:25:00"
"2679","20154907054902-752",2,"2015-06-07 18:57:00",1433728620,"C5",152460,1433881080,"2015-06-09 13:18:00"
"1816","20150408060458-999",1,"2015-06-08 06:33:00",1433770380,"C6",260460,1434030840,"2015-06-11 06:54:00"
"3368","20150008060003-21",1,"2015-06-08 06:49:00",1433771340,"C7",293160,1434064500,"2015-06-11 16:15:00"
"3841","20151808071834-232",1,"2015-06-08 07:29:00",1433773740,"C3",292800,1434066540,"2015-06-11 16:49:00"
"3765","20153708073703-436",2,"2015-06-08 08:09:00",1433776140,"C0",355800,1434131940,"2015-06-12 10:59:00"
"5820","20155908075949-522",2,"2015-06-08 08:29:00",1433777340,"C3",512340,1434289680,"2015-06-14 06:48:00"
"4077","20152008082056-988",1,"2015-06-08 08:36:00",1433777760,"C7",310500,1434088260,"2015-06-11 22:51:00"
"4206","20153208083240-926",3,"2015-06-08 08:53:00",1433778780,"C7",1485720,1435264500,"2015-06-25 13:35:00"
"5023","20153808083849-175",1,"2015-06-08 09:10:00",1433779800,"C8",394200,1434174000,"2015-06-12 22:40:00"
"575","20150808090842-727",1,"2015-06-08 09:38:00",1433781480,"C6",824520,1434606000,"2015-06-17 22:40:00"
"3495","20150808100805-344",1,"2015-06-08 10:14:00",1433783640,"C8",131640,1433915280,"2015-06-09 22:48:00"
"5422","20150308110346-628",1,"2015-06-08 11:09:00",1433786940,"C2",119280,1433906220,"2015-06-09 20:17:00"
"3015","20152908102913-779",1,"2015-06-08 11:18:00",1433787480,"C8",212700,1434000180,"2015-06-10 22:23:00"
"990","20150508110558-558",1,"2015-06-08 11:36:00",1433788560,"C3",126000,1433914560,"2015-06-09 22:36:00"
"1563","20154108114121-535",1,"2015-06-08 12:14:00",1433790840,"C6",538440,1434329280,"2015-06-14 17:48:00"
"3408","20153808123846-946",2,"2015-06-08 13:11:00",1433794260,"C7",250440,1434044700,"2015-06-11 10:45:00"
"858","20151808121857-411",1,"2015-06-08 13:12:00",1433794320,"C5",1015140,1434809460,"2015-06-20 07:11:00"
"5012","20151008121044-244",1,"2015-06-08 13:13:00",1433794380,"C7",529320,1434323700,"2015-06-14 16:15:00"
"2175","20151808121849-986",2,"2015-06-08 13:16:00",1433794560,"C6",66960,1433861520,"2015-06-09 07:52:00"
"4252","20155208125234-73",2,"2015-06-08 13:16:00",1433794560,"C8",265440,1434060000,"2015-06-11 15:00:00"
"5833","20153808013814-745",1,"2015-06-08 14:13:00",1433797980,"C3",672540,1434470520,"2015-06-16 09:02:00"
"5628","20150808020840-877",1,"2015-06-08 14:15:00",1433798100,"C8",201240,1433999340,"2015-06-10 22:09:00"
"4348","20150808020805-83",2,"2015-06-08 14:32:00",1433799120,"C5",289140,1434088260,"2015-06-11 22:51:00"
"868","20155408015402-944",2,"2015-06-08 14:47:00",1433800020,"C4",97620,1433897640,"2015-06-09 17:54:00"
"173","20153008023037-716",1,"2015-06-08 14:55:00",1433800500,"C5",100320,1433900820,"2015-06-09 18:47:00"
"5070","20151708021738-621",1,"2015-06-08 14:56:00",1433800560,"C0",102780,1433903340,"2015-06-09 19:29:00"
"5688","20155608015646-673",1,"2015-06-08 15:03:00",1433800980,"C7",231720,1434032700,"2015-06-11 07:25:00"
"1422","20150708030724-124",2,"2015-06-08 15:26:00",1433802360,"C6",228900,1434031260,"2015-06-11 07:01:00"
"4116","20153208033241-763",1,"2015-06-08 15:37:00",1433803020,"C2",356820,1434159840,"2015-06-12 18:44:00"
"2193","20154308034359-236",1,"2015-06-08 15:51:00",1433803860,"C4",843420,1434647280,"2015-06-18 10:08:00"
"3736","20153008033000-100",1,"2015-06-08 15:51:00",1433803860,"C5",1379580,1435183440,"2015-06-24 15:04:00"
"1151","20150108040141-642",1,"2015-06-08 16:15:00",1433805300,"C7",186000,1433991300,"2015-06-10 19:55:00"
"6132","20153808033819-967",3,"2015-06-08 16:51:00",1433807460,"C3",786600,1434594060,"2015-06-17 19:21:00"
"2522","20150108040111-888",1,"2015-06-08 16:57:00",1433807820,"C4",190860,1433998680,"2015-06-10 21:58:00"
"560","20152108052101-440",1,"2015-06-08 17:48:00",1433810880,"C5",428400,1434239280,"2015-06-13 16:48:00"
"4075","20154508054512-557",1,"2015-06-08 18:00:00",1433811600,"C7",502080,1434313680,"2015-06-14 13:28:00"
"6089","20153508053537-848",3,"2015-06-08 18:09:00",1433812140,"C2",229500,1434041640,"2015-06-11 09:54:00"
"3313","20152308052334-841",3,"2015-06-08 18:17:00",1433812620,"C3",98280,1433910900,"2015-06-09 21:35:00"
"1367","20151009061043-83",1,"2015-06-09 06:41:00",1433857260,"C0",125820,1433983080,"2015-06-10 17:38:00"
"2558","20150209060231-719",1,"2015-06-09 06:56:00",1433858160,"C8",1319940,1435178100,"2015-06-24 13:35:00"
"4278","20155409065419-204",3,"2015-06-09 07:16:00",1433859360,"C7",273660,1434133020,"2015-06-12 11:17:00"
"125","20152109062104-583",2,"2015-06-09 07:30:00",1433860200,"C2",312240,1434172440,"2015-06-12 22:14:00"
"3583","20151309071349-323",1,"2015-06-09 07:35:00",1433860500,"C8",87300,1433947800,"2015-06-10 07:50:00"
"2277","20152709072702-390",2,"2015-06-09 07:37:00",1433860620,"C3",110760,1433971380,"2015-06-10 14:23:00"
"4971","20153709073753-995",3,"2015-06-09 07:40:00",1433860800,"C6",797280,1434658080,"2015-06-18 13:08:00"
"4329","20152509072533-673",2,"2015-06-09 07:55:00",1433861700,"C5",167700,1434029400,"2015-06-11 06:30:00"
"272","20152509072520-737",1,"2015-06-09 08:22:00",1433863320,"C3",197220,1434060540,"2015-06-11 15:09:00"
"6404","20152709072703-969",1,"2015-06-09 08:24:00",1433863440,"C6",607740,1434471180,"2015-06-16 09:13:00"
"1181","20155909075931-597",3,"2015-06-09 08:30:00",1433863800,"C2",344100,1434207900,"2015-06-13 08:05:00"
"2924","20151009091020-539",2,"2015-06-09 09:32:00",1433867520,"C4",595020,1434462540,"2015-06-16 06:49:00"
"5690","20151109091155-536",3,"2015-06-09 09:48:00",1433868480,"C2",467100,1434335580,"2015-06-14 19:33:00"
"255","20152509092558-706",1,"2015-06-09 09:49:00",1433868540,"C5",92760,1433961300,"2015-06-10 11:35:00"
"4325","20154009094029-596",2,"2015-06-09 10:40:00",1433871600,"C8",342000,1434213600,"2015-06-13 09:40:00"
"6461","20150409100452-47",1,"2015-06-09 10:43:00",1433871780,"C0",255120,1434126900,"2015-06-12 09:35:00"
"1184","20151809111800-66",1,"2015-06-09 11:38:00",1433875080,"C5",460500,1434335580,"2015-06-14 19:33:00"
"1125","20150509110512-403",2,"2015-06-09 11:41:00",1433875260,"C6",454800,1434330060,"2015-06-14 18:01:00"
"3497","20154309114329-296",2,"2015-06-09 12:06:00",1433876760,"C5",378300,1434255060,"2015-06-13 21:11:00"
"2632","20152209122210-562",1,"2015-06-09 12:39:00",1433878740,"C7",170280,1434049020,"2015-06-11 11:57:00"
"3952","20153509123549-969",1,"2015-06-09 12:59:00",1433879940,"C5",101520,1433981460,"2015-06-10 17:11:00"
"4805","20155309115343-721",3,"2015-06-09 13:01:00",1433880060,"C5",588060,1434468120,"2015-06-16 08:22:00"
"1101","20150309010348-628",1,"2015-06-09 13:24:00",1433881440,"C5",268380,1434149820,"2015-06-12 15:57:00"
"5013","20152909122903-721",3,"2015-06-09 13:30:00",1433881800,"C4",178020,1434059820,"2015-06-11 14:57:00"
"4145","20153909123913-261",2,"2015-06-09 13:40:00",1433882400,"C0",85920,1433968320,"2015-06-10 13:32:00"
"3434","20155409125422-39",2,"2015-06-09 13:46:00",1433882760,"C5",82500,1433965260,"2015-06-10 12:41:00"
"5250","20155809125823-570",1,"2015-06-09 14:02:00",1433883720,"C3",94560,1433978280,"2015-06-10 16:18:00"
"1486","20153509013553-476",3,"2015-06-09 14:08:00",1433884080,"C7",93900,1433977980,"2015-06-10 16:13:00"
"456","20151609011626-759",2,"2015-06-09 14:11:00",1433884260,"C5",290700,1434174960,"2015-06-12 22:56:00"
"4696","20154509014559-37",1,"2015-06-09 14:11:00",1433884260,"C7",204120,1434088380,"2015-06-11 22:53:00"
"4245","20152809032822-774",1,"2015-06-09 15:53:00",1433890380,"C5",1892700,1435783080,"2015-07-01 13:38:00"
"1087","20154909034948-631",1,"2015-06-09 16:15:00",1433891700,"C4",499560,1434391260,"2015-06-15 11:01:00"
"4644","20150509040535-12",2,"2015-06-09 16:40:00",1433893200,"C2",88980,1433982180,"2015-06-10 17:23:00"
"3658","20155009035012-229",2,"2015-06-09 16:51:00",1433893860,"C3",252960,1434146820,"2015-06-12 15:07:00"
"5257","20153309043302-556",2,"2015-06-09 17:01:00",1433894460,"C4",444780,1434339240,"2015-06-14 20:34:00"
"1369","20154009054046-633",3,"2015-06-09 18:03:00",1433898180,"C5",265500,1434163680,"2015-06-12 19:48:00"
"5093","20152709052754-9",3,"2015-06-09 18:28:00",1433899680,"C4",332700,1434232380,"2015-06-13 14:53:00"
"2704","20153310073327-373",2,"2015-06-10 08:04:00",1433948640,"C8",1434360,1435383000,"2015-06-26 22:30:00"
"554","20154810074844-679",2,"2015-06-10 08:20:00",1433949600,"C8",136740,1434086340,"2015-06-11 22:19:00"
"1635","20151710081754-167",2,"2015-06-10 09:12:00",1433952720,"C5",287700,1434240420,"2015-06-13 17:07:00"
"2872","20150010080038-54",2,"2015-06-10 09:12:00",1433952720,"C2",420780,1434373500,"2015-06-15 06:05:00"
"850","20153710103717-23",1,"2015-06-10 11:05:00",1433959500,"C4",162420,1434121920,"2015-06-12 08:12:00"
"4094","20154210104209-855",1,"2015-06-10 11:15:00",1433960100,"C7",197520,1434157620,"2015-06-12 18:07:00"
"3403","20154310114354-581",1,"2015-06-10 11:51:00",1433962260,"C8",114300,1434076560,"2015-06-11 19:36:00"
"298","20151710121709-837",1,"2015-06-10 12:37:00",1433965020,"C5",628680,1434593700,"2015-06-17 19:15:00"
"1396","20151210121248-239",1,"2015-06-10 13:02:00",1433966520,"C1",114660,1434081180,"2015-06-11 20:53:00"
"2647","20154210124201-733",1,"2015-06-10 13:04:00",1433966640,"C4",347820,1434314460,"2015-06-14 13:41:00"
"6133","20150710010709-698",1,"2015-06-10 13:37:00",1433968620,"C8",67020,1434035640,"2015-06-11 08:14:00"
"529","20154710124711-907",3,"2015-06-10 13:45:00",1433969100,"C3",416760,1434385860,"2015-06-15 09:31:00"
"1667","20154910014900-520",1,"2015-06-10 13:56:00",1433969760,"C4",70680,1434040440,"2015-06-11 09:34:00"
"3422","20152010012044-386",1,"2015-06-10 14:21:00",1433971260,"C4",106920,1434078180,"2015-06-11 20:03:00"
"3580","20150910020919-2",3,"2015-06-10 14:36:00",1433972160,"C5",365640,1434337800,"2015-06-14 20:10:00"
"4683","20152910022924-572",2,"2015-06-10 14:40:00",1433972400,"C3",176880,1434149280,"2015-06-12 15:48:00"
"3380","20154310024344-489",3,"2015-06-10 14:50:00",1433973000,"C2",157140,1434130140,"2015-06-12 10:29:00"
"6041","20150210020219-563",1,"2015-06-10 14:55:00",1433973300,"C4",80040,1434053340,"2015-06-11 13:09:00"
"1455","20150510020551-789",3,"2015-06-10 15:08:00",1433974080,"C8",191820,1434165900,"2015-06-12 20:25:00"
"4718","20153510023528-508",2,"2015-06-10 15:31:00",1433975460,"C4",88680,1434064140,"2015-06-11 16:09:00"
"770","20155610035651-241",2,"2015-06-10 15:59:00",1433977140,"C6",58560,1434035700,"2015-06-11 08:15:00"
"404","20154810034812-304",3,"2015-06-10 16:14:00",1433978040,"C4",276600,1434254640,"2015-06-13 21:04:00"
"3299","20152310032340-322",1,"2015-06-10 16:14:00",1433978040,"C4",79260,1434057300,"2015-06-11 14:15:00"
"632","20151910041931-214",3,"2015-06-10 16:36:00",1433979360,"C7",97920,1434077280,"2015-06-11 19:48:00"
"2174","20151310041329-620",1,"2015-06-10 16:38:00",1433979480,"C5",619020,1434598500,"2015-06-17 20:35:00"
"5235","20153910033908-495",3,"2015-06-10 16:43:00",1433979780,"C3",518340,1434498120,"2015-06-16 16:42:00"
"62","20150610040636-776",2,"2015-06-10 17:19:00",1433981940,"C7",248640,1434230580,"2015-06-13 14:23:00"
"608","20154810044808-531",1,"2015-06-10 17:31:00",1433982660,"C2",335940,1434318600,"2015-06-14 14:50:00"
"1903","20150010050052-231",1,"2015-06-10 18:11:00",1433985060,"C2",68580,1434053640,"2015-06-11 13:14:00"
"2448","20151511061503-898",1,"2015-06-11 06:45:00",1434030300,"C2",133320,1434163620,"2015-06-12 19:47:00"
"1174","20152311062324-562",1,"2015-06-11 06:50:00",1434030600,"C5",139860,1434170460,"2015-06-12 21:41:00"
"1412","20155311065304-252",1,"2015-06-11 07:26:00",1434032760,"C2",100380,1434133140,"2015-06-12 11:19:00"
"3647","20155511075557-246",2,"2015-06-11 08:22:00",1434036120,"C3",305220,1434341340,"2015-06-14 21:09:00"
"5827","20151411091404-225",1,"2015-06-11 09:20:00",1434039600,"C8",459360,1434498960,"2015-06-16 16:56:00"
"697","20154111084119-363",1,"2015-06-11 09:48:00",1434041280,"C2",125160,1434166440,"2015-06-12 20:34:00"
"6513","20155911095900-214",2,"2015-06-11 10:19:00",1434043140,"C5",364680,1434407820,"2015-06-15 15:37:00"
"949","20155011095054-239",1,"2015-06-11 10:25:00",1434043500,"C2",379860,1434423360,"2015-06-15 19:56:00"
"3859","20152311102311-455",2,"2015-06-11 11:08:00",1434046080,"C6",204660,1434250740,"2015-06-13 19:59:00"
"1277","20152311102347-770",1,"2015-06-11 11:24:00",1434047040,"C0",95940,1434142980,"2015-06-12 14:03:00"
"3521","20152711112749-922",3,"2015-06-11 12:30:00",1434051000,"C2",95940,1434146940,"2015-06-12 15:09:00"
"6250","20154011124049-78",1,"2015-06-11 13:15:00",1434053700,"C2",776100,1434829800,"2015-06-20 12:50:00"
"890","20155711125712-255",1,"2015-06-11 13:22:00",1434054120,"C5",453960,1434508080,"2015-06-16 19:28:00"
"5979","20151011011032-480",2,"2015-06-11 13:31:00",1434054660,"C8",243780,1434298440,"2015-06-14 09:14:00"
"2856","20151711011732-63",3,"2015-06-11 13:32:00",1434054720,"C0",973380,1435028100,"2015-06-22 19:55:00"
"4681","20151711021720-756",2,"2015-06-11 14:22:00",1434057720,"C2",173880,1434231600,"2015-06-13 14:40:00"
"2123","20150011020058-334",2,"2015-06-11 15:07:00",1434060420,"C2",61800,1434122220,"2015-06-12 08:17:00"
"5724","20153411023411-472",1,"2015-06-11 15:40:00",1434062400,"C4",101940,1434164340,"2015-06-12 19:59:00"
"1871","20155711035748-460",3,"2015-06-11 16:48:00",1434066480,"C4",92580,1434159060,"2015-06-12 18:31:00"
"2744","20154711044729-817",2,"2015-06-11 17:14:00",1434068040,"C4",52560,1434120600,"2015-06-12 07:50:00"
"3192","20155311045315-402",1,"2015-06-11 17:20:00",1434068400,"C4",267180,1434335580,"2015-06-14 19:33:00"
"968","20151211051259-166",1,"2015-06-11 17:41:00",1434069660,"C4",508320,1434577980,"2015-06-17 14:53:00"
"3132","20151811051833-890",2,"2015-06-11 17:46:00",1434069960,"C8",55020,1434124980,"2015-06-12 09:03:00"
"5515","20155811055815-517",1,"2015-06-11 18:25:00",1434072300,"C5",479400,1434551700,"2015-06-17 07:35:00"
"6279","20152912072922-999",1,"2015-06-12 08:00:00",1434121200,"C0",481260,1434602460,"2015-06-17 21:41:00"
"3961","20155612075623-190",1,"2015-06-12 08:27:00",1434122820,"C8",104820,1434227640,"2015-06-13 13:34:00"
"5453","20154612074618-947",3,"2015-06-12 08:38:00",1434123480,"C5",187020,1434310500,"2015-06-14 12:35:00"
"6042","20155712085725-362",1,"2015-06-12 09:22:00",1434126120,"C4",297240,1434423360,"2015-06-15 19:56:00"
"4244","20151012091054-963",2,"2015-06-12 09:31:00",1434126660,"C7",604980,1434731640,"2015-06-19 09:34:00"
"646","20153512093552-508",1,"2015-06-12 09:42:00",1434127320,"C4",260520,1434387840,"2015-06-15 10:04:00"
"2649","20154112084109-806",1,"2015-06-12 09:45:00",1434127500,"C8",303540,1434431040,"2015-06-15 22:04:00"
"1737","20150612090614-805",1,"2015-06-12 10:10:00",1434129000,"C2",109320,1434238320,"2015-06-13 16:32:00"
"3709","20152012102044-576",3,"2015-06-12 10:48:00",1434131280,"C5",370980,1434502260,"2015-06-16 17:51:00"
"5331","20153312103323-598",3,"2015-06-12 11:07:00",1434132420,"C5",642780,1434775200,"2015-06-19 21:40:00"
"3048","20154212104244-750",1,"2015-06-12 11:15:00",1434132900,"C8",290340,1434423240,"2015-06-15 19:54:00"
"6094","20151012111048-832",1,"2015-06-12 11:18:00",1434133080,"C4",331500,1434464580,"2015-06-16 07:23:00"
"1697","20152712102715-951",2,"2015-06-12 11:22:00",1434133320,"C5",196980,1434330300,"2015-06-14 18:05:00"
"4337","20150112110147-385",1,"2015-06-12 11:34:00",1434134040,"C6",699120,1434833160,"2015-06-20 13:46:00"
"4399","20154412114408-299",2,"2015-06-12 11:50:00",1434135000,"C2",626040,1434761040,"2015-06-19 17:44:00"
"5314","20154612114650-326",1,"2015-06-12 12:09:00",1434136140,"C7",523980,1434660120,"2015-06-18 13:42:00"
"4597","20152112122156-641",2,"2015-06-12 12:28:00",1434137280,"C4",79260,1434216540,"2015-06-13 10:29:00"
"1629","20152712122737-855",1,"2015-06-12 13:02:00",1434139320,"C6",442740,1434582060,"2015-06-17 16:01:00"
"2575","20154312124334-595",1,"2015-06-12 13:05:00",1434139500,"C5",78060,1434217560,"2015-06-13 10:46:00"
"84","20152312122312-603",1,"2015-06-12 13:07:00",1434139620,"C0",970800,1435110420,"2015-06-23 18:47:00"
"634","20154412124411-6",1,"2015-06-12 13:07:00",1434139620,"C5",859080,1434998700,"2015-06-22 11:45:00"
"4362","20154512124548-471",1,"2015-06-12 13:15:00",1434140100,"C4",91080,1434231180,"2015-06-13 14:33:00"
"1488","20155712125721-681",1,"2015-06-12 13:32:00",1434141120,"C2",117600,1434258720,"2015-06-13 22:12:00"
"6226","20151212011241-763",3,"2015-06-12 13:40:00",1434141600,"C8",328020,1434469620,"2015-06-16 08:47:00"
"1746","20154112014114-381",1,"2015-06-12 14:11:00",1434143460,"C6",202440,1434345900,"2015-06-14 22:25:00"
"5507","20150312020332-263",1,"2015-06-12 14:30:00",1434144600,"C8",192120,1434336720,"2015-06-14 19:52:00"
"4708","20155312015304-1",1,"2015-06-12 14:53:00",1434145980,"C2",81180,1434227160,"2015-06-13 13:26:00"
"472","20155412025458-760",1,"2015-06-12 15:19:00",1434147540,"C5",89700,1434237240,"2015-06-13 16:14:00"
"1134","20151212031240-621",1,"2015-06-12 15:40:00",1434148800,"C5",98100,1434246900,"2015-06-13 18:55:00"
"2627","20152012032058-971",1,"2015-06-12 15:43:00",1434148980,"C5",172860,1434321840,"2015-06-14 15:44:00"
"1388","20152312032319-646",2,"2015-06-12 15:51:00",1434149460,"C4",246360,1434395820,"2015-06-15 12:17:00"
"5076","20155412025439-711",2,"2015-06-12 16:08:00",1434150480,"C0",231480,1434381960,"2015-06-15 08:26:00"
"4297","20152012032058-382",2,"2015-06-12 16:23:00",1434151380,"C4",102420,1434253800,"2015-06-13 20:50:00"
"6212","20155412045446-0",1,"2015-06-12 17:01:00",1434153660,"C8",269460,1434423120,"2015-06-15 19:52:00"
"4128","20150312050331-531",3,"2015-06-12 17:15:00",1434154500,"C3",949200,1435103700,"2015-06-23 16:55:00"
"278","20151712051721-6",1,"2015-06-12 17:51:00",1434156660,"C0",273780,1434430440,"2015-06-15 21:54:00"
"3370","20154512054518-584",2,"2015-06-12 17:51:00",1434156660,"C8",445080,1434601740,"2015-06-17 21:29:00"
"4428","20154212054245-458",1,"2015-06-12 17:54:00",1434156840,"C3",97140,1434253980,"2015-06-13 20:53:00"
"3394","20150112050156-642",1,"2015-06-12 17:59:00",1434157140,"C8",186900,1434344040,"2015-06-14 21:54:00"
"4336","20153912053941-227",1,"2015-06-12 18:01:00",1434157260,"C4",255300,1434412560,"2015-06-15 16:56:00"
"111","20155212055238-204",1,"2015-06-12 18:49:00",1434160140,"C8",140460,1434300600,"2015-06-14 09:50:00"
"1571","20153213063205-982",1,"2015-06-13 06:58:00",1434203880,"C8",110700,1434314580,"2015-06-14 13:43:00"
"5942","20151113061129-478",3,"2015-06-13 07:12:00",1434204720,"C4",1129860,1435334580,"2015-06-26 09:03:00"
"3068","20153113063149-619",2,"2015-06-13 07:28:00",1434205680,"C4",687240,1434892920,"2015-06-21 06:22:00"
"4802","20150613070629-561",2,"2015-06-13 07:28:00",1434205680,"C8",257340,1434463020,"2015-06-16 06:57:00"
"2468","20154713064720-448",3,"2015-06-13 07:32:00",1434205920,"C8",221040,1434426960,"2015-06-15 20:56:00"
"1213","20155613065614-139",1,"2015-06-13 07:40:00",1434206400,"C2",204600,1434411000,"2015-06-15 16:30:00"
"2340","20151113071127-855",3,"2015-06-13 07:47:00",1434206820,"C3",366000,1434572820,"2015-06-17 13:27:00"
"4747","20154513064520-256",2,"2015-06-13 07:53:00",1434207180,"C5",210240,1434417420,"2015-06-15 18:17:00"
"1335","20150313080324-835",1,"2015-06-13 08:09:00",1434208140,"C8",906720,1435114860,"2015-06-23 20:01:00"
"3212","20152113072113-341",2,"2015-06-13 08:12:00",1434208320,"C8",195420,1434403740,"2015-06-15 14:29:00"
"6487","20154413074407-257",1,"2015-06-13 08:39:00",1434209940,"C5",478740,1434688680,"2015-06-18 21:38:00"
"1058","20153213083242-735",1,"2015-06-13 09:05:00",1434211500,"C2",274560,1434486060,"2015-06-16 13:21:00"
"5668","20151813091850-644",1,"2015-06-13 09:21:00",1434212460,"C6",175980,1434388440,"2015-06-15 10:14:00"
"3389","20155013085022-330",2,"2015-06-13 09:43:00",1434213780,"C5",565020,1434778800,"2015-06-19 22:40:00"
"4104","20152513092510-818",2,"2015-06-13 10:15:00",1434215700,"C6",120600,1434336300,"2015-06-14 19:45:00"
"3084","20154913094911-76",1,"2015-06-13 10:19:00",1434215940,"C2",89220,1434305160,"2015-06-14 11:06:00"
"5465","20151813101843-73",1,"2015-06-13 10:24:00",1434216240,"C8",78780,1434295020,"2015-06-14 08:17:00"
"5160","20151913091934-158",1,"2015-06-13 10:39:00",1434217140,"C8",383640,1434600780,"2015-06-17 21:13:00"
"2633","20153813093827-417",1,"2015-06-13 10:40:00",1434217200,"C3",113460,1434330660,"2015-06-14 18:11:00"
"3312","20152313102357-845",2,"2015-06-13 10:42:00",1434217320,"C0",344880,1434562200,"2015-06-17 10:30:00"
"1427","20150413110402-150",1,"2015-06-13 11:11:00",1434219060,"C4",126060,1434345120,"2015-06-14 22:12:00"
"5394","20155313105324-362",1,"2015-06-13 11:21:00",1434219660,"C4",694500,1434914160,"2015-06-21 12:16:00"
"3687","20152513102549-213",3,"2015-06-13 11:23:00",1434219780,"C5",264600,1434484380,"2015-06-16 12:53:00"
"6060","20150013110026-797",1,"2015-06-13 11:23:00",1434219780,"C5",106560,1434326340,"2015-06-14 16:59:00"
"5939","20152113112111-474",1,"2015-06-13 11:48:00",1434221280,"C5",516120,1434737400,"2015-06-19 11:10:00"
"3194","20155813105800-351",3,"2015-06-13 11:50:00",1434221400,"C5",68280,1434289680,"2015-06-14 06:48:00"
"2440","20155813115831-288",1,"2015-06-13 12:30:00",1434223800,"C0",161220,1434385020,"2015-06-15 09:17:00"
"4080","20152913122916-642",2,"2015-06-13 12:46:00",1434224760,"C7",96840,1434321600,"2015-06-14 15:40:00"
"2904","20155213115254-355",1,"2015-06-13 13:03:00",1434225780,"C2",88800,1434314580,"2015-06-14 13:43:00"
"2652","20152813122838-287",2,"2015-06-13 13:29:00",1434227340,"C6",420240,1434647580,"2015-06-18 10:13:00"
"5142","20153013013015-228",1,"2015-06-13 13:35:00",1434227700,"C2",373740,1434601440,"2015-06-17 21:24:00"
"5502","20151113011134-396",1,"2015-06-13 13:36:00",1434227760,"C4",67740,1434295500,"2015-06-14 08:25:00"
"3277","20153513123506-982",1,"2015-06-13 13:39:00",1434227940,"C4",281700,1434509640,"2015-06-16 19:54:00"
"4373","20153513013506-980",3,"2015-06-13 13:45:00",1434228300,"C3",439500,1434667800,"2015-06-18 15:50:00"
"966","20155613125611-113",1,"2015-06-13 14:00:00",1434229200,"C5",60300,1434289500,"2015-06-14 06:45:00"
"828","20154713014720-385",1,"2015-06-13 14:20:00",1434230400,"C8",170100,1434400500,"2015-06-15 13:35:00"
"4901","20151813021824-408",2,"2015-06-13 14:29:00",1434230940,"C3",237840,1434468780,"2015-06-16 08:33:00"
"3975","20152913022938-375",3,"2015-06-13 14:35:00",1434231300,"C8",175380,1434406680,"2015-06-15 15:18:00"
"5918","20154213024208-839",2,"2015-06-13 14:47:00",1434232020,"C2",930780,1435162800,"2015-06-24 09:20:00"
"6435","20150013020033-816",1,"2015-06-13 15:00:00",1434232800,"C8",278700,1434511500,"2015-06-16 20:25:00"
"4389","20150113030159-936",1,"2015-06-13 15:08:00",1434233280,"C4",196020,1434429300,"2015-06-15 21:35:00"
"1318","20154213024216-561",1,"2015-06-13 15:09:00",1434233340,"C4",176220,1434409560,"2015-06-15 16:06:00"
"5941","20155913025927-438",3,"2015-06-13 15:16:00",1434233760,"C7",69060,1434302820,"2015-06-14 10:27:00"
"5630","20150513030530-407",2,"2015-06-13 15:26:00",1434234360,"C8",82140,1434316500,"2015-06-14 14:15:00"
"6353","20154913024913-440",2,"2015-06-13 15:27:00",1434234420,"C7",59700,1434294120,"2015-06-14 08:02:00"
"5510","20153013023047-224",2,"2015-06-13 15:36:00",1434234960,"C6",333780,1434568740,"2015-06-17 12:19:00"
"2489","20151413031402-190",3,"2015-06-13 15:44:00",1434235440,"C2",109680,1434345120,"2015-06-14 22:12:00"
"6086","20153213033256-646",1,"2015-06-13 15:57:00",1434236220,"C5",70260,1434306480,"2015-06-14 11:28:00"
"917","20151813031843-852",1,"2015-06-13 16:18:00",1434237480,"C3",137760,1434375240,"2015-06-15 06:34:00"
"6376","20152813042842-830",3,"2015-06-13 17:00:00",1434240000,"C2",84060,1434324060,"2015-06-14 16:21:00"
"2801","20155413045417-828",2,"2015-06-13 17:08:00",1434240480,"C7",85440,1434325920,"2015-06-14 16:52:00"
"542","20153313043332-986",1,"2015-06-13 17:09:00",1434240540,"C0",843900,1435084440,"2015-06-23 11:34:00"
"4689","20152213052248-272",2,"2015-06-13 17:33:00",1434241980,"C3",781320,1435023300,"2015-06-22 18:35:00"
"4273","20154213044221-384",1,"2015-06-13 17:40:00",1434242400,"C8",67020,1434309420,"2015-06-14 12:17:00"
"6478","20153813043802-884",2,"2015-06-13 17:42:00",1434242520,"C8",230760,1434473280,"2015-06-16 09:48:00"
"3387","20153713053720-934",3,"2015-06-13 18:36:00",1434245760,"C5",1637100,1435882860,"2015-07-02 17:21:00"
"6397","20152314062321-228",2,"2015-06-14 06:25:00",1434288300,"C6",650820,1434939120,"2015-06-21 19:12:00"
"6031","20152914062905-376",1,"2015-06-14 07:22:00",1434291720,"C5",94860,1434386580,"2015-06-15 09:43:00"
"1088","20151414071412-997",1,"2015-06-14 07:35:00",1434292500,"C8",371460,1434663960,"2015-06-18 14:46:00"
"3644","20152514072525-135",1,"2015-06-14 07:47:00",1434293220,"C8",879000,1435172220,"2015-06-24 11:57:00"
"5381","20153514073524-157",3,"2015-06-14 08:07:00",1434294420,"C5",201900,1434496320,"2015-06-16 16:12:00"
"5444","20153514073548-195",2,"2015-06-14 08:08:00",1434294480,"C5",344820,1434639300,"2015-06-18 07:55:00"
"2902","20155314075350-327",1,"2015-06-14 08:17:00",1434295020,"C7",119100,1434414120,"2015-06-15 17:22:00"
"446","20152414072405-565",2,"2015-06-14 08:27:00",1434295620,"C0",434400,1434730020,"2015-06-19 09:07:00"
"5303","20154714074704-144",3,"2015-06-14 08:38:00",1434296280,"C4",543120,1434839400,"2015-06-20 15:30:00"
"2995","20151914081957-769",1,"2015-06-14 08:41:00",1434296460,"C4",438480,1434734940,"2015-06-19 10:29:00"
"4846","20153114083105-937",1,"2015-06-14 09:09:00",1434298140,"C2",267180,1434565320,"2015-06-17 11:22:00"
"5534","20154914084953-37",3,"2015-06-14 09:19:00",1434298740,"C4",259740,1434558480,"2015-06-17 09:28:00"
"1798","20151314081340-101",1,"2015-06-14 09:20:00",1434298800,"C5",193200,1434492000,"2015-06-16 15:00:00"
"3698","20150514090542-943",3,"2015-06-14 09:34:00",1434299640,"C5",85620,1434385260,"2015-06-15 09:21:00"
"6096","20150914090940-696",1,"2015-06-14 09:37:00",1434299820,"C8",115740,1434415560,"2015-06-15 17:46:00"
"1321","20151514091533-555",2,"2015-06-14 09:41:00",1434300060,"C4",79140,1434379200,"2015-06-15 07:40:00"
"2062","20151314091343-744",1,"2015-06-14 09:43:00",1434300180,"C6",547800,1434847980,"2015-06-20 17:53:00"
"6533","20151014091022-504",1,"2015-06-14 09:44:00",1434300240,"C6",84420,1434384660,"2015-06-15 09:11:00"
"3739","20153914093936-718",1,"2015-06-14 10:11:00",1434301860,"C3",477360,1434779220,"2015-06-19 22:47:00"
"5352","20151614091646-956",1,"2015-06-14 10:26:00",1434302760,"C0",213840,1434516600,"2015-06-16 21:50:00"
"2387","20155914095952-732",2,"2015-06-14 10:56:00",1434304560,"C8",277380,1434581940,"2015-06-17 15:59:00"
"4102","20153014103053-84",3,"2015-06-14 11:27:00",1434306420,"C3",633360,1434939780,"2015-06-21 19:23:00"
"6536","20155614105606-280",2,"2015-06-14 11:50:00",1434307800,"C5",325380,1434633180,"2015-06-18 06:13:00"
"2262","20152614112619-98",2,"2015-06-14 11:52:00",1434307920,"C3",196200,1434504120,"2015-06-16 18:22:00"
"3847","20155514115559-607",1,"2015-06-14 12:13:00",1434309180,"C0",526080,1434835260,"2015-06-20 14:21:00"
"1205","20155214125258-653",1,"2015-06-14 13:12:00",1434312720,"C7",66060,1434378780,"2015-06-15 07:33:00"
"2337","20150614120640-492",1,"2015-06-14 13:12:00",1434312720,"C0",250440,1434563160,"2015-06-17 10:46:00"
"3991","20152114012137-37",1,"2015-06-14 13:28:00",1434313680,"C4",113880,1434427560,"2015-06-15 21:06:00"
"3400","20154914124917-488",1,"2015-06-14 13:42:00",1434314520,"C8",93720,1434408240,"2015-06-15 15:44:00"
"6104","20152414012455-891",1,"2015-06-14 13:48:00",1434314880,"C7",441060,1434755940,"2015-06-19 16:19:00"
"3686","20155014015019-965",1,"2015-06-14 14:26:00",1434317160,"C3",84360,1434401520,"2015-06-15 13:52:00"
"5324","20152814012834-417",2,"2015-06-14 14:29:00",1434317340,"C3",419700,1434737040,"2015-06-19 11:04:00"
"3802","20151114021156-85",1,"2015-06-14 14:41:00",1434318060,"C6",453000,1434771060,"2015-06-19 20:31:00"
"2459","20150214020239-72",2,"2015-06-14 15:04:00",1434319440,"C6",413580,1434733020,"2015-06-19 09:57:00"
"4175","20154714024730-244",1,"2015-06-14 15:22:00",1434320520,"C7",282420,1434602940,"2015-06-17 21:49:00"
"4142","20153514023510-367",1,"2015-06-14 15:28:00",1434320880,"C5",59580,1434380460,"2015-06-15 08:01:00"
"1219","20150114030106-231",1,"2015-06-14 15:32:00",1434321120,"C2",66480,1434387600,"2015-06-15 10:00:00"
"3697","20152614032608-515",3,"2015-06-14 15:33:00",1434321180,"C8",139980,1434461160,"2015-06-16 06:26:00"
"2322","20153414023451-770",3,"2015-06-14 15:45:00",1434321900,"C3",85800,1434407700,"2015-06-15 15:35:00"
"1692","20153814023849-856",1,"2015-06-14 15:48:00",1434322080,"C8",164760,1434486840,"2015-06-16 13:34:00"
"1973","20151414041459-646",1,"2015-06-14 16:35:00",1434324900,"C6",90900,1434415800,"2015-06-15 17:50:00"
"3355","20155814045802-471",2,"2015-06-14 17:34:00",1434328440,"C2",508500,1434836940,"2015-06-20 14:49:00"
"4327","20153314043314-37",1,"2015-06-14 17:39:00",1434328740,"C2",409320,1434738060,"2015-06-19 11:21:00"
"477","20155914045934-20",2,"2015-06-14 18:05:00",1434330300,"C2",481740,1434812040,"2015-06-20 07:54:00"
"540","20154914054916-877",2,"2015-06-14 18:52:00",1434333120,"C0",61680,1434394800,"2015-06-15 12:00:00"
"5034","20153915063929-257",1,"2015-06-15 06:55:00",1434376500,"C7",139800,1434516300,"2015-06-16 21:45:00"
"1492","20151615061625-429",3,"2015-06-15 07:18:00",1434377880,"C5",473820,1434851700,"2015-06-20 18:55:00"
"5064","20155415065439-614",1,"2015-06-15 07:51:00",1434379860,"C8",431040,1434810900,"2015-06-20 07:35:00"
"294","20152215082242-794",1,"2015-06-15 08:52:00",1434383520,"C3",166500,1434550020,"2015-06-17 07:07:00"
"1869","20153815083827-733",2,"2015-06-15 09:12:00",1434384720,"C2",83880,1434468600,"2015-06-16 08:30:00"
"6157","20151515081555-958",3,"2015-06-15 09:13:00",1434384780,"C4",94800,1434479580,"2015-06-16 11:33:00"
"898","20152515082556-333",2,"2015-06-15 09:28:00",1434385680,"C7",161100,1434546780,"2015-06-17 06:13:00"
"4014","20155815085831-779",1,"2015-06-15 09:53:00",1434387180,"C6",121080,1434508260,"2015-06-16 19:31:00"
"2962","20154715084738-41",2,"2015-06-15 09:54:00",1434387240,"C2",438420,1434825660,"2015-06-20 11:41:00"
"3226","20155515095508-771",2,"2015-06-15 10:11:00",1434388260,"C0",803520,1435191780,"2015-06-24 17:23:00"
"1849","20152415102404-680",2,"2015-06-15 10:31:00",1434389460,"C4",296700,1434686160,"2015-06-18 20:56:00"
"3010","20152315102354-941",1,"2015-06-15 10:32:00",1434389520,"C4",91500,1434481020,"2015-06-16 11:57:00"
"5694","20150715100705-414",1,"2015-06-15 10:36:00",1434389760,"C5",111360,1434501120,"2015-06-16 17:32:00"
"1402","20152815102844-133",2,"2015-06-15 10:52:00",1434390720,"C4",385200,1434775920,"2015-06-19 21:52:00"
"2718","20150415110415-762",2,"2015-06-15 11:10:00",1434391800,"C2",1138620,1435530420,"2015-06-28 15:27:00"
"4831","20153115103103-717",1,"2015-06-15 11:23:00",1434392580,"C8",426060,1434818640,"2015-06-20 09:44:00"
"5645","20154915104900-986",2,"2015-06-15 11:49:00",1434394140,"C6",530760,1434924900,"2015-06-21 15:15:00"
"2483","20150215110234-930",2,"2015-06-15 12:16:00",1434395760,"C7",275700,1434671460,"2015-06-18 16:51:00"
"1016","20155315115319-974",3,"2015-06-15 12:19:00",1434395940,"C8",872760,1435268700,"2015-06-25 14:45:00"
"5640","20152215122235-485",1,"2015-06-15 12:25:00",1434396300,"C6",327180,1434723480,"2015-06-19 07:18:00"
"5342","20152315122321-162",3,"2015-06-15 12:37:00",1434397020,"C0",84420,1434481440,"2015-06-16 12:04:00"
"4845","20151615011608-528",2,"2015-06-15 13:18:00",1434399480,"C6",120720,1434520200,"2015-06-16 22:50:00"
"1112","20152515012542-655",1,"2015-06-15 14:17:00",1434403020,"C8",170100,1434573120,"2015-06-17 13:32:00"
"5714","20155415015459-549",1,"2015-06-15 14:30:00",1434403800,"C7",857100,1435260900,"2015-06-25 12:35:00"
"2443","20151215021211-822",1,"2015-06-15 14:35:00",1434404100,"C7",186900,1434591000,"2015-06-17 18:30:00"
"1690","20152215022221-833",1,"2015-06-15 14:43:00",1434404580,"C7",973680,1435378260,"2015-06-26 21:11:00"
"4144","20153015023037-512",1,"2015-06-15 14:51:00",1434405060,"C8",84900,1434489960,"2015-06-16 14:26:00"
"4777","20150515020535-533",1,"2015-06-15 15:03:00",1434405780,"C2",334260,1434740040,"2015-06-19 11:54:00"
"4867","20154115024109-180",2,"2015-06-15 15:05:00",1434405900,"C5",419940,1434825840,"2015-06-20 11:44:00"
"771","20151515021534-406",1,"2015-06-15 15:29:00",1434407340,"C2",270120,1434677460,"2015-06-18 18:31:00"
"5486","20151115031100-780",1,"2015-06-15 15:44:00",1434408240,"C4",189900,1434598140,"2015-06-17 20:29:00"
"36","20152115032120-829",1,"2015-06-15 15:54:00",1434408840,"C2",252600,1434661440,"2015-06-18 14:04:00"
"4848","20152915032948-543",1,"2015-06-15 16:02:00",1434409320,"C3",335100,1434744420,"2015-06-19 13:07:00"
"6472","20151315031359-879",2,"2015-06-15 16:13:00",1434409980,"C0",265920,1434675900,"2015-06-18 18:05:00"
"2486","20151815041843-802",1,"2015-06-15 16:25:00",1434410700,"C4",327600,1434738300,"2015-06-19 11:25:00"
"1935","20155915035951-998",2,"2015-06-15 16:27:00",1434410820,"C5",708420,1435119240,"2015-06-23 21:14:00"
"4431","20153115033133-708",1,"2015-06-15 16:43:00",1434411780,"C2",605580,1435017360,"2015-06-22 16:56:00"
"4821","20151515041526-196",1,"2015-06-15 16:43:00",1434411780,"C4",82680,1434494460,"2015-06-16 15:41:00"
"2164","20153315043301-166",3,"2015-06-15 17:08:00",1434413280,"C2",179700,1434592980,"2015-06-17 19:03:00"
"4795","20150815040821-280",1,"2015-06-15 17:08:00",1434413280,"C4",175800,1434589080,"2015-06-17 17:58:00"
"4068","20151515051521-888",1,"2015-06-15 17:35:00",1434414900,"C8",314940,1434729840,"2015-06-19 09:04:00"
"567","20151415051449-943",1,"2015-06-15 17:48:00",1434415680,"C6",478740,1434894420,"2015-06-21 06:47:00"
"5440","20153016063038-967",2,"2015-06-16 06:59:00",1434463140,"C6",400500,1434863640,"2015-06-20 22:14:00"
"5150","20150616060652-850",3,"2015-06-16 07:11:00",1434463860,"C5",178440,1434642300,"2015-06-18 08:45:00"
"5171","20152016062004-516",2,"2015-06-16 07:30:00",1434465000,"C8",122340,1434587340,"2015-06-17 17:29:00"
"2270","20154416074444-263",1,"2015-06-16 07:51:00",1434466260,"C4",176580,1434642840,"2015-06-18 08:54:00"
"2320","20154816064800-119",1,"2015-06-16 07:52:00",1434466320,"C5",523080,1434989400,"2015-06-22 09:10:00"
"1048","20151116081119-191",1,"2015-06-16 09:15:00",1434471300,"C7",104760,1434576060,"2015-06-17 14:21:00"
"4400","20152216102203-558",1,"2015-06-16 11:14:00",1434478440,"C5",721380,1435199820,"2015-06-24 19:37:00"
"283","20154316104341-889",3,"2015-06-16 11:43:00",1434480180,"C4",175080,1434655260,"2015-06-18 12:21:00"
"4137","20151816121814-878",1,"2015-06-16 12:24:00",1434482640,"C8",111300,1434593940,"2015-06-17 19:19:00"
"4232","20152816112859-104",1,"2015-06-16 12:27:00",1434482820,"C3",945060,1435427880,"2015-06-27 10:58:00"
"3414","20150616120616-647",1,"2015-06-16 12:34:00",1434483240,"C4",164220,1434647460,"2015-06-18 10:11:00"
"2238","20153316123340-662",1,"2015-06-16 13:29:00",1434486540,"C5",264660,1434751200,"2015-06-19 15:00:00"
"1018","20153416013418-86",2,"2015-06-16 13:40:00",1434487200,"C8",194340,1434681540,"2015-06-18 19:39:00"
"1609","20151416011455-25",2,"2015-06-16 13:42:00",1434487320,"C4",239580,1434726900,"2015-06-19 08:15:00"
"749","20155216125240-140",1,"2015-06-16 13:49:00",1434487740,"C8",167580,1434655320,"2015-06-18 12:22:00"
"2688","20153216013237-980",2,"2015-06-16 13:51:00",1434487860,"C6",798660,1435286520,"2015-06-25 19:42:00"
"4146","20150016010039-314",3,"2015-06-16 13:59:00",1434488340,"C2",157380,1434645720,"2015-06-18 09:42:00"
"2568","20154816014841-737",1,"2015-06-16 14:15:00",1434489300,"C4",927900,1435417200,"2015-06-27 08:00:00"
"1089","20155216015226-188",2,"2015-06-16 14:18:00",1434489480,"C5",979080,1435468560,"2015-06-27 22:16:00"
"2300","20151616021636-386",1,"2015-06-16 14:19:00",1434489540,"C6",102960,1434592500,"2015-06-17 18:55:00"
"3641","20154916014913-150",3,"2015-06-16 14:23:00",1434489780,"C0",116100,1434605880,"2015-06-17 22:38:00"
"5102","20155716015702-925",3,"2015-06-16 14:26:00",1434489960,"C6",696540,1435186500,"2015-06-24 15:55:00"
"344","20151316021336-107",3,"2015-06-16 14:44:00",1434491040,"C2",85260,1434576300,"2015-06-17 14:25:00"
"4222","20150416030444-791",3,"2015-06-16 15:11:00",1434492660,"C8",495840,1434988500,"2015-06-22 08:55:00"
"4495","20153416023407-833",1,"2015-06-16 15:11:00",1434492660,"C2",494940,1434987600,"2015-06-22 08:40:00"
"733","20152116022122-905",1,"2015-06-16 15:24:00",1434493440,"C0",272340,1434765780,"2015-06-19 19:03:00"
"2641","20153716033726-119",2,"2015-06-16 15:44:00",1434494640,"C2",109860,1434604500,"2015-06-17 22:15:00"
"346","20150716030750-947",1,"2015-06-16 15:45:00",1434494700,"C7",368100,1434862800,"2015-06-20 22:00:00"
"1097","20155416025450-542",3,"2015-06-16 15:46:00",1434494760,"C4",250500,1434745260,"2015-06-19 13:21:00"
"2457","20151816031811-238",1,"2015-06-16 15:56:00",1434495360,"C0",362040,1434857400,"2015-06-20 20:30:00"
"3515","20155616035629-355",1,"2015-06-16 16:20:00",1434496800,"C8",184740,1434681540,"2015-06-18 19:39:00"
"6291","20153016033036-967",1,"2015-06-16 16:26:00",1434497160,"C6",96120,1434593280,"2015-06-17 19:08:00"
"561","20150116050129-415",2,"2015-06-16 17:03:00",1434499380,"C6",272640,1434772020,"2015-06-19 20:47:00"
"3617","20155816045813-135",3,"2015-06-16 17:03:00",1434499380,"C2",689880,1435189260,"2015-06-24 16:41:00"
"5026","20150816050850-701",1,"2015-06-16 17:15:00",1434500100,"C8",95100,1434595200,"2015-06-17 19:40:00"
"2953","20152116052127-688",1,"2015-06-16 17:57:00",1434502620,"C2",91080,1434593700,"2015-06-17 19:15:00"
"5086","20155516055530-619",3,"2015-06-16 18:19:00",1434503940,"C5",148620,1434652560,"2015-06-18 11:36:00"
"626","20153516053542-376",2,"2015-06-16 18:39:00",1434505140,"C2",144600,1434649740,"2015-06-18 10:49:00"
"539","20152417062433-543",1,"2015-06-17 06:45:00",1434548700,"C8",230040,1434778740,"2015-06-19 22:39:00"
"4031","20153917063943-246",1,"2015-06-17 07:35:00",1434551700,"C8",513000,1435064700,"2015-06-23 06:05:00"
"3781","20151717071728-569",1,"2015-06-17 07:41:00",1434552060,"C4",224760,1434776820,"2015-06-19 22:07:00"
"713","20154317064310-833",1,"2015-06-17 07:45:00",1434552300,"C8",174960,1434727260,"2015-06-19 08:21:00"
"5854","20152517072506-105",3,"2015-06-17 08:01:00",1434553260,"C3",271200,1434824460,"2015-06-20 11:21:00"
"5748","20153417073443-887",3,"2015-06-17 08:13:00",1434553980,"C0",80880,1434634860,"2015-06-18 06:41:00"
"1930","20155417075442-571",1,"2015-06-17 08:25:00",1434554700,"C3",118020,1434672720,"2015-06-18 17:12:00"
"5241","20151017081005-686",1,"2015-06-17 08:33:00",1434555180,"C8",127260,1434682440,"2015-06-18 19:54:00"
"1469","20152917082934-698",1,"2015-06-17 08:57:00",1434556620,"C5",805440,1435362060,"2015-06-26 16:41:00"
"5866","20150517080508-420",2,"2015-06-17 09:06:00",1434557160,"C2",198600,1434755760,"2015-06-19 16:16:00"
"143","20155817085846-463",1,"2015-06-17 09:28:00",1434558480,"C5",692880,1435251360,"2015-06-25 09:56:00"
"154","20155417085454-80",3,"2015-06-17 09:28:00",1434558480,"C8",130920,1434689400,"2015-06-18 21:50:00"
"400","20150017100000-961",2,"2015-06-17 10:06:00",1434560760,"C4",168060,1434728820,"2015-06-19 08:47:00"
"1175","20150417100406-907",3,"2015-06-17 10:17:00",1434561420,"C7",472500,1435033920,"2015-06-22 21:32:00"
"22","20155817095851-242",3,"2015-06-17 10:25:00",1434561900,"C4",76860,1434638760,"2015-06-18 07:46:00"
"894","20153217103251-836",1,"2015-06-17 10:38:00",1434562680,"C2",79320,1434642000,"2015-06-18 08:40:00"
"548","20153617093653-526",2,"2015-06-17 10:39:00",1434562740,"C7",177420,1434740160,"2015-06-19 11:56:00"
"5054","20154517094500-459",2,"2015-06-17 10:39:00",1434562740,"C8",542640,1435105380,"2015-06-23 17:23:00"
"4710","20153217103218-546",1,"2015-06-17 10:40:00",1434562800,"C4",204420,1434767220,"2015-06-19 19:27:00"
"5297","20155517095518-749",1,"2015-06-17 10:52:00",1434563520,"C3",271140,1434834660,"2015-06-20 14:11:00"
"4647","20151317101348-437",1,"2015-06-17 11:10:00",1434564600,"C8",84780,1434649380,"2015-06-18 10:43:00"
"776","20155217105219-132",2,"2015-06-17 11:35:00",1434566100,"C2",425760,1434991860,"2015-06-22 09:51:00"
"3718","20154017114049-331",1,"2015-06-17 12:46:00",1434570360,"C4",69720,1434640080,"2015-06-18 08:08:00"
"198","20153717123759-246",1,"2015-06-17 12:59:00",1434571140,"C7",234600,1434805740,"2015-06-20 06:09:00"
"3112","20153317123351-161",1,"2015-06-17 13:27:00",1434572820,"C8",68880,1434641700,"2015-06-18 08:35:00"
"5426","20151417011439-309",2,"2015-06-17 13:40:00",1434573600,"C5",453240,1435026840,"2015-06-22 19:34:00"
"4451","20154317014329-54",1,"2015-06-17 14:07:00",1434575220,"C5",72420,1434647640,"2015-06-18 10:14:00"
"3353","20152017012017-5",1,"2015-06-17 14:13:00",1434575580,"C8",194160,1434769740,"2015-06-19 20:09:00"
"4879","20152317012346-970",1,"2015-06-17 14:17:00",1434575820,"C7",166200,1434742020,"2015-06-19 12:27:00"
"2244","20153317013317-798",2,"2015-06-17 14:36:00",1434576960,"C4",338940,1434915900,"2015-06-21 12:45:00"
"2676","20152917022939-684",2,"2015-06-17 14:36:00",1434576960,"C4",197220,1434774180,"2015-06-19 21:23:00"
"589","20152517012540-586",2,"2015-06-17 14:43:00",1434577380,"C0",583680,1435161060,"2015-06-24 08:51:00"
"1597","20154117024144-496",3,"2015-06-17 15:04:00",1434578640,"C5",335280,1434913920,"2015-06-21 12:12:00"
"5898","20152917022938-308",2,"2015-06-17 15:05:00",1434578700,"C2",110520,1434689220,"2015-06-18 21:47:00"
"6383","20150717030756-157",1,"2015-06-17 15:15:00",1434579300,"C8",331500,1434910800,"2015-06-21 11:20:00"
"5516","20155517025520-359",1,"2015-06-17 15:33:00",1434580380,"C2",141600,1434721980,"2015-06-19 06:53:00"
"1566","20154217034220-309",2,"2015-06-17 16:04:00",1434582240,"C5",714660,1435296900,"2015-06-25 22:35:00"
"5999","20155417035454-444",3,"2015-06-17 16:29:00",1434583740,"C6",147960,1434731700,"2015-06-19 09:35:00"
"1246","20153917033947-416",3,"2015-06-17 16:44:00",1434584640,"C8",222060,1434806700,"2015-06-20 06:25:00"
"3593","20155617035626-878",3,"2015-06-17 16:59:00",1434585540,"C4",313560,1434899100,"2015-06-21 08:05:00"
"3204","20152517042527-36",1,"2015-06-17 17:03:00",1434585780,"C2",87900,1434673680,"2015-06-18 17:28:00"
"2592","20151317041326-366",1,"2015-06-17 17:09:00",1434586140,"C5",784920,1435371060,"2015-06-26 19:11:00"
"4346","20150517050533-767",3,"2015-06-17 17:28:00",1434587280,"C5",186720,1434774000,"2015-06-19 21:20:00"
"5752","20154617044627-301",1,"2015-06-17 17:56:00",1434588960,"C3",131520,1434720480,"2015-06-19 06:28:00"
"1838","20151617051603-789",1,"2015-06-17 18:15:00",1434590100,"C7",274920,1434865020,"2015-06-20 22:37:00"
"5922","20155417055404-842",2,"2015-06-17 18:27:00",1434590820,"C5",87780,1434678600,"2015-06-18 18:50:00"
"5562","20150418070414-573",2,"2015-06-18 07:36:00",1434638160,"C7",306060,1434944220,"2015-06-21 20:37:00"
"1981","20151818071851-924",2,"2015-06-18 07:41:00",1434638460,"C5",288300,1434926760,"2015-06-21 15:46:00"
"2561","20154318074327-65",2,"2015-06-18 07:53:00",1434639180,"C3",83940,1434723120,"2015-06-19 07:12:00"
"5572","20150218080215-880",3,"2015-06-18 08:08:00",1434640080,"C4",90600,1434730680,"2015-06-19 09:18:00"
"65","20154918074910-267",1,"2015-06-18 08:14:00",1434640440,"C8",164880,1434805320,"2015-06-20 06:02:00"
"199","20152118072137-646",2,"2015-06-18 08:23:00",1434640980,"C3",117480,1434758460,"2015-06-19 17:01:00"
"3101","20155318075334-519",2,"2015-06-18 08:25:00",1434641100,"C3",290160,1434931260,"2015-06-21 17:01:00"
"2072","20155618085648-561",1,"2015-06-18 09:21:00",1434644460,"C8",247440,1434891900,"2015-06-21 06:05:00"
"2870","20151118091136-43",3,"2015-06-18 09:34:00",1434645240,"C8",169800,1434815040,"2015-06-20 08:44:00"
"6100","20154018084053-456",1,"2015-06-18 09:35:00",1434645300,"C7",699240,1435344540,"2015-06-26 11:49:00"
"1476","20154618094619-43",2,"2015-06-18 09:52:00",1434646320,"C2",614040,1435260360,"2015-06-25 12:26:00"
"1717","20155318095346-528",1,"2015-06-18 10:16:00",1434647760,"C4",955020,1435602780,"2015-06-29 11:33:00"
"3382","20150118110157-82",1,"2015-06-18 11:08:00",1434650880,"C8",677160,1435328040,"2015-06-26 07:14:00"
"2179","20155118105146-971",1,"2015-06-18 11:15:00",1434651300,"C4",277680,1434928980,"2015-06-21 16:23:00"
"1704","20154118104113-978",3,"2015-06-18 11:42:00",1434652920,"C0",81780,1434734700,"2015-06-19 10:25:00"
"5463","20152518112549-926",2,"2015-06-18 12:03:00",1434654180,"C2",613560,1435267740,"2015-06-25 14:29:00"
"4975","20153718113730-766",1,"2015-06-18 12:40:00",1434656400,"C2",420420,1435076820,"2015-06-23 09:27:00"
"1190","20152218122205-541",1,"2015-06-18 12:48:00",1434656880,"C5",272160,1434929040,"2015-06-21 16:24:00"
"2104","20153618123612-480",2,"2015-06-18 12:58:00",1434657480,"C6",64500,1434721980,"2015-06-19 06:53:00"
"3877","20153218123229-36",2,"2015-06-18 13:05:00",1434657900,"C5",772560,1435430460,"2015-06-27 11:41:00"
"5563","20152218012209-123",1,"2015-06-18 14:13:00",1434661980,"C8",106440,1434768420,"2015-06-19 19:47:00"
"3126","20150518020503-955",1,"2015-06-18 14:40:00",1434663600,"C6",83520,1434747120,"2015-06-19 13:52:00"
"2742","20153118023112-598",3,"2015-06-18 15:05:00",1434665100,"C2",80280,1434745380,"2015-06-19 13:23:00"
"3393","20150518020501-460",1,"2015-06-18 15:13:00",1434665580,"C6",432180,1435097760,"2015-06-23 15:16:00"
"4864","20150918040902-934",1,"2015-06-18 16:14:00",1434669240,"C2",51120,1434720360,"2015-06-19 06:26:00"
"3083","20154718034701-35",1,"2015-06-18 16:24:00",1434669840,"C7",362880,1435032720,"2015-06-22 21:12:00"
"5008","20155418035415-502",1,"2015-06-18 16:24:00",1434669840,"C6",273660,1434943500,"2015-06-21 20:25:00"
"5857","20153818043830-284",2,"2015-06-18 16:43:00",1434670980,"C2",358020,1435029000,"2015-06-22 20:10:00"
"3337","20155818035853-341",2,"2015-06-18 16:56:00",1434671760,"C5",531600,1435203360,"2015-06-24 20:36:00"
"2806","20150018050050-556",2,"2015-06-18 17:07:00",1434672420,"C4",164400,1434836820,"2015-06-20 14:47:00"
"3142","20150318040329-875",1,"2015-06-18 17:11:00",1434672660,"C7",99180,1434771840,"2015-06-19 20:44:00"
"3144","20155418045458-340",1,"2015-06-18 17:13:00",1434672780,"C0",157920,1434830700,"2015-06-20 13:05:00"
"1376","20155418045455-317",2,"2015-06-18 17:24:00",1434673440,"C0",772440,1435445880,"2015-06-27 15:58:00"
"1456","20151218051211-725",3,"2015-06-18 17:30:00",1434673800,"C6",157020,1434830820,"2015-06-20 13:07:00"
"3714","20152918052938-439",2,"2015-06-18 17:37:00",1434674220,"C8",598680,1435272900,"2015-06-25 15:55:00"
"5813","20155918055936-835",1,"2015-06-18 18:52:00",1434678720,"C5",300780,1434979500,"2015-06-22 06:25:00"
"1466","20150419060418-689",1,"2015-06-19 06:27:00",1434720420,"C5",654720,1435375140,"2015-06-26 20:19:00"
"3983","20151619061642-149",2,"2015-06-19 06:46:00",1434721560,"C0",115860,1434837420,"2015-06-20 14:57:00"
"2194","20152619062611-689",3,"2015-06-19 06:48:00",1434721680,"C4",296640,1435018320,"2015-06-22 17:12:00"
"3020","20153919063918-509",1,"2015-06-19 06:49:00",1434721740,"C3",124380,1434846120,"2015-06-20 17:22:00"
"5500","20155019065024-371",2,"2015-06-19 07:19:00",1434723540,"C8",366000,1435089540,"2015-06-23 12:59:00"
"1301","20151619071622-794",1,"2015-06-19 07:38:00",1434724680,"C5",283740,1435008420,"2015-06-22 14:27:00"
"41","20153419063412-632",1,"2015-06-19 07:46:00",1434725160,"C0",140460,1434865620,"2015-06-20 22:47:00"
"4568","20153619073613-656",2,"2015-06-19 08:11:00",1434726660,"C0",1080900,1435807560,"2015-07-01 20:26:00"
"3953","20155019075059-941",3,"2015-06-19 08:19:00",1434727140,"C5",465960,1435193100,"2015-06-24 17:45:00"
"5576","20151219081235-39",1,"2015-06-19 08:20:00",1434727200,"C4",307920,1435035120,"2015-06-22 21:52:00"
"5246","20152819072857-484",2,"2015-06-19 08:31:00",1434727860,"C2",730380,1435458240,"2015-06-27 19:24:00"
"6265","20153019073056-11",1,"2015-06-19 08:32:00",1434727920,"C5",224760,1434952680,"2015-06-21 22:58:00"
"4430","20152319082350-281",1,"2015-06-19 08:57:00",1434729420,"C8",124260,1434853680,"2015-06-20 19:28:00"
"3999","20154519084549-54",1,"2015-06-19 09:23:00",1434730980,"C6",419940,1435150920,"2015-06-24 06:02:00"
"4422","20155919085937-643",3,"2015-06-19 09:25:00",1434731100,"C5",372000,1435103100,"2015-06-23 16:45:00"
"2882","20152319092320-59",1,"2015-06-19 09:30:00",1434731400,"C4",292620,1435024020,"2015-06-22 18:47:00"
"5824","20155919085948-945",3,"2015-06-19 09:33:00",1434731580,"C3",181980,1434913560,"2015-06-21 12:06:00"
"3767","20154919094921-666",2,"2015-06-19 09:56:00",1434732960,"C8",375900,1435108860,"2015-06-23 18:21:00"
"2787","20154119094154-19",2,"2015-06-19 10:15:00",1434734100,"C0",82680,1434816780,"2015-06-20 09:13:00"
"5964","20151819091842-213",1,"2015-06-19 10:23:00",1434734580,"C3",528420,1435263000,"2015-06-25 13:10:00"
"3588","20151619091658-670",1,"2015-06-19 10:26:00",1434734760,"C2",213180,1434947940,"2015-06-21 21:39:00"
"6433","20153619103622-151",1,"2015-06-19 10:43:00",1434735780,"C4",80940,1434816720,"2015-06-20 09:12:00"
"6078","20154019104036-155",2,"2015-06-19 10:58:00",1434736680,"C0",299040,1435035720,"2015-06-22 22:02:00"
"5048","20151319101312-156",3,"2015-06-19 11:16:00",1434737760,"C8",276180,1435013940,"2015-06-22 15:59:00"
"5388","20152419102424-497",1,"2015-06-19 11:17:00",1434737820,"C8",1399740,1436137560,"2015-07-05 16:06:00"
"880","20155519105547-921",1,"2015-06-19 11:19:00",1434737940,"C5",101520,1434839460,"2015-06-20 15:31:00"
"5902","20153319103352-70",2,"2015-06-19 11:27:00",1434738420,"C5",70140,1434808560,"2015-06-20 06:56:00"
"5450","20153719113733-632",1,"2015-06-19 12:10:00",1434741000,"C4",69900,1434810900,"2015-06-20 07:35:00"
"2480","20152119122102-412",1,"2015-06-19 12:42:00",1434742920,"C5",65580,1434808500,"2015-06-20 06:55:00"
"77","20153619123625-792",3,"2015-06-19 12:48:00",1434743280,"C3",156240,1434899520,"2015-06-21 08:12:00"
"3218","20153719123745-647",3,"2015-06-19 13:00:00",1434744000,"C5",238200,1434982200,"2015-06-22 07:10:00"
"3998","20154019124057-626",1,"2015-06-19 13:13:00",1434744780,"C5",332580,1435077360,"2015-06-23 09:36:00"
"3168","20151419121435-102",3,"2015-06-19 13:16:00",1434744960,"C8",243720,1434988680,"2015-06-22 08:58:00"
"10","20152119012112-241",1,"2015-06-19 13:27:00",1434745620,"C4",91440,1434837060,"2015-06-20 14:51:00"
"2881","20152919012937-798",1,"2015-06-19 13:32:00",1434745920,"C6",162720,1434908640,"2015-06-21 10:44:00"
"5801","20152219012207-18",3,"2015-06-19 13:50:00",1434747000,"C5",371940,1435118940,"2015-06-23 21:09:00"
"1747","20154112014114-381",1,"2015-06-19 14:12:00",1434748320,"C6",202980,1434951300,"2015-06-21 22:35:00"
"4602","20154519024544-322",2,"2015-06-19 14:52:00",1434750720,"C4",204720,1434955440,"2015-06-21 23:44:00"
"2293","20155919015912-624",1,"2015-06-19 14:56:00",1434750960,"C8",172920,1434923880,"2015-06-21 14:58:00"
"5245","20153919023921-5",2,"2015-06-19 15:04:00",1434751440,"C5",66300,1434817740,"2015-06-20 09:29:00"
"5338","20153419023448-961",1,"2015-06-19 15:04:00",1434751440,"C8",108480,1434859920,"2015-06-20 21:12:00"
"2808","20152819022855-141",1,"2015-06-19 15:35:00",1434753300,"C7",1018620,1435771920,"2015-07-01 10:32:00"
"6516","20155319035359-974",1,"2015-06-19 16:15:00",1434755700,"C8",226260,1434981960,"2015-06-22 07:06:00"
"4059","20150219040226-843",1,"2015-06-19 16:56:00",1434758160,"C5",798540,1435556700,"2015-06-28 22:45:00"
"786","20150019050058-11",2,"2015-06-19 17:24:00",1434759840,"C5",175680,1434935520,"2015-06-21 18:12:00"
"2763","20152519052551-298",1,"2015-06-19 17:43:00",1434760980,"C0",262560,1435023540,"2015-06-22 18:39:00"
"1076","20153419053450-999",1,"2015-06-19 18:01:00",1434762060,"C4",62460,1434824520,"2015-06-20 11:22:00"
"5540","20151919051903-993",3,"2015-06-19 18:35:00",1434764100,"C0",96900,1434861000,"2015-06-20 21:30:00"
"1170","20152619052643-277",3,"2015-06-19 18:37:00",1434764220,"C3",144360,1434908580,"2015-06-21 10:43:00"
"4217","20152319052357-61",3,"2015-06-19 18:40:00",1434764400,"C0",349140,1435113540,"2015-06-23 19:39:00"
"3216","20152020062041-92",3,"2015-06-20 07:19:00",1434809940,"C2",340980,1435150920,"2015-06-24 06:02:00"
"4858","20155720065732-452",1,"2015-06-20 07:27:00",1434810420,"C3",168660,1434979080,"2015-06-22 06:18:00"
"516","20152120062126-798",2,"2015-06-20 07:33:00",1434810780,"C0",87900,1434898680,"2015-06-21 07:58:00"
"113","20150620070638-960",1,"2015-06-20 07:34:00",1434810840,"C3",795960,1435606800,"2015-06-29 12:40:00"
"1500","20155620065658-617",1,"2015-06-20 08:00:00",1434812400,"C2",425940,1435238340,"2015-06-25 06:19:00"
"613","20155420065446-200",3,"2015-06-20 08:01:00",1434812460,"C5",352560,1435165020,"2015-06-24 09:57:00"
"4190","20154520074540-882",3,"2015-06-20 08:08:00",1434812880,"C8",880380,1435693260,"2015-06-30 12:41:00"
"6449","20151120071106-120",1,"2015-06-20 08:12:00",1434813120,"C5",111180,1434924300,"2015-06-21 15:05:00"
"2450","20150820070819-746",2,"2015-06-20 08:21:00",1434813660,"C0",133620,1434947280,"2015-06-21 21:28:00"
"899","20153920073949-207",1,"2015-06-20 08:33:00",1434814380,"C5",437520,1435251900,"2015-06-25 10:05:00"
"3929","20151020081012-980",1,"2015-06-20 08:48:00",1434815280,"C0",537420,1435352700,"2015-06-26 14:05:00"
"1515","20151720081740-125",3,"2015-06-20 08:51:00",1434815460,"C8",107160,1434922620,"2015-06-21 14:37:00"
"3627","20154220084208-864",2,"2015-06-20 09:29:00",1434817740,"C8",172860,1434990600,"2015-06-22 09:30:00"
"1788","20151320091309-87",1,"2015-06-20 09:41:00",1434818460,"C4",85320,1434903780,"2015-06-21 09:23:00"
"4184","20151020091049-173",1,"2015-06-20 09:46:00",1434818760,"C2",431280,1435250040,"2015-06-25 09:34:00"
"2250","20155020095009-169",3,"2015-06-20 10:11:00",1434820260,"C7",337140,1435157400,"2015-06-24 07:50:00"
"4660","20154920094954-832",3,"2015-06-20 10:14:00",1434820440,"C5",114360,1434934800,"2015-06-21 18:00:00"
"4372","20151920091934-950",1,"2015-06-20 10:20:00",1434820800,"C2",243600,1435064400,"2015-06-23 06:00:00"
"2165","20155720095752-177",1,"2015-06-20 10:27:00",1434821220,"C2",217320,1435038540,"2015-06-22 22:49:00"
"3787","20150420100412-238",2,"2015-06-20 10:39:00",1434821940,"C2",128280,1434950220,"2015-06-21 22:17:00"
"3882","20151920101933-665",1,"2015-06-20 10:47:00",1434822420,"C5",892980,1435715400,"2015-06-30 18:50:00"
"268","20153320113340-933",1,"2015-06-20 11:41:00",1434825660,"C8",126000,1434951660,"2015-06-21 22:41:00"
"6188","20153120103108-805",2,"2015-06-20 11:47:00",1434826020,"C2",170220,1434996240,"2015-06-22 11:04:00"
"1768","20155420105422-518",3,"2015-06-20 11:52:00",1434826320,"C4",174660,1435000980,"2015-06-22 12:23:00"
"4658","20152220112252-143",1,"2015-06-20 11:57:00",1434826620,"C2",280260,1435106880,"2015-06-23 17:48:00"
"6221","20150420110457-500",2,"2015-06-20 11:58:00",1434826680,"C4",168240,1434994920,"2015-06-22 10:42:00"
"3309","20150720110747-627",1,"2015-06-20 12:06:00",1434827160,"C3",117720,1434944880,"2015-06-21 20:48:00"
"6079","20154620114644-698",2,"2015-06-20 12:13:00",1434827580,"C5",458280,1435285860,"2015-06-25 19:31:00"
"1258","20150420120432-763",3,"2015-06-20 12:37:00",1434829020,"C8",72660,1434901680,"2015-06-21 08:48:00"
"3326","20154820114822-453",2,"2015-06-20 12:42:00",1434829320,"C4",159660,1434988980,"2015-06-22 09:03:00"
"1337","20155520125548-491",1,"2015-06-20 13:03:00",1434830580,"C8",84420,1434915000,"2015-06-21 12:30:00"
"6345","20152420122429-39",2,"2015-06-20 13:32:00",1434832320,"C6",232860,1435065180,"2015-06-23 06:13:00"
"6357","20153920123932-501",2,"2015-06-20 13:36:00",1434832560,"C8",664860,1435497420,"2015-06-28 06:17:00"
"2771","20155120125158-102",1,"2015-06-20 13:46:00",1434833160,"C5",1050600,1435883760,"2015-07-02 17:36:00"
"5890","20154520014506-55",1,"2015-06-20 14:17:00",1434835020,"C0",781140,1435616160,"2015-06-29 15:16:00"
"6200","20150320020348-641",2,"2015-06-20 14:27:00",1434835620,"C5",802500,1435638120,"2015-06-29 21:22:00"
"5771","20154320014349-634",1,"2015-06-20 14:34:00",1434836040,"C5",432720,1435268760,"2015-06-25 14:46:00"
"4414","20152420022419-264",2,"2015-06-20 14:54:00",1434837240,"C3",58080,1434895320,"2015-06-21 07:02:00"
"3527","20150120020159-683",1,"2015-06-20 15:10:00",1434838200,"C4",81300,1434919500,"2015-06-21 13:45:00"
"3655","20155620025615-452",1,"2015-06-20 15:18:00",1434838680,"C5",105720,1434944400,"2015-06-21 20:40:00"
"2957","20153020023013-76",1,"2015-06-20 15:23:00",1434838980,"C4",441960,1435280940,"2015-06-25 18:09:00"
"1103","20155820025849-226",2,"2015-06-20 15:27:00",1434839220,"C4",572220,1435411440,"2015-06-27 06:24:00"
"4196","20155720025749-383",1,"2015-06-20 15:40:00",1434840000,"C0",52740,1434892740,"2015-06-21 06:19:00"
"1358","20153520033505-60",1,"2015-06-20 15:43:00",1434840180,"C4",143280,1434983460,"2015-06-22 07:31:00"
"3786","20150320030349-572",1,"2015-06-20 16:07:00",1434841620,"C5",453660,1435295280,"2015-06-25 22:08:00"
"2177","20151520041535-563",2,"2015-06-20 16:41:00",1434843660,"C4",135300,1434978960,"2015-06-22 06:16:00"
"5004","20154520034536-573",2,"2015-06-20 16:52:00",1434844320,"C5",234420,1435078740,"2015-06-23 09:59:00"
"116","20152620042635-437",3,"2015-06-20 16:55:00",1434844500,"C5",314700,1435159200,"2015-06-24 08:20:00"
"2375","20152920042942-140",1,"2015-06-20 16:57:00",1434844620,"C4",169140,1435013760,"2015-06-22 15:56:00"
"5144","20155620035613-395",1,"2015-06-20 16:57:00",1434844620,"C2",86460,1434931080,"2015-06-21 16:58:00"
"2607","20153320043334-346",1,"2015-06-20 17:00:00",1434844800,"C8",776160,1435620960,"2015-06-29 16:36:00"
"3407","20150220040211-856",1,"2015-06-20 17:05:00",1434845100,"C4",263760,1435108860,"2015-06-23 18:21:00"
"4186","20152120042149-770",2,"2015-06-20 17:21:00",1434846060,"C2",322500,1435168560,"2015-06-24 10:56:00"
"3276","20153320043305-28",2,"2015-06-20 17:37:00",1434847020,"C2",577560,1435424580,"2015-06-27 10:03:00"
"2057","20153020053014-949",1,"2015-06-20 17:43:00",1434847380,"C7",56400,1434903780,"2015-06-21 09:23:00"
"6432","20151820051846-474",2,"2015-06-20 17:52:00",1434847920,"C8",59940,1434907860,"2015-06-21 10:31:00"
"2863","20154420054455-558",2,"2015-06-20 18:25:00",1434849900,"C0",149940,1434999840,"2015-06-22 12:04:00"
"1067","20153620053622-72",1,"2015-06-20 18:35:00",1434850500,"C0",161400,1435011900,"2015-06-22 15:25:00"
"6412","20154920054923-830",2,"2015-06-20 18:46:00",1434851160,"C8",144000,1434995160,"2015-06-22 10:46:00"
"3462","20151321061336-628",2,"2015-06-21 06:36:00",1434893760,"C5",1008600,1435902360,"2015-07-02 22:46:00"
"2281","20155121065100-589",1,"2015-06-21 07:22:00",1434896520,"C4",99720,1434996240,"2015-06-22 11:04:00"
"5421","20154221064205-207",1,"2015-06-21 07:39:00",1434897540,"C7",480300,1435377840,"2015-06-26 21:04:00"
"4727","20153021073045-85",1,"2015-06-21 07:51:00",1434898260,"C8",303120,1435201380,"2015-06-24 20:03:00"
"6074","20153721073751-968",1,"2015-06-21 07:55:00",1434898500,"C6",621900,1435520400,"2015-06-28 12:40:00"
"3253","20154521074546-272",2,"2015-06-21 08:16:00",1434899760,"C5",137640,1435037400,"2015-06-22 22:30:00"
"2255","20155721075705-83",1,"2015-06-21 08:23:00",1434900180,"C8",285360,1435185540,"2015-06-24 15:39:00"
"2053","20153821073821-483",1,"2015-06-21 08:28:00",1434900480,"C8",127860,1435028340,"2015-06-22 19:59:00"
"2509","20150221080233-162",1,"2015-06-21 08:33:00",1434900780,"C5",816840,1435717620,"2015-06-30 19:27:00"
"2328","20150221080255-974",3,"2015-06-21 08:37:00",1434901020,"C5",93780,1434994800,"2015-06-22 10:40:00"
"3214","20155121075125-805",2,"2015-06-21 08:50:00",1434901800,"C4",351420,1435253220,"2015-06-25 10:27:00"
"5778","20155721085718-188",2,"2015-06-21 09:03:00",1434902580,"C8",805920,1435708500,"2015-06-30 16:55:00"
"3454","20154121084107-952",3,"2015-06-21 09:05:00",1434902700,"C5",644820,1435547520,"2015-06-28 20:12:00"
"6225","20150521080528-185",1,"2015-06-21 09:06:00",1434902760,"C6",526740,1435429500,"2015-06-27 11:25:00"
"2389","20150521090524-397",1,"2015-06-21 09:07:00",1434902820,"C6",822840,1435725660,"2015-06-30 21:41:00"
"5031","20152921082906-529",3,"2015-06-21 09:19:00",1434903540,"C4",457680,1435361220,"2015-06-26 16:27:00"
"5697","20152521082543-773",2,"2015-06-21 09:33:00",1434904380,"C2",74820,1434979200,"2015-06-22 06:20:00"
"2833","20153921093922-779",2,"2015-06-21 10:04:00",1434906240,"C5",375540,1435281780,"2015-06-25 18:23:00"
"4914","20154521094550-685",1,"2015-06-21 10:18:00",1434907080,"C4",557400,1435464480,"2015-06-27 21:08:00"
"6414","20155721095721-40",1,"2015-06-21 10:18:00",1434907080,"C5",71580,1434978660,"2015-06-22 06:11:00"
"5315","20150621090620-651",2,"2015-06-21 10:21:00",1434907260,"C0",506280,1435413540,"2015-06-27 06:59:00"
"3542","20153221093222-957",2,"2015-06-21 10:34:00",1434908040,"C8",119580,1435027620,"2015-06-22 19:47:00"
"988","20152921092953-210",2,"2015-06-21 10:39:00",1434908340,"C2",250020,1435158360,"2015-06-24 08:06:00"
"5197","20155021095034-253",3,"2015-06-21 10:42:00",1434908520,"C7",92040,1435000560,"2015-06-22 12:16:00"
"4948","20151121111157-61",3,"2015-06-21 11:18:00",1434910680,"C8",105960,1435016640,"2015-06-22 16:44:00"
"4041","20154821104859-297",2,"2015-06-21 11:52:00",1434912720,"C5",171720,1435084440,"2015-06-23 11:34:00"
"5779","20153121113129-538",2,"2015-06-21 12:05:00",1434913500,"C2",203100,1435116600,"2015-06-23 20:30:00"
"5375","20151921121956-754",3,"2015-06-21 12:22:00",1434914520,"C6",241680,1435156200,"2015-06-24 07:30:00"
"6359","20154021124002-193",3,"2015-06-21 12:45:00",1434915900,"C2",245040,1435160940,"2015-06-24 08:49:00"
"5199","20151521121533-656",1,"2015-06-21 12:46:00",1434915960,"C3",527160,1435443120,"2015-06-27 15:12:00"
"4046","20154121124110-292",1,"2015-06-21 12:48:00",1434916080,"C4",712980,1435629060,"2015-06-29 18:51:00"
"6296","20153121123116-781",3,"2015-06-21 12:53:00",1434916380,"C4",85620,1435002000,"2015-06-22 12:40:00"
"3124","20154321124336-179",1,"2015-06-21 13:14:00",1434917640,"C0",1581180,1436498820,"2015-07-09 20:27:00"
"1511","20151121121107-368",1,"2015-06-21 13:18:00",1434917880,"C2",114540,1435032420,"2015-06-22 21:07:00"
"5788","20151821121849-891",3,"2015-06-21 13:23:00",1434918180,"C4",185340,1435103520,"2015-06-23 16:52:00"
"6063","20155021125027-18",1,"2015-06-21 13:27:00",1434918420,"C0",507480,1435425900,"2015-06-27 10:25:00"
"2823","20150921010943-734",2,"2015-06-21 14:00:00",1434920400,"C8",280200,1435200600,"2015-06-24 19:50:00"
"4402","20152721012702-519",2,"2015-06-21 14:05:00",1434920700,"C2",87900,1435008600,"2015-06-22 14:30:00"
"2024","20151621011631-58",1,"2015-06-21 14:08:00",1434920880,"C5",319380,1435240260,"2015-06-25 06:51:00"
"5657","20150621010643-875",2,"2015-06-21 14:15:00",1434921300,"C7",104040,1435025340,"2015-06-22 19:09:00"
"1451","20154421014437-375",1,"2015-06-21 14:44:00",1434923040,"C4",164820,1435087860,"2015-06-23 12:31:00"
"2267","20154021014001-277",2,"2015-06-21 14:48:00",1434923280,"C2",340260,1435263540,"2015-06-25 13:19:00"
"2363","20154521024518-105",2,"2015-06-21 15:14:00",1434924840,"C4",537840,1435462680,"2015-06-27 20:38:00"
"2396","20155221025244-122",1,"2015-06-21 15:19:00",1434925140,"C4",684600,1435609740,"2015-06-29 13:29:00"
"4019","20152421022448-172",1,"2015-06-21 15:26:00",1434925560,"C3",76380,1435001940,"2015-06-22 12:39:00"
"6362","20153621033624-514",3,"2015-06-21 15:47:00",1434926820,"C3",281100,1435207920,"2015-06-24 21:52:00"
"312","20154821034852-404",1,"2015-06-21 16:27:00",1434929220,"C0",789120,1435718340,"2015-06-30 19:39:00"
"1086","20151221041237-821",1,"2015-06-21 16:33:00",1434929580,"C5",436440,1435366020,"2015-06-26 17:47:00"
"2757","20155121035116-274",1,"2015-06-21 16:43:00",1434930180,"C4",311220,1435241400,"2015-06-25 07:10:00"
"5618","20153521043509-287",2,"2015-06-21 17:00:00",1434931200,"C5",341280,1435272480,"2015-06-25 15:48:00"
"2590","20155621035631-676",2,"2015-06-21 17:02:00",1434931320,"C5",395640,1435326960,"2015-06-26 06:56:00"
"4984","20153521043512-619",2,"2015-06-21 17:02:00",1434931320,"C4",335940,1435267260,"2015-06-25 14:21:00"
"2156","20151021041005-169",1,"2015-06-21 17:10:00",1434931800,"C8",101580,1435033380,"2015-06-22 21:23:00"
"1628","20154821044849-587",3,"2015-06-21 17:11:00",1434931860,"C6",184200,1435116060,"2015-06-23 20:21:00"
"3237","20153721043746-702",3,"2015-06-21 17:15:00",1434932100,"C0",171480,1435103580,"2015-06-23 16:53:00"
"3693","20151821051837-55",1,"2015-06-21 17:46:00",1434933960,"C3",148140,1435082100,"2015-06-23 10:55:00"
"5226","20155021055038-706",3,"2015-06-21 18:13:00",1434935580,"C7",83520,1435019100,"2015-06-22 17:25:00"
"3002","20150122060128-25",2,"2015-06-22 06:33:00",1434979980,"C7",194100,1435174080,"2015-06-24 12:28:00"
"759","20152522072551-380",2,"2015-06-22 08:16:00",1434986160,"C4",126960,1435113120,"2015-06-23 19:32:00"
"5541","20154522074550-726",3,"2015-06-22 08:19:00",1434986340,"C0",262260,1435248600,"2015-06-25 09:10:00"
"2202","20155022075038-528",1,"2015-06-22 08:21:00",1434986460,"C2",184140,1435170600,"2015-06-24 11:30:00"
"5095","20150422080420-314",3,"2015-06-22 08:45:00",1434987900,"C0",114120,1435102020,"2015-06-23 16:27:00"
"379","20150822090837-736",2,"2015-06-22 09:37:00",1434991020,"C8",99180,1435090200,"2015-06-23 13:10:00"
"4996","20152422092440-277",1,"2015-06-22 09:45:00",1434991500,"C8",73260,1435064760,"2015-06-23 06:06:00"
"2526","20150122090132-684",1,"2015-06-22 09:58:00",1434992280,"C5",462060,1435454340,"2015-06-27 18:19:00"
"999","20150722100759-856",3,"2015-06-22 10:30:00",1434994200,"C5",100920,1435095120,"2015-06-23 14:32:00"
"5350","20151722101732-165",2,"2015-06-22 10:55:00",1434995700,"C6",193320,1435189020,"2015-06-24 16:37:00"
"2162","20155622095638-223",2,"2015-06-22 10:57:00",1434995820,"C5",536700,1435532520,"2015-06-28 16:02:00"
"3819","20151022101006-317",1,"2015-06-22 11:10:00",1434996600,"C4",387060,1435383660,"2015-06-26 22:41:00"
"6330","20154422114404-501",1,"2015-06-22 12:08:00",1435000080,"C5",422460,1435422540,"2015-06-27 09:29:00"
"1019","20152322112332-133",1,"2015-06-22 12:19:00",1435000740,"C3",281340,1435282080,"2015-06-25 18:28:00"
"5335","20153122113135-902",1,"2015-06-22 12:35:00",1435001700,"C7",162240,1435163940,"2015-06-24 09:39:00"
"507","20155522115544-987",2,"2015-06-22 12:49:00",1435002540,"C4",74340,1435076880,"2015-06-23 09:28:00"
"2624","20151322121351-809",1,"2015-06-22 13:08:00",1435003680,"C8",194760,1435198440,"2015-06-24 19:14:00"
"866","20155822125820-486",1,"2015-06-22 13:34:00",1435005240,"C0",686100,1435691340,"2015-06-30 12:09:00"
"1898","20155122015143-390",2,"2015-06-22 13:54:00",1435006440,"C6",427560,1435434000,"2015-06-27 12:40:00"
"4427","20153222013237-308",1,"2015-06-22 14:00:00",1435006800,"C4",460680,1435467480,"2015-06-27 21:58:00"
"4047","20155122015113-891",1,"2015-06-22 14:15:00",1435007700,"C5",101580,1435109280,"2015-06-23 18:28:00"
"3607","20152222012249-468",3,"2015-06-22 14:17:00",1435007820,"C5",159240,1435167060,"2015-06-24 10:31:00"
"4768","20150222020245-78",1,"2015-06-22 14:23:00",1435008180,"C8",351480,1435359660,"2015-06-26 16:01:00"
"4811","20155922015952-462",1,"2015-06-22 14:54:00",1435010040,"C8",400080,1435410120,"2015-06-27 06:02:00"
"58","20151422021453-376",2,"2015-06-22 15:08:00",1435010880,"C7",163560,1435174440,"2015-06-24 12:34:00"
"5991","20150522030548-312",1,"2015-06-22 15:21:00",1435011660,"C7",180780,1435192440,"2015-06-24 17:34:00"
"4967","20151222031241-371",1,"2015-06-22 15:50:00",1435013400,"C2",100980,1435114380,"2015-06-23 19:53:00"
"724","20154922024915-450",3,"2015-06-22 15:54:00",1435013640,"C4",234240,1435247880,"2015-06-25 08:58:00"
"2305","20153722033750-276",1,"2015-06-22 16:08:00",1435014480,"C5",254340,1435268820,"2015-06-25 14:47:00"
"1866","20151122031145-815",2,"2015-06-22 16:10:00",1435014600,"C6",99480,1435114080,"2015-06-23 19:48:00"
"4447","20154722034718-115",2,"2015-06-22 16:21:00",1435015260,"C2",669180,1435684440,"2015-06-30 10:14:00"
"4983","20150422040421-938",1,"2015-06-22 16:56:00",1435017360,"C8",76380,1435093740,"2015-06-23 14:09:00"
"26","20153622043643-625",1,"2015-06-22 17:02:00",1435017720,"C5",78540,1435096260,"2015-06-23 14:51:00"
"5096","20151522051555-293",3,"2015-06-22 17:21:00",1435018860,"C2",48480,1435067340,"2015-06-23 06:49:00"
"3529","20153322053325-204",3,"2015-06-22 17:59:00",1435021140,"C5",189780,1435210920,"2015-06-24 22:42:00"
"5848","20155122055116-333",1,"2015-06-22 18:21:00",1435022460,"C4",699420,1435721880,"2015-06-30 20:38:00"
"6080","20151722051724-428",1,"2015-06-22 18:24:00",1435022640,"C5",340200,1435362840,"2015-06-26 16:54:00"
"3315","20151823061853-546",1,"2015-06-23 06:51:00",1435067460,"C3",140700,1435208160,"2015-06-24 21:56:00"
"2865","20154623064643-371",1,"2015-06-23 07:24:00",1435069440,"C2",101340,1435170780,"2015-06-24 11:33:00"
"295","20152923072910-395",2,"2015-06-23 07:37:00",1435070220,"C8",479100,1435549320,"2015-06-28 20:42:00"
"4255","20155023065026-661",1,"2015-06-23 07:49:00",1435070940,"C5",87060,1435158000,"2015-06-24 08:00:00"
"5418","20150523060517-30",1,"2015-06-23 07:49:00",1435070940,"C5",103500,1435174440,"2015-06-24 12:34:00"
"408","20155923075941-191",3,"2015-06-23 08:04:00",1435071840,"C2",119820,1435191660,"2015-06-24 17:21:00"
"5568","20154623074640-436",3,"2015-06-23 08:14:00",1435072440,"C5",285600,1435358040,"2015-06-26 15:34:00"
"1931","20155823075842-421",2,"2015-06-23 08:19:00",1435072740,"C6",194700,1435267440,"2015-06-25 14:24:00"
"3005","20152323072348-119",2,"2015-06-23 08:23:00",1435072980,"C2",165120,1435238100,"2015-06-25 06:15:00"
"861","20153623073655-303",2,"2015-06-23 08:29:00",1435073340,"C5",273960,1435347300,"2015-06-26 12:35:00"
"627","20154923074927-301",2,"2015-06-23 08:36:00",1435073760,"C6",123660,1435197420,"2015-06-24 18:57:00"
"238","20154623084625-271",2,"2015-06-23 09:15:00",1435076100,"C4",108480,1435184580,"2015-06-24 15:23:00"
"1153","20151823081833-359",1,"2015-06-23 09:17:00",1435076220,"C0",103980,1435180200,"2015-06-24 14:10:00"
"1419","20155523085557-121",2,"2015-06-23 09:22:00",1435076520,"C5",202680,1435279200,"2015-06-25 17:40:00"
"3484","20150723090724-2",1,"2015-06-23 09:23:00",1435076580,"C0",208740,1435285320,"2015-06-25 19:22:00"
"2525","20151323091336-516",1,"2015-06-23 09:36:00",1435077360,"C5",359460,1435436820,"2015-06-27 13:27:00"
"1352","20151223091224-134",2,"2015-06-23 09:55:00",1435078500,"C2",419820,1435498320,"2015-06-28 06:32:00"
"1434","20151223091254-664",1,"2015-06-23 10:13:00",1435079580,"C3",88560,1435168140,"2015-06-24 10:49:00"
"3488","20155123095125-681",2,"2015-06-23 10:49:00",1435081740,"C3",722220,1435803960,"2015-07-01 19:26:00"
"3538","20153723103701-496",3,"2015-06-23 11:02:00",1435082520,"C5",186600,1435269120,"2015-06-25 14:52:00"
"685","20153023103028-824",2,"2015-06-23 11:21:00",1435083660,"C5",866040,1435949700,"2015-07-03 11:55:00"
"1804","20155423105427-757",1,"2015-06-23 11:28:00",1435084080,"C3",614880,1435698960,"2015-06-30 14:16:00"
"1656","20155023115047-443",1,"2015-06-23 12:15:00",1435086900,"C5",86880,1435173780,"2015-06-24 12:23:00"
"2137","20150923010958-595",3,"2015-06-23 14:15:00",1435094100,"C5",583740,1435677840,"2015-06-30 08:24:00"
"4632","20154923014909-680",3,"2015-06-23 14:16:00",1435094160,"C5",623700,1435717860,"2015-06-30 19:31:00"
"571","20152123012131-392",2,"2015-06-23 14:18:00",1435094280,"C6",152640,1435246920,"2015-06-25 08:42:00"
"873","20150623020640-155",1,"2015-06-23 14:28:00",1435094880,"C5",93840,1435188720,"2015-06-24 16:32:00"
"6040","20153123023120-949",2,"2015-06-23 15:03:00",1435096980,"C4",286080,1435383060,"2015-06-26 22:31:00"
"4656","20152723022703-590",1,"2015-06-23 15:14:00",1435097640,"C1",1097640,1436195280,"2015-07-06 08:08:00"
"4970","20152123022155-571",1,"2015-06-23 15:27:00",1435098420,"C4",505260,1435603680,"2015-06-29 11:48:00"
"6175","20152823032800-166",3,"2015-06-23 15:30:00",1435098600,"C6",99780,1435198380,"2015-06-24 19:13:00"
"67","20152523032526-775",1,"2015-06-23 16:01:00",1435100460,"C3",137760,1435238220,"2015-06-25 06:17:00"
"5693","20150523030511-17",2,"2015-06-23 16:10:00",1435101000,"C3",186360,1435287360,"2015-06-25 19:56:00"
"5717","20150823040809-813",2,"2015-06-23 16:29:00",1435102140,"C8",787860,1435890000,"2015-07-02 19:20:00"
"195","20150123040140-843",3,"2015-06-23 16:31:00",1435102260,"C4",181740,1435284000,"2015-06-25 19:00:00"
"2336","20150323040301-184",1,"2015-06-23 16:43:00",1435102980,"C7",176640,1435279620,"2015-06-25 17:47:00"
"6423","20153723043748-531",2,"2015-06-23 17:08:00",1435104480,"C3",89400,1435193880,"2015-06-24 17:58:00"
"1868","20154023044047-684",1,"2015-06-23 17:10:00",1435104600,"C5",141600,1435246200,"2015-06-25 08:30:00"
"464","20151823051805-597",1,"2015-06-23 17:24:00",1435105440,"C2",614220,1435719660,"2015-06-30 20:01:00"
"1889","20153123053127-918",1,"2015-06-23 18:07:00",1435108020,"C0",63780,1435171800,"2015-06-24 11:50:00"
"5565","20151423051449-551",1,"2015-06-23 18:11:00",1435108260,"C3",141660,1435249920,"2015-06-25 09:32:00"
"426","20150723050745-341",1,"2015-06-23 18:15:00",1435108500,"C8",159840,1435268340,"2015-06-25 14:39:00"
"4937","20151623051636-911",2,"2015-06-23 18:23:00",1435108980,"C2",70500,1435179480,"2015-06-24 13:58:00"
"2007","20154723054713-268",1,"2015-06-23 18:26:00",1435109160,"C7",531720,1435640880,"2015-06-29 22:08:00"
"5310","20154123054103-632",1,"2015-06-23 18:40:00",1435110000,"C3",318960,1435428960,"2015-06-27 11:16:00"
"5059","20153624063634-720",2,"2015-06-24 06:43:00",1435153380,"C4",110340,1435263720,"2015-06-25 13:22:00"
"3270","20152424062413-508",1,"2015-06-24 06:49:00",1435153740,"C5",97440,1435251180,"2015-06-25 09:53:00"
"4544","20151924061911-225",2,"2015-06-24 06:55:00",1435154100,"C2",447120,1435601220,"2015-06-29 11:07:00"
"3035","20153524063556-760",1,"2015-06-24 06:57:00",1435154220,"C5",137760,1435291980,"2015-06-25 21:13:00"
"3255","20152424062452-330",2,"2015-06-24 06:57:00",1435154220,"C5",472260,1435626480,"2015-06-29 18:08:00"
"3878","20153224063221-780",1,"2015-06-24 06:59:00",1435154340,"C4",306780,1435461120,"2015-06-27 20:12:00"
"5443","20150024060019-914",1,"2015-06-24 07:07:00",1435154820,"C5",541260,1435696080,"2015-06-30 13:28:00"
"1065","20151324061307-900",2,"2015-06-24 07:10:00",1435155000,"C6",537840,1435692840,"2015-06-30 12:34:00"
"5761","20150924070945-953",1,"2015-06-24 07:24:00",1435155840,"C7",396000,1435551840,"2015-06-28 21:24:00"
"1252","20154024064023-567",1,"2015-06-24 07:25:00",1435155900,"C8",989100,1436145000,"2015-07-05 18:10:00"
"4873","20152424062441-168",2,"2015-06-24 07:28:00",1435156080,"C4",731160,1435887240,"2015-07-02 18:34:00"
"2600","20155524065529-638",3,"2015-06-24 07:30:00",1435156200,"C0",725880,1435882080,"2015-07-02 17:08:00"
"1135","20153224073256-73",1,"2015-06-24 07:59:00",1435157940,"C5",611340,1435769280,"2015-07-01 09:48:00"
"2973","20152624072652-602",3,"2015-06-24 08:01:00",1435158060,"C5",696540,1435854600,"2015-07-02 09:30:00"
"6438","20155324075339-328",1,"2015-06-24 08:14:00",1435158840,"C8",209820,1435368660,"2015-06-26 18:31:00"
"5349","20155324075301-513",3,"2015-06-24 08:25:00",1435159500,"C4",178380,1435337880,"2015-06-26 09:58:00"
"5650","20152524082502-366",1,"2015-06-24 08:58:00",1435161480,"C5",268260,1435429740,"2015-06-27 11:29:00"
"918","20155324085325-903",3,"2015-06-24 09:19:00",1435162740,"C3",121800,1435284540,"2015-06-25 19:09:00"
"3417","20155524085551-928",1,"2015-06-24 09:27:00",1435163220,"C4",346860,1435510080,"2015-06-28 09:48:00"
"6047","20150024090008-901",1,"2015-06-24 09:30:00",1435163400,"C8",383280,1435546680,"2015-06-28 19:58:00"
"5596","20154424084414-48",1,"2015-06-24 09:37:00",1435163820,"C4",614460,1435778280,"2015-07-01 12:18:00"
"3751","20153824083801-208",1,"2015-06-24 09:39:00",1435163940,"C4",291300,1435455240,"2015-06-27 18:34:00"
"1095","20154324084313-457",2,"2015-06-24 09:44:00",1435164240,"C5",194760,1435359000,"2015-06-26 15:50:00"
"2760","20152224092219-261",1,"2015-06-24 09:46:00",1435164360,"C5",85800,1435250160,"2015-06-25 09:36:00"
"1285","20151924091906-140",3,"2015-06-24 10:08:00",1435165680,"C7",179820,1435345500,"2015-06-26 12:05:00"
"1537","20153624093618-492",1,"2015-06-24 10:12:00",1435165920,"C7",73200,1435239120,"2015-06-25 06:32:00"
"3173","20155124095131-809",1,"2015-06-24 10:33:00",1435167180,"C2",164880,1435332060,"2015-06-26 08:21:00"
"2423","20154624094613-438",2,"2015-06-24 10:49:00",1435168140,"C2",349380,1435517520,"2015-06-28 11:52:00"
"5265","20155424095403-620",1,"2015-06-24 10:52:00",1435168320,"C3",896700,1436065020,"2015-07-04 19:57:00"
"6161","20153924103929-927",3,"2015-06-24 10:52:00",1435168320,"C7",118200,1435286520,"2015-06-25 19:42:00"
"5727","20155824105804-483",2,"2015-06-24 11:28:00",1435170480,"C8",386760,1435557240,"2015-06-28 22:54:00"
"2677","20150524110507-879",2,"2015-06-24 11:35:00",1435170900,"C3",604980,1435775880,"2015-07-01 11:38:00"
"4528","20152824112857-18",1,"2015-06-24 12:10:00",1435173000,"C2",870600,1436043600,"2015-07-04 14:00:00"
"4663","20152124122113-381",3,"2015-06-24 12:43:00",1435174980,"C5",62340,1435237320,"2015-06-25 06:02:00"
"1779","20152824122825-461",2,"2015-06-24 12:57:00",1435175820,"C4",931080,1436106900,"2015-07-05 07:35:00"
"4036","20153524123538-428",1,"2015-06-24 13:01:00",1435176060,"C4",510420,1435686480,"2015-06-30 10:48:00"
"179","20154824124835-785",1,"2015-06-24 13:22:00",1435177320,"C0",181140,1435358460,"2015-06-26 15:41:00"
"5482","20150024010014-301",2,"2015-06-24 13:57:00",1435179420,"C4",277200,1435456620,"2015-06-27 18:57:00"
"3774","20150224010207-397",2,"2015-06-24 14:04:00",1435179840,"C0",415800,1435595640,"2015-06-29 09:34:00"
"4445","20153924013929-447",1,"2015-06-24 14:42:00",1435182120,"C4",619740,1435801860,"2015-07-01 18:51:00"
"6246","20155324015326-739",2,"2015-06-24 14:57:00",1435183020,"C8",278520,1435461540,"2015-06-27 20:19:00"
"857","20151724021705-148",1,"2015-06-24 15:19:00",1435184340,"C8",968460,1436152800,"2015-07-05 20:20:00"
"4262","20152124032130-189",1,"2015-06-24 15:51:00",1435186260,"C3",102600,1435288860,"2015-06-25 20:21:00"
"2129","20153324033312-407",3,"2015-06-24 15:58:00",1435186680,"C7",444180,1435630860,"2015-06-29 19:21:00"
"2485","20154024034035-259",2,"2015-06-24 16:09:00",1435187340,"C8",62040,1435249380,"2015-06-25 09:23:00"
"5168","20150224040251-670",1,"2015-06-24 16:33:00",1435188780,"C2",157140,1435345920,"2015-06-26 12:12:00"
"4898","20151224041202-651",2,"2015-06-24 16:35:00",1435188900,"C4",99540,1435288440,"2015-06-25 20:14:00"
"1045","20155124045148-189",1,"2015-06-24 16:58:00",1435190280,"C2",570480,1435760760,"2015-07-01 07:26:00"
"3065","20155024045031-794",3,"2015-06-24 17:13:00",1435191180,"C5",330540,1435521720,"2015-06-28 13:02:00"
"3873","20151924051922-114",2,"2015-06-24 17:25:00",1435191900,"C8",144960,1435336860,"2015-06-26 09:41:00"
"1498","20151924051901-835",2,"2015-06-24 17:34:00",1435192440,"C0",170760,1435363200,"2015-06-26 17:00:00"
"3228","20155624045618-21",1,"2015-06-24 18:07:00",1435194420,"C0",681960,1435876380,"2015-07-02 15:33:00"
"445","20154825064848-825",2,"2015-06-25 07:23:00",1435242180,"C7",187860,1435430040,"2015-06-27 11:34:00"
"1168","20153225063205-641",3,"2015-06-25 07:27:00",1435242420,"C5",169020,1435411440,"2015-06-27 06:24:00"
"380","20155725075744-903",1,"2015-06-25 07:59:00",1435244340,"C6",116700,1435361040,"2015-06-26 16:24:00"
"5943","20152925072930-684",3,"2015-06-25 07:59:00",1435244340,"C5",130260,1435374600,"2015-06-26 20:10:00"
"3347","20153025083001-968",3,"2015-06-25 08:58:00",1435247880,"C6",221880,1435469760,"2015-06-27 22:36:00"
"4333","20155425085422-138",1,"2015-06-25 08:59:00",1435247940,"C2",368760,1435616700,"2015-06-29 15:25:00"
"6235","20153725083712-151",3,"2015-06-25 09:09:00",1435248540,"C6",394320,1435642860,"2015-06-29 22:41:00"
"2377","20154525084548-607",2,"2015-06-25 09:24:00",1435249440,"C2",273180,1435522620,"2015-06-28 13:17:00"
"5227","20155725095739-361",2,"2015-06-25 10:21:00",1435252860,"C4",176160,1435429020,"2015-06-27 11:17:00"
"3354","20151025061010-490",2,"2015-06-25 10:46:00",1435254360,"C2",532080,1435786440,"2015-07-01 14:34:00"
"1728","20154725104717-951",2,"2015-06-25 11:01:00",1435255260,"C7",341100,1435596360,"2015-06-29 09:46:00"
"4411","20151525101516-848",2,"2015-06-25 11:08:00",1435255680,"C4",190560,1435446240,"2015-06-27 16:04:00"
"6185","20151625101651-52",1,"2015-06-25 11:17:00",1435256220,"C3",537060,1435793280,"2015-07-01 16:28:00"
"2745","20150225120206-4",1,"2015-06-25 12:07:00",1435259220,"C2",534780,1435794000,"2015-07-01 16:40:00"
"4535","20153125123107-117",2,"2015-06-25 13:11:00",1435263060,"C2",595080,1435858140,"2015-07-02 10:29:00"
"4838","20150425010456-10",1,"2015-06-25 13:19:00",1435263540,"C7",65460,1435329000,"2015-06-26 07:30:00"
"3155","20152325012334-763",1,"2015-06-25 13:45:00",1435265100,"C5",267240,1435532340,"2015-06-28 15:59:00"
"254","20153425013459-560",1,"2015-06-25 14:33:00",1435267980,"C5",352320,1435620300,"2015-06-29 16:25:00"
"525","20155525015513-235",2,"2015-06-25 14:34:00",1435268040,"C0",345720,1435613760,"2015-06-29 14:36:00"
"2060","20150325020345-881",3,"2015-06-25 14:38:00",1435268280,"C8",183600,1435451880,"2015-06-27 17:38:00"
"1197","20155625015652-201",2,"2015-06-25 14:54:00",1435269240,"C2",459960,1435729200,"2015-06-30 22:40:00"
"5807","20153125023152-681",2,"2015-06-25 15:02:00",1435269720,"C4",847200,1436116920,"2015-07-05 10:22:00"
"3578","20153125023115-598",1,"2015-06-25 15:06:00",1435269960,"C0",329040,1435599000,"2015-06-29 10:30:00"
"5340","20151625021614-449",1,"2015-06-25 15:29:00",1435271340,"C0",677520,1435948860,"2015-07-03 11:41:00"
"180","20152725032725-88",1,"2015-06-25 15:33:00",1435271580,"C2",154740,1435426320,"2015-06-27 10:32:00"
"4343","20152025032033-74",1,"2015-06-25 15:59:00",1435273140,"C2",358620,1435631760,"2015-06-29 19:36:00"
"4497","20155625025639-594",1,"2015-06-25 15:59:00",1435273140,"C3",255060,1435528200,"2015-06-28 14:50:00"
"5260","20154925034902-555",1,"2015-06-25 16:49:00",1435276140,"C5",350400,1435626540,"2015-06-29 18:09:00"
"3914","20154325044303-21",2,"2015-06-25 17:04:00",1435277040,"C5",331500,1435608540,"2015-06-29 13:09:00"
"704","20150025040004-379",2,"2015-06-25 17:10:00",1435277400,"C0",159540,1435436940,"2015-06-27 13:29:00"
"4557","20151025051035-258",1,"2015-06-25 17:36:00",1435278960,"C4",89400,1435368360,"2015-06-26 18:26:00"
"2110","20153525043522-499",1,"2015-06-25 17:42:00",1435279320,"C3",55620,1435334940,"2015-06-26 09:09:00"
"6468","20151325051319-382",3,"2015-06-25 17:42:00",1435279320,"C5",221640,1435500960,"2015-06-28 07:16:00"
"3755","20154925044945-414",1,"2015-06-25 17:49:00",1435279740,"C7",167040,1435446780,"2015-06-27 16:13:00"
"2626","20154825054846-818",1,"2015-06-25 18:15:00",1435281300,"C8",53460,1435334760,"2015-06-26 09:06:00"
"1996","20151626061648-946",3,"2015-06-26 06:50:00",1435326600,"C5",313200,1435639800,"2015-06-29 21:50:00"
"4737","20153126063149-265",1,"2015-06-26 06:52:00",1435326720,"C6",462660,1435789380,"2015-07-01 15:23:00"
"3115","20154126064136-539",3,"2015-06-26 06:59:00",1435327140,"C0",88440,1435415580,"2015-06-27 07:33:00"
"5488","20151726071747-488",1,"2015-06-26 07:35:00",1435329300,"C0",440880,1435770180,"2015-07-01 10:03:00"
"4531","20154526064518-551",2,"2015-06-26 07:36:00",1435329360,"C4",895620,1436224980,"2015-07-06 16:23:00"
"5638","20153826063809-399",1,"2015-06-26 07:46:00",1435329960,"C7",258240,1435588200,"2015-06-29 07:30:00"
"5696","20151926071934-564",3,"2015-06-26 08:13:00",1435331580,"C5",721440,1436053020,"2015-07-04 16:37:00"
"1108","20151026081006-92",2,"2015-06-26 08:30:00",1435332600,"C5",186300,1435518900,"2015-06-28 12:15:00"
"3590","20152326082325-308",1,"2015-06-26 09:02:00",1435334520,"C7",109200,1435443720,"2015-06-27 15:22:00"
"5060","20153926083915-568",3,"2015-06-26 09:21:00",1435335660,"C2",1374180,1436709840,"2015-07-12 07:04:00"
"3321","20150326090329-717",2,"2015-06-26 09:36:00",1435336560,"C8",210960,1435547520,"2015-06-28 20:12:00"
"2687","20151826091818-219",1,"2015-06-26 09:45:00",1435337100,"C5",98580,1435435680,"2015-06-27 13:08:00"
"3056","20152126092144-384",2,"2015-06-26 09:56:00",1435337760,"C5",92340,1435430100,"2015-06-27 11:35:00"
"1583","20153526093522-53",1,"2015-06-26 10:01:00",1435338060,"C5",334140,1435672200,"2015-06-30 06:50:00"
"4309","20150226090206-282",1,"2015-06-26 10:01:00",1435338060,"C3",285060,1435623120,"2015-06-29 17:12:00"
"2274","20152826092848-943",1,"2015-06-26 10:03:00",1435338180,"C6",214980,1435553160,"2015-06-28 21:46:00"
"4800","20150926090945-943",3,"2015-06-26 10:10:00",1435338600,"C5",197580,1435536180,"2015-06-28 17:03:00"
"3358","20151426091431-80",2,"2015-06-26 10:20:00",1435339200,"C0",1133880,1436473080,"2015-07-09 13:18:00"
"4743","20153226093201-782",3,"2015-06-26 10:37:00",1435340220,"C5",169680,1435509900,"2015-06-28 09:45:00"
"1459","20153626093628-77",2,"2015-06-26 10:50:00",1435341000,"C2",518580,1435859580,"2015-07-02 10:53:00"
"2725","20153326103309-465",2,"2015-06-26 10:52:00",1435341120,"C7",270180,1435611300,"2015-06-29 13:55:00"
"3973","20155826105805-860",1,"2015-06-26 11:26:00",1435343160,"C4",267660,1435610820,"2015-06-29 13:47:00"
"5552","20155626105649-404",1,"2015-06-26 11:30:00",1435343400,"C0",120420,1435463820,"2015-06-27 20:57:00"
"362","20150526110553-791",2,"2015-06-26 11:39:00",1435343940,"C4",1724820,1437068760,"2015-07-16 10:46:00"
"177","20150926110958-805",2,"2015-06-26 11:46:00",1435344360,"C0",285060,1435629420,"2015-06-29 18:57:00"
"1574","20150626110605-541",1,"2015-06-26 11:49:00",1435344540,"C2",1058760,1436403300,"2015-07-08 17:55:00"
"3738","20153126113104-616",1,"2015-06-26 11:58:00",1435345080,"C5",206040,1435551120,"2015-06-28 21:12:00"
"2968","20154726114701-192",1,"2015-06-26 12:08:00",1435345680,"C5",237180,1435582860,"2015-06-29 06:01:00"
"3657","20151326111319-353",1,"2015-06-26 12:16:00",1435346160,"C8",202620,1435548780,"2015-06-28 20:33:00"
"5612","20155926125931-19",1,"2015-06-26 13:04:00",1435349040,"C2",100800,1435449840,"2015-06-27 17:04:00"
"6216","20152226122251-984",3,"2015-06-26 13:14:00",1435349640,"C5",240060,1435589700,"2015-06-29 07:55:00"
"458","20150426010442-203",1,"2015-06-26 13:25:00",1435350300,"C5",115200,1435465500,"2015-06-27 21:25:00"
"1748","20154112014114-381",1,"2015-06-26 14:00:00",1435352400,"C6",204480,1435556880,"2015-06-28 22:48:00"
"1332","20153926013940-342",1,"2015-06-26 14:02:00",1435352520,"C5",508080,1435860600,"2015-07-02 11:10:00"
"2908","20155826125821-822",3,"2015-06-26 14:07:00",1435352820,"C3",72120,1435424940,"2015-06-27 10:09:00"
"3532","20154926014915-775",2,"2015-06-26 14:19:00",1435353540,"C0",592920,1435946460,"2015-07-03 11:01:00"
"1257","20152426012444-553",1,"2015-06-26 14:27:00",1435354020,"C5",65520,1435419540,"2015-06-27 08:39:00"
"5105","20153026023048-941",1,"2015-06-26 14:54:00",1435355640,"C5",194940,1435550580,"2015-06-28 21:03:00"
"1327","20153626023632-111",1,"2015-06-26 15:06:00",1435356360,"C0",233880,1435590240,"2015-06-29 08:04:00"
"4350","20150826020807-226",1,"2015-06-26 15:16:00",1435356960,"C8",157020,1435513980,"2015-06-28 10:53:00"
"4475","20154426024411-840",2,"2015-06-26 15:20:00",1435357200,"C0",277800,1435635000,"2015-06-29 20:30:00"
"2537","20153626023634-935",1,"2015-06-26 15:37:00",1435358220,"C2",55260,1435413480,"2015-06-27 06:58:00"
"4603","20154519024544-322",2,"2015-06-26 15:43:00",1435358580,"C4",201300,1435559880,"2015-06-28 23:38:00"
"2233","20154026034051-679",2,"2015-06-26 15:48:00",1435358880,"C8",102060,1435460940,"2015-06-27 20:09:00"
"5651","20152226032253-445",1,"2015-06-26 15:50:00",1435359000,"C4",247020,1435606020,"2015-06-29 12:27:00"
"109","20153026033020-755",3,"2015-06-26 15:51:00",1435359060,"C6",451920,1435810980,"2015-07-01 21:23:00"
"2188","20152826032848-662",1,"2015-06-26 16:04:00",1435359840,"C6",323100,1435682940,"2015-06-30 09:49:00"
"1490","20152726032754-124",1,"2015-06-26 16:32:00",1435361520,"C5",409140,1435770660,"2015-07-01 10:11:00"
"3894","20152726042728-687",2,"2015-06-26 16:47:00",1435362420,"C5",253260,1435615680,"2015-06-29 15:08:00"
"1732","20155126035129-589",2,"2015-06-26 16:53:00",1435362780,"C5",325620,1435688400,"2015-06-30 11:20:00"
"4757","20155026035048-916",1,"2015-06-26 16:57:00",1435363020,"C0",63060,1435426080,"2015-06-27 10:28:00"
"1186","20155826045826-106",2,"2015-06-26 17:15:00",1435364100,"C6",333600,1435697700,"2015-06-30 13:55:00"
"3185","20151926041922-655",1,"2015-06-26 17:16:00",1435364160,"C5",845940,1436210100,"2015-07-06 12:15:00"
"5731","20155826045853-500",1,"2015-06-26 17:29:00",1435364940,"C4",74160,1435439100,"2015-06-27 14:05:00"
"425","20153826053837-25",2,"2015-06-26 17:45:00",1435365900,"C4",263400,1435629300,"2015-06-29 18:55:00"
"3827","20153626053623-916",3,"2015-06-26 18:02:00",1435366920,"C4",794280,1436161200,"2015-07-05 22:40:00"
"741","20151526051513-980",1,"2015-06-26 18:05:00",1435367100,"C4",336540,1435703640,"2015-06-30 15:34:00"
"3921","20153426053424-13",1,"2015-06-26 18:21:00",1435368060,"C8",697200,1436065260,"2015-07-04 20:01:00"
"4388","20151127061106-88",3,"2015-06-27 06:52:00",1435413120,"C0",94500,1435507620,"2015-06-28 09:07:00"
"5067","20150227070202-589",2,"2015-06-27 07:24:00",1435415040,"C5",101580,1435516620,"2015-06-28 11:37:00"
"2621","20150827070822-694",3,"2015-06-27 07:33:00",1435415580,"C5",97080,1435512660,"2015-06-28 10:31:00"
"573","20150627070602-460",2,"2015-06-27 07:36:00",1435415760,"C5",113100,1435528860,"2015-06-28 15:01:00"
"3461","20150827070855-530",3,"2015-06-27 07:39:00",1435415940,"C8",304740,1435720680,"2015-06-30 20:18:00"
"6165","20151927081907-93",1,"2015-06-27 08:21:00",1435418460,"C6",134580,1435553040,"2015-06-28 21:44:00"
"3548","20151527081514-392",1,"2015-06-27 08:54:00",1435420440,"C7",198060,1435618500,"2015-06-29 15:55:00"
"4466","20154127084141-786",3,"2015-06-27 09:04:00",1435421040,"C5",126480,1435547520,"2015-06-28 20:12:00"
"2919","20151827081812-463",1,"2015-06-27 09:08:00",1435421280,"C4",180720,1435602000,"2015-06-29 11:20:00"
"549","20151927091933-671",2,"2015-06-27 09:54:00",1435424040,"C6",512700,1435936740,"2015-07-03 08:19:00"
"3857","20151727091758-4",3,"2015-06-27 10:02:00",1435424520,"C8",198540,1435623060,"2015-06-29 17:11:00"
"1199","20154627094625-389",2,"2015-06-27 10:09:00",1435424940,"C4",121380,1435546320,"2015-06-28 19:52:00"
"3666","20154627094652-597",1,"2015-06-27 10:22:00",1435425720,"C2",84720,1435510440,"2015-06-28 09:54:00"
"5236","20150027100030-310",1,"2015-06-27 10:31:00",1435426260,"C8",194220,1435620480,"2015-06-29 16:28:00"
"2888","20152827092833-950",2,"2015-06-27 10:34:00",1435426440,"C4",196200,1435622640,"2015-06-29 17:04:00"
"2555","20154527104510-24",1,"2015-06-27 10:52:00",1435427520,"C4",122700,1435550220,"2015-06-28 20:57:00"
"3645","20151927101928-443",1,"2015-06-27 10:53:00",1435427580,"C0",246660,1435674240,"2015-06-30 07:24:00"
"3045","20155827095826-435",1,"2015-06-27 10:57:00",1435427820,"C8",440280,1435868100,"2015-07-02 13:15:00"
"1948","20153627113639-711",1,"2015-06-27 12:02:00",1435431720,"C3",99960,1435531680,"2015-06-28 15:48:00"
"1163","20152027112040-21",2,"2015-06-27 12:08:00",1435432080,"C8",204120,1435636200,"2015-06-29 20:50:00"
"5302","20154127114129-6",1,"2015-06-27 12:08:00",1435432080,"C8",180300,1435612380,"2015-06-29 14:13:00"
"4798","20154227114255-944",1,"2015-06-27 12:17:00",1435432620,"C2",96960,1435529580,"2015-06-28 15:13:00"
"2276","20151027121025-240",1,"2015-06-27 12:32:00",1435433520,"C5",982080,1436415600,"2015-07-08 21:20:00"
"3003","20152127122100-117",1,"2015-06-27 12:45:00",1435434300,"C5",69960,1435504260,"2015-06-28 08:11:00"
"5296","20154827114820-401",1,"2015-06-27 12:56:00",1435434960,"C8",186660,1435621620,"2015-06-29 16:47:00"
"147","20150027120012-20",3,"2015-06-27 13:04:00",1435435440,"C4",277980,1435713420,"2015-06-30 18:17:00"
"2821","20151327011349-700",2,"2015-06-27 13:36:00",1435437360,"C5",780540,1436217900,"2015-07-06 14:25:00"
"2326","20150527020511-685",1,"2015-06-27 14:26:00",1435440360,"C8",182520,1435622880,"2015-06-29 17:08:00"
"2260","20150427020450-544",2,"2015-06-27 14:35:00",1435440900,"C2",694260,1436135160,"2015-07-05 15:26:00"
"2029","20150827020823-652",2,"2015-06-27 15:07:00",1435442820,"C0",228120,1435670940,"2015-06-30 06:29:00"
"3721","20154627024615-98",2,"2015-06-27 15:07:00",1435442820,"C6",687420,1436130240,"2015-07-05 14:04:00"
"3920","20154527024553-723",1,"2015-06-27 15:12:00",1435443120,"C5",344400,1435787520,"2015-07-01 14:52:00"
"4654","20152727032726-130",1,"2015-06-27 15:55:00",1435445700,"C4",140640,1435586340,"2015-06-29 06:59:00"
"651","20153927033926-724",3,"2015-06-27 16:01:00",1435446060,"C5",54000,1435500060,"2015-06-28 07:01:00"
"5212","20150127030110-863",1,"2015-06-27 16:13:00",1435446780,"C7",77340,1435524120,"2015-06-28 13:42:00"
"4572","20152927032921-834",1,"2015-06-27 16:41:00",1435448460,"C2",190680,1435639140,"2015-06-29 21:39:00"
"5368","20151927041904-297",3,"2015-06-27 16:55:00",1435449300,"C0",309480,1435758780,"2015-07-01 06:53:00"
"1237","20152827042814-470",2,"2015-06-27 16:58:00",1435449480,"C4",145560,1435595040,"2015-06-29 09:24:00"
"6276","20155827045831-194",1,"2015-06-27 17:26:00",1435451160,"C4",104580,1435555740,"2015-06-28 22:29:00"
"4725","20153727053754-806",1,"2015-06-27 18:09:00",1435453740,"C4",88800,1435542540,"2015-06-28 18:49:00"
"2080","20154227054240-936",1,"2015-06-27 18:13:00",1435453980,"C5",61200,1435515180,"2015-06-28 11:13:00"
"4303","20155327055311-62",3,"2015-06-27 18:15:00",1435454100,"C6",75420,1435529520,"2015-06-28 15:12:00"
"3981","20152128062123-84",3,"2015-06-28 06:52:00",1435499520,"C4",89340,1435588860,"2015-06-29 07:41:00"
"1217","20154928064939-570",2,"2015-06-28 07:01:00",1435500060,"C3",97920,1435597980,"2015-06-29 10:13:00"
"4548","20155428065442-400",3,"2015-06-28 07:02:00",1435500120,"C4",812340,1436312460,"2015-07-07 16:41:00"
"3906","20150828060845-403",3,"2015-06-28 07:04:00",1435500240,"C8",429120,1435929360,"2015-07-03 06:16:00"
"5262","20150128070124-874",1,"2015-06-28 07:09:00",1435500540,"C4",731700,1436232240,"2015-07-06 18:24:00"
"4765","20153728063706-624",2,"2015-06-28 07:37:00",1435502220,"C5",1313160,1436815380,"2015-07-13 12:23:00"
"287","20154428064410-192",3,"2015-06-28 07:38:00",1435502280,"C8",89880,1435592160,"2015-06-29 08:36:00"
"6329","20151928081935-515",2,"2015-06-28 08:47:00",1435506420,"C5",273000,1435779420,"2015-07-01 12:37:00"
"1809","20155528075553-143",1,"2015-06-28 08:51:00",1435506660,"C3",791580,1436298240,"2015-07-07 12:44:00"
"1937","20152728082727-282",1,"2015-06-28 08:54:00",1435506840,"C4",454200,1435961040,"2015-07-03 15:04:00"
"209","20152528092511-140",3,"2015-06-28 09:31:00",1435509060,"C8",73800,1435582860,"2015-06-29 06:01:00"
"396","20151128091155-501",1,"2015-06-28 09:44:00",1435509840,"C5",93600,1435603440,"2015-06-29 11:44:00"
"819","20154328084349-846",1,"2015-06-28 09:55:00",1435510500,"C0",473460,1435983960,"2015-07-03 21:26:00"
"449","20153028103038-731",3,"2015-06-28 10:33:00",1435512780,"C6",619920,1436132700,"2015-07-05 14:45:00"
"6337","20154128094123-201",1,"2015-06-28 10:40:00",1435513200,"C5",442800,1435956000,"2015-07-03 13:40:00"
"1082","20151728101733-413",3,"2015-06-28 10:41:00",1435513260,"C5",163020,1435676280,"2015-06-30 07:58:00"
"6502","20155828095857-94",2,"2015-06-28 11:07:00",1435514820,"C2",84360,1435599180,"2015-06-29 10:33:00"
"962","20153428103417-553",2,"2015-06-28 11:14:00",1435515240,"C2",519720,1436034960,"2015-07-04 11:36:00"
"4158","20152328112340-523",1,"2015-06-28 11:31:00",1435516260,"C8",67320,1435583580,"2015-06-29 06:13:00"
"963","20153128113151-636",1,"2015-06-28 11:38:00",1435516680,"C2",75600,1435592280,"2015-06-29 08:38:00"
"5923","20153428103458-866",2,"2015-06-28 11:42:00",1435516920,"C4",294960,1435811880,"2015-07-01 21:38:00"
"3164","20154128104144-208",2,"2015-06-28 11:46:00",1435517160,"C6",77160,1435594320,"2015-06-29 09:12:00"
"6372","20153028123046-38",3,"2015-06-28 12:52:00",1435521120,"C8",159720,1435680840,"2015-06-30 09:14:00"
"2285","20155228125210-442",3,"2015-06-28 13:06:00",1435521960,"C0",104520,1435626480,"2015-06-29 18:08:00"
"3154","20154928124919-762",2,"2015-06-28 13:16:00",1435522560,"C4",66900,1435589460,"2015-06-29 07:51:00"
"5600","20150828120844-852",1,"2015-06-28 13:16:00",1435522560,"C4",120960,1435643520,"2015-06-29 22:52:00"
"867","20152828012807-551",2,"2015-06-28 13:50:00",1435524600,"C6",291780,1435816380,"2015-07-01 22:53:00"
"6544","20151028011029-820",3,"2015-06-28 14:09:00",1435525740,"C0",82680,1435608420,"2015-06-29 13:07:00"
"3562","20150628010613-142",1,"2015-06-28 14:21:00",1435526460,"C2",67920,1435594380,"2015-06-29 09:13:00"
"1072","20155228015245-135",2,"2015-06-28 14:31:00",1435527060,"C3",439260,1435966320,"2015-07-03 16:32:00"
"3963","20153428023417-311",3,"2015-06-28 14:41:00",1435527660,"C8",64560,1435592220,"2015-06-29 08:37:00"
"4318","20154828014808-208",2,"2015-06-28 15:06:00",1435529160,"C2",516600,1436045760,"2015-07-04 14:36:00"
"6424","20155328035310-746",2,"2015-06-28 15:55:00",1435532100,"C6",609960,1436142060,"2015-07-05 17:21:00"
"1413","20152828112812-119",1,"2015-06-28 16:06:00",1435532760,"C3",87720,1435620480,"2015-06-29 16:28:00"
"568","20155328035326-113",2,"2015-06-28 16:11:00",1435533060,"C6",350160,1435883220,"2015-07-02 17:27:00"
"5282","20155528055512-788",2,"2015-06-28 18:02:00",1435539720,"C8",48060,1435587780,"2015-06-29 07:23:00"
"4931","20154228054230-169",1,"2015-06-28 18:15:00",1435540500,"C5",97620,1435638120,"2015-06-29 21:22:00"
"4527","20150028050007-273",2,"2015-06-28 21:44:00",1435553040,"C2",429120,1435982160,"2015-07-03 20:56:00"
"4687","20150629060651-645",3,"2015-06-29 06:39:00",1435585140,"C5",466440,1436051580,"2015-07-04 16:13:00"
"3563","20153029063054-508",1,"2015-06-29 06:54:00",1435586040,"C7",316860,1435902900,"2015-07-02 22:55:00"
"492","20153729063729-602",1,"2015-06-29 07:01:00",1435586460,"C5",82740,1435669200,"2015-06-30 06:00:00"
"6399","20150929060957-709",1,"2015-06-29 07:14:00",1435587240,"C0",101220,1435688460,"2015-06-30 11:21:00"
"6310","20153629073622-752",2,"2015-06-29 08:02:00",1435590120,"C8",284220,1435874340,"2015-07-02 14:59:00"
"1230","20153529083516-535",1,"2015-06-29 08:50:00",1435593000,"C0",85140,1435678140,"2015-06-30 08:29:00"
"6277","20151029081008-399",1,"2015-06-29 09:01:00",1435593660,"C7",301740,1435895400,"2015-07-02 20:50:00"
"2507","20151429091426-986",2,"2015-06-29 09:40:00",1435596000,"C5",178020,1435774020,"2015-07-01 11:07:00"
"339","20150129090159-131",2,"2015-06-29 09:44:00",1435596240,"C0",85800,1435682040,"2015-06-30 09:34:00"
"4039","20154129084132-74",1,"2015-06-29 09:49:00",1435596540,"C3",82560,1435679100,"2015-06-30 08:45:00"
"1553","20152529092504-987",2,"2015-06-29 09:57:00",1435597020,"C0",246000,1435843020,"2015-07-02 06:17:00"
"357","20153629093635-690",3,"2015-06-29 10:11:00",1435597860,"C6",850200,1436448060,"2015-07-09 06:21:00"
"3634","20155829095814-906",3,"2015-06-29 10:18:00",1435598280,"C7",164160,1435762440,"2015-07-01 07:54:00"
"879","20151929101959-58",3,"2015-06-29 10:27:00",1435598820,"C8",159060,1435757880,"2015-07-01 06:38:00"
"5134","20155729095741-271",1,"2015-06-29 10:52:00",1435600320,"C5",450180,1436050500,"2015-07-04 15:55:00"
"1373","20154729104715-725",1,"2015-06-29 10:54:00",1435600440,"C4",186600,1435787040,"2015-07-01 14:44:00"
"6546","20154829104840-718",1,"2015-06-29 11:12:00",1435601520,"C8",548160,1436149680,"2015-07-05 19:28:00"
"3724","20150529110523-979",2,"2015-06-29 11:27:00",1435602420,"C4",125580,1435728000,"2015-06-30 22:20:00"
"1831","20150729120752-754",2,"2015-06-29 12:38:00",1435606680,"C2",335640,1435942320,"2015-07-03 09:52:00"
"5667","20154929114937-129",2,"2015-06-29 12:43:00",1435606980,"C3",336120,1435943100,"2015-07-03 10:05:00"
"166","20151329011319-87",1,"2015-06-29 14:08:00",1435612080,"C5",158700,1435770780,"2015-07-01 10:13:00"
"18","20155529015507-923",1,"2015-06-29 14:21:00",1435612860,"C5",65160,1435678020,"2015-06-30 08:27:00"
"923","20154229014226-973",1,"2015-06-29 14:36:00",1435613760,"C8",319380,1435933140,"2015-07-03 07:19:00"
"1254","20150329020331-802",2,"2015-06-29 14:58:00",1435615080,"C4",659460,1436274540,"2015-07-07 06:09:00"
"4210","20150029030057-969",2,"2015-06-29 15:08:00",1435615680,"C4",452040,1436067720,"2015-07-04 20:42:00"
"4125","20155129025110-549",2,"2015-06-29 15:24:00",1435616640,"C2",60420,1435677060,"2015-06-30 08:11:00"
"4769","20152929022956-198",1,"2015-06-29 15:29:00",1435616940,"C0",193380,1435810320,"2015-07-01 21:12:00"
"5661","20152729032736-810",2,"2015-06-29 15:33:00",1435617180,"C2",108960,1435726140,"2015-06-30 21:49:00"
"6401","20152629022625-52",1,"2015-06-29 15:39:00",1435617540,"C2",424080,1436041620,"2015-07-04 13:27:00"
"5154","20152729032750-703",2,"2015-06-29 15:59:00",1435618740,"C0",61500,1435680240,"2015-06-30 09:04:00"
"2524","20155229035239-568",3,"2015-06-29 16:12:00",1435619520,"C7",50100,1435669620,"2015-06-30 06:07:00"
"5880","20153029033048-921",2,"2015-06-29 16:22:00",1435620120,"C8",65640,1435685760,"2015-06-30 10:36:00"
"2477","20153229033240-417",1,"2015-06-29 16:25:00",1435620300,"C5",196440,1435816740,"2015-07-01 22:59:00"
"3333","20153029033050-443",3,"2015-06-29 16:26:00",1435620360,"C3",153480,1435773840,"2015-07-01 11:04:00"
"2050","20153529033559-238",1,"2015-06-29 16:39:00",1435621140,"C5",505980,1436127120,"2015-07-05 13:12:00"
"3994","20152729042736-714",2,"2015-06-29 17:02:00",1435622520,"C0",436140,1436058660,"2015-07-04 18:11:00"
"291","20151429041405-463",1,"2015-06-29 17:08:00",1435622880,"C5",418920,1436041800,"2015-07-04 13:30:00"
"3870","20154629044625-977",2,"2015-06-29 17:16:00",1435623360,"C3",75900,1435699260,"2015-06-30 14:21:00"
"2084","20150229050210-638",1,"2015-06-29 17:25:00",1435623900,"C5",170280,1435794180,"2015-07-01 16:43:00"
"6552","20151229041225-130",1,"2015-06-29 17:28:00",1435624080,"C2",400740,1436024820,"2015-07-04 08:47:00"
"6258","20151929051927-102",1,"2015-06-29 17:45:00",1435625100,"C8",421560,1436046660,"2015-07-04 14:51:00"
"2623","20152329052335-690",1,"2015-06-29 17:46:00",1435625160,"C5",186300,1435811460,"2015-07-01 21:31:00"
"3830","20155929045944-214",1,"2015-06-29 18:16:00",1435626960,"C0",330720,1435957680,"2015-07-03 14:08:00"
"4220","20151429051412-750",1,"2015-06-29 18:19:00",1435627140,"C8",335880,1435963020,"2015-07-03 15:37:00"
"1079","20152030062014-252",2,"2015-06-30 06:44:00",1435671840,"C4",533940,1436205780,"2015-07-06 11:03:00"
"2003","20150330060312-987",1,"2015-06-30 06:58:00",1435672680,"C4",111720,1435784400,"2015-07-01 14:00:00"
"5478","20152730062723-66",2,"2015-06-30 07:04:00",1435673040,"C0",86520,1435759560,"2015-07-01 07:06:00"
"4095","20152730062720-372",1,"2015-06-30 07:10:00",1435673400,"C0",97800,1435771200,"2015-07-01 10:20:00"
"4915","20154430064432-451",2,"2015-06-30 07:36:00",1435674960,"C8",227640,1435902600,"2015-07-02 22:50:00"
"1572","20150730070718-674",2,"2015-06-30 08:04:00",1435676640,"C3",96000,1435772640,"2015-07-01 10:44:00"
"2694","20150730080701-11",2,"2015-06-30 08:29:00",1435678140,"C5",515700,1436193840,"2015-07-06 07:44:00"
"5433","20153130073133-253",3,"2015-06-30 08:36:00",1435678560,"C0",621480,1436300040,"2015-07-07 13:14:00"
"1857","20153130083112-439",2,"2015-06-30 09:05:00",1435680300,"C0",378180,1436058480,"2015-07-04 18:08:00"
"5437","20155830085850-481",1,"2015-06-30 09:16:00",1435680960,"C6",434400,1436115360,"2015-07-05 09:56:00"
"20","20155430085434-503",1,"2015-06-30 10:01:00",1435683660,"C7",418680,1436102340,"2015-07-05 06:19:00"
"6486","20150830090823-240",1,"2015-06-30 10:09:00",1435684140,"C8",390780,1436074920,"2015-07-04 22:42:00"
"4093","20151030091029-116",2,"2015-06-30 10:19:00",1435684740,"C5",469140,1436153880,"2015-07-05 20:38:00"
"5308","20152730102714-620",1,"2015-06-30 10:33:00",1435685580,"C2",551760,1436237340,"2015-07-06 19:49:00"
"5139","20153530093500-378",1,"2015-06-30 10:38:00",1435685880,"C2",79740,1435765620,"2015-07-01 08:47:00"
"1150","20154030104055-168",3,"2015-06-30 11:14:00",1435688040,"C2",538020,1436226060,"2015-07-06 16:41:00"
"2239","20154830104827-205",1,"2015-06-30 11:23:00",1435688580,"C0",176820,1435865400,"2015-07-02 12:30:00"
"3146","20153330113330-512",2,"2015-06-30 11:56:00",1435690560,"C5",160560,1435851120,"2015-07-02 08:32:00"
"4055","20150830110807-384",1,"2015-06-30 12:07:00",1435691220,"C8",201480,1435892700,"2015-07-02 20:05:00"
"4839","20150430120449-822",2,"2015-06-30 12:07:00",1435691220,"C6",194040,1435885260,"2015-07-02 18:01:00"
"5536","20155230115226-97",3,"2015-06-30 12:15:00",1435691700,"C8",1295640,1436987340,"2015-07-15 12:09:00"
"4150","20154530114544-776",1,"2015-06-30 12:41:00",1435693260,"C4",149460,1435842720,"2015-07-02 06:12:00"
"3308","20152230122233-577",1,"2015-06-30 12:45:00",1435693500,"C4",270120,1435963620,"2015-07-03 15:47:00"
"3361","20154730124723-254",3,"2015-06-30 13:01:00",1435694460,"C0",330060,1436024520,"2015-07-04 08:42:00"
"4355","20153730123713-648",1,"2015-06-30 13:08:00",1435694880,"C8",90600,1435785480,"2015-07-01 14:18:00"
"1385","20150930010911-718",1,"2015-06-30 13:17:00",1435695420,"C4",274260,1435969680,"2015-07-03 17:28:00"
"3926","20151430011409-669",1,"2015-06-30 13:42:00",1435696920,"C4",250980,1435947900,"2015-07-03 11:25:00"
"5759","20153830123835-677",1,"2015-06-30 13:43:00",1435696980,"C0",117780,1435814760,"2015-07-01 22:26:00"
"3189","20153830123858-160",1,"2015-06-30 13:45:00",1435697100,"C4",84480,1435781580,"2015-07-01 13:13:00"
"2942","20154630124651-529",1,"2015-06-30 13:51:00",1435697460,"C3",166740,1435864200,"2015-07-02 12:10:00"
"4441","20154430014454-721",1,"2015-06-30 14:07:00",1435698420,"C7",62160,1435760580,"2015-07-01 07:23:00"
"1348","20155030015058-336",1,"2015-06-30 14:23:00",1435699380,"C0",286920,1435986300,"2015-07-03 22:05:00"
"459","20155630015659-740",1,"2015-06-30 14:30:00",1435699800,"C8",115260,1435815060,"2015-07-01 22:31:00"
"2469","20152830022847-358",3,"2015-06-30 14:39:00",1435700340,"C3",103560,1435803900,"2015-07-01 19:25:00"
"6440","20153730013733-766",3,"2015-06-30 14:48:00",1435700880,"C0",64980,1435765860,"2015-07-01 08:51:00"
"1611","20152730022758-606",1,"2015-06-30 15:27:00",1435703220,"C2",197160,1435900380,"2015-07-02 22:13:00"
"4955","20150830030855-79",2,"2015-06-30 16:03:00",1435705380,"C8",1191660,1436897040,"2015-07-14 11:04:00"
"1657","20154530034515-528",1,"2015-06-30 16:12:00",1435705920,"C3",80400,1435786320,"2015-07-01 14:32:00"
"2344","20155230035222-748",2,"2015-06-30 16:15:00",1435706100,"C8",157020,1435863120,"2015-07-02 11:52:00"
"6053","20154430034436-879",2,"2015-06-30 16:15:00",1435706100,"C7",175860,1435881960,"2015-07-02 17:06:00"
"4956","20154630044606-595",3,"2015-06-30 16:53:00",1435708380,"C8",172440,1435880820,"2015-07-02 16:47:00"
"530","20150030050049-156",2,"2015-06-30 17:11:00",1435709460,"C3",258720,1435968180,"2015-07-03 17:03:00"
"5578","20151330051300-634",1,"2015-06-30 17:28:00",1435710480,"C0",256140,1435966620,"2015-07-03 16:37:00"
"2197","20152530052504-640",3,"2015-06-30 17:32:00",1435710720,"C8",231060,1435941780,"2015-07-03 09:43:00"
"523","20152130052126-284",1,"2015-06-30 18:14:00",1435713240,"C5",356580,1436069820,"2015-07-04 21:17:00"
"517","20155430055405-608",3,"2015-06-30 18:19:00",1435713540,"C5",65940,1435779480,"2015-07-01 12:38:00"
"5677","20153230053236-758",2,"2015-06-30 18:39:00",1435714740,"C5",158640,1435873380,"2015-07-02 14:43:00"
"3610","20150901060931-375",3,"2015-07-01 07:03:00",1435759380,"C4",188880,1435948260,"2015-07-03 11:31:00"
"5300","20151701071741-626",3,"2015-07-01 07:23:00",1435760580,"C2",136920,1435897500,"2015-07-02 21:25:00"
"3577","20152001072036-614",1,"2015-07-01 07:40:00",1435761600,"C7",780480,1436542080,"2015-07-10 08:28:00"
"5993","20153001073008-682",3,"2015-07-01 07:51:00",1435762260,"C7",535320,1436297580,"2015-07-07 12:33:00"
"3243","20150601070655-151",1,"2015-07-01 08:04:00",1435763040,"C5",475560,1436238600,"2015-07-06 20:10:00"
"118","20154701074721-510",2,"2015-07-01 08:18:00",1435763880,"C4",193140,1435957020,"2015-07-03 13:57:00"
"4588","20153401073437-826",3,"2015-07-01 08:25:00",1435764300,"C5",214200,1435978500,"2015-07-03 19:55:00"
"5998","20152801072801-74",1,"2015-07-01 08:27:00",1435764420,"C4",1383780,1437148200,"2015-07-17 08:50:00"
"488","20150001080044-124",1,"2015-07-01 08:33:00",1435764780,"C5",776100,1436540880,"2015-07-10 08:08:00"
"1354","20154201074239-779",2,"2015-07-01 08:36:00",1435764960,"C5",115080,1435880040,"2015-07-02 16:34:00"
"4317","20153601083632-281",3,"2015-07-01 08:41:00",1435765260,"C2",126960,1435892220,"2015-07-02 19:57:00"
"4164","20153101083156-266",2,"2015-07-01 08:46:00",1435765560,"C0",131040,1435896600,"2015-07-02 21:10:00"
"1323","20153801073845-972",1,"2015-07-01 08:47:00",1435765620,"C2",216780,1435982400,"2015-07-03 21:00:00"
"5851","20155101075136-111",1,"2015-07-01 08:50:00",1435765800,"C5",163080,1435928880,"2015-07-03 06:08:00"
"2307","20152401082424-321",1,"2015-07-01 08:51:00",1435765860,"C8",221580,1435987440,"2015-07-03 22:24:00"
"131","20155801085847-425",1,"2015-07-01 09:06:00",1435766760,"C4",336600,1436103360,"2015-07-05 06:36:00"
"3116","20155901075938-57",2,"2015-07-01 09:08:00",1435766880,"C8",285180,1436052060,"2015-07-04 16:21:00"
"4256","20154201084214-252",1,"2015-07-01 09:09:00",1435766940,"C5",439980,1436206920,"2015-07-06 11:22:00"
"668","20154801084800-755",1,"2015-07-01 09:14:00",1435767240,"C8",83100,1435850340,"2015-07-02 08:19:00"
"1137","20151101081129-848",1,"2015-07-01 09:15:00",1435767300,"C0",783840,1436551140,"2015-07-10 10:59:00"
"4438","20151001091034-497",1,"2015-07-01 09:30:00",1435768200,"C1",371700,1436139900,"2015-07-05 16:45:00"
"1691","20154501084530-202",2,"2015-07-01 09:42:00",1435768920,"C8",73500,1435842420,"2015-07-02 06:07:00"
"4154","20151701091730-48",3,"2015-07-01 09:42:00",1435768920,"C5",181680,1435950600,"2015-07-03 12:10:00"
"4459","20152401092405-316",3,"2015-07-01 10:14:00",1435770840,"C7",253860,1436024700,"2015-07-04 08:45:00"
"6283","20154201094221-490",3,"2015-07-01 10:18:00",1435771080,"C7",720780,1436491860,"2015-07-09 18:31:00"
"1242","20152201102241-597",3,"2015-07-01 10:43:00",1435772580,"C7",194520,1435967100,"2015-07-03 16:45:00"
"6076","20150801100813-808",1,"2015-07-01 11:11:00",1435774260,"C5",115380,1435889640,"2015-07-02 19:14:00"
"2291","20151801111852-365",1,"2015-07-01 11:21:00",1435774860,"C6",207240,1435982100,"2015-07-03 20:55:00"
"790","20154201104250-936",2,"2015-07-01 11:22:00",1435774920,"C2",126840,1435901760,"2015-07-02 22:36:00"
"3098","20155001105054-534",1,"2015-07-01 11:45:00",1435776300,"C4",100200,1435876500,"2015-07-02 15:35:00"
"1043","20155501105513-756",2,"2015-07-01 12:01:00",1435777260,"C4",71520,1435848780,"2015-07-02 07:53:00"
"2332","20153701113704-354",1,"2015-07-01 12:04:00",1435777440,"C4",555180,1436332620,"2015-07-07 22:17:00"
"1302","20152701112759-138",1,"2015-07-01 12:07:00",1435777620,"C7",688500,1436466120,"2015-07-09 11:22:00"
"170","20150801120859-136",2,"2015-07-01 12:11:00",1435777860,"C6",170100,1435947960,"2015-07-03 11:26:00"
"1234","20151301111308-417",1,"2015-07-01 12:16:00",1435778160,"C2",173580,1435951740,"2015-07-03 12:29:00"
"2190","20154201114254-498",2,"2015-07-01 12:16:00",1435778160,"C8",103140,1435881300,"2015-07-02 16:55:00"
"4635","20152601112611-300",2,"2015-07-01 12:31:00",1435779060,"C4",361260,1436140320,"2015-07-05 16:52:00"
"1774","20152601122623-54",1,"2015-07-01 12:56:00",1435780560,"C3",204960,1435985520,"2015-07-03 21:52:00"
"2442","20155501115549-423",2,"2015-07-01 12:57:00",1435780620,"C4",73620,1435854240,"2015-07-02 09:24:00"
"5468","20155501125529-527",3,"2015-07-01 13:02:00",1435780920,"C8",718980,1436499900,"2015-07-09 20:45:00"
"1297","20153801123847-62",1,"2015-07-01 13:07:00",1435781220,"C4",873060,1436654280,"2015-07-11 15:38:00"
"6458","20151101121144-520",2,"2015-07-01 13:08:00",1435781280,"C4",410340,1436191620,"2015-07-06 07:07:00"
"4375","20154801124855-611",3,"2015-07-01 13:10:00",1435781400,"C5",337200,1436118600,"2015-07-05 10:50:00"
"2232","20153601123633-561",1,"2015-07-01 13:12:00",1435781520,"C2",235740,1436017260,"2015-07-04 06:41:00"
"1443","20154001124007-163",1,"2015-07-01 13:17:00",1435781820,"C2",121140,1435902960,"2015-07-02 22:56:00"
"401","20153001123033-350",1,"2015-07-01 13:23:00",1435782180,"C4",803100,1436585280,"2015-07-10 20:28:00"
"611","20153301123341-61",2,"2015-07-01 13:37:00",1435783020,"C5",76440,1435859460,"2015-07-02 10:51:00"
"6317","20154501124525-792",2,"2015-07-01 13:45:00",1435783500,"C3",105360,1435888860,"2015-07-02 19:01:00"
"2611","20150001010009-284",3,"2015-07-01 13:51:00",1435783860,"C6",106620,1435890480,"2015-07-02 19:28:00"
"3543","20155901125946-822",2,"2015-07-01 13:55:00",1435784100,"C4",256140,1436040240,"2015-07-04 13:04:00"
"6537","20151001011026-433",1,"2015-07-01 14:05:00",1435784700,"C5",107820,1435892520,"2015-07-02 20:02:00"
"1802","20154101014157-341",1,"2015-07-01 14:13:00",1435785180,"C7",359160,1436144340,"2015-07-05 17:59:00"
"3049","20150801020830-440",1,"2015-07-01 14:33:00",1435786380,"C4",158220,1435944600,"2015-07-03 10:30:00"
"6241","20150201020251-919",2,"2015-07-01 14:35:00",1435786500,"C2",447300,1436233800,"2015-07-06 18:50:00"
"4546","20155901015947-373",2,"2015-07-01 14:40:00",1435786800,"C0",285480,1436072280,"2015-07-04 21:58:00"
"4940","20151801021811-599",1,"2015-07-01 14:40:00",1435786800,"C4",1398840,1437185640,"2015-07-17 19:14:00"
"887","20155401025432-410",1,"2015-07-01 15:08:00",1435788480,"C7",754920,1436543400,"2015-07-10 08:50:00"
"3917","20155601025658-508",1,"2015-07-01 15:14:00",1435788840,"C6",173400,1435962240,"2015-07-03 15:24:00"
"3405","20151501021548-648",1,"2015-07-01 15:18:00",1435789080,"C4",175980,1435965060,"2015-07-03 16:11:00"
"2922","20152301022309-569",2,"2015-07-01 15:22:00",1435789320,"C5",362520,1436151840,"2015-07-05 20:04:00"
"3210","20152301032339-982",2,"2015-07-01 15:39:00",1435790340,"C7",176760,1435967100,"2015-07-03 16:45:00"
"1920","20153101023158-837",1,"2015-07-01 15:40:00",1435790400,"C3",103800,1435894200,"2015-07-02 20:30:00"
"228","20154201024259-199",2,"2015-07-01 15:42:00",1435790520,"C7",485220,1436275740,"2015-07-07 06:29:00"
"3699","20152701022725-153",3,"2015-07-01 15:42:00",1435790520,"C2",401040,1436191560,"2015-07-06 07:06:00"
"892","20151501031546-207",3,"2015-07-01 15:47:00",1435790820,"C2",796740,1436587560,"2015-07-10 21:06:00"
"259","20151001031016-663",1,"2015-07-01 15:48:00",1435790880,"C2",138960,1435929840,"2015-07-03 06:24:00"
"3706","20155501035526-887",1,"2015-07-01 16:01:00",1435791660,"C2",313800,1436105460,"2015-07-05 07:11:00"
"3840","20153901033952-705",3,"2015-07-01 16:09:00",1435792140,"C5",875640,1436667780,"2015-07-11 19:23:00"
"2752","20151601031635-401",3,"2015-07-01 16:10:00",1435792200,"C7",183180,1435975380,"2015-07-03 19:03:00"
"4513","20155501035544-811",3,"2015-07-01 16:13:00",1435792380,"C6",243360,1436035740,"2015-07-04 11:49:00"
"4945","20154401034422-998",2,"2015-07-01 16:14:00",1435792440,"C5",404580,1436197020,"2015-07-06 08:37:00"
"3754","20150301040355-981",1,"2015-07-01 16:24:00",1435793040,"C5",521880,1436314920,"2015-07-07 17:22:00"
"4818","20150701040708-313",3,"2015-07-01 16:29:00",1435793340,"C5",172500,1435965840,"2015-07-03 16:24:00"
"2603","20151001041004-853",3,"2015-07-01 16:36:00",1435793760,"C8",602100,1436395860,"2015-07-08 15:51:00"
"3585","20150201040231-215",1,"2015-07-01 16:37:00",1435793820,"C2",232080,1436025900,"2015-07-04 09:05:00"
"1914","20151501041530-577",2,"2015-07-01 16:43:00",1435794180,"C4",742080,1436536260,"2015-07-10 06:51:00"
"3712","20152201042246-439",2,"2015-07-01 16:44:00",1435794240,"C7",764100,1436558340,"2015-07-10 12:59:00"
"3557","20151501041514-837",1,"2015-07-01 16:51:00",1435794660,"C7",336180,1436130840,"2015-07-05 14:14:00"
"3483","20155201035224-590",1,"2015-07-01 17:02:00",1435795320,"C0",497280,1436292600,"2015-07-07 11:10:00"
"5448","20154801044816-267",2,"2015-07-01 17:14:00",1435796040,"C5",430800,1436226840,"2015-07-06 16:54:00"
"1228","20151801041821-719",2,"2015-07-01 17:16:00",1435796160,"C7",313920,1436110080,"2015-07-05 08:28:00"
"4899","20151101051151-134",1,"2015-07-01 17:18:00",1435796280,"C4",55020,1435851300,"2015-07-02 08:35:00"
"4048","20150801050802-446",2,"2015-07-01 17:30:00",1435797000,"C4",222480,1436019480,"2015-07-04 07:18:00"
"699","20154501044554-839",2,"2015-07-01 17:52:00",1435798320,"C8",66960,1435865280,"2015-07-02 12:28:00"
"2609","20151802061810-813",1,"2015-07-02 06:34:00",1435844040,"C0",97380,1435941420,"2015-07-03 09:37:00"
"3416","20153502063540-65",1,"2015-07-02 07:03:00",1435845780,"C4",382740,1436228520,"2015-07-06 17:22:00"
"5457","20153802063824-325",3,"2015-07-02 07:38:00",1435847880,"C8",640920,1436488800,"2015-07-09 17:40:00"
"467","20153902073935-578",2,"2015-07-02 08:01:00",1435849260,"C8",109680,1435958940,"2015-07-03 14:29:00"
"1480","20155702065700-462",1,"2015-07-02 08:09:00",1435849740,"C7",86820,1435936560,"2015-07-03 08:16:00"
"1287","20152702082701-295",1,"2015-07-02 08:29:00",1435850940,"C6",119460,1435970400,"2015-07-03 17:40:00"
"6395","20154002074029-503",1,"2015-07-02 08:33:00",1435851180,"C5",105060,1435956240,"2015-07-03 13:44:00"
"4038","20151302081321-676",3,"2015-07-02 08:45:00",1435851900,"C4",110520,1435962420,"2015-07-03 15:27:00"
"5429","20151402081427-528",2,"2015-07-02 09:27:00",1435854420,"C2",473940,1436328360,"2015-07-07 21:06:00"
"2381","20153102093104-707",2,"2015-07-02 10:03:00",1435856580,"C3",519900,1436376480,"2015-07-08 10:28:00"
"779","20153902093914-109",1,"2015-07-02 10:09:00",1435856940,"C4",108960,1435965900,"2015-07-03 16:25:00"
"4260","20151002101014-792",3,"2015-07-02 10:44:00",1435859040,"C0",190080,1436049120,"2015-07-04 15:32:00"
"5273","20151502111546-232",1,"2015-07-02 12:16:00",1435864560,"C4",181680,1436046240,"2015-07-04 14:44:00"
"644","20150202120211-959",3,"2015-07-02 12:19:00",1435864740,"C7",371340,1436236080,"2015-07-06 19:28:00"
"1014","20151602121624-797",1,"2015-07-02 12:26:00",1435865160,"C3",455820,1436320980,"2015-07-07 19:03:00"
"4796","20150502120548-840",2,"2015-07-02 12:30:00",1435865400,"C4",461580,1436326980,"2015-07-07 20:43:00"
"5715","20154002114020-604",2,"2015-07-02 12:38:00",1435865880,"C5",268380,1436134260,"2015-07-05 15:11:00"
"2778","20155502115525-896",3,"2015-07-02 12:52:00",1435866720,"C3",113040,1435979760,"2015-07-03 20:16:00"
"2491","20150402120425-392",3,"2015-07-02 13:04:00",1435867440,"C2",99840,1435967280,"2015-07-03 16:48:00"
"893","20154702124720-238",3,"2015-07-02 13:13:00",1435867980,"C5",75360,1435943340,"2015-07-03 10:09:00"
"3450","20152102122135-146",2,"2015-07-02 13:28:00",1435868880,"C2",612960,1436481840,"2015-07-09 15:44:00"
"1074","20152302012357-409",1,"2015-07-02 13:37:00",1435869420,"C7",192240,1436061660,"2015-07-04 19:01:00"
"3962","20154402124413-668",3,"2015-07-02 13:51:00",1435870260,"C8",95460,1435965720,"2015-07-03 16:22:00"
"2210","20155502125507-435",1,"2015-07-02 14:04:00",1435871040,"C2",63780,1435934820,"2015-07-03 07:47:00"
"4578","20155902015910-865",1,"2015-07-02 14:05:00",1435871100,"C4",509460,1436380560,"2015-07-08 11:36:00"
"6187","20155002125000-291",1,"2015-07-02 14:08:00",1435871280,"C0",145380,1436016660,"2015-07-04 06:31:00"
"2583","20152902012912-255",3,"2015-07-02 14:10:00",1435871400,"C0",263700,1436135100,"2015-07-05 15:25:00"
"4709","20151202011253-62",3,"2015-07-02 14:10:00",1435871400,"C4",188820,1436060220,"2015-07-04 18:37:00"
"4916","20155002015002-492",1,"2015-07-02 14:17:00",1435871820,"C5",434160,1436305980,"2015-07-07 14:53:00"
"6194","20151202021203-963",1,"2015-07-02 14:19:00",1435871940,"C4",373740,1436245680,"2015-07-06 22:08:00"
"6210","20153302013336-618",1,"2015-07-02 14:41:00",1435873260,"C2",166980,1436040240,"2015-07-04 13:04:00"
"32","20152902022959-436",1,"2015-07-02 15:00:00",1435874400,"C0",1195500,1437069900,"2015-07-16 11:05:00"
"618","20152202022209-169",1,"2015-07-02 15:26:00",1435875960,"C0",674940,1436550900,"2015-07-10 10:55:00"
"5348","20151102031156-128",2,"2015-07-02 16:08:00",1435878480,"C8",514560,1436393040,"2015-07-08 15:04:00"
"1695","20151602031635-816",1,"2015-07-02 16:23:00",1435879380,"C3",257280,1436136660,"2015-07-05 15:51:00"
"2012","20154602034646-21",1,"2015-07-02 16:23:00",1435879380,"C2",187020,1436066400,"2015-07-04 20:20:00"
"2951","20153202033251-484",2,"2015-07-02 16:26:00",1435879560,"C5",227700,1436107260,"2015-07-05 07:41:00"
"261","20150702040704-305",1,"2015-07-02 16:38:00",1435880280,"C8",73200,1435953480,"2015-07-03 12:58:00"
"5019","20153602043607-343",1,"2015-07-02 17:31:00",1435883460,"C4",264900,1436148360,"2015-07-05 19:06:00"
"2518","20152302052353-71",1,"2015-07-02 17:50:00",1435884600,"C5",67680,1435952280,"2015-07-03 12:38:00"
"908","20153502053554-349",2,"2015-07-02 18:05:00",1435885500,"C8",233220,1436118720,"2015-07-05 10:52:00"
"4425","20152202052214-494",1,"2015-07-02 18:16:00",1435886160,"C4",585720,1436471880,"2015-07-09 12:58:00"
"235","20155302055357-472",1,"2015-07-02 18:24:00",1435886640,"C5",331260,1436217900,"2015-07-06 14:25:00"
"5992","20155802055814-251",2,"2015-07-02 18:37:00",1435887420,"C7",76020,1435963440,"2015-07-03 15:44:00"
"5438","20155402055423-909",1,"2015-07-02 18:53:00",1435888380,"C8",94140,1435982520,"2015-07-03 21:02:00"
"6129","20150603060632-383",2,"2015-07-03 06:27:00",1435930020,"C5",469020,1436399040,"2015-07-08 16:44:00"
"6016","20150203060259-209",2,"2015-07-03 06:33:00",1435930380,"C5",120480,1436050860,"2015-07-04 16:01:00"
"2755","20151603061640-724",2,"2015-07-03 06:38:00",1435930680,"C8",885720,1436816400,"2015-07-13 12:40:00"
"4316","20150203060230-10",1,"2015-07-03 07:02:00",1435932120,"C7",136320,1436068440,"2015-07-04 20:54:00"
"4924","20153403063427-228",3,"2015-07-03 07:02:00",1435932120,"C4",269940,1436202060,"2015-07-06 10:01:00"
"3854","20154203064217-174",1,"2015-07-03 07:14:00",1435932840,"C5",137880,1436070720,"2015-07-04 21:32:00"
"89","20151303071356-254",3,"2015-07-03 07:36:00",1435934160,"C5",174180,1436108340,"2015-07-05 07:59:00"
"2130","20155203065228-993",1,"2015-07-03 07:36:00",1435934160,"C8",383400,1436317560,"2015-07-07 18:06:00"
"1009","20152703072701-166",2,"2015-07-03 07:58:00",1435935480,"C5",427140,1436362620,"2015-07-08 06:37:00"
"5467","20152603072604-152",1,"2015-07-03 08:22:00",1435936920,"C6",112680,1436049600,"2015-07-04 15:40:00"
"3057","20150303080344-262",1,"2015-07-03 08:36:00",1435937760,"C7",220920,1436158680,"2015-07-05 21:58:00"
"4174","20153003083030-321",3,"2015-07-03 08:36:00",1435937760,"C8",214320,1436152080,"2015-07-05 20:08:00"
"4835","20154003074029-430",1,"2015-07-03 08:37:00",1435937820,"C4",394320,1436332140,"2015-07-07 22:09:00"
"120","20155603075643-430",1,"2015-07-03 08:54:00",1435938840,"C2",203580,1436142420,"2015-07-05 17:27:00"
"1271","20150703080734-840",2,"2015-07-03 09:09:00",1435939740,"C2",356100,1436295840,"2015-07-07 12:04:00"
"4532","20154103084141-252",3,"2015-07-03 09:13:00",1435939980,"C4",639540,1436579520,"2015-07-10 18:52:00"
"5404","20150003080058-668",3,"2015-07-03 09:15:00",1435940100,"C0",520500,1436460600,"2015-07-09 09:50:00"
"4646","20155503085502-843",1,"2015-07-03 09:27:00",1435940820,"C3",95160,1436035980,"2015-07-04 11:53:00"
"5627","20150003090030-424",3,"2015-07-03 09:28:00",1435940880,"C4",373140,1436314020,"2015-07-07 17:07:00"
"4139","20150903090957-551",1,"2015-07-03 09:33:00",1435941180,"C5",180240,1436121420,"2015-07-05 11:37:00"
"987","20150603090639-155",3,"2015-07-03 09:43:00",1435941780,"C0",294540,1436236320,"2015-07-06 19:32:00"
"1196","20152403092454-380",2,"2015-07-03 09:50:00",1435942200,"C5",269160,1436211360,"2015-07-06 12:36:00"
"4069","20155803085804-911",3,"2015-07-03 09:53:00",1435942380,"C3",112920,1436055300,"2015-07-04 17:15:00"
"2417","20153603093633-912",2,"2015-07-03 10:07:00",1435943220,"C8",417480,1436360700,"2015-07-08 06:05:00"
"2788","20155503095520-726",3,"2015-07-03 10:16:00",1435943760,"C8",285300,1436229060,"2015-07-06 17:31:00"
"1650","20150903090936-932",1,"2015-07-03 10:23:00",1435944180,"C0",175380,1436119560,"2015-07-05 11:06:00"
"725","20150103100100-923",2,"2015-07-03 10:26:00",1435944360,"C5",97080,1436041440,"2015-07-04 13:24:00"
"3621","20151103101135-993",1,"2015-07-03 10:37:00",1435945020,"C5",111600,1436056620,"2015-07-04 17:37:00"
"3776","20151203101246-894",2,"2015-07-03 10:46:00",1435945560,"C5",471420,1436416980,"2015-07-08 21:43:00"
"3133","20150303100335-568",2,"2015-07-03 10:58:00",1435946280,"C3",615540,1436561820,"2015-07-10 13:57:00"
"6328","20154003094041-201",1,"2015-07-03 10:58:00",1435946280,"C2",503760,1436450040,"2015-07-09 06:54:00"
"1004","20153903103958-735",3,"2015-07-03 10:59:00",1435946340,"C6",330660,1436277000,"2015-07-07 06:50:00"
"3631","20150903100903-596",2,"2015-07-03 11:02:00",1435946520,"C4",184380,1436130900,"2015-07-05 14:15:00"
"1231","20150103100107-497",1,"2015-07-03 11:10:00",1435947000,"C6",192480,1436139480,"2015-07-05 16:38:00"
"1320","20151403101408-211",1,"2015-07-03 11:12:00",1435947120,"C0",589200,1436536320,"2015-07-10 06:52:00"
"3726","20152403102434-408",3,"2015-07-03 11:21:00",1435947660,"C8",102720,1436050380,"2015-07-04 15:53:00"
"3897","20152003112040-99",1,"2015-07-03 11:25:00",1435947900,"C2",99660,1436047560,"2015-07-04 15:06:00"
"665","20152003102027-431",1,"2015-07-03 11:28:00",1435948080,"C6",537240,1436485320,"2015-07-09 16:42:00"
"4705","20154703104742-613",1,"2015-07-03 11:42:00",1435948920,"C3",199800,1436148720,"2015-07-05 19:12:00"
"323","20152703112735-711",1,"2015-07-03 11:53:00",1435949580,"C5",166560,1436116140,"2015-07-05 10:09:00"
"4976","20154803104834-431",2,"2015-07-03 11:56:00",1435949760,"C7",74880,1436024640,"2015-07-04 08:44:00"
"2170","20152703112748-47",2,"2015-07-03 11:59:00",1435949940,"C5",283800,1436233740,"2015-07-06 18:49:00"
"959","20154003114038-680",2,"2015-07-03 12:11:00",1435950660,"C3",81060,1436031720,"2015-07-04 10:42:00"
"3597","20153103113118-650",1,"2015-07-03 12:22:00",1435951320,"C4",250140,1436201460,"2015-07-06 09:51:00"
"4198","20150403120428-179",2,"2015-07-03 12:42:00",1435952520,"C2",681960,1436634480,"2015-07-11 10:08:00"
"1999","20152403122407-918",2,"2015-07-03 12:49:00",1435952940,"C5",716220,1436669160,"2015-07-11 19:46:00"
"6480","20150303120312-233",3,"2015-07-03 13:07:00",1435954020,"C6",206700,1436160720,"2015-07-05 22:32:00"
"6190","20154303124314-941",1,"2015-07-03 13:08:00",1435954080,"C5",174960,1436129040,"2015-07-05 13:44:00"
"729","20151203121253-478",3,"2015-07-03 13:24:00",1435955040,"C2",89040,1436044080,"2015-07-04 14:08:00"
"4826","20153903123902-205",1,"2015-07-03 13:41:00",1435956060,"C5",183120,1436139180,"2015-07-05 16:33:00"
"1409","20151503011524-795",2,"2015-07-03 13:45:00",1435956300,"C5",146580,1436102880,"2015-07-05 06:28:00"
"275","20155303125317-749",1,"2015-07-03 13:48:00",1435956480,"C4",674460,1436630940,"2015-07-11 09:09:00"
"4601","20153803013812-529",1,"2015-07-03 13:54:00",1435956840,"C7",630360,1436587200,"2015-07-10 21:00:00"
"599","20155003015007-18",1,"2015-07-03 13:56:00",1435956960,"C8",452100,1436409060,"2015-07-08 19:31:00"
"220","20155603015631-143",2,"2015-07-03 14:03:00",1435957380,"C4",410280,1436367660,"2015-07-08 08:01:00"
"1749","20154112014114-381",1,"2015-07-03 14:14:00",1435958040,"C6",202380,1436160420,"2015-07-05 22:27:00"
"2860","20155103015112-816",2,"2015-07-03 14:20:00",1435958400,"C8",145740,1436104140,"2015-07-05 06:49:00"
"6135","20150503020544-302",1,"2015-07-03 14:27:00",1435958820,"C5",234240,1436193060,"2015-07-06 07:31:00"
"4453","20153003023020-726",1,"2015-07-03 14:43:00",1435959780,"C3",88260,1436048040,"2015-07-04 15:14:00"
"5158","20154303014356-798",2,"2015-07-03 14:43:00",1435959780,"C4",418260,1436378040,"2015-07-08 10:54:00"
"1394","20155503025536-107",3,"2015-07-03 15:03:00",1435960980,"C4",622440,1436583420,"2015-07-10 19:57:00"
"3365","20155603015621-472",2,"2015-07-03 15:05:00",1435961100,"C0",62940,1436024040,"2015-07-04 08:34:00"
"6542","20150003020050-522",2,"2015-07-03 15:05:00",1435961100,"C5",337860,1436298960,"2015-07-07 12:56:00"
"1463","20154303024324-525",2,"2015-07-03 15:06:00",1435961160,"C5",85320,1436046480,"2015-07-04 14:48:00"
"4949","20154603024647-48",2,"2015-07-03 15:08:00",1435961280,"C8",94380,1436055660,"2015-07-04 17:21:00"
"2200","20154603024631-872",3,"2015-07-03 15:13:00",1435961580,"C4",278400,1436239980,"2015-07-06 20:33:00"
"4604","20154519024544-322",2,"2015-07-03 15:31:00",1435962660,"C4",203580,1436166240,"2015-07-06 00:04:00"
"4179","20155303025331-674",1,"2015-07-03 15:39:00",1435963140,"C6",368220,1436331360,"2015-07-07 21:56:00"
"1176","20151403031412-911",1,"2015-07-03 15:44:00",1435963440,"C3",99780,1436063220,"2015-07-04 19:27:00"
"5733","20155705025759-63",1,"2015-07-03 16:01:00",1435964460,"C2",2410680,1438375140,"2015-07-31 13:39:00"
"1525","20152303032328-493",1,"2015-07-03 16:03:00",1435964580,"C2",179700,1436144280,"2015-07-05 17:58:00"
"6394","20154003034016-1",2,"2015-07-03 16:37:00",1435966620,"C8",250500,1436217120,"2015-07-06 14:12:00"
"6098","20152103042134-429",2,"2015-07-03 16:38:00",1435966680,"C7",50880,1436017560,"2015-07-04 06:46:00"
"2792","20150503040507-176",1,"2015-07-03 16:43:00",1435966980,"C0",308280,1436275260,"2015-07-07 06:21:00"
"512","20150103040138-632",1,"2015-07-03 16:46:00",1435967160,"C8",146940,1436114100,"2015-07-05 09:35:00"
"944","20151203041231-943",1,"2015-07-03 16:47:00",1435967220,"C2",97920,1436065140,"2015-07-04 19:59:00"
"2082","20154703044705-734",1,"2015-07-03 16:57:00",1435967820,"C3",171060,1436138880,"2015-07-05 16:28:00"
"5416","20150903040923-931",3,"2015-07-03 17:03:00",1435968180,"C5",60780,1436028960,"2015-07-04 09:56:00"
"3330","20155003045027-887",1,"2015-07-03 17:04:00",1435968240,"C0",399240,1436367480,"2015-07-08 07:58:00"
"4595","20153903043925-167",2,"2015-07-03 17:09:00",1435968540,"C2",269460,1436238000,"2015-07-06 20:00:00"
"1915","20151503041535-262",3,"2015-07-03 17:22:00",1435969320,"C0",326220,1436295540,"2015-07-07 11:59:00"
"4741","20154903044916-720",1,"2015-07-03 17:24:00",1435969440,"C2",477480,1436446920,"2015-07-09 06:02:00"
"4109","20152303042327-304",1,"2015-07-03 17:28:00",1435969680,"C8",166860,1436136540,"2015-07-05 15:49:00"
"2847","20155803045848-101",3,"2015-07-03 17:34:00",1435970040,"C2",174000,1436144040,"2015-07-05 17:54:00"
"601","20151103051148-977",3,"2015-07-03 17:36:00",1435970160,"C5",261360,1436231520,"2015-07-06 18:12:00"
"3341","20151603051629-978",1,"2015-07-03 17:43:00",1435970580,"C5",83460,1436054040,"2015-07-04 16:54:00"
"3184","20154703044709-708",1,"2015-07-03 17:49:00",1435970940,"C3",427920,1436398860,"2015-07-08 16:41:00"
"5721","20155303045356-851",1,"2015-07-03 17:52:00",1435971120,"C2",535680,1436506800,"2015-07-09 22:40:00"
"3227","20152303052328-94",2,"2015-07-03 18:15:00",1435972500,"C4",677760,1436650260,"2015-07-11 14:31:00"
"5271","20155703055749-564",1,"2015-07-03 18:21:00",1435972860,"C8",1696080,1437668940,"2015-07-23 09:29:00"
"241","20152303052305-443",1,"2015-07-03 18:22:00",1435972920,"C5",51780,1436024700,"2015-07-04 08:45:00"
"5648","20154003054009-197",1,"2015-07-03 18:44:00",1435974240,"C5",749160,1436723400,"2015-07-12 10:50:00"
"411","20155303055334-250",2,"2015-07-03 19:07:00",1435975620,"C0",168060,1436143680,"2015-07-05 17:48:00"
"1991","20151004061009-733",2,"2015-07-04 06:25:00",1436016300,"C0",622320,1436638620,"2015-07-11 11:17:00"
"3773","20152004062054-876",1,"2015-07-04 06:27:00",1436016420,"C4",695940,1436712360,"2015-07-12 07:46:00"
"5230","20155404065421-768",1,"2015-07-04 07:01:00",1436018460,"C4",113820,1436132280,"2015-07-05 14:38:00"
"6446","20155304065358-506",3,"2015-07-04 07:16:00",1436019360,"C7",524280,1436543640,"2015-07-10 08:54:00"
"2266","20154404064457-308",1,"2015-07-04 07:22:00",1436019720,"C2",284460,1436304180,"2015-07-07 14:23:00"
"1674","20155704065719-686",1,"2015-07-04 07:26:00",1436019960,"C8",371400,1436391360,"2015-07-08 14:36:00"
"4040","20155504065559-69",1,"2015-07-04 07:27:00",1436020020,"C8",301500,1436321520,"2015-07-07 19:12:00"
"1243","20153304063341-413",3,"2015-07-04 07:33:00",1436020380,"C4",100680,1436121060,"2015-07-05 11:31:00"
"2578","20155904065927-209",1,"2015-07-04 07:33:00",1436020380,"C2",128880,1436149260,"2015-07-05 19:21:00"
"128","20154104064113-956",2,"2015-07-04 07:39:00",1436020740,"C8",1312380,1437333120,"2015-07-19 12:12:00"
"3202","20152004072035-991",2,"2015-07-04 07:41:00",1436020860,"C8",198240,1436219100,"2015-07-06 14:45:00"
"1965","20151504071559-733",3,"2015-07-04 07:51:00",1436021460,"C3",482760,1436504220,"2015-07-09 21:57:00"
"5924","20155904075953-519",2,"2015-07-04 08:06:00",1436022360,"C8",366840,1436389200,"2015-07-08 14:00:00"
"4398","20151704071753-165",1,"2015-07-04 08:10:00",1436022600,"C5",302880,1436325480,"2015-07-07 20:18:00"
"1584","20150304070342-20",2,"2015-07-04 08:21:00",1436023260,"C0",445020,1436468280,"2015-07-09 11:58:00"
"3790","20152104072145-815",1,"2015-07-04 08:22:00",1436023320,"C0",131880,1436155200,"2015-07-05 21:00:00"
"1421","20153204073231-660",3,"2015-07-04 08:23:00",1436023380,"C8",92400,1436115780,"2015-07-05 10:03:00"
"1315","20153704073745-278",2,"2015-07-04 08:24:00",1436023440,"C8",512340,1436535780,"2015-07-10 06:43:00"
"2211","20153504073526-319",1,"2015-07-04 08:29:00",1436023740,"C8",424920,1436448660,"2015-07-09 06:31:00"
"6062","20152404072411-614",1,"2015-07-04 08:29:00",1436023740,"C2",116700,1436140440,"2015-07-05 16:54:00"
"510","20151604081612-669",1,"2015-07-04 08:45:00",1436024700,"C2",211560,1436236260,"2015-07-06 19:31:00"
"435","20154304074334-798",1,"2015-07-04 08:55:00",1436025300,"C3",429780,1436455080,"2015-07-09 08:18:00"
"546","20155504075511-773",1,"2015-07-04 08:55:00",1436025300,"C8",116040,1436141340,"2015-07-05 17:09:00"
"2780","20151404081429-288",1,"2015-07-04 09:08:00",1436026080,"C4",1315260,1437341340,"2015-07-19 14:29:00"
"2569","20151104091151-104",3,"2015-07-04 09:18:00",1436026680,"C8",195480,1436222160,"2015-07-06 15:36:00"
"4670","20152004082011-358",1,"2015-07-04 09:30:00",1436027400,"C2",443760,1436471160,"2015-07-09 12:46:00"
"593","20153204093236-149",2,"2015-07-04 10:01:00",1436029260,"C2",689820,1436719080,"2015-07-12 09:38:00"
"3884","20151504091530-898",2,"2015-07-04 10:11:00",1436029860,"C4",96720,1436126580,"2015-07-05 13:03:00"
"5309","20154404094430-924",3,"2015-07-04 10:14:00",1436030040,"C5",129840,1436159880,"2015-07-05 22:18:00"
"822","20154604094636-292",2,"2015-07-04 10:15:00",1436030100,"C4",457560,1436487660,"2015-07-09 17:21:00"
"3498","20151604091656-972",1,"2015-07-04 10:20:00",1436030400,"C5",1046460,1437076860,"2015-07-16 13:01:00"
"3702","20154804094840-923",1,"2015-07-04 10:24:00",1436030640,"C2",282480,1436313120,"2015-07-07 16:52:00"
"3825","20155304095308-767",1,"2015-07-04 10:27:00",1436030820,"C0",370560,1436401380,"2015-07-08 17:23:00"
"4257","20152004102015-754",1,"2015-07-04 10:40:00",1436031600,"C5",379200,1436410800,"2015-07-08 20:00:00"
"5353","20152504102511-329",2,"2015-07-04 10:52:00",1436032320,"C4",1285320,1437317640,"2015-07-19 07:54:00"
"286","20153504103503-465",1,"2015-07-04 10:55:00",1436032500,"C5",374940,1436407440,"2015-07-08 19:04:00"
"219","20155204105251-380",3,"2015-07-04 11:00:00",1436032800,"C4",381300,1436414100,"2015-07-08 20:55:00"
"5723","20150804100804-119",1,"2015-07-04 11:07:00",1436033220,"C7",330960,1436364180,"2015-07-08 07:03:00"
"3213","20150704100721-493",2,"2015-07-04 11:08:00",1436033280,"C3",283440,1436316720,"2015-07-07 17:52:00"
"3978","20154904104947-550",2,"2015-07-04 11:19:00",1436033940,"C3",85320,1436119260,"2015-07-05 11:01:00"
"4629","20151804111828-884",1,"2015-07-04 11:43:00",1436035380,"C8",1231920,1437267300,"2015-07-18 17:55:00"
"6257","20153104103154-685",1,"2015-07-04 11:43:00",1436035380,"C2",79800,1436115180,"2015-07-05 09:53:00"
"61","20154404114459-43",1,"2015-07-04 11:51:00",1436035860,"C8",264060,1436299920,"2015-07-07 13:12:00"
"1343","20152504112551-431",2,"2015-07-04 11:55:00",1436036100,"C2",198180,1436234280,"2015-07-06 18:58:00"
"2950","20153604113656-45",1,"2015-07-04 11:58:00",1436036280,"C5",289740,1436326020,"2015-07-07 20:27:00"
"3442","20150904110945-706",1,"2015-07-04 12:05:00",1436036700,"C4",714120,1436750820,"2015-07-12 18:27:00"
"5527","20153404113438-674",2,"2015-07-04 12:12:00",1436037120,"C2",534300,1436571420,"2015-07-10 16:37:00"
"3601","20151304121328-420",1,"2015-07-04 12:25:00",1436037900,"C3",202920,1436240820,"2015-07-06 20:47:00"
"4167","20154104114100-134",2,"2015-07-04 12:42:00",1436038920,"C5",714420,1436753340,"2015-07-12 19:09:00"
"3169","20150404120407-76",3,"2015-07-04 13:03:00",1436040180,"C4",61860,1436102040,"2015-07-05 06:14:00"
"504","20153404123427-942",1,"2015-07-04 13:11:00",1436040660,"C0",765900,1436806560,"2015-07-13 09:56:00"
"369","20155604125644-698",2,"2015-07-04 13:18:00",1436041080,"C5",431640,1436472720,"2015-07-09 13:12:00"
"3874","20152004122028-933",1,"2015-07-04 13:21:00",1436041260,"C5",590040,1436631300,"2015-07-11 09:15:00"
"1665","20154204124245-802",3,"2015-07-04 13:22:00",1436041320,"C2",93300,1436134620,"2015-07-05 15:17:00"
"6505","20151304011310-154",1,"2015-07-04 13:24:00",1436041440,"C3",150240,1436191680,"2015-07-06 07:08:00"
"1430","20152804012816-125",2,"2015-07-04 13:34:00",1436042040,"C8",339780,1436381820,"2015-07-08 11:57:00"
"4025","20150604010643-971",3,"2015-07-04 13:34:00",1436042040,"C5",805440,1436847480,"2015-07-13 21:18:00"
"814","20152204122238-160",2,"2015-07-04 13:39:00",1436042340,"C2",526140,1436568480,"2015-07-10 15:48:00"
"2439","20153604123646-881",3,"2015-07-04 13:39:00",1436042340,"C5",237540,1436279880,"2015-07-07 07:38:00"
"5533","20154904124934-601",1,"2015-07-04 13:48:00",1436042880,"C4",95700,1436138580,"2015-07-05 16:23:00"
"985","20152704012705-41",1,"2015-07-04 13:54:00",1436043240,"C5",168600,1436211840,"2015-07-06 12:44:00"
"2473","20150004010010-724",2,"2015-07-04 13:54:00",1436043240,"C3",327720,1436370960,"2015-07-08 08:56:00"
"2710","20153504013504-269",1,"2015-07-04 14:02:00",1436043720,"C5",74400,1436118120,"2015-07-05 10:42:00"
"1133","20153204013239-640",1,"2015-07-04 14:14:00",1436044440,"C2",100320,1436144760,"2015-07-05 18:06:00"
"1608","20155204015210-595",2,"2015-07-04 14:25:00",1436045100,"C5",143340,1436188440,"2015-07-06 06:14:00"
"4380","20155004015003-341",3,"2015-07-04 14:27:00",1436045220,"C7",199320,1436244540,"2015-07-06 21:49:00"
"4228","20151404021437-954",3,"2015-07-04 14:32:00",1436045520,"C0",235800,1436281320,"2015-07-07 08:02:00"
"4168","20150304020357-184",1,"2015-07-04 14:36:00",1436045760,"C3",799500,1436845260,"2015-07-13 20:41:00"
"5989","20153504013535-186",1,"2015-07-04 14:43:00",1436046180,"C6",88020,1436134200,"2015-07-05 15:10:00"
"2159","20154504014517-802",2,"2015-07-04 14:53:00",1436046780,"C6",91200,1436137980,"2015-07-05 16:13:00"
"3813","20155704015728-85",1,"2015-07-04 14:53:00",1436046780,"C4",361260,1436408040,"2015-07-08 19:14:00"
"4234","20154704014703-466",1,"2015-07-04 14:54:00",1436046840,"C6",234900,1436281740,"2015-07-07 08:09:00"
"1341","20153004023033-371",2,"2015-07-04 14:55:00",1436046900,"C7",195120,1436242020,"2015-07-06 21:07:00"
"4823","20152704022701-232",1,"2015-07-04 15:00:00",1436047200,"C5",577260,1436624460,"2015-07-11 07:21:00"
"964","20153104023109-416",3,"2015-07-04 15:03:00",1436047380,"C8",61380,1436108760,"2015-07-05 08:06:00"
"5614","20155704015757-89",1,"2015-07-04 15:09:00",1436047740,"C3",591360,1436639100,"2015-07-11 11:25:00"
"263","20155704025719-973",1,"2015-07-04 15:21:00",1436048460,"C5",671940,1436720400,"2015-07-12 10:00:00"
"5603","20152904022933-687",2,"2015-07-04 15:28:00",1436048880,"C2",401100,1436449980,"2015-07-09 06:53:00"
"1899","20155304025306-399",1,"2015-07-04 15:29:00",1436048940,"C2",102900,1436151840,"2015-07-05 20:04:00"
"332","20151504021557-531",2,"2015-07-04 15:32:00",1436049120,"C0",169140,1436218260,"2015-07-06 14:31:00"
"4541","20154004024021-315",2,"2015-07-04 15:41:00",1436049660,"C5",150780,1436200440,"2015-07-06 09:34:00"
"6313","20154404024426-337",2,"2015-07-04 15:42:00",1436049720,"C4",143940,1436193660,"2015-07-06 07:41:00"
"1726","20150904030958-830",1,"2015-07-04 16:04:00",1436051040,"C4",104220,1436155260,"2015-07-05 21:01:00"
"192","20154904034903-354",1,"2015-07-04 16:15:00",1436051700,"C4",163380,1436215080,"2015-07-06 13:38:00"
"5415","20151004041028-27",1,"2015-07-04 16:16:00",1436051760,"C2",180900,1436232660,"2015-07-06 18:31:00"
"3599","20155304035331-275",1,"2015-07-04 16:20:00",1436052000,"C8",1173360,1437225360,"2015-07-18 06:16:00"
"732","20151804041847-14",2,"2015-07-04 16:25:00",1436052300,"C8",232260,1436284560,"2015-07-07 08:56:00"
"4728","20154204034234-400",3,"2015-07-04 16:35:00",1436052900,"C4",161100,1436214000,"2015-07-06 13:20:00"
"4212","20155804035844-100",3,"2015-07-04 16:49:00",1436053740,"C5",324360,1436378100,"2015-07-08 10:55:00"
"4570","20153104043140-683",2,"2015-07-04 16:54:00",1436054040,"C5",252420,1436306460,"2015-07-07 15:01:00"
"1713","20153904043911-814",3,"2015-07-04 17:06:00",1436054760,"C3",86940,1436141700,"2015-07-05 17:15:00"
"679","20154304044323-645",1,"2015-07-04 17:08:00",1436054880,"C3",90780,1436145660,"2015-07-05 18:21:00"
"4352","20152404042428-569",1,"2015-07-04 17:08:00",1436054880,"C8",147480,1436202360,"2015-07-06 10:06:00"
"4886","20151704041709-562",1,"2015-07-04 17:10:00",1436055000,"C5",55860,1436110860,"2015-07-05 08:41:00"
"3489","20154804044802-635",2,"2015-07-04 17:12:00",1436055120,"C5",92880,1436148000,"2015-07-05 19:00:00"
"4378","20154304044326-805",2,"2015-07-04 17:17:00",1436055420,"C2",186600,1436242020,"2015-07-06 21:07:00"
"6351","20150704050743-697",1,"2015-07-04 17:20:00",1436055600,"C7",445440,1436501040,"2015-07-09 21:04:00"
"709","20151704041733-844",1,"2015-07-04 17:24:00",1436055840,"C5",339840,1436395680,"2015-07-08 15:48:00"
"2241","20152504042522-96",2,"2015-07-04 17:34:00",1436056440,"C8",615000,1436671440,"2015-07-11 20:24:00"
"2681","20155104055125-368",2,"2015-07-04 17:53:00",1436057580,"C6",230460,1436288040,"2015-07-07 09:54:00"
"327","20154804044849-878",3,"2015-07-04 17:55:00",1436057700,"C2",439080,1436496780,"2015-07-09 19:53:00"
"5957","20153204053251-894",2,"2015-07-04 18:08:00",1436058480,"C0",189180,1436247660,"2015-07-06 22:41:00"
"2310","20155604055630-978",1,"2015-07-04 18:24:00",1436059440,"C5",178500,1436237940,"2015-07-06 19:59:00"
"661","20154104054114-147",1,"2015-07-04 18:33:00",1436059980,"C4",605640,1436665620,"2015-07-11 18:47:00"
"2805","20153404053446-388",1,"2015-07-04 18:35:00",1436060100,"C2",319140,1436379240,"2015-07-08 11:14:00"
"181","20155204055234-952",3,"2015-07-04 18:46:00",1436060760,"C8",1567140,1437627900,"2015-07-22 22:05:00"
"3207","20153604053608-723",2,"2015-07-04 18:52:00",1436061120,"C0",401340,1436462460,"2015-07-09 10:21:00"
"773","20150105060134-242",1,"2015-07-05 06:04:00",1436101440,"C6",1487580,1437589020,"2015-07-22 11:17:00"
"3381","20152105062125-369",2,"2015-07-05 06:42:00",1436103720,"C5",211320,1436315040,"2015-07-07 17:24:00"
"1450","20152105062151-555",2,"2015-07-05 06:43:00",1436103780,"C5",995580,1437099360,"2015-07-16 19:16:00"
"5172","20152605062636-836",1,"2015-07-05 06:48:00",1436104080,"C8",440160,1436544240,"2015-07-10 09:04:00"
"2551","20152805062805-519",1,"2015-07-05 06:57:00",1436104620,"C2",350220,1436454840,"2015-07-09 08:14:00"
"1925","20154205064237-776",2,"2015-07-05 07:03:00",1436104980,"C8",472440,1436577420,"2015-07-10 18:17:00"
"6103","20150605070642-510",1,"2015-07-05 07:16:00",1436105760,"C3",89520,1436195280,"2015-07-06 08:08:00"
"2400","20155005065043-343",1,"2015-07-05 07:20:00",1436106000,"C4",604200,1436710200,"2015-07-12 07:10:00"
"217","20151005071024-452",1,"2015-07-05 07:34:00",1436106840,"C5",366420,1436473260,"2015-07-09 13:21:00"
"3295","20151805071821-119",3,"2015-07-05 07:39:00",1436107140,"C6",138060,1436245200,"2015-07-06 22:00:00"
"3440","20150905070939-279",1,"2015-07-05 07:39:00",1436107140,"C3",286200,1436393340,"2015-07-08 15:09:00"
"726","20155705065729-214",2,"2015-07-05 07:43:00",1436107380,"C6",282120,1436389500,"2015-07-08 14:05:00"
"2640","20153905073902-613",3,"2015-07-05 07:46:00",1436107560,"C8",196860,1436304420,"2015-07-07 14:27:00"
"2017","20153505073536-429",1,"2015-07-05 07:55:00",1436108100,"C6",350940,1436459040,"2015-07-09 09:24:00"
"1386","20153205073222-529",2,"2015-07-05 08:01:00",1436108460,"C4",483300,1436591760,"2015-07-10 22:16:00"
"5173","20150205080250-857",2,"2015-07-05 08:09:00",1436108940,"C8",172800,1436281740,"2015-07-07 08:09:00"
"1508","20150605080621-713",3,"2015-07-05 08:40:00",1436110800,"C8",195660,1436306460,"2015-07-07 15:01:00"
"4160","20154405074442-509",2,"2015-07-05 08:46:00",1436111160,"C4",164040,1436275200,"2015-07-07 06:20:00"
"891","20151705081717-385",1,"2015-07-05 08:47:00",1436111220,"C2",182700,1436293920,"2015-07-07 11:32:00"
"5384","20153205083252-86",1,"2015-07-05 08:47:00",1436111220,"C0",202740,1436313960,"2015-07-07 17:06:00"
"3732","20154605074608-859",2,"2015-07-05 08:49:00",1436111340,"C4",478200,1436589540,"2015-07-10 21:39:00"
"3630","20150105080122-729",1,"2015-07-05 08:57:00",1436111820,"C5",299040,1436410860,"2015-07-08 20:01:00"
"5000","20153905083900-16",3,"2015-07-05 09:05:00",1436112300,"C4",359040,1436471340,"2015-07-09 12:49:00"
"519","20150405080425-970",2,"2015-07-05 09:09:00",1436112540,"C5",435660,1436548200,"2015-07-10 10:10:00"
"4754","20154605084600-982",3,"2015-07-05 09:12:00",1436112720,"C5",248880,1436361600,"2015-07-08 06:20:00"
"1029","20154905084932-890",3,"2015-07-05 09:24:00",1436113440,"C0",771720,1436885160,"2015-07-14 07:46:00"
"2597","20150405090426-651",2,"2015-07-05 09:33:00",1436113980,"C8",549000,1436662980,"2015-07-11 18:03:00"
"6270","20153505093535-456",2,"2015-07-05 09:53:00",1436115180,"C0",124200,1436239380,"2015-07-06 20:23:00"
"5377","20155705085712-420",1,"2015-07-05 09:54:00",1436115240,"C8",200220,1436315460,"2015-07-07 17:31:00"
"4099","20151105091109-417",2,"2015-07-05 09:59:00",1436115540,"C6",361140,1436476680,"2015-07-09 14:18:00"
"4359","20150105090139-623",1,"2015-07-05 10:02:00",1436115720,"C0",614100,1436729820,"2015-07-12 12:37:00"
"5206","20152005092047-998",2,"2015-07-05 10:15:00",1436116500,"C5",250440,1436366940,"2015-07-08 07:49:00"
"2986","20151705091722-67",3,"2015-07-05 10:16:00",1436116560,"C5",555720,1436672280,"2015-07-11 20:38:00"
"5656","20154405094402-820",1,"2015-07-05 10:18:00",1436116680,"C2",384960,1436501640,"2015-07-09 21:14:00"
"5543","20150405100402-510",1,"2015-07-05 10:19:00",1436116740,"C0",734520,1436851260,"2015-07-13 22:21:00"
"2016","20152705092735-661",1,"2015-07-05 10:31:00",1436117460,"C4",119700,1436237160,"2015-07-06 19:46:00"
"31","20152005102037-864",2,"2015-07-05 10:43:00",1436118180,"C5",246300,1436364480,"2015-07-08 07:08:00"
"6441","20154305094304-138",1,"2015-07-05 10:52:00",1436118720,"C0",706080,1436824800,"2015-07-13 15:00:00"
"5862","20153505103526-82",1,"2015-07-05 11:05:00",1436119500,"C4",465780,1436585280,"2015-07-10 20:28:00"
"2008","20152505102515-978",1,"2015-07-05 11:23:00",1436120580,"C5",679800,1436800380,"2015-07-13 08:13:00"
"2544","20153805103821-658",3,"2015-07-05 11:31:00",1436121060,"C5",113700,1436234760,"2015-07-06 19:06:00"
"903","20151405111428-942",2,"2015-07-05 11:50:00",1436122200,"C6",167460,1436289660,"2015-07-07 10:21:00"
"5971","20150005110029-714",3,"2015-07-05 11:54:00",1436122440,"C8",243120,1436365560,"2015-07-08 07:26:00"
"5757","20153505113500-23",2,"2015-07-05 11:58:00",1436122680,"C5",210240,1436332920,"2015-07-07 22:22:00"
"491","20154805104835-68",3,"2015-07-05 12:00:00",1436122800,"C2",269280,1436392080,"2015-07-08 14:48:00"
"1545","20153905113904-390",2,"2015-07-05 12:07:00",1436123220,"C6",470760,1436593980,"2015-07-10 22:53:00"
"3785","20153605113620-487",1,"2015-07-05 12:10:00",1436123400,"C2",195180,1436318580,"2015-07-07 18:23:00"
"305","20154705114743-724",2,"2015-07-05 12:17:00",1436123820,"C4",259740,1436383560,"2015-07-08 12:26:00"
"1282","20153005113023-61",2,"2015-07-05 12:30:00",1436124600,"C4",80520,1436205120,"2015-07-06 10:52:00"
"2774","20152705112730-412",3,"2015-07-05 12:33:00",1436124780,"C2",106560,1436231340,"2015-07-06 18:09:00"
"1502","20150605120608-125",3,"2015-07-05 12:36:00",1436124960,"C8",250740,1436375700,"2015-07-08 10:15:00"
"1307","20153705123714-935",3,"2015-07-05 12:43:00",1436125380,"C4",506700,1436632080,"2015-07-11 09:28:00"
"5219","20154005114042-468",1,"2015-07-05 12:44:00",1436125440,"C4",264900,1436390340,"2015-07-08 14:19:00"
"3236","20153305123353-662",1,"2015-07-05 13:07:00",1436126820,"C5",100080,1436226900,"2015-07-06 16:55:00"
"1532","20150405010405-973",1,"2015-07-05 13:26:00",1436127960,"C5",113160,1436241120,"2015-07-06 20:52:00"
"2103","20152405122436-184",3,"2015-07-05 13:27:00",1436128020,"C2",288900,1436416920,"2015-07-08 21:42:00"
"3491","20150205010257-226",1,"2015-07-05 13:28:00",1436128080,"C5",163740,1436291820,"2015-07-07 10:57:00"
"656","20151305011309-201",2,"2015-07-05 13:45:00",1436129100,"C3",424020,1436553120,"2015-07-10 11:32:00"
"2259","20154505124525-350",1,"2015-07-05 13:46:00",1436129160,"C5",184500,1436313660,"2015-07-07 17:01:00"
"5344","20155605125654-111",1,"2015-07-05 13:50:00",1436129400,"C8",200460,1436329860,"2015-07-07 21:31:00"
"5893","20152305012336-61",3,"2015-07-05 13:51:00",1436129460,"C3",596520,1436725980,"2015-07-12 11:33:00"
"2273","20155205015233-851",3,"2015-07-05 13:58:00",1436129880,"C2",609300,1436739180,"2015-07-12 15:13:00"
"4649","20155405015448-33",2,"2015-07-05 14:02:00",1436130120,"C4",453060,1436583180,"2015-07-10 19:53:00"
"5607","20150905010927-978",2,"2015-07-05 14:04:00",1436130240,"C5",105180,1436235420,"2015-07-06 19:17:00"
"3971","20155905015920-414",1,"2015-07-05 14:05:00",1436130300,"C8",840240,1436970540,"2015-07-15 07:29:00"
"5312","20150105010142-777",3,"2015-07-05 14:05:00",1436130300,"C2",195360,1436325660,"2015-07-07 20:21:00"
"69","20151405011458-832",2,"2015-07-05 14:08:00",1436130480,"C5",60120,1436190600,"2015-07-06 06:50:00"
"5655","20155805015836-890",1,"2015-07-05 14:09:00",1436130540,"C3",103980,1436234520,"2015-07-06 19:02:00"
"602","20154905014906-97",1,"2015-07-05 14:10:00",1436130600,"C5",177240,1436307840,"2015-07-07 15:24:00"
"1942","20154805014852-697",2,"2015-07-05 14:22:00",1436131320,"C8",76260,1436207580,"2015-07-06 11:33:00"
"1261","20154305014335-971",3,"2015-07-05 14:45:00",1436132700,"C5",366600,1436499300,"2015-07-09 20:35:00"
"698","20152605012634-824",1,"2015-07-05 14:57:00",1436133420,"C4",185700,1436319120,"2015-07-07 18:32:00"
"1040","20150005020044-437",1,"2015-07-05 14:58:00",1436133480,"C4",111000,1436244480,"2015-07-06 21:48:00"
"755","20153805023838-887",1,"2015-07-05 15:11:00",1436134260,"C5",99060,1436233320,"2015-07-06 18:42:00"
"3256","20150305030356-98",2,"2015-07-05 15:30:00",1436135400,"C8",229140,1436364540,"2015-07-08 07:09:00"
"6206","20152205022233-507",2,"2015-07-05 15:37:00",1436135820,"C0",264840,1436400660,"2015-07-08 17:11:00"
"11","20153705023701-460",1,"2015-07-05 15:39:00",1436135940,"C4",72480,1436208420,"2015-07-06 11:47:00"
"5017","20153605033636-902",1,"2015-07-05 15:57:00",1436137020,"C8",90600,1436227620,"2015-07-06 17:07:00"
"2751","20150105040155-8",1,"2015-07-05 16:09:00",1436137740,"C8",502440,1436640180,"2015-07-11 11:43:00"
"112","20150105040107-528",2,"2015-07-05 16:11:00",1436137860,"C3",80880,1436218740,"2015-07-06 14:39:00"
"2965","20155705025745-109",1,"2015-07-05 16:12:00",1436137920,"C7",242040,1436379960,"2015-07-08 11:26:00"
"1428","20151505031524-959",2,"2015-07-05 16:16:00",1436138160,"C3",180480,1436318640,"2015-07-07 18:24:00"
"829","20155405035411-744",3,"2015-07-05 16:21:00",1436138460,"C8",311460,1436449920,"2015-07-09 06:52:00"
"461","20154405034454-883",3,"2015-07-05 16:24:00",1436138640,"C2",151620,1436290260,"2015-07-07 10:31:00"
"5323","20150905040910-240",3,"2015-07-05 16:35:00",1436139300,"C5",255660,1436394960,"2015-07-08 15:36:00"
"5978","20152005042050-261",1,"2015-07-05 16:52:00",1436140320,"C5",540180,1436680500,"2015-07-11 22:55:00"
"5321","20150405040445-909",2,"2015-07-05 17:05:00",1436141100,"C5",71280,1436212380,"2015-07-06 12:53:00"
"3415","20151905041959-420",2,"2015-07-05 17:28:00",1436142480,"C5",65520,1436208000,"2015-07-06 11:40:00"
"5177","20152605042639-261",2,"2015-07-05 17:33:00",1436142780,"C8",60420,1436203200,"2015-07-06 10:20:00"
"2730","20150705050702-651",1,"2015-07-05 17:35:00",1436142900,"C4",160140,1436303040,"2015-07-07 14:04:00"
"5917","20152405052406-500",3,"2015-07-05 17:47:00",1436143620,"C5",338040,1436481660,"2015-07-09 15:41:00"
"6203","20155405045446-551",1,"2015-07-05 17:47:00",1436143620,"C6",61800,1436205420,"2015-07-06 10:57:00"
"1034","20155905045912-583",1,"2015-07-05 17:49:00",1436143740,"C6",88740,1436232480,"2015-07-06 18:28:00"
"5143","20153805053836-382",1,"2015-07-05 18:01:00",1436144460,"C4",315540,1436460000,"2015-07-09 09:40:00"
"6407","20155605055620-608",3,"2015-07-05 18:11:00",1436145060,"C7",244620,1436389680,"2015-07-08 14:08:00"
"2983","20155405055416-800",1,"2015-07-05 18:20:00",1436145600,"C5",503520,1436649120,"2015-07-11 14:12:00"
"4719","20151906061932-564",3,"2015-07-06 07:08:00",1436191680,"C7",171780,1436363460,"2015-07-08 06:51:00"
"5814","20153606063624-577",3,"2015-07-06 07:22:00",1436192520,"C8",94380,1436286900,"2015-07-07 09:35:00"
"2883","20150006070032-991",2,"2015-07-06 07:23:00",1436192580,"C5",556260,1436748840,"2015-07-12 17:54:00"
"1815","20153006063005-968",2,"2015-07-06 07:30:00",1436193000,"C4",108540,1436301540,"2015-07-07 13:39:00"
"1631","20153906073935-24",2,"2015-07-06 07:46:00",1436193960,"C4",115500,1436309460,"2015-07-07 15:51:00"
"4865","20151006071021-877",2,"2015-07-06 08:12:00",1436195520,"C3",136080,1436331600,"2015-07-07 22:00:00"
"4566","20153306073311-379",2,"2015-07-06 08:27:00",1436196420,"C8",378900,1436575320,"2015-07-10 17:42:00"
"633","20150206080212-82",1,"2015-07-06 08:35:00",1436196900,"C4",788340,1436985240,"2015-07-15 11:34:00"
"5806","20150306080327-887",2,"2015-07-06 09:00:00",1436198400,"C7",261660,1436460060,"2015-07-09 09:41:00"
"6097","20150106080113-871",1,"2015-07-06 09:00:00",1436198400,"C2",128160,1436326560,"2015-07-07 20:36:00"
"835","20155706075759-768",2,"2015-07-06 09:01:00",1436198460,"C2",214080,1436412540,"2015-07-08 20:29:00"
"995","20153406083403-509",2,"2015-07-06 09:05:00",1436198700,"C0",205320,1436404020,"2015-07-08 18:07:00"
"5886","20154206094218-555",1,"2015-07-06 09:47:00",1436201220,"C2",711960,1436913180,"2015-07-14 15:33:00"
"1836","20151306101326-304",3,"2015-07-06 10:33:00",1436203980,"C5",185100,1436389080,"2015-07-08 13:58:00"
"5670","20155306095352-482",3,"2015-07-06 10:56:00",1436205360,"C5",280200,1436485560,"2015-07-09 16:46:00"
"3504","20150606110611-539",1,"2015-07-06 11:23:00",1436206980,"C7",248160,1436455140,"2015-07-09 08:19:00"
"3064","20153206103213-613",1,"2015-07-06 11:25:00",1436207100,"C4",68520,1436275620,"2015-07-07 06:27:00"
"2425","20155206105220-877",1,"2015-07-06 12:00:00",1436209200,"C4",437460,1436646660,"2015-07-11 13:31:00"
"4674","20151306121351-539",1,"2015-07-06 12:21:00",1436210460,"C4",588480,1436798940,"2015-07-13 07:49:00"
"328","20153606123639-984",3,"2015-07-06 13:08:00",1436213280,"C7",94440,1436307720,"2015-07-07 15:22:00"
"6485","20150406120427-726",3,"2015-07-06 13:12:00",1436213520,"C3",423540,1436637060,"2015-07-11 10:51:00"
"5512","20151306121325-748",2,"2015-07-06 13:15:00",1436213700,"C7",779040,1436992740,"2015-07-15 13:39:00"
"6488","20153906123907-891",1,"2015-07-06 13:26:00",1436214360,"C6",187680,1436402040,"2015-07-08 17:34:00"
"3335","20152506122555-795",2,"2015-07-06 13:29:00",1436214540,"C3",613380,1436827920,"2015-07-13 15:52:00"
"6421","20152706122712-540",2,"2015-07-06 13:31:00",1436214660,"C3",78060,1436292720,"2015-07-07 11:12:00"
"5897","20154806014828-598",1,"2015-07-06 14:18:00",1436217480,"C3",156180,1436373660,"2015-07-08 09:41:00"
"5844","20151906011943-68",2,"2015-07-06 14:23:00",1436217780,"C2",359040,1436576820,"2015-07-10 18:07:00"
"3810","20154706014712-28",2,"2015-07-06 15:01:00",1436220060,"C2",273600,1436493660,"2015-07-09 19:01:00"
"5346","20155206025244-634",3,"2015-07-06 15:17:00",1436221020,"C4",516180,1436737200,"2015-07-12 14:40:00"
"4702","20151506031509-899",2,"2015-07-06 15:27:00",1436221620,"C3",52500,1436274120,"2015-07-07 06:02:00"
"3771","20152206032259-605",2,"2015-07-06 15:55:00",1436223300,"C0",249840,1436473140,"2015-07-09 13:19:00"
"2706","20150806030837-471",1,"2015-07-06 16:02:00",1436223720,"C5",274380,1436498100,"2015-07-09 20:15:00"
"2296","20155206025224-627",2,"2015-07-06 16:03:00",1436223780,"C0",245580,1436469360,"2015-07-09 12:16:00"
"3694","20155506035548-222",1,"2015-07-06 16:25:00",1436225100,"C3",72060,1436297160,"2015-07-07 12:26:00"
"4065","20152806032847-86",3,"2015-07-06 16:26:00",1436225160,"C3",368880,1436594040,"2015-07-10 22:54:00"
"1278","20151106041146-807",1,"2015-07-06 16:45:00",1436226300,"C0",84120,1436310420,"2015-07-07 16:07:00"
"882","20154706044718-338",3,"2015-07-06 17:12:00",1436227920,"C5",494520,1436722440,"2015-07-12 10:34:00"
"2280","20154306044342-841",2,"2015-07-06 17:50:00",1436230200,"C5",52080,1436282280,"2015-07-07 08:18:00"
"5840","20151206051246-156",1,"2015-07-06 18:06:00",1436231160,"C3",129540,1436360700,"2015-07-08 06:05:00"
"3661","20151106051115-506",3,"2015-07-06 18:09:00",1436231340,"C3",88620,1436319960,"2015-07-07 18:46:00"
"5081","20154106054126-881",3,"2015-07-06 18:37:00",1436233020,"C5",187440,1436420460,"2015-07-08 22:41:00"
"617","20154506054510-602",3,"2015-07-06 18:43:00",1436233380,"C3",392280,1436625660,"2015-07-11 07:41:00"
"1041","20154606054615-464",2,"2015-07-06 18:43:00",1436233380,"C7",391440,1436624820,"2015-07-11 07:27:00"
"1232","20154506054509-852",2,"2015-07-06 18:45:00",1436233500,"C7",92160,1436325660,"2015-07-07 20:21:00"
"297","20154306054321-56",1,"2015-07-06 18:51:00",1436233860,"C2",131460,1436365320,"2015-07-08 07:22:00"
"2160","20153907063955-529",2,"2015-07-07 06:45:00",1436276700,"C2",91260,1436367960,"2015-07-08 08:06:00"
"1983","20153707073745-657",1,"2015-07-07 07:43:00",1436280180,"C2",227520,1436507700,"2015-07-09 22:55:00"
"5963","20154507074558-617",1,"2015-07-07 08:11:00",1436281860,"C5",95580,1436377440,"2015-07-08 10:44:00"
"3261","20150907070922-234",1,"2015-07-07 08:13:00",1436281980,"C0",563940,1436845920,"2015-07-13 20:52:00"
"6272","20153707073715-128",2,"2015-07-07 08:41:00",1436283660,"C3",984000,1437267660,"2015-07-18 18:01:00"
"5122","20152207082206-772",2,"2015-07-07 08:51:00",1436284260,"C8",301380,1436585640,"2015-07-10 20:34:00"
"5493","20153807083832-588",3,"2015-07-07 09:18:00",1436285880,"C2",194160,1436480040,"2015-07-09 15:14:00"
"83","20151207091211-916",2,"2015-07-07 09:35:00",1436286900,"C5",95100,1436382000,"2015-07-08 12:00:00"
"3203","20150707090744-193",2,"2015-07-07 09:36:00",1436286960,"C4",124500,1436411460,"2015-07-08 20:11:00"
"3292","20153407083404-718",2,"2015-07-07 09:40:00",1436287200,"C7",120180,1436407380,"2015-07-08 19:03:00"
"178","20155407085436-987",2,"2015-07-07 09:47:00",1436287620,"C5",270240,1436557860,"2015-07-10 12:51:00"
"5988","20150407090456-983",1,"2015-07-07 10:02:00",1436288520,"C3",109620,1436398140,"2015-07-08 16:29:00"
"5146","20155707095706-832",1,"2015-07-07 10:03:00",1436288580,"C8",550500,1436839080,"2015-07-13 18:58:00"
"4942","20155307085318-512",3,"2015-07-07 10:08:00",1436288880,"C0",88320,1436377200,"2015-07-08 10:40:00"
"3386","20155407095445-308",1,"2015-07-07 10:11:00",1436289060,"C7",216000,1436505060,"2015-07-09 22:11:00"
"6057","20150807090832-325",3,"2015-07-07 10:12:00",1436289120,"C8",91140,1436380260,"2015-07-08 11:31:00"
"5683","20150307100357-262",2,"2015-07-07 10:27:00",1436290020,"C5",100140,1436390160,"2015-07-08 14:16:00"
"3777","20152707102716-827",3,"2015-07-07 10:52:00",1436291520,"C5",86580,1436378100,"2015-07-08 10:55:00"
"2035","20154107104138-147",2,"2015-07-07 11:52:00",1436295120,"C2",296280,1436591400,"2015-07-10 22:10:00"
"306","20150207110213-868",3,"2015-07-07 11:59:00",1436295540,"C7",104040,1436399580,"2015-07-08 16:53:00"
"3406","20152207112247-321",3,"2015-07-07 12:27:00",1436297220,"C4",244200,1436541420,"2015-07-10 08:17:00"
"320","20153407113449-132",1,"2015-07-07 12:28:00",1436297280,"C8",355740,1436653020,"2015-07-11 15:17:00"
"2183","20152307122306-159",3,"2015-07-07 12:30:00",1436297400,"C4",799860,1437097260,"2015-07-16 18:41:00"
"2279","20154107114151-839",2,"2015-07-07 12:40:00",1436298000,"C8",155160,1436453160,"2015-07-09 07:46:00"
"3028","20152707122720-612",3,"2015-07-07 12:50:00",1436298600,"C8",81960,1436380560,"2015-07-08 11:36:00"
"849","20155107125107-821",1,"2015-07-07 13:25:00",1436300700,"C5",186180,1436486880,"2015-07-09 17:08:00"
"6324","20155307125327-646",1,"2015-07-07 13:28:00",1436300880,"C8",532500,1436833380,"2015-07-13 17:23:00"
"2972","20154007124035-405",2,"2015-07-07 13:51:00",1436302260,"C3",634320,1436936580,"2015-07-14 22:03:00"
"1638","20151507011530-88",1,"2015-07-07 14:09:00",1436303340,"C5",288960,1436592300,"2015-07-10 22:25:00"
"3215","20151907011937-909",3,"2015-07-07 14:16:00",1436303760,"C8",494340,1436798100,"2015-07-13 07:35:00"
"3889","20153007013003-908",1,"2015-07-07 14:23:00",1436304180,"C5",350040,1436654220,"2015-07-11 15:37:00"
"2813","20153707023747-858",1,"2015-07-07 15:04:00",1436306640,"C4",145500,1436452140,"2015-07-09 07:29:00"
"3220","20150307030320-55",3,"2015-07-07 15:11:00",1436307060,"C8",176640,1436483700,"2015-07-09 16:15:00"
"4408","20152207042208-551",1,"2015-07-07 16:28:00",1436311680,"C8",742980,1437054660,"2015-07-16 06:51:00"
"1160","20154507034519-6",2,"2015-07-07 16:33:00",1436311980,"C8",171720,1436483700,"2015-07-09 16:15:00"
"3872","20151807041826-31",1,"2015-07-07 16:41:00",1436312460,"C4",167880,1436480340,"2015-07-09 15:19:00"
"5692","20153507043529-286",1,"2015-07-07 16:47:00",1436312820,"C3",656760,1436969580,"2015-07-15 07:13:00"
"4429","20155307045325-414",2,"2015-07-07 17:01:00",1436313660,"C4",136500,1436450160,"2015-07-09 06:56:00"
"4078","20154107044154-514",1,"2015-07-07 17:07:00",1436314020,"C4",145500,1436459520,"2015-07-09 09:32:00"
"2898","20153407043429-914",1,"2015-07-07 17:25:00",1436315100,"C7",165960,1436481060,"2015-07-09 15:31:00"
"2135","20152507052543-844",2,"2015-07-07 17:50:00",1436316600,"C8",441960,1436758560,"2015-07-12 20:36:00"
"1102","20150207050259-178",1,"2015-07-07 18:05:00",1436317500,"C4",153300,1436470800,"2015-07-09 12:40:00"
"4079","20151707051702-432",1,"2015-07-07 18:11:00",1436317860,"C8",221700,1436539560,"2015-07-10 07:46:00"
"4335","20155907045941-874",3,"2015-07-07 18:11:00",1436317860,"C2",409440,1436727300,"2015-07-12 11:55:00"
"2927","20152907052915-532",2,"2015-07-07 18:34:00",1436319240,"C0",128400,1436447640,"2015-07-09 06:14:00"
"5849","20152308062330-627",3,"2015-07-08 06:53:00",1436363580,"C3",109140,1436472720,"2015-07-09 13:12:00"
"1625","20151008061031-83",1,"2015-07-08 07:02:00",1436364120,"C7",363240,1436727360,"2015-07-12 11:56:00"
"4559","20153908063905-670",3,"2015-07-08 07:05:00",1436364300,"C4",273120,1436637420,"2015-07-11 10:57:00"
"4592","20154608064621-71",1,"2015-07-08 07:08:00",1436364480,"C5",207720,1436572200,"2015-07-10 16:50:00"
"4878","20154408064412-833",3,"2015-07-08 07:18:00",1436365080,"C3",87600,1436452680,"2015-07-09 07:38:00"
"3041","20154708064723-472",3,"2015-07-08 07:41:00",1436366460,"C4",224700,1436591160,"2015-07-10 22:06:00"
"428","20151908071935-977",1,"2015-07-08 07:43:00",1436366580,"C8",283440,1436650020,"2015-07-11 14:27:00"
"104","20154708074757-401",1,"2015-07-08 07:55:00",1436367300,"C4",191700,1436559000,"2015-07-10 13:10:00"
"3208","20153708073726-600",2,"2015-07-08 07:57:00",1436367420,"C7",363780,1436731200,"2015-07-12 13:00:00"
"470","20155808075842-527",3,"2015-07-08 08:04:00",1436367840,"C2",124380,1436492220,"2015-07-09 18:37:00"
"2395","20150108080154-471",1,"2015-07-08 08:17:00",1436368620,"C7",120300,1436488920,"2015-07-09 17:42:00"
"3310","20153208073235-389",2,"2015-07-08 08:33:00",1436369580,"C7",81300,1436450880,"2015-07-09 07:08:00"
"3234","20155108075139-964",2,"2015-07-08 08:44:00",1436370240,"C8",216180,1436586420,"2015-07-10 20:47:00"
"6069","20150908080915-434",3,"2015-07-08 08:53:00",1436370780,"C8",222000,1436592780,"2015-07-10 22:33:00"
"499","20153508083547-956",1,"2015-07-08 09:13:00",1436371980,"C0",264720,1436636700,"2015-07-11 10:45:00"
"4701","20151008091003-541",1,"2015-07-08 09:15:00",1436372100,"C2",280200,1436652300,"2015-07-11 15:05:00"
"378","20151008091058-366",1,"2015-07-08 09:41:00",1436373660,"C6",94380,1436468040,"2015-07-09 11:54:00"
"2560","20151208091253-564",3,"2015-07-08 09:42:00",1436373720,"C2",75120,1436448840,"2015-07-09 06:34:00"
"6393","20152008092051-845",2,"2015-07-08 09:43:00",1436373780,"C5",337500,1436711280,"2015-07-12 07:28:00"
"5954","20152008092020-195",3,"2015-07-08 09:51:00",1436374260,"C2",351360,1436725620,"2015-07-12 11:27:00"
"3269","20150608090629-720",2,"2015-07-08 10:04:00",1436375040,"C8",807840,1437182880,"2015-07-17 18:28:00"
"831","20150408090423-286",1,"2015-07-08 10:16:00",1436375760,"C2",182400,1436558160,"2015-07-10 12:56:00"
"184","20151008101045-291",3,"2015-07-08 10:17:00",1436375820,"C2",1147560,1437523380,"2015-07-21 17:03:00"
"1240","20150108100110-534",2,"2015-07-08 10:26:00",1436376360,"C8",290700,1436667060,"2015-07-11 19:11:00"
"1442","20152908092908-702",1,"2015-07-08 10:26:00",1436376360,"C5",90900,1436467260,"2015-07-09 11:41:00"
"6338","20153408093405-996",1,"2015-07-08 10:36:00",1436376960,"C2",351300,1436728260,"2015-07-12 12:11:00"
"4114","20155008095000-690",2,"2015-07-08 10:48:00",1436377680,"C0",256860,1436634540,"2015-07-11 10:09:00"
"2864","20152408102406-549",2,"2015-07-08 10:57:00",1436378220,"C5",269220,1436647440,"2015-07-11 13:44:00"
"1812","20150708100721-172",3,"2015-07-08 11:03:00",1436378580,"C5",332820,1436711400,"2015-07-12 07:30:00"
"6000","20155508105537-280",1,"2015-07-08 11:17:00",1436379420,"C8",548580,1436928000,"2015-07-14 19:40:00"
"2490","20152608112631-387",3,"2015-07-08 11:40:00",1436380800,"C0",195300,1436576100,"2015-07-10 17:55:00"
"3177","20150308110350-292",2,"2015-07-08 11:56:00",1436381760,"C6",273540,1436655300,"2015-07-11 15:55:00"
"4221","20155608105623-726",3,"2015-07-08 11:58:00",1436381880,"C5",465300,1436847180,"2015-07-13 21:13:00"
"5639","20153908113930-121",1,"2015-07-08 12:04:00",1436382240,"C5",117420,1436499660,"2015-07-09 20:41:00"
"5691","20152908112909-319",2,"2015-07-08 12:26:00",1436383560,"C4",602940,1436986500,"2015-07-15 11:55:00"
"6434","20150408120450-64",1,"2015-07-08 12:53:00",1436385180,"C6",93180,1436478360,"2015-07-09 14:46:00"
"335","20152408122403-570",1,"2015-07-08 13:20:00",1436386800,"C5",79680,1436466480,"2015-07-09 11:28:00"
"3834","20151308011359-158",2,"2015-07-08 13:21:00",1436386860,"C8",201480,1436588340,"2015-07-10 21:19:00"
"325","20154508124538-434",2,"2015-07-08 13:40:00",1436388000,"C7",171240,1436559240,"2015-07-10 13:14:00"
"900","20150008010023-545",3,"2015-07-08 14:05:00",1436389500,"C2",164640,1436554140,"2015-07-10 11:49:00"
"2628","20154408014459-479",2,"2015-07-08 14:13:00",1436389980,"C8",146580,1436536560,"2015-07-10 06:56:00"
"2339","20151808021841-200",2,"2015-07-08 14:26:00",1436390760,"C8",174420,1436565180,"2015-07-10 14:53:00"
"547","20153708023749-220",1,"2015-07-08 15:02:00",1436392920,"C7",164280,1436557200,"2015-07-10 12:40:00"
"2093","20150208020258-125",1,"2015-07-08 15:03:00",1436392980,"C2",179160,1436572140,"2015-07-10 16:49:00"
"2775","20150508030553-514",3,"2015-07-08 15:33:00",1436394780,"C8",270780,1436665560,"2015-07-11 18:46:00"
"3096","20150708030735-179",1,"2015-07-08 15:46:00",1436395560,"C2",320880,1436716440,"2015-07-12 08:54:00"
"1013","20152808032826-116",3,"2015-07-08 15:54:00",1436396040,"C5",432300,1436828340,"2015-07-13 15:59:00"
"4432","20155708025739-913",1,"2015-07-08 15:54:00",1436396040,"C5",92760,1436488800,"2015-07-09 17:40:00"
"4989","20155708025745-242",1,"2015-07-08 15:55:00",1436396100,"C5",53940,1436450040,"2015-07-09 06:54:00"
"4655","20155708025703-505",3,"2015-07-08 15:57:00",1436396220,"C0",313740,1436709960,"2015-07-12 07:06:00"
"5385","20155908025926-104",2,"2015-07-08 15:59:00",1436396340,"C6",265800,1436662140,"2015-07-11 17:49:00"
"2711","20152508032527-438",1,"2015-07-08 16:02:00",1436396520,"C6",85980,1436482500,"2015-07-09 15:55:00"
"5620","20150808030815-401",1,"2015-07-08 16:03:00",1436396580,"C4",63900,1436460480,"2015-07-09 09:48:00"
"4998","20150408040443-205",2,"2015-07-08 16:10:00",1436397000,"C2",65340,1436462340,"2015-07-09 10:19:00"
"4932","20152408032407-297",2,"2015-07-08 16:22:00",1436397720,"C5",165180,1436562900,"2015-07-10 14:15:00"
"1892","20152208032247-227",1,"2015-07-08 16:23:00",1436397780,"C0",242940,1436640720,"2015-07-11 11:52:00"
"801","20152408032428-524",1,"2015-07-08 16:24:00",1436397840,"C0",94140,1436491980,"2015-07-09 18:33:00"
"313","20153908033947-597",1,"2015-07-08 16:36:00",1436398560,"C6",1134960,1437533520,"2015-07-21 19:52:00"
"2237","20154208034244-0",1,"2015-07-08 16:36:00",1436398560,"C4",230940,1436629500,"2015-07-11 08:45:00"
"1384","20151208041208-309",1,"2015-07-08 16:57:00",1436399820,"C8",274020,1436673840,"2015-07-11 21:04:00"
"3140","20155908035956-424",2,"2015-07-08 17:03:00",1436400180,"C2",94980,1436495160,"2015-07-09 19:26:00"
"1141","20154708044728-934",1,"2015-07-08 17:14:00",1436400840,"C4",413280,1436814120,"2015-07-13 12:02:00"
"5079","20150508050523-569",1,"2015-07-08 17:19:00",1436401140,"C7",331380,1436732520,"2015-07-12 13:22:00"
"901","20151808051847-914",1,"2015-07-08 17:24:00",1436401440,"C2",220920,1436622360,"2015-07-11 06:46:00"
"4310","20151008051030-28",1,"2015-07-08 17:26:00",1436401560,"C7",146220,1436547780,"2015-07-10 10:03:00"
"2196","20154908044958-492",1,"2015-07-08 17:28:00",1436401680,"C2",664200,1437065880,"2015-07-16 09:58:00"
"537","20152008052025-846",2,"2015-07-08 18:33:00",1436405580,"C3",263880,1436669460,"2015-07-11 19:51:00"
"6163","20150209060238-306",3,"2015-07-09 06:36:00",1436448960,"C2",116700,1436565660,"2015-07-10 15:01:00"
"4130","20150209060231-540",1,"2015-07-09 06:56:00",1436450160,"C5",290820,1436740980,"2015-07-12 15:43:00"
"979","20155309065327-597",1,"2015-07-09 07:01:00",1436450460,"C4",370020,1436820480,"2015-07-13 13:48:00"
"5476","20151109071101-943",1,"2015-07-09 07:32:00",1436452320,"C5",287040,1436739360,"2015-07-12 15:16:00"
"4776","20150409070446-883",2,"2015-07-09 07:52:00",1436453520,"C8",279180,1436732700,"2015-07-12 13:25:00"
"3565","20153609073654-587",1,"2015-07-09 08:03:00",1436454180,"C8",634380,1437088560,"2015-07-16 16:16:00"
"2403","20155009075029-871",2,"2015-07-09 08:04:00",1436454240,"C7",278940,1436733180,"2015-07-12 13:33:00"
"371","20154309074338-532",2,"2015-07-09 08:06:00",1436454360,"C5",462420,1436916780,"2015-07-14 16:33:00"
"1542","20155509065515-933",2,"2015-07-09 08:09:00",1436454540,"C7",222840,1436677380,"2015-07-11 22:03:00"
"4734","20155809065829-220",2,"2015-07-09 08:11:00",1436454660,"C2",86340,1436541000,"2015-07-10 08:10:00"
"4159","20153209073227-817",1,"2015-07-09 08:24:00",1436455440,"C4",102060,1436557500,"2015-07-10 12:45:00"
"4306","20151709081703-888",2,"2015-07-09 08:24:00",1436455440,"C8",259920,1436715360,"2015-07-12 08:36:00"
"479","20155909075954-808",1,"2015-07-09 08:26:00",1436455560,"C4",259260,1436714820,"2015-07-12 08:27:00"
"4672","20152009082025-752",1,"2015-07-09 08:27:00",1436455620,"C8",132180,1436587800,"2015-07-10 21:10:00"
"418","20155809075828-607",1,"2015-07-09 08:30:00",1436455800,"C0",544680,1437000480,"2015-07-15 15:48:00"
"869","20154109074131-62",2,"2015-07-09 08:30:00",1436455800,"C7",197220,1436653020,"2015-07-11 15:17:00"
"1694","20151109081144-678",3,"2015-07-09 08:48:00",1436456880,"C3",422100,1436878980,"2015-07-14 06:03:00"
"5884","20152909082925-700",1,"2015-07-09 08:53:00",1436457180,"C5",386100,1436843280,"2015-07-13 20:08:00"
"1562","20152909082901-932",1,"2015-07-09 09:23:00",1436458980,"C8",173520,1436632500,"2015-07-11 09:35:00"
"5339","20152709082754-396",1,"2015-07-09 09:25:00",1436459100,"C7",254460,1436713560,"2015-07-12 08:06:00"
"454","20155209085255-542",3,"2015-07-09 09:40:00",1436460000,"C6",289740,1436749740,"2015-07-12 18:09:00"
"1180","20153909083938-573",2,"2015-07-09 09:44:00",1436460240,"C5",180060,1436640300,"2015-07-11 11:45:00"
"3893","20152309092303-862",2,"2015-07-09 10:07:00",1436461620,"C8",177900,1436639520,"2015-07-11 11:32:00"
"3945","20155809095821-297",1,"2015-07-09 10:11:00",1436461860,"C3",92580,1436554440,"2015-07-10 11:54:00"
"6181","20155709095715-337",3,"2015-07-09 10:25:00",1436462700,"C4",275460,1436738160,"2015-07-12 14:56:00"
"1591","20153709093756-988",1,"2015-07-09 10:30:00",1436463000,"C8",415800,1436878800,"2015-07-14 06:00:00"
"4032","20152709092720-465",2,"2015-07-09 10:40:00",1436463600,"C2",262680,1436726280,"2015-07-12 11:38:00"
"5460","20155709095720-363",1,"2015-07-09 10:51:00",1436464260,"C5",417420,1436881680,"2015-07-14 06:48:00"
"5167","20151709101746-425",1,"2015-07-09 11:08:00",1436465280,"C5",628320,1437093600,"2015-07-16 17:40:00"
"5264","20155509105541-792",1,"2015-07-09 11:11:00",1436465460,"C7",92880,1436558340,"2015-07-10 12:59:00"
"329","20152509102521-374",1,"2015-07-09 11:33:00",1436466780,"C2",109980,1436576760,"2015-07-10 18:06:00"
"2331","20151409111433-68",2,"2015-07-09 11:41:00",1436467260,"C3",298080,1436765340,"2015-07-12 22:29:00"
"3520","20152509112544-291",1,"2015-07-09 11:41:00",1436467260,"C7",102060,1436569320,"2015-07-10 16:02:00"
"1036","20154809104801-644",3,"2015-07-09 11:42:00",1436467320,"C5",112260,1436579580,"2015-07-10 18:53:00"
"2990","20151709111735-195",1,"2015-07-09 12:13:00",1436469180,"C5",349020,1436818200,"2015-07-13 13:10:00"
"4162","20155809115800-678",1,"2015-07-09 12:28:00",1436470080,"C4",1038240,1437508320,"2015-07-21 12:52:00"
"3571","20155309115300-960",1,"2015-07-09 12:29:00",1436470140,"C0",73140,1436543280,"2015-07-10 08:48:00"
"71","20152909122903-463",1,"2015-07-09 13:21:00",1436473260,"C4",167340,1436640600,"2015-07-11 11:50:00"
"1778","20150209010259-697",1,"2015-07-09 13:34:00",1436474040,"C8",64980,1436539020,"2015-07-10 07:37:00"
"353","20154809124808-913",3,"2015-07-09 13:45:00",1436474700,"C4",191400,1436666100,"2015-07-11 18:55:00"
"412","20154709124756-980",1,"2015-07-09 13:48:00",1436474880,"C4",629700,1437104580,"2015-07-16 20:43:00"
"5601","20155209015212-409",3,"2015-07-09 13:57:00",1436475420,"C2",417840,1436893260,"2015-07-14 10:01:00"
"6075","20153909013957-769",1,"2015-07-09 14:03:00",1436475780,"C8",234600,1436710380,"2015-07-12 07:13:00"
"3186","20150109020137-850",3,"2015-07-09 14:08:00",1436476080,"C8",432660,1436908740,"2015-07-14 14:19:00"
"3713","20155409015439-148",1,"2015-07-09 14:27:00",1436477220,"C3",108960,1436586180,"2015-07-10 20:43:00"
"4600","20151909021907-531",2,"2015-07-09 14:50:00",1436478600,"C8",100140,1436578740,"2015-07-10 18:39:00"
"1642","20152009022052-994",2,"2015-07-09 15:07:00",1436479620,"C8",99300,1436578920,"2015-07-10 18:42:00"
"5609","20154509024548-175",1,"2015-07-09 15:09:00",1436479740,"C4",603420,1437083160,"2015-07-16 14:46:00"
"1646","20152909022912-907",1,"2015-07-09 15:26:00",1436480760,"C8",961740,1437442500,"2015-07-20 18:35:00"
"1944","20150509030549-76",1,"2015-07-09 15:32:00",1436481120,"C4",322800,1436803920,"2015-07-13 09:12:00"
"1886","20151209031242-452",1,"2015-07-09 15:35:00",1436481300,"C6",410220,1436891520,"2015-07-14 09:32:00"
"2026","20152409032441-824",2,"2015-07-09 16:08:00",1436483280,"C8",1006080,1437489360,"2015-07-21 07:36:00"
"4661","20155009035026-293",1,"2015-07-09 16:28:00",1436484480,"C2",851100,1437335580,"2015-07-19 12:53:00"
"6522","20155409035441-881",2,"2015-07-09 16:28:00",1436484480,"C4",354540,1436839020,"2015-07-13 18:57:00"
"5078","20151309041310-608",1,"2015-07-09 16:38:00",1436485080,"C5",62640,1436547720,"2015-07-10 10:02:00"
"2921","20154409044423-907",1,"2015-07-09 16:50:00",1436485800,"C2",711540,1437197340,"2015-07-17 22:29:00"
"3549","20154409044439-912",3,"2015-07-09 17:05:00",1436486700,"C5",250620,1436737320,"2015-07-12 14:42:00"
"1907","20151009041023-63",1,"2015-07-09 17:14:00",1436487240,"C2",95700,1436582940,"2015-07-10 19:49:00"
"6085","20155109045104-759",3,"2015-07-09 17:45:00",1436489100,"C4",265200,1436754300,"2015-07-12 19:25:00"
"3629","20154809044835-78",1,"2015-07-09 17:47:00",1436489220,"C5",1225500,1437714720,"2015-07-23 22:12:00"
"4410","20155809045856-713",2,"2015-07-09 17:56:00",1436489760,"C3",98400,1436588160,"2015-07-10 21:16:00"
"4870","20154209054227-699",1,"2015-07-09 18:03:00",1436490180,"C5",250260,1436740440,"2015-07-12 15:34:00"
"2245","20152109052153-334",1,"2015-07-09 18:10:00",1436490600,"C8",162120,1436652720,"2015-07-11 15:12:00"
"5818","20150509050552-677",1,"2015-07-09 18:17:00",1436491020,"C7",270480,1436761500,"2015-07-12 21:25:00"
"3402","20150910060904-59",2,"2015-07-10 06:41:00",1436535660,"C7",212460,1436748120,"2015-07-12 17:42:00"
"3573","20153910063929-445",1,"2015-07-10 06:41:00",1436535660,"C6",218940,1436754600,"2015-07-12 19:30:00"
"975","20152610062612-425",1,"2015-07-10 06:55:00",1436536500,"C8",287640,1436824140,"2015-07-13 14:49:00"
"4185","20153110063138-887",2,"2015-07-10 06:56:00",1436536560,"C4",115920,1436652480,"2015-07-11 15:08:00"
"660","20150810060851-257",1,"2015-07-10 07:03:00",1436536980,"C4",92100,1436629080,"2015-07-11 08:38:00"
"5819","20155810065842-768",2,"2015-07-10 07:34:00",1436538840,"C2",108720,1436647560,"2015-07-11 13:46:00"
"4108","20153410073455-798",1,"2015-07-10 08:01:00",1436540460,"C5",189060,1436729520,"2015-07-12 12:32:00"
"190","20150910080926-255",1,"2015-07-10 08:33:00",1436542380,"C8",784920,1437327300,"2015-07-19 10:35:00"
"1623","20151410081443-694",3,"2015-07-10 08:36:00",1436542560,"C5",107040,1436649600,"2015-07-11 14:20:00"
"4485","20151410081406-824",1,"2015-07-10 08:38:00",1436542680,"C5",565620,1437108300,"2015-07-16 21:45:00"
"3225","20154610074635-808",1,"2015-07-10 08:41:00",1436542860,"C6",183180,1436726040,"2015-07-12 11:34:00"
"4947","20153010083042-172",2,"2015-07-10 08:56:00",1436543760,"C4",211920,1436755680,"2015-07-12 19:48:00"
"4118","20150410080439-253",3,"2015-07-10 08:57:00",1436543820,"C5",279780,1436823600,"2015-07-13 14:40:00"
"6054","20155710075750-214",1,"2015-07-10 09:03:00",1436544180,"C8",99180,1436643360,"2015-07-11 12:36:00"
"4682","20150810080815-587",2,"2015-07-10 09:04:00",1436544240,"C5",86220,1436630460,"2015-07-11 09:01:00"
"1159","20151710081736-544",3,"2015-07-10 09:10:00",1436544600,"C5",174960,1436719560,"2015-07-12 09:46:00"
"4073","20151510081555-297",2,"2015-07-10 09:11:00",1436544660,"C3",103920,1436648580,"2015-07-11 14:03:00"
"557","20150810090808-3",2,"2015-07-10 09:18:00",1436545080,"C3",340020,1436885100,"2015-07-14 07:45:00"
"865","20150110090142-745",2,"2015-07-10 09:35:00",1436546100,"C0",174300,1436720400,"2015-07-12 10:00:00"
"5320","20151110091107-217",1,"2015-07-10 09:37:00",1436546220,"C5",161520,1436707740,"2015-07-12 06:29:00"
"3807","20150910090926-819",1,"2015-07-10 09:38:00",1436546280,"C6",279780,1436826060,"2015-07-13 15:21:00"
"1785","20155810095859-88",1,"2015-07-10 10:06:00",1436547960,"C4",734280,1437282240,"2015-07-18 22:04:00"
"3285","20151210101237-47",2,"2015-07-10 10:48:00",1436550480,"C2",415200,1436965680,"2015-07-15 06:08:00"
"4129","20154510104522-927",1,"2015-07-10 10:50:00",1436550600,"C2",97380,1436647980,"2015-07-11 13:53:00"
"3940","20153410103418-726",2,"2015-07-10 11:04:00",1436551440,"C0",178260,1436729700,"2015-07-12 12:35:00"
"4115","20153510103502-685",1,"2015-07-10 11:08:00",1436551680,"C5",602220,1437153900,"2015-07-17 10:25:00"
"2319","20151210101225-79",2,"2015-07-10 11:11:00",1436551860,"C4",89220,1436641080,"2015-07-11 11:58:00"
"2984","20153510103505-180",2,"2015-07-10 11:35:00",1436553300,"C4",423840,1436977140,"2015-07-15 09:19:00"
"1887","20153310113338-127",2,"2015-07-10 12:10:00",1436555400,"C7",177960,1436733360,"2015-07-12 13:36:00"
"4295","20154710114715-117",1,"2015-07-10 12:14:00",1436555640,"C5",347160,1436902800,"2015-07-14 12:40:00"
"6137","20150010120037-8",1,"2015-07-10 12:36:00",1436556960,"C2",1122900,1437679860,"2015-07-23 12:31:00"
"13","20151510121543-670",3,"2015-07-10 12:53:00",1436557980,"C2",252120,1436810100,"2015-07-13 10:55:00"
"2672","20155410115442-469",2,"2015-07-10 13:01:00",1436558460,"C3",268680,1436827140,"2015-07-13 15:39:00"
"5470","20152310122332-782",2,"2015-07-10 13:31:00",1436560260,"C6",455100,1437015360,"2015-07-15 19:56:00"
"6176","20150810010834-148",2,"2015-07-10 13:32:00",1436560320,"C5",269880,1436830200,"2015-07-13 16:30:00"
"562","20153910123921-997",1,"2015-07-10 13:33:00",1436560380,"C4",108180,1436668560,"2015-07-11 19:36:00"
"3324","20155610125653-388",2,"2015-07-10 13:54:00",1436561640,"C5",178020,1436739660,"2015-07-12 15:21:00"
"4021","20155110125158-386",1,"2015-07-10 13:54:00",1436561640,"C2",444360,1437006000,"2015-07-15 17:20:00"
"1750","20154112014114-381",1,"2015-07-10 14:14:00",1436562840,"C6",203760,1436766600,"2015-07-12 22:50:00"
"3616","20154210014220-695",3,"2015-07-10 14:16:00",1436562960,"C5",264840,1436827800,"2015-07-13 15:50:00"
"210","20155710015717-292",2,"2015-07-10 14:26:00",1436563560,"C5",587580,1437151140,"2015-07-17 09:39:00"
"2119","20150010020057-694",2,"2015-07-10 14:26:00",1436563560,"C5",520860,1437084420,"2015-07-16 15:07:00"
"6408","20151710021746-134",1,"2015-07-10 14:50:00",1436565000,"C4",505920,1437070920,"2015-07-16 11:22:00"
"4917","20153010023059-654",1,"2015-07-10 14:52:00",1436565120,"C8",240120,1436805240,"2015-07-13 09:34:00"
"2187","20152010022051-412",2,"2015-07-10 14:53:00",1436565180,"C3",160020,1436725200,"2015-07-12 11:20:00"
"2746","20155510025531-344",2,"2015-07-10 15:01:00",1436565660,"C2",250140,1436815800,"2015-07-13 12:30:00"
"376","20155210025230-794",1,"2015-07-10 15:20:00",1436566800,"C4",619860,1437186660,"2015-07-17 19:31:00"
"1977","20151210031224-723",2,"2015-07-10 15:34:00",1436567640,"C5",281820,1436849460,"2015-07-13 21:51:00"
"5882","20153310023320-488",1,"2015-07-10 15:34:00",1436567640,"C7",60600,1436628240,"2015-07-11 08:24:00"
"4138","20153710023741-996",1,"2015-07-10 15:45:00",1436568300,"C4",316620,1436884920,"2015-07-14 07:42:00"
"5625","20154010034018-964",3,"2015-07-10 15:45:00",1436568300,"C2",334980,1436903280,"2015-07-14 12:48:00"
"2859","20154410024451-978",3,"2015-07-10 15:46:00",1436568360,"C5",106620,1436674980,"2015-07-11 21:23:00"
"2354","20151510031519-222",1,"2015-07-10 15:47:00",1436568420,"C8",272940,1436841360,"2015-07-13 19:36:00"
"4605","20154519024544-322",2,"2015-07-10 15:55:00",1436568900,"C4",202140,1436771040,"2015-07-13 00:04:00"
"1686","20150010030002-664",2,"2015-07-10 16:04:00",1436569440,"C3",279840,1436849280,"2015-07-13 21:48:00"
"3988","20152210032211-174",3,"2015-07-10 16:18:00",1436570280,"C4",279900,1436850180,"2015-07-13 22:03:00"
"6531","20150010040037-125",1,"2015-07-10 16:21:00",1436570460,"C5",96540,1436667000,"2015-07-11 19:10:00"
"1740","20155310035300-431",1,"2015-07-10 16:30:00",1436571000,"C6",886080,1437457080,"2015-07-20 22:38:00"
"469","20153310033332-410",2,"2015-07-10 16:40:00",1436571600,"C4",99420,1436671020,"2015-07-11 20:17:00"
"4842","20155910035954-864",1,"2015-07-10 16:57:00",1436572620,"C8",279360,1436851980,"2015-07-13 22:33:00"
"1549","20153610043627-233",2,"2015-07-10 17:05:00",1436573100,"C5",522720,1437095820,"2015-07-16 18:17:00"
"5838","20150510050547-65",1,"2015-07-10 17:13:00",1436573580,"C8",140520,1436714100,"2015-07-12 08:15:00"
"3860","20152810052855-807",1,"2015-07-10 17:39:00",1436575140,"C3",274740,1436849880,"2015-07-13 21:58:00"
"6205","20151610051648-803",2,"2015-07-10 17:44:00",1436575440,"C4",223440,1436798880,"2015-07-13 07:48:00"
"680","20154310054327-591",1,"2015-07-10 17:49:00",1436575740,"C8",246720,1436822460,"2015-07-13 14:21:00"
"135","20152610052623-296",1,"2015-07-10 18:04:00",1436576640,"C7",754620,1437331260,"2015-07-19 11:41:00"
"4902","20153810053835-229",1,"2015-07-10 18:05:00",1436576700,"C8",438540,1437015240,"2015-07-15 19:54:00"
"9","20151710051755-835",3,"2015-07-10 18:10:00",1436577000,"C5",93600,1436670600,"2015-07-11 20:10:00"
"279","20155610055624-279",1,"2015-07-10 18:57:00",1436579820,"C7",670800,1437250620,"2015-07-18 13:17:00"
"4","20153111063125-468",2,"2015-07-11 06:52:00",1436622720,"C5",179460,1436802180,"2015-07-13 08:43:00"
"2830","20151211061235-957",2,"2015-07-11 07:12:00",1436623920,"C5",171300,1436795220,"2015-07-13 06:47:00"
"3200","20151511071529-602",2,"2015-07-11 07:17:00",1436624220,"C6",97920,1436722140,"2015-07-12 10:29:00"
"4847","20154711064739-979",1,"2015-07-11 07:23:00",1436624580,"C0",209820,1436834400,"2015-07-13 17:40:00"
"3531","20153211063223-512",1,"2015-07-11 07:31:00",1436625060,"C5",191880,1436816940,"2015-07-13 12:49:00"
"3378","20150011070002-311",3,"2015-07-11 07:37:00",1436625420,"C0",485580,1437111000,"2015-07-16 22:30:00"
"5061","20154211064241-592",1,"2015-07-11 07:48:00",1436626080,"C4",538740,1437164820,"2015-07-17 13:27:00"
"4404","20152811072856-634",1,"2015-07-11 07:57:00",1436626620,"C4",194280,1436820900,"2015-07-13 13:55:00"
"5432","20154411064440-435",1,"2015-07-11 08:00:00",1436626800,"C2",104640,1436731440,"2015-07-12 13:04:00"
"6342","20154111074111-452",1,"2015-07-11 08:07:00",1436627220,"C5",467700,1437094920,"2015-07-16 18:02:00"
"683","20150211080249-753",2,"2015-07-11 08:20:00",1436628000,"C6",187440,1436815440,"2015-07-13 12:24:00"
"2428","20150911080900-458",3,"2015-07-11 08:21:00",1436628060,"C3",203040,1436831100,"2015-07-13 16:45:00"
"915","20153711073747-446",1,"2015-07-11 08:22:00",1436628120,"C8",552300,1437180420,"2015-07-17 17:47:00"
"3263","20152711082701-441",1,"2015-07-11 08:34:00",1436628840,"C8",120240,1436749080,"2015-07-12 17:58:00"
"686","20153511073525-756",1,"2015-07-11 08:40:00",1436629200,"C8",447240,1437076440,"2015-07-16 12:54:00"
"610","20152411082436-105",3,"2015-07-11 08:41:00",1436629260,"C0",340920,1436970180,"2015-07-15 07:23:00"
"2235","20153011083029-396",1,"2015-07-11 08:57:00",1436630220,"C5",358740,1436988960,"2015-07-15 12:36:00"
"1724","20153811083856-28",1,"2015-07-11 08:59:00",1436630340,"C5",94620,1436724960,"2015-07-12 11:16:00"
"2768","20154311084343-102",3,"2015-07-11 09:09:00",1436630940,"C5",94980,1436725920,"2015-07-12 11:32:00"
"4338","20150311090356-344",3,"2015-07-11 09:10:00",1436631000,"C8",88860,1436719860,"2015-07-12 09:51:00"
"5889","20151711081724-536",1,"2015-07-11 09:16:00",1436631360,"C4",184620,1436815980,"2015-07-13 12:33:00"
"1797","20155811085816-277",2,"2015-07-11 09:20:00",1436631600,"C4",119220,1436750820,"2015-07-12 18:27:00"
"5804","20152811092825-833",1,"2015-07-11 09:34:00",1436632440,"C2",355020,1436987460,"2015-07-15 12:11:00"
"6043","20152711092730-427",3,"2015-07-11 09:35:00",1436632500,"C8",74880,1436707380,"2015-07-12 06:23:00"
"5594","20154011084036-355",3,"2015-07-11 09:38:00",1436632680,"C5",420000,1437052680,"2015-07-16 06:18:00"
"6249","20151911091902-88",3,"2015-07-11 09:46:00",1436633160,"C4",122880,1436756040,"2015-07-12 19:54:00"
"2731","20150111090110-546",2,"2015-07-11 10:00:00",1436634000,"C4",973740,1437607740,"2015-07-22 16:29:00"
"2067","20151411101443-797",1,"2015-07-11 10:41:00",1436636460,"C8",680940,1437317400,"2015-07-19 07:50:00"
"4349","20154911094955-742",1,"2015-07-11 10:43:00",1436636580,"C4",1073820,1437710400,"2015-07-23 21:00:00"
"1173","20152511102520-964",3,"2015-07-11 10:44:00",1436636640,"C7",177720,1436814360,"2015-07-13 12:06:00"
"1444","20155111095109-411",1,"2015-07-11 10:53:00",1436637180,"C5",436920,1437074100,"2015-07-16 12:15:00"
"3432","20154811104853-331",3,"2015-07-11 10:56:00",1436637360,"C4",284940,1436922300,"2015-07-14 18:05:00"
"6231","20155111095142-349",1,"2015-07-11 10:56:00",1436637360,"C4",261780,1436899140,"2015-07-14 11:39:00"
"3544","20153411103404-448",1,"2015-07-11 11:10:00",1436638200,"C6",354600,1436992800,"2015-07-15 13:40:00"
"2410","20153211103235-736",1,"2015-07-11 11:35:00",1436639700,"C4",208500,1436848200,"2015-07-13 21:30:00"
"6172","20151611111649-796",1,"2015-07-11 11:38:00",1436639880,"C8",159720,1436799600,"2015-07-13 08:00:00"
"5664","20152711112746-346",2,"2015-07-11 11:51:00",1436640660,"C7",69720,1436710380,"2015-07-12 07:13:00"
"5906","20150411110416-875",1,"2015-07-11 12:03:00",1436641380,"C4",555300,1437196680,"2015-07-17 22:18:00"
"4471","20150411110416-472",2,"2015-07-11 12:18:00",1436642280,"C2",179880,1436822160,"2015-07-13 14:16:00"
"4396","20154511114515-568",1,"2015-07-11 12:20:00",1436642400,"C8",176340,1436818740,"2015-07-13 13:19:00"
"1298","20150011120023-724",1,"2015-07-11 12:22:00",1436642520,"C5",189960,1436832480,"2015-07-13 17:08:00"
"1894","20154111114145-439",2,"2015-07-11 12:29:00",1436642940,"C7",94740,1436737680,"2015-07-12 14:48:00"
"4851","20153311113332-277",2,"2015-07-11 12:38:00",1436643480,"C2",98700,1436742180,"2015-07-12 16:03:00"
"267","20155711115749-167",1,"2015-07-11 12:56:00",1436644560,"C6",888780,1437533340,"2015-07-21 19:49:00"
"717","20153111123156-389",1,"2015-07-11 13:05:00",1436645100,"C2",504000,1437149100,"2015-07-17 09:05:00"
"207","20155311125300-290",1,"2015-07-11 13:18:00",1436645880,"C8",96420,1436742300,"2015-07-12 16:05:00"
"309","20154911124924-532",1,"2015-07-11 13:26:00",1436646360,"C3",61680,1436708040,"2015-07-12 06:34:00"
"3486","20150311010308-753",3,"2015-07-11 13:26:00",1436646360,"C5",620880,1437267240,"2015-07-18 17:54:00"
"1810","20155911125954-688",1,"2015-07-11 13:54:00",1436648040,"C7",73140,1436721180,"2015-07-12 10:13:00"
"3223","20154611014601-555",3,"2015-07-11 14:07:00",1436648820,"C5",441300,1437090120,"2015-07-16 16:42:00"
"5975","20155511125500-140",1,"2015-07-11 14:07:00",1436648820,"C2",868620,1437517440,"2015-07-21 15:24:00"
"2118","20150611020620-822",3,"2015-07-11 14:28:00",1436650080,"C8",73860,1436723940,"2015-07-12 10:59:00"
"4339","20154011014020-687",2,"2015-07-11 14:32:00",1436650320,"C5",627840,1437278160,"2015-07-18 20:56:00"
"3556","20151811021803-685",1,"2015-07-11 14:43:00",1436650980,"C5",779340,1437430320,"2015-07-20 15:12:00"
"417","20154211024216-107",3,"2015-07-11 15:14:00",1436652840,"C6",1119120,1437771960,"2015-07-24 14:06:00"
"2703","20151911021956-775",1,"2015-07-11 15:16:00",1436652960,"C3",780480,1437433440,"2015-07-20 16:04:00"
"4750","20152211022237-502",2,"2015-07-11 15:21:00",1436653260,"C3",147720,1436800980,"2015-07-13 08:23:00"
"2738","20150211030246-951",3,"2015-07-11 15:28:00",1436653680,"C8",86280,1436739960,"2015-07-12 15:26:00"
"556","20154111024150-826",1,"2015-07-11 15:29:00",1436653740,"C7",96480,1436750220,"2015-07-12 18:17:00"
"1757","20153011023048-461",3,"2015-07-11 15:31:00",1436653860,"C5",261540,1436915400,"2015-07-14 16:10:00"
"5915","20150811030814-454",2,"2015-07-11 15:31:00",1436653860,"C5",239400,1436893260,"2015-07-14 10:01:00"
"3410","20152711032724-725",3,"2015-07-11 15:34:00",1436654040,"C2",679740,1437333780,"2015-07-19 12:23:00"
"2736","20152411032440-684",1,"2015-07-11 15:35:00",1436654100,"C3",431760,1437085860,"2015-07-16 15:31:00"
"5036","20153011023028-435",1,"2015-07-11 15:43:00",1436654580,"C6",283200,1436937780,"2015-07-14 22:23:00"
"1353","20151911031933-491",1,"2015-07-11 15:46:00",1436654760,"C3",231660,1436886420,"2015-07-14 08:07:00"
"705","20150111030116-821",1,"2015-07-11 16:00:00",1436655600,"C0",191220,1436846820,"2015-07-13 21:07:00"
"150","20154211034247-278",1,"2015-07-11 16:04:00",1436655840,"C8",879540,1437535380,"2015-07-21 20:23:00"
"3692","20155311035305-535",1,"2015-07-11 16:17:00",1436656620,"C4",178740,1436835360,"2015-07-13 17:56:00"
"1872","20151511041558-368",1,"2015-07-11 16:23:00",1436656980,"C8",141600,1436798580,"2015-07-13 07:43:00"
"2217","20152711032704-985",2,"2015-07-11 16:26:00",1436657160,"C3",264720,1436921880,"2015-07-14 17:58:00"
"672","20151111041119-158",1,"2015-07-11 16:27:00",1436657220,"C0",86280,1436743500,"2015-07-12 16:25:00"
"3954","20153311033321-730",1,"2015-07-11 16:33:00",1436657580,"C4",62460,1436720040,"2015-07-12 09:54:00"
"5972","20154111034148-335",1,"2015-07-11 16:40:00",1436658000,"C0",270120,1436928120,"2015-07-14 19:42:00"
"360","20155811045827-264",3,"2015-07-11 17:09:00",1436659740,"C3",134760,1436794500,"2015-07-13 06:35:00"
"1280","20150311040324-846",3,"2015-07-11 17:10:00",1436659800,"C3",504300,1437164100,"2015-07-17 13:15:00"
"3956","20152211042210-394",2,"2015-07-11 17:13:00",1436659980,"C8",148380,1436808360,"2015-07-13 10:26:00"
"558","20150911050916-197",1,"2015-07-11 17:15:00",1436660100,"C2",83760,1436743860,"2015-07-12 16:31:00"
"1771","20155511045543-118",2,"2015-07-11 17:18:00",1436660280,"C7",57540,1436717820,"2015-07-12 09:17:00"
"3109","20151811041814-115",2,"2015-07-11 17:24:00",1436660640,"C4",172140,1436832780,"2015-07-13 17:13:00"
"2420","20153611043604-222",2,"2015-07-11 17:35:00",1436661300,"C0",219840,1436881140,"2015-07-14 06:39:00"
"2997","20153111043103-266",3,"2015-07-11 17:39:00",1436661540,"C3",58440,1436719980,"2015-07-12 09:53:00"
"550","20151611051619-74",1,"2015-07-11 17:40:00",1436661600,"C4",97920,1436759520,"2015-07-12 20:52:00"
"1178","20154611044614-561",2,"2015-07-11 17:43:00",1436661780,"C3",45960,1436707740,"2015-07-12 06:29:00"
"1165","20151911051900-484",1,"2015-07-11 17:56:00",1436662560,"C2",221580,1436884140,"2015-07-14 07:29:00"
"1995","20154911054914-248",1,"2015-07-11 17:56:00",1436662560,"C2",409320,1437071880,"2015-07-16 11:38:00"
"3690","20153711053702-226",3,"2015-07-11 18:02:00",1436662920,"C5",96900,1436759820,"2015-07-12 20:57:00"
"5268","20150811050851-143",2,"2015-07-11 18:14:00",1436663640,"C7",251280,1436914920,"2015-07-14 16:02:00"
"1719","20150811050843-334",2,"2015-07-11 18:18:00",1436663880,"C2",83640,1436747520,"2015-07-12 17:32:00"
"1329","20150112060145-428",1,"2015-07-12 06:35:00",1436708100,"C7",85440,1436793540,"2015-07-13 06:19:00"
"2378","20151612061624-150",1,"2015-07-12 06:53:00",1436709180,"C7",638520,1437347700,"2015-07-19 16:15:00"
"3640","20153112063157-147",3,"2015-07-12 06:58:00",1436709480,"C5",86580,1436796060,"2015-07-13 07:01:00"
"2785","20152512062545-262",1,"2015-07-12 07:05:00",1436709900,"C2",471060,1437180960,"2015-07-17 17:56:00"
"2323","20155812065819-311",1,"2015-07-12 07:16:00",1436710560,"C6",130080,1436840640,"2015-07-13 19:24:00"
"3478","20150912060916-518",1,"2015-07-12 07:16:00",1436710560,"C2",826740,1437537300,"2015-07-21 20:55:00"
"5215","20152512062542-417",1,"2015-07-12 07:20:00",1436710800,"C4",122400,1436833200,"2015-07-13 17:20:00"
"3642","20153312063341-591",3,"2015-07-12 07:27:00",1436711220,"C4",96360,1436807580,"2015-07-13 10:13:00"
"1533","20153412063404-685",2,"2015-07-12 07:31:00",1436711460,"C5",121860,1436833320,"2015-07-13 17:22:00"
"4180","20153512063509-117",1,"2015-07-12 07:32:00",1436711520,"C2",106920,1436818440,"2015-07-13 13:14:00"
"6477","20154212064205-889",2,"2015-07-12 07:46:00",1436712360,"C6",192540,1436904900,"2015-07-14 13:15:00"
"6352","20153712063756-502",2,"2015-07-12 07:47:00",1436712420,"C3",93960,1436806380,"2015-07-13 09:53:00"
"4461","20153612073632-445",1,"2015-07-12 07:59:00",1436713140,"C8",283200,1436996340,"2015-07-15 14:39:00"
"3769","20151212081202-125",3,"2015-07-12 08:39:00",1436715540,"C8",903180,1437618720,"2015-07-22 19:32:00"
"1568","20153012083039-675",1,"2015-07-12 08:59:00",1436716740,"C6",119760,1436836500,"2015-07-13 18:15:00"
"2317","20155012085048-766",2,"2015-07-12 09:15:00",1436717700,"C5",176760,1436894460,"2015-07-14 10:21:00"
"723","20151612081630-430",3,"2015-07-12 09:22:00",1436718120,"C5",378720,1437096840,"2015-07-16 18:34:00"
"6350","20154712084755-402",1,"2015-07-12 09:22:00",1436718120,"C2",182460,1436900580,"2015-07-14 12:03:00"
"2514","20152312092334-13",3,"2015-07-12 09:46:00",1436719560,"C6",306300,1437025860,"2015-07-15 22:51:00"
"6056","20152412092409-540",2,"2015-07-12 09:51:00",1436719860,"C8",712920,1437432780,"2015-07-20 15:53:00"
"1485","20154912084916-322",1,"2015-07-12 09:52:00",1436719920,"C6",303900,1437023820,"2015-07-15 22:17:00"
"692","20154112094107-810",3,"2015-07-12 10:01:00",1436720460,"C6",446280,1437166740,"2015-07-17 13:59:00"
"5718","20150412090424-439",1,"2015-07-12 10:11:00",1436721060,"C2",727860,1437448920,"2015-07-20 20:22:00"
"1146","20152012092008-483",1,"2015-07-12 10:13:00",1436721180,"C5",218460,1436939640,"2015-07-14 22:54:00"
"5767","20151412091419-116",1,"2015-07-12 10:24:00",1436721840,"C0",518220,1437240060,"2015-07-18 10:21:00"
"711","20151612101618-908",3,"2015-07-12 10:46:00",1436723160,"C6",253260,1436976420,"2015-07-15 09:07:00"
"4286","20153012103050-559",1,"2015-07-12 10:48:00",1436723280,"C7",334920,1437058200,"2015-07-16 07:50:00"
"2936","20151312101325-662",3,"2015-07-12 10:49:00",1436723340,"C2",689820,1437413160,"2015-07-20 10:26:00"
"2890","20151512111517-621",1,"2015-07-12 11:22:00",1436725320,"C8",351360,1437076680,"2015-07-16 12:58:00"
"2020","20155112105111-296",3,"2015-07-12 11:28:00",1436725680,"C0",176880,1436902560,"2015-07-14 12:36:00"
"4351","20154212104231-5",3,"2015-07-12 11:41:00",1436726460,"C3",705840,1437432300,"2015-07-20 15:45:00"
"6402","20154612104653-119",1,"2015-07-12 11:54:00",1436727240,"C5",423240,1437150480,"2015-07-17 09:28:00"
"2151","20150312110353-306",1,"2015-07-12 12:04:00",1436727840,"C5",152880,1436880720,"2015-07-14 06:32:00"
"5859","20152212112239-676",2,"2015-07-12 12:17:00",1436728620,"C4",65580,1436794200,"2015-07-13 06:30:00"
"227","20154212114201-175",2,"2015-07-12 12:42:00",1436730120,"C5",85560,1436815680,"2015-07-13 12:28:00"
"3901","20154712124711-992",2,"2015-07-12 12:49:00",1436730540,"C6",118920,1436849460,"2015-07-13 21:51:00"
"6514","20151212121250-641",1,"2015-07-12 13:04:00",1436731440,"C5",86040,1436817480,"2015-07-13 12:58:00"
"4147","20155812125816-703",3,"2015-07-12 13:12:00",1436731920,"C0",121140,1436853060,"2015-07-13 22:51:00"
"1843","20154612124636-207",2,"2015-07-12 13:19:00",1436732340,"C5",165780,1436898120,"2015-07-14 11:22:00"
"290","20152612122652-844",1,"2015-07-12 13:22:00",1436732520,"C5",76440,1436808960,"2015-07-13 10:36:00"
"4135","20155112125144-954",2,"2015-07-12 13:41:00",1436733660,"C7",116700,1436850360,"2015-07-13 22:06:00"
"1091","20152812122818-384",3,"2015-07-12 13:46:00",1436733960,"C0",610320,1437344280,"2015-07-19 15:18:00"
"265","20151512011521-735",1,"2015-07-12 13:49:00",1436734140,"C4",259980,1436994120,"2015-07-15 14:02:00"
"5751","20154612014642-990",1,"2015-07-12 13:52:00",1436734320,"C2",884460,1437618780,"2015-07-22 19:33:00"
"638","20153712013720-181",3,"2015-07-12 13:55:00",1436734500,"C6",204180,1436938680,"2015-07-14 22:38:00"
"3581","20155712125720-473",1,"2015-07-12 14:10:00",1436735400,"C0",699480,1437434880,"2015-07-20 16:28:00"
"2895","20151112011137-325",1,"2015-07-12 14:15:00",1436735700,"C2",344640,1437080340,"2015-07-16 13:59:00"
"3397","20154712014753-800",1,"2015-07-12 14:18:00",1436735880,"C8",74940,1436810820,"2015-07-13 11:07:00"
"2513","20152012012031-178",2,"2015-07-12 14:22:00",1436736120,"C4",105660,1436841780,"2015-07-13 19:43:00"
"6034","20152112022147-274",2,"2015-07-12 14:28:00",1436736480,"C8",324240,1437060720,"2015-07-16 08:32:00"
"4714","20151312011312-740",1,"2015-07-12 14:29:00",1436736540,"C2",1441080,1438177620,"2015-07-29 06:47:00"
"368","20152712012712-669",2,"2015-07-12 14:33:00",1436736780,"C5",64140,1436800920,"2015-07-13 08:22:00"
"645","20154312014352-916",1,"2015-07-12 14:37:00",1436737020,"C8",88140,1436825160,"2015-07-13 15:06:00"
"715","20151812021854-880",2,"2015-07-12 14:50:00",1436737800,"C2",364020,1437101820,"2015-07-16 19:57:00"
"4452","20155812015855-673",3,"2015-07-12 15:00:00",1436738400,"C5",152040,1436890440,"2015-07-14 09:14:00"
"3613","20151212021252-485",3,"2015-07-12 15:21:00",1436739660,"C6",84660,1436824320,"2015-07-13 14:52:00"
"356","20153012023040-460",1,"2015-07-12 15:23:00",1436739780,"C7",174000,1436913780,"2015-07-14 15:43:00"
"2606","20154712024716-747",2,"2015-07-12 15:45:00",1436741100,"C5",1137540,1437878640,"2015-07-25 19:44:00"
"2246","20154612024622-150",1,"2015-07-12 15:47:00",1436741220,"C0",693360,1437434580,"2015-07-20 16:23:00"
"5800","20152412032403-590",3,"2015-07-12 15:55:00",1436741700,"C6",434640,1437176340,"2015-07-17 16:39:00"
"1039","20151612031639-61",1,"2015-07-12 16:00:00",1436742000,"C8",151860,1436893860,"2015-07-14 10:11:00"
"1723","20155712035738-767",3,"2015-07-12 16:04:00",1436742240,"C4",1017360,1437759600,"2015-07-24 10:40:00"
"2985","20150212030241-721",2,"2015-07-12 16:13:00",1436742780,"C3",512100,1437254880,"2015-07-18 14:28:00"
"2841","20151412031428-824",3,"2015-07-12 16:17:00",1436743020,"C2",1304400,1438047420,"2015-07-27 18:37:00"
"3626","20152012032040-682",2,"2015-07-12 16:28:00",1436743680,"C0",584700,1437328380,"2015-07-19 10:53:00"
"4625","20152612032640-395",1,"2015-07-12 16:36:00",1436744160,"C2",56580,1436800740,"2015-07-13 08:19:00"
"1863","20153412033403-441",1,"2015-07-12 16:46:00",1436744760,"C2",930360,1437675120,"2015-07-23 11:12:00"
"2982","20152012042036-344",1,"2015-07-12 17:06:00",1436745960,"C8",435060,1437181020,"2015-07-17 17:57:00"
"4679","20153712043748-60",3,"2015-07-12 17:35:00",1436747700,"C5",436200,1437183900,"2015-07-17 18:45:00"
"2101","20153312053318-51",2,"2015-07-12 17:40:00",1436748000,"C4",144180,1436892180,"2015-07-14 09:43:00"
"2925","20150112050122-27",1,"2015-07-12 17:58:00",1436749080,"C5",362280,1437111360,"2015-07-16 22:36:00"
"4290","20153712053742-911",2,"2015-07-12 18:00:00",1436749200,"C5",69000,1436818200,"2015-07-13 13:10:00"
"387","20151412051446-871",1,"2015-07-12 18:15:00",1436750100,"C2",90900,1436841000,"2015-07-13 19:30:00"
"5083","20154912054955-518",1,"2015-07-12 18:16:00",1436750160,"C3",83100,1436833260,"2015-07-13 17:21:00"
"1208","20155712055713-620",1,"2015-07-12 18:19:00",1436750340,"C4",60660,1436811000,"2015-07-13 11:10:00"
"1856","20154812054846-708",1,"2015-07-12 18:22:00",1436750520,"C2",488160,1437238680,"2015-07-18 09:58:00"
"4394","20151113061132-529",3,"2015-07-13 06:18:00",1436793480,"C2",818400,1437611880,"2015-07-22 17:38:00"
"2359","20152113062104-747",2,"2015-07-13 06:29:00",1436794140,"C8",312480,1437106620,"2015-07-16 21:17:00"
"1110","20150513060545-668",1,"2015-07-13 06:56:00",1436795760,"C4",126660,1436922420,"2015-07-14 18:07:00"
"1433","20154613064658-613",1,"2015-07-13 07:00:00",1436796000,"C7",96060,1436892060,"2015-07-14 09:41:00"
"4182","20155013065048-240",1,"2015-07-13 07:11:00",1436796660,"C7",375420,1437172080,"2015-07-17 15:28:00"
"229","20154113074143-823",1,"2015-07-13 08:17:00",1436800620,"C3",122220,1436922840,"2015-07-14 18:14:00"
"3099","20152813072833-760",1,"2015-07-13 08:29:00",1436801340,"C2",343560,1437144900,"2015-07-17 07:55:00"
"731","20152813082850-252",1,"2015-07-13 08:31:00",1436801460,"C6",129180,1436930640,"2015-07-14 20:24:00"
"4946","20152913082912-781",1,"2015-07-13 08:49:00",1436802540,"C5",882180,1437684720,"2015-07-23 13:52:00"
"5184","20154513074545-202",1,"2015-07-13 08:53:00",1436802780,"C8",185340,1436988120,"2015-07-15 12:22:00"
"6459","20155813075840-171",2,"2015-07-13 09:09:00",1436803740,"C2",462720,1437266460,"2015-07-18 17:41:00"
"2961","20151113081103-202",1,"2015-07-13 09:14:00",1436804040,"C5",548580,1437352620,"2015-07-19 17:37:00"
"2581","20155313085311-65",3,"2015-07-13 09:20:00",1436804400,"C8",190140,1436994540,"2015-07-15 14:09:00"
"4797","20151413081417-823",1,"2015-07-13 09:26:00",1436804760,"C0",93480,1436898240,"2015-07-14 11:24:00"
"6158","20155413095429-78",2,"2015-07-13 10:24:00",1436808240,"C2",360540,1437168780,"2015-07-17 14:33:00"
"5392","20152513092550-113",1,"2015-07-13 10:34:00",1436808840,"C0",179640,1436988480,"2015-07-15 12:28:00"
"1703","20150213100244-187",1,"2015-07-13 10:35:00",1436808900,"C2",619800,1437428700,"2015-07-20 14:45:00"
"3990","20154813094806-514",2,"2015-07-13 10:45:00",1436809500,"C4",80220,1436889720,"2015-07-14 09:02:00"
"4023","20153813103815-223",1,"2015-07-13 10:51:00",1436809860,"C7",974100,1437783960,"2015-07-24 17:26:00"
"374","20155713105709-55",2,"2015-07-13 11:12:00",1436811120,"C0",85740,1436896860,"2015-07-14 11:01:00"
"1882","20152513102558-161",2,"2015-07-13 11:41:00",1436812860,"C2",250680,1437063540,"2015-07-16 09:19:00"
"5186","20150013110015-112",2,"2015-07-13 12:03:00",1436814180,"C3",248460,1437062640,"2015-07-16 09:04:00"
"2944","20154113114117-693",2,"2015-07-13 12:12:00",1436814720,"C7",381300,1437196020,"2015-07-17 22:07:00"
"1189","20154513114555-897",1,"2015-07-13 12:19:00",1436815140,"C5",380040,1437195180,"2015-07-17 21:53:00"
"1616","20153013113059-327",1,"2015-07-13 12:23:00",1436815380,"C7",434340,1437249720,"2015-07-18 13:02:00"
"5808","20155513115543-669",1,"2015-07-13 12:41:00",1436816460,"C6",186840,1437003300,"2015-07-15 16:35:00"
"2800","20151113121156-771",2,"2015-07-13 12:55:00",1436817300,"C8",540060,1437357360,"2015-07-19 18:56:00"
"475","20151713011710-914",3,"2015-07-13 13:40:00",1436820000,"C5",348660,1437168660,"2015-07-17 14:31:00"
"5228","20153213013210-111",1,"2015-07-13 13:54:00",1436820840,"C4",185460,1437006300,"2015-07-15 17:25:00"
"377","20154913124955-986",3,"2015-07-13 13:56:00",1436820960,"C4",75780,1436896740,"2015-07-14 10:59:00"
"1142","20153613013647-912",3,"2015-07-13 14:01:00",1436821260,"C5",62100,1436883360,"2015-07-14 07:16:00"
"4199","20150213020216-787",3,"2015-07-13 14:08:00",1436821680,"C2",317760,1437139440,"2015-07-17 06:24:00"
"812","20155313015324-374",1,"2015-07-13 14:23:00",1436822580,"C6",404880,1437227460,"2015-07-18 06:51:00"
"2935","20153913013912-134",2,"2015-07-13 14:29:00",1436822940,"C4",239580,1437062520,"2015-07-16 09:02:00"
"3011","20150713020758-120",2,"2015-07-13 14:32:00",1436823120,"C5",65580,1436888700,"2015-07-14 08:45:00"
"348","20153013023021-720",1,"2015-07-13 14:58:00",1436824680,"C4",140580,1436965260,"2015-07-15 06:01:00"
"100","20153313023303-282",3,"2015-07-13 15:00:00",1436824800,"C8",263460,1437088260,"2015-07-16 16:11:00"
"836","20152613022643-189",1,"2015-07-13 15:02:00",1436824920,"C0",84660,1436909580,"2015-07-14 14:33:00"
"6364","20151413021408-91",2,"2015-07-13 15:12:00",1436825520,"C6",187500,1437013020,"2015-07-15 19:17:00"
"5912","20152313032302-271",2,"2015-07-13 15:48:00",1436827680,"C4",67320,1436895000,"2015-07-14 10:30:00"
"91","20153813033817-519",2,"2015-07-13 16:07:00",1436828820,"C6",444660,1437273480,"2015-07-18 19:38:00"
"5084","20154813034829-169",1,"2015-07-13 16:13:00",1436829180,"C8",1351800,1438180980,"2015-07-29 07:43:00"
"4214","20151113031115-28",1,"2015-07-13 16:14:00",1436829240,"C3",691980,1437521220,"2015-07-21 16:27:00"
"2916","20153113043100-622",2,"2015-07-13 16:38:00",1436830680,"C4",1107840,1437938520,"2015-07-26 12:22:00"
"4922","20152813042802-5",2,"2015-07-13 16:56:00",1436831760,"C8",333840,1437165600,"2015-07-17 13:40:00"
"3464","20155713045735-33",1,"2015-07-13 17:03:00",1436832180,"C2",93180,1436925360,"2015-07-14 18:56:00"
"3058","20152413042403-986",3,"2015-07-13 17:31:00",1436833860,"C8",97200,1436931060,"2015-07-14 20:31:00"
"2700","20154213044259-545",1,"2015-07-13 17:42:00",1436834520,"C8",135900,1436970420,"2015-07-15 07:27:00"
"3027","20151313051340-385",2,"2015-07-13 17:46:00",1436834760,"C8",409740,1437244500,"2015-07-18 11:35:00"
"3587","20153013053056-41",1,"2015-07-13 17:47:00",1436834820,"C0",49620,1436884440,"2015-07-14 07:34:00"
"943","20153613053658-337",1,"2015-07-13 18:09:00",1436836140,"C8",422340,1437258480,"2015-07-18 15:28:00"
"5112","20150413050412-329",2,"2015-07-13 18:15:00",1436836500,"C3",48120,1436884620,"2015-07-14 07:37:00"
"4581","20151013041011-524",1,"2015-07-13 19:56:00",1436842560,"C8",870240,1437712800,"2015-07-23 21:40:00"
"3519","20152114062143-72",1,"2015-07-14 06:24:00",1436880240,"C6",354180,1437234420,"2015-07-18 08:47:00"
"6159","20150214060215-80",3,"2015-07-14 06:56:00",1436882160,"C8",567960,1437450120,"2015-07-20 20:42:00"
"5673","20152914062912-293",2,"2015-07-14 07:02:00",1436882520,"C7",117420,1436999940,"2015-07-15 15:39:00"
"6454","20150214070205-409",2,"2015-07-14 07:10:00",1436883000,"C4",290760,1437173760,"2015-07-17 15:56:00"
"3238","20152714062757-568",3,"2015-07-14 07:28:00",1436884080,"C5",282720,1437166800,"2015-07-17 14:00:00"
"3372","20154214064232-812",2,"2015-07-14 07:40:00",1436884800,"C0",260160,1437144960,"2015-07-17 07:56:00"
"3267","20153414073455-915",3,"2015-07-14 07:42:00",1436884920,"C4",266160,1437151080,"2015-07-17 09:38:00"
"740","20153814073818-418",1,"2015-07-14 07:45:00",1436885100,"C4",226320,1437111420,"2015-07-16 22:37:00"
"3291","20153514073546-814",3,"2015-07-14 07:52:00",1436885520,"C0",84540,1436970060,"2015-07-15 07:21:00"
"609","20151614071608-934",1,"2015-07-14 07:53:00",1436885580,"C7",80220,1436965800,"2015-07-15 06:10:00"
"6507","20155614075656-559",1,"2015-07-14 08:19:00",1436887140,"C8",468420,1437355560,"2015-07-19 18:26:00"
"6445","20152614072648-135",1,"2015-07-14 08:28:00",1436887680,"C7",253680,1437141360,"2015-07-17 06:56:00"
"5505","20153214083255-828",2,"2015-07-14 08:59:00",1436889540,"C8",100680,1436990220,"2015-07-15 12:57:00"
"1754","20151114081116-872",2,"2015-07-14 09:03:00",1436889780,"C4",369000,1437258780,"2015-07-18 15:33:00"
"666","20155514095514-716",1,"2015-07-14 10:23:00",1436894580,"C5",116820,1437011400,"2015-07-15 18:50:00"
"4789","20151814091820-723",1,"2015-07-14 10:24:00",1436894640,"C3",623160,1437517800,"2015-07-21 15:30:00"
"296","20152514102555-759",3,"2015-07-14 10:33:00",1436895180,"C8",74160,1436969340,"2015-07-15 07:09:00"
"1980","20151214101217-551",1,"2015-07-14 10:33:00",1436895180,"C5",100260,1436995440,"2015-07-15 14:24:00"
"971","20154914104905-829",3,"2015-07-14 11:30:00",1436898600,"C0",382080,1437280680,"2015-07-18 21:38:00"
"5539","20151514111514-132",3,"2015-07-14 11:39:00",1436899140,"C5",275760,1437174900,"2015-07-17 16:15:00"
"5867","20155914105910-953",1,"2015-07-14 11:59:00",1436900340,"C4",274200,1437174540,"2015-07-17 16:09:00"
"3523","20150914110948-268",1,"2015-07-14 12:12:00",1436901120,"C7",325260,1437226380,"2015-07-18 06:33:00"
"3018","20152614112602-965",3,"2015-07-14 12:18:00",1436901480,"C5",87660,1436989140,"2015-07-15 12:39:00"
"1974","20150514120512-102",1,"2015-07-14 12:22:00",1436901720,"C7",295920,1437197640,"2015-07-17 22:34:00"
"2288","20152914112948-207",1,"2015-07-14 12:35:00",1436902500,"C0",671220,1437573720,"2015-07-22 07:02:00"
"6014","20151514121511-340",2,"2015-07-14 12:46:00",1436903160,"C8",760680,1437663840,"2015-07-23 08:04:00"
"6539","20153914123913-490",3,"2015-07-14 12:52:00",1436903520,"C7",178380,1437081900,"2015-07-16 14:25:00"
"4742","20152014122034-385",1,"2015-07-14 12:53:00",1436903580,"C6",632760,1437536340,"2015-07-21 20:39:00"
"1407","20155014125011-81",1,"2015-07-14 13:16:00",1436904960,"C4",184020,1437088980,"2015-07-16 16:23:00"
"6036","20153414123429-267",1,"2015-07-14 13:29:00",1436905740,"C8",339900,1437245640,"2015-07-18 11:54:00"
"5786","20150514010523-466",1,"2015-07-14 13:38:00",1436906280,"C2",73920,1436980200,"2015-07-15 10:10:00"
"223","20155314125319-412",3,"2015-07-14 13:44:00",1436906640,"C7",241200,1437147840,"2015-07-17 08:44:00"
"4877","20151414021427-933",1,"2015-07-14 14:20:00",1436908800,"C2",117480,1437026280,"2015-07-15 22:58:00"
"1946","20153914023918-636",1,"2015-07-14 14:55:00",1436910900,"C0",256080,1437166980,"2015-07-17 14:03:00"
"2528","20155514015554-802",2,"2015-07-14 14:56:00",1436910960,"C7",149460,1437060420,"2015-07-16 08:27:00"
"1521","20155414025452-910",1,"2015-07-14 15:16:00",1436912160,"C5",255240,1437167400,"2015-07-17 14:10:00"
"528","20154414024400-712",1,"2015-07-14 15:40:00",1436913600,"C3",340260,1437253860,"2015-07-18 14:11:00"
"5925","20150514030514-420",1,"2015-07-14 16:11:00",1436915460,"C2",352500,1437267960,"2015-07-18 18:06:00"
"6092","20154514034553-145",2,"2015-07-14 16:40:00",1436917200,"C5",232680,1437149880,"2015-07-17 09:18:00"
"5238","20152014052009-210",2,"2015-07-14 17:26:00",1436919960,"C4",152760,1437072720,"2015-07-16 11:52:00"
"1943","20153914043938-754",2,"2015-07-14 17:32:00",1436920320,"C8",50460,1436970780,"2015-07-15 07:33:00"
"16","20152614052608-658",1,"2015-07-14 17:34:00",1436920440,"C4",72240,1436992680,"2015-07-15 13:38:00"
"5492","20151314051327-38",1,"2015-07-14 17:38:00",1436920680,"C7",247740,1437168420,"2015-07-17 14:27:00"
"3838","20153014053026-5",1,"2015-07-14 17:59:00",1436921940,"C8",770940,1437692880,"2015-07-23 16:08:00"
"4952","20152614052641-115",1,"2015-07-14 18:06:00",1436922360,"C2",95160,1437017520,"2015-07-15 20:32:00"
"3749","20150314050311-620",2,"2015-07-14 18:09:00",1436922540,"C5",855960,1437778500,"2015-07-24 15:55:00"
"5938","20154114054132-501",2,"2015-07-14 18:37:00",1436924220,"C4",92520,1437016740,"2015-07-15 20:19:00"
"2756","20155114055130-358",1,"2015-07-14 18:52:00",1436925120,"C0",1468440,1438393560,"2015-07-31 18:46:00"
"6174","20154415064448-712",1,"2015-07-15 06:55:00",1436968500,"C3",1086180,1438054680,"2015-07-27 20:38:00"
"5503","20153915073941-756",1,"2015-07-15 07:47:00",1436971620,"C8",456120,1437427740,"2015-07-20 14:29:00"
"5222","20154715074737-500",2,"2015-07-15 07:50:00",1436971800,"C6",290520,1437262320,"2015-07-18 16:32:00"
"399","20150415070401-918",2,"2015-07-15 08:02:00",1436972520,"C4",260040,1437232560,"2015-07-18 08:16:00"
"5965","20153915073941-58",1,"2015-07-15 08:07:00",1436972820,"C3",390480,1437363300,"2015-07-19 20:35:00"
"6099","20150115080143-276",2,"2015-07-15 08:26:00",1436973960,"C7",687120,1437661080,"2015-07-23 07:18:00"
"2894","20155715075716-596",2,"2015-07-15 08:40:00",1436974800,"C2",90660,1437065460,"2015-07-16 09:51:00"
"183","20154615084621-811",3,"2015-07-15 09:09:00",1436976540,"C5",81840,1437058380,"2015-07-16 07:53:00"
"6046","20150415090454-392",1,"2015-07-15 09:32:00",1436977920,"C4",122280,1437100200,"2015-07-16 19:30:00"
"3139","20150615090601-623",2,"2015-07-15 09:42:00",1436978520,"C3",248580,1437227100,"2015-07-18 06:45:00"
"863","20153415093431-204",2,"2015-07-15 10:04:00",1436979840,"C0",108960,1437088800,"2015-07-16 16:20:00"
"1491","20150115100135-182",2,"2015-07-15 10:06:00",1436979960,"C2",368940,1437348900,"2015-07-19 16:35:00"
"3508","20151315091329-68",1,"2015-07-15 10:17:00",1436980620,"C2",79200,1437059820,"2015-07-16 08:17:00"
"4151","20154315094344-834",2,"2015-07-15 10:24:00",1436981040,"C2",385200,1437366240,"2015-07-19 21:24:00"
"3303","20152215092206-481",1,"2015-07-15 10:35:00",1436981700,"C0",893940,1437875640,"2015-07-25 18:54:00"
"17","20152715102727-628",3,"2015-07-15 11:00:00",1436983200,"C8",338280,1437321480,"2015-07-19 08:58:00"
"3085","20152715102715-129",2,"2015-07-15 11:00:00",1436983200,"C4",327960,1437311160,"2015-07-19 06:06:00"
"3188","20150815100857-72",1,"2015-07-15 11:00:00",1436983200,"C5",261120,1437244320,"2015-07-18 11:32:00"
"1002","20150815100834-958",1,"2015-07-15 11:06:00",1436983560,"C7",897480,1437881040,"2015-07-25 20:24:00"
"5037","20151215111234-603",2,"2015-07-15 11:34:00",1436985240,"C5",264720,1437249960,"2015-07-18 13:06:00"
"1221","20155415105401-84",2,"2015-07-15 11:53:00",1436986380,"C6",72180,1437058560,"2015-07-16 07:56:00"
"897","20152515112517-831",1,"2015-07-15 11:59:00",1436986740,"C0",269940,1437256680,"2015-07-18 14:58:00"
"1677","20150115110144-566",1,"2015-07-15 12:03:00",1436986980,"C2",286860,1437273840,"2015-07-18 19:44:00"
"2690","20154615114612-209",2,"2015-07-15 12:08:00",1436987280,"C4",286740,1437274020,"2015-07-18 19:47:00"
"4985","20153215113217-764",3,"2015-07-15 12:31:00",1436988660,"C2",101400,1437090060,"2015-07-16 16:41:00"
"1512","20151315121354-235",1,"2015-07-15 12:33:00",1436988780,"C6",375840,1437364620,"2015-07-19 20:57:00"
"5711","20154215124253-8",3,"2015-07-15 13:09:00",1436990940,"C4",365460,1437356400,"2015-07-19 18:40:00"
"3086","20150915010905-807",2,"2015-07-15 14:14:00",1436994840,"C2",178320,1437173160,"2015-07-17 15:46:00"
"2142","20155415015401-576",1,"2015-07-15 14:24:00",1436995440,"C4",146640,1437142080,"2015-07-17 07:08:00"
"5412","20155315015313-84",1,"2015-07-15 14:24:00",1436995440,"C8",95040,1437090480,"2015-07-16 16:48:00"
"5810","20153015023001-696",2,"2015-07-15 15:01:00",1436997660,"C5",631860,1437629520,"2015-07-22 22:32:00"
"322","20150315030313-186",1,"2015-07-15 15:14:00",1436998440,"C3",60660,1437059100,"2015-07-16 08:05:00"
"4319","20152115022106-782",1,"2015-07-15 15:18:00",1436998680,"C5",101640,1437100320,"2015-07-16 19:32:00"
"4722","20150315040346-314",1,"2015-07-15 16:24:00",1437002640,"C8",239700,1437242340,"2015-07-18 10:59:00"
"4386","20151115041148-836",2,"2015-07-15 16:33:00",1437003180,"C8",78360,1437081540,"2015-07-16 14:19:00"
"1380","20151415041441-660",3,"2015-07-15 16:50:00",1437004200,"C7",446460,1437450660,"2015-07-20 20:51:00"
"6184","20155715045720-815",2,"2015-07-15 17:13:00",1437005580,"C0",437280,1437442860,"2015-07-20 18:41:00"
"2671","20150115050115-511",2,"2015-07-15 17:19:00",1437005940,"C0",408180,1437414120,"2015-07-20 10:42:00"
"2811","20155515045550-909",1,"2015-07-15 17:25:00",1437006300,"C2",59700,1437066000,"2015-07-16 10:00:00"
"1356","20153015053016-75",1,"2015-07-15 17:58:00",1437008280,"C4",130200,1437138480,"2015-07-17 06:08:00"
"6001","20155115055126-836",3,"2015-07-15 17:58:00",1437008280,"C8",58680,1437066960,"2015-07-16 10:16:00"
"664","20155915055956-404",3,"2015-07-15 18:36:00",1437010560,"C0",145560,1437156120,"2015-07-17 11:02:00"
"1988","20153015053056-910",2,"2015-07-15 18:42:00",1437010920,"C2",61980,1437072900,"2015-07-16 11:55:00"
"2032","20154515054556-394",2,"2015-07-15 18:43:00",1437010980,"C5",956940,1437967920,"2015-07-26 20:32:00"
"747","20154615054615-774",3,"2015-07-15 18:49:00",1437011340,"C5",173520,1437184860,"2015-07-17 19:01:00"
"3908","20150816060849-742",3,"2015-07-16 06:35:00",1437053700,"C5",84900,1437138600,"2015-07-17 06:10:00"
"2027","20150816060823-385",3,"2015-07-16 06:39:00",1437053940,"C3",805680,1437859620,"2015-07-25 14:27:00"
"4520","20151816061843-103",1,"2015-07-16 06:44:00",1437054240,"C5",228480,1437282720,"2015-07-18 22:12:00"
"5196","20153316063306-527",3,"2015-07-16 06:58:00",1437055080,"C7",127260,1437182340,"2015-07-17 18:19:00"
"934","20155916065950-407",1,"2015-07-16 07:06:00",1437055560,"C8",142860,1437198420,"2015-07-17 22:47:00"
"5974","20150616070612-761",2,"2015-07-16 07:30:00",1437057000,"C5",174720,1437231720,"2015-07-18 08:02:00"
"1888","20152516072549-566",1,"2015-07-16 07:51:00",1437058260,"C5",266940,1437325200,"2015-07-19 10:00:00"
"3564","20153516073525-833",2,"2015-07-16 08:08:00",1437059280,"C6",81420,1437140700,"2015-07-17 06:45:00"
"1655","20152416072430-9",3,"2015-07-16 08:14:00",1437059640,"C8",192780,1437252420,"2015-07-18 13:47:00"
"1700","20155616075650-682",1,"2015-07-16 08:29:00",1437060540,"C8",177720,1437238260,"2015-07-18 09:51:00"
"1985","20150516080500-163",1,"2015-07-16 08:29:00",1437060540,"C4",379380,1437439920,"2015-07-20 17:52:00"
"1755","20152816082835-10",1,"2015-07-16 08:35:00",1437060900,"C4",83820,1437144720,"2015-07-17 07:52:00"
"825","20152216082220-757",1,"2015-07-16 09:19:00",1437063540,"C8",103920,1437167460,"2015-07-17 14:11:00"
"5659","20155916085912-350",3,"2015-07-16 10:01:00",1437066060,"C5",820560,1437886620,"2015-07-25 21:57:00"
"4583","20153616093612-196",1,"2015-07-16 10:02:00",1437066120,"C4",635340,1437701460,"2015-07-23 18:31:00"
"3716","20150716100718-333",1,"2015-07-16 10:54:00",1437069240,"C8",105840,1437175080,"2015-07-17 16:18:00"
"4066","20152816102825-722",1,"2015-07-16 10:56:00",1437069360,"C5",301860,1437371220,"2015-07-19 22:47:00"
"3427","20151916101912-704",2,"2015-07-16 11:00:00",1437069600,"C2",450900,1437520500,"2015-07-21 16:15:00"
"5259","20152816102821-282",1,"2015-07-16 11:03:00",1437069780,"C7",1157640,1438227420,"2015-07-29 20:37:00"
"1209","20155416105428-103",2,"2015-07-16 11:26:00",1437071160,"C8",168060,1437239220,"2015-07-18 10:07:00"
"6261","20154216104239-427",3,"2015-07-16 11:41:00",1437072060,"C8",123360,1437195420,"2015-07-17 21:57:00"
"2577","20153816113806-724",1,"2015-07-16 12:00:00",1437073200,"C5",121500,1437194700,"2015-07-17 21:45:00"
"4499","20155516115547-576",2,"2015-07-16 12:16:00",1437074160,"C8",123000,1437197160,"2015-07-17 22:26:00"
"2180","20152716122736-950",1,"2015-07-16 12:47:00",1437076020,"C1",347280,1437423300,"2015-07-20 13:15:00"
"2635","20152516122531-638",1,"2015-07-16 12:48:00",1437076080,"C5",67800,1437143880,"2015-07-17 07:38:00"
"5466","20152416012433-808",1,"2015-07-16 13:53:00",1437079980,"C4",275100,1437355080,"2015-07-19 18:18:00"
"3833","20150316010332-387",1,"2015-07-16 14:09:00",1437080940,"C2",458700,1437539640,"2015-07-21 21:34:00"
"3708","20152716022735-871",1,"2015-07-16 14:34:00",1437082440,"C8",57240,1437139680,"2015-07-17 06:28:00"
"1330","20153416013430-901",2,"2015-07-16 14:37:00",1437082620,"C2",266820,1437349440,"2015-07-19 16:44:00"
"1565","20155916015917-666",1,"2015-07-16 14:37:00",1437082620,"C1",425160,1437507780,"2015-07-21 12:43:00"
"5286","20155016015015-241",1,"2015-07-16 14:52:00",1437083520,"C8",95100,1437178620,"2015-07-17 17:17:00"
"876","20151116021105-602",1,"2015-07-16 15:04:00",1437084240,"C5",407160,1437491400,"2015-07-21 08:10:00"
"1595","20153816023820-577",2,"2015-07-16 15:12:00",1437084720,"C8",238260,1437322980,"2015-07-19 09:23:00"
"5055","20153616023658-518",2,"2015-07-16 15:12:00",1437084720,"C2",162360,1437247080,"2015-07-18 12:18:00"
"798","20151116031103-753",1,"2015-07-16 15:17:00",1437085020,"C8",409380,1437494400,"2015-07-21 09:00:00"
"1090","20150216030218-144",1,"2015-07-16 15:30:00",1437085800,"C5",431580,1437517380,"2015-07-21 15:23:00"
"2546","20152216022232-679",1,"2015-07-16 15:32:00",1437085920,"C3",111120,1437197040,"2015-07-17 22:24:00"
"4694","20152616032618-514",2,"2015-07-16 15:48:00",1437086880,"C4",77340,1437164220,"2015-07-17 13:17:00"
"842","20150316030333-652",2,"2015-07-16 16:01:00",1437087660,"C5",187620,1437275280,"2015-07-18 20:08:00"
"5042","20150916030932-958",1,"2015-07-16 16:02:00",1437087720,"C5",1825260,1438912980,"2015-08-06 19:03:00"
"4007","20153916033930-668",3,"2015-07-16 16:07:00",1437088020,"C4",177060,1437265080,"2015-07-18 17:18:00"
"2858","20151216041200-755",1,"2015-07-16 16:37:00",1437089820,"C5",430980,1437520800,"2015-07-21 16:20:00"
"1933","20154516034505-603",1,"2015-07-16 16:40:00",1437090000,"C8",74760,1437164760,"2015-07-17 13:26:00"
"140","20154116034139-452",1,"2015-07-16 16:42:00",1437090120,"C0",91020,1437181140,"2015-07-17 17:59:00"
"6260","20155616035612-493",1,"2015-07-16 16:49:00",1437090540,"C8",489780,1437580320,"2015-07-22 08:52:00"
"4526","20154416044414-95",2,"2015-07-16 17:08:00",1437091680,"C8",247560,1437339240,"2015-07-19 13:54:00"
"4501","20152616042649-259",1,"2015-07-16 17:31:00",1437093060,"C3",134040,1437227100,"2015-07-18 06:45:00"
"967","20155916045900-996",2,"2015-07-16 17:46:00",1437093960,"C7",222900,1437316860,"2015-07-19 07:41:00"
"4664","20154416054424-28",1,"2015-07-16 17:51:00",1437094260,"C4",137280,1437231540,"2015-07-18 07:59:00"
"307","20155216055209-787",2,"2015-07-16 17:54:00",1437094440,"C6",1106160,1438200600,"2015-07-29 13:10:00"
"124","20152316052346-175",2,"2015-07-16 18:01:00",1437094860,"C2",232020,1437326880,"2015-07-19 10:28:00"
"5700","20153716053741-328",1,"2015-07-16 18:01:00",1437094860,"C8",179700,1437274560,"2015-07-18 19:56:00"
"2799","20150717060746-729",3,"2015-07-17 06:32:00",1437139920,"C7",950400,1438090320,"2015-07-28 06:32:00"
"6419","20152817062832-264",2,"2015-07-17 06:52:00",1437141120,"C5",380160,1437521280,"2015-07-21 16:28:00"
"2493","20150117060105-392",1,"2015-07-17 06:58:00",1437141480,"C5",141060,1437282540,"2015-07-18 22:09:00"
"2136","20153217063258-545",2,"2015-07-17 07:02:00",1437141720,"C5",298080,1437439800,"2015-07-20 17:50:00"
"6067","20154617064600-936",1,"2015-07-17 07:02:00",1437141720,"C7",192720,1437334440,"2015-07-19 12:34:00"
"6254","20152817062846-890",2,"2015-07-17 07:05:00",1437141900,"C0",226260,1437368160,"2015-07-19 21:56:00"
"4979","20152217062234-111",3,"2015-07-17 07:17:00",1437142620,"C4",282300,1437424920,"2015-07-20 13:42:00"
"848","20150417070431-372",1,"2015-07-17 07:25:00",1437143100,"C6",459720,1437602820,"2015-07-22 15:07:00"
"5202","20153117063125-391",3,"2015-07-17 07:33:00",1437143580,"C4",87360,1437230940,"2015-07-18 07:49:00"
"774","20151317071311-118",3,"2015-07-17 07:41:00",1437144060,"C8",258120,1437402180,"2015-07-20 07:23:00"
"2504","20155717065720-517",1,"2015-07-17 07:49:00",1437144540,"C6",127680,1437272220,"2015-07-18 19:17:00"
"1351","20150217070227-343",1,"2015-07-17 07:55:00",1437144900,"C4",287340,1437432240,"2015-07-20 15:44:00"
"204","20155417065414-463",1,"2015-07-17 07:59:00",1437145140,"C0",173460,1437318600,"2015-07-19 08:10:00"
"2901","20150917070930-301",3,"2015-07-17 08:00:00",1437145200,"C5",339000,1437484200,"2015-07-21 06:10:00"
"1701","20155517065511-650",1,"2015-07-17 08:04:00",1437145440,"C2",129000,1437274440,"2015-07-18 19:54:00"
"6492","20153817073832-550",2,"2015-07-17 08:04:00",1437145440,"C4",214860,1437360300,"2015-07-19 19:45:00"
"1661","20150217080254-664",2,"2015-07-17 08:11:00",1437145860,"C4",302640,1437448500,"2015-07-20 20:15:00"
"2899","20150817070821-454",2,"2015-07-17 08:16:00",1437146160,"C2",112200,1437258360,"2015-07-18 15:26:00"
"2475","20152917072944-998",1,"2015-07-17 08:20:00",1437146400,"C4",391620,1437538020,"2015-07-21 21:07:00"
"4457","20155117075129-610",2,"2015-07-17 08:23:00",1437146580,"C6",397920,1437544500,"2015-07-21 22:55:00"
"2460","20152517072551-546",1,"2015-07-17 08:26:00",1437146760,"C0",96420,1437243180,"2015-07-18 11:13:00"
"5118","20155117065115-489",3,"2015-07-17 08:41:00",1437147660,"C0",179100,1437326760,"2015-07-19 10:26:00"
"4712","20153717083746-738",1,"2015-07-17 08:43:00",1437147780,"C2",265740,1437413520,"2015-07-20 10:32:00"
"4493","20151517081557-258",2,"2015-07-17 08:45:00",1437147900,"C2",79320,1437227220,"2015-07-18 06:47:00"
"5045","20153317083347-992",1,"2015-07-17 08:52:00",1437148320,"C0",800340,1437948660,"2015-07-26 15:11:00"
"6242","20155417075428-77",1,"2015-07-17 08:57:00",1437148620,"C6",79500,1437228120,"2015-07-18 07:02:00"
"5050","20152917082925-523",1,"2015-07-17 09:02:00",1437148920,"C2",293940,1437442860,"2015-07-20 18:41:00"
"1926","20155517085542-741",3,"2015-07-17 09:12:00",1437149520,"C0",208500,1437358020,"2015-07-19 19:07:00"
"5254","20151617081652-70",1,"2015-07-17 09:16:00",1437149760,"C4",1471080,1438620840,"2015-08-03 09:54:00"
"2556","20155617085640-226",2,"2015-07-17 09:17:00",1437149820,"C8",83280,1437233100,"2015-07-18 08:25:00"
"5316","20153117083124-431",2,"2015-07-17 09:20:00",1437150000,"C7",184140,1437334140,"2015-07-19 12:29:00"
"1578","20153517083522-960",2,"2015-07-17 09:27:00",1437150420,"C4",450780,1437601200,"2015-07-22 14:40:00"
"5479","20155817085808-370",1,"2015-07-17 09:27:00",1437150420,"C5",110880,1437261300,"2015-07-18 16:15:00"
"1684","20150517090518-811",3,"2015-07-17 09:29:00",1437150540,"C7",87000,1437237540,"2015-07-18 09:39:00"
"3993","20150517090533-187",1,"2015-07-17 09:35:00",1437150900,"C4",306240,1437457140,"2015-07-20 22:39:00"
"5126","20154517094544-833",2,"2015-07-17 10:12:00",1437153120,"C4",774180,1437927300,"2015-07-26 09:15:00"
"6323","20152517092529-612",3,"2015-07-17 10:15:00",1437153300,"C6",94380,1437247680,"2015-07-18 12:28:00"
"2045","20153317093336-203",2,"2015-07-17 10:30:00",1437154200,"C7",123600,1437277800,"2015-07-18 20:50:00"
"3541","20152917092938-198",1,"2015-07-17 10:37:00",1437154620,"C5",91080,1437245700,"2015-07-18 11:55:00"
"2827","20155317095355-5",1,"2015-07-17 10:42:00",1437154920,"C6",203760,1437358680,"2015-07-19 19:18:00"
"6452","20150517100545-515",1,"2015-07-17 10:42:00",1437154920,"C6",303000,1437457920,"2015-07-20 22:52:00"
"3063","20154217104228-732",1,"2015-07-17 10:49:00",1437155340,"C4",1486740,1438642080,"2015-08-03 15:48:00"
"5567","20155917095958-769",2,"2015-07-17 10:51:00",1437155460,"C6",779640,1437935100,"2015-07-26 11:25:00"
"2335","20150217100259-352",1,"2015-07-17 11:00:00",1437156000,"C2",164280,1437320280,"2015-07-19 08:38:00"
"1030","20151217101212-140",1,"2015-07-17 11:08:00",1437156480,"C5",588060,1437744540,"2015-07-24 06:29:00"
"2126","20153017103047-976",1,"2015-07-17 11:09:00",1437156540,"C0",427800,1437584340,"2015-07-22 09:59:00"
"2036","20153017103045-244",1,"2015-07-17 11:15:00",1437156900,"C8",170040,1437326940,"2015-07-19 10:29:00"
"889","20155217105212-400",1,"2015-07-17 11:20:00",1437157200,"C5",1324020,1438481220,"2015-08-01 19:07:00"
"895","20152317102301-124",3,"2015-07-17 11:25:00",1437157500,"C3",990360,1438147860,"2015-07-28 22:31:00"
"824","20155017105044-579",1,"2015-07-17 11:44:00",1437158640,"C8",193920,1437352560,"2015-07-19 17:36:00"
"4778","20154217104217-430",1,"2015-07-17 11:46:00",1437158760,"C2",155280,1437314040,"2015-07-19 06:54:00"
"4239","20154417114443-748",1,"2015-07-17 11:51:00",1437159060,"C8",78960,1437238020,"2015-07-18 09:47:00"
"6050","20155317105335-21",1,"2015-07-17 11:55:00",1437159300,"C7",67860,1437227160,"2015-07-18 06:46:00"
"5132","20150517110524-251",2,"2015-07-17 11:57:00",1437159420,"C5",74340,1437233760,"2015-07-18 08:36:00"
"846","20150917110936-396",3,"2015-07-17 12:03:00",1437159780,"C4",280200,1437439980,"2015-07-20 17:53:00"
"1099","20154417114443-51",1,"2015-07-17 12:09:00",1437160140,"C8",110580,1437270720,"2015-07-18 18:52:00"
"3595","20155217115255-205",1,"2015-07-17 12:15:00",1437160500,"C5",376620,1437537120,"2015-07-21 20:52:00"
"6007","20155617115643-257",1,"2015-07-17 12:20:00",1437160800,"C5",66900,1437227700,"2015-07-18 06:55:00"
"3412","20155517115552-543",1,"2015-07-17 12:23:00",1437160980,"C5",194580,1437355560,"2015-07-19 18:26:00"
"3794","20153717113702-835",1,"2015-07-17 12:40:00",1437162000,"C5",86400,1437248400,"2015-07-18 12:40:00"
"1449","20154317114331-457",1,"2015-07-17 12:42:00",1437162120,"C2",115800,1437277920,"2015-07-18 20:52:00"
"2535","20151717121704-659",3,"2015-07-17 12:55:00",1437162900,"C0",181800,1437344700,"2015-07-19 15:25:00"
"1561","20150817120835-419",3,"2015-07-17 12:58:00",1437163080,"C8",79920,1437243000,"2015-07-18 11:10:00"
"2025","20155317125332-60",2,"2015-07-17 13:01:00",1437163260,"C4",1061640,1438224900,"2015-07-29 19:55:00"
"1270","20151217121243-265",1,"2015-07-17 13:12:00",1437163920,"C3",680400,1437844320,"2015-07-25 10:12:00"
"158","20151817011850-621",1,"2015-07-17 13:25:00",1437164700,"C4",207060,1437371760,"2015-07-19 22:56:00"
"2844","20150517010500-796",2,"2015-07-17 13:39:00",1437165540,"C0",150900,1437316440,"2015-07-19 07:34:00"
"43","20151617011611-701",1,"2015-07-17 13:42:00",1437165720,"C3",426480,1437592200,"2015-07-22 12:10:00"
"590","20153617013645-103",3,"2015-07-17 13:42:00",1437165720,"C2",65880,1437231600,"2015-07-18 08:00:00"
"6109","20153617013601-315",1,"2015-07-17 13:43:00",1437165780,"C8",682980,1437848760,"2015-07-25 11:26:00"
"1284","20152217012232-158",3,"2015-07-17 14:03:00",1437166980,"C2",450180,1437617160,"2015-07-22 19:06:00"
"1627","20152917012956-923",1,"2015-07-17 14:03:00",1437166980,"C4",199200,1437366180,"2015-07-19 21:23:00"
"5162","20155917015932-755",3,"2015-07-17 14:06:00",1437167160,"C8",496020,1437663180,"2015-07-23 07:53:00"
"1751","20154112014114-381",1,"2015-07-17 14:21:00",1437168060,"C6",201840,1437369900,"2015-07-19 22:25:00"
"1716","20151717021725-292",1,"2015-07-17 14:52:00",1437169920,"C2",977700,1438147620,"2015-07-28 22:27:00"
"3467","20152117022136-22",1,"2015-07-17 14:55:00",1437170100,"C4",97200,1437267300,"2015-07-18 17:55:00"
"5682","20153817023845-593",1,"2015-07-17 15:04:00",1437170640,"C5",56880,1437227520,"2015-07-18 06:52:00"
"4730","20152117032144-298",1,"2015-07-17 15:27:00",1437172020,"C2",427140,1437599160,"2015-07-22 14:06:00"
"5647","20153917023952-510",3,"2015-07-17 15:30:00",1437172200,"C5",79560,1437251760,"2015-07-18 13:36:00"
"3316","20153817033857-516",1,"2015-07-17 15:44:00",1437173040,"C2",1205220,1438378260,"2015-07-31 14:31:00"
"2269","20152517032501-916",1,"2015-07-17 15:52:00",1437173520,"C5",111540,1437285060,"2015-07-18 22:51:00"
"4606","20154519024544-322",2,"2015-07-17 15:58:00",1437173880,"C4",201480,1437375360,"2015-07-19 23:56:00"
"5910","20152217032234-627",2,"2015-07-17 16:26:00",1437175560,"C5",87840,1437263400,"2015-07-18 16:50:00"
"4906","20153617033658-794",3,"2015-07-17 16:36:00",1437176160,"C5",165540,1437341700,"2015-07-19 14:35:00"
"6411","20155417045444-36",1,"2015-07-17 17:01:00",1437177660,"C2",268980,1437446640,"2015-07-20 19:44:00"
"2552","20153417043413-536",2,"2015-07-17 17:06:00",1437177960,"C7",365520,1437543480,"2015-07-21 22:38:00"
"1621","20150817040833-849",2,"2015-07-17 17:07:00",1437178020,"C8",162060,1437340080,"2015-07-19 14:08:00"
"5809","20154217044214-559",1,"2015-07-17 17:10:00",1437178200,"C5",234840,1437413040,"2015-07-20 10:24:00"
"794","20154517044506-783",3,"2015-07-17 17:19:00",1437178740,"C8",181800,1437360540,"2015-07-19 19:49:00"
"160","20150717050734-803",1,"2015-07-17 17:28:00",1437179280,"C5",512280,1437691560,"2015-07-23 15:46:00"
"4464","20154117054141-402",1,"2015-07-17 18:04:00",1437181440,"C5",130920,1437312360,"2015-07-19 06:26:00"
"1763","20154417054458-449",1,"2015-07-17 18:09:00",1437181740,"C7",430860,1437612600,"2015-07-22 17:50:00"
"3037","20151117051123-614",1,"2015-07-17 18:10:00",1437181800,"C2",1209240,1438391040,"2015-07-31 18:04:00"
"845","20155517055510-758",2,"2015-07-17 22:51:00",1437198660,"C2",2751900,1439950560,"2015-08-18 19:16:00"
"1626","20151918061901-392",3,"2015-07-18 06:43:00",1437226980,"C8",317160,1437544140,"2015-07-21 22:49:00"
"1338","20151518061551-586",2,"2015-07-18 06:51:00",1437227460,"C0",993180,1438220640,"2015-07-29 18:44:00"
"4392","20154618064654-392",1,"2015-07-18 06:53:00",1437227580,"C8",196020,1437423600,"2015-07-20 13:20:00"
"2653","20154818074851-145",1,"2015-07-18 08:18:00",1437232680,"C2",219060,1437451740,"2015-07-20 21:09:00"
"5936","20152318072357-176",1,"2015-07-18 08:26:00",1437233160,"C5",540180,1437773340,"2015-07-24 14:29:00"
"6151","20155318075328-481",3,"2015-07-18 08:50:00",1437234600,"C5",342300,1437576900,"2015-07-22 07:55:00"
"6243","20152118082127-664",2,"2015-07-18 08:59:00",1437235140,"C0",273660,1437508800,"2015-07-21 13:00:00"
"2461","20150518090500-717",3,"2015-07-18 09:12:00",1437235920,"C4",197700,1437433620,"2015-07-20 16:07:00"
"669","20155218085232-407",3,"2015-07-18 09:26:00",1437236760,"C2",113340,1437350100,"2015-07-19 16:55:00"
"2563","20155618085617-440",2,"2015-07-18 09:30:00",1437237000,"C6",459000,1437696000,"2015-07-23 17:00:00"
"1730","20152818092849-712",1,"2015-07-18 09:35:00",1437237300,"C2",103080,1437340380,"2015-07-19 14:13:00"
"2845","20150918090928-755",2,"2015-07-18 09:38:00",1437237480,"C5",531600,1437769080,"2015-07-24 13:18:00"
"5275","20155218085224-640",2,"2015-07-18 09:54:00",1437238440,"C8",515160,1437753600,"2015-07-24 09:00:00"
"3600","20155518095558-521",1,"2015-07-18 10:24:00",1437240240,"C4",216600,1437456840,"2015-07-20 22:34:00"
"4620","20155618095623-707",1,"2015-07-18 10:30:00",1437240600,"C3",340200,1437580800,"2015-07-22 09:00:00"
"2474","20151318101338-951",2,"2015-07-18 10:36:00",1437240960,"C7",512220,1437753180,"2015-07-24 08:53:00"
"3240","20152018102004-940",1,"2015-07-18 10:37:00",1437241020,"C0",72960,1437313980,"2015-07-19 06:53:00"
"4836","20151418111432-774",3,"2015-07-18 11:34:00",1437244440,"C7",110760,1437355200,"2015-07-19 18:20:00"
"6496","20153318113337-404",3,"2015-07-18 11:47:00",1437245220,"C7",119880,1437365100,"2015-07-19 21:05:00"
"4680","20153518113501-500",1,"2015-07-18 12:05:00",1437246300,"C3",93420,1437339720,"2015-07-19 14:02:00"
"3445","20153618113644-795",1,"2015-07-18 12:09:00",1437246540,"C2",106320,1437352860,"2015-07-19 17:41:00"
"3934","20153718113750-118",2,"2015-07-18 12:10:00",1437246600,"C4",85560,1437332160,"2015-07-19 11:56:00"
"5790","20154818114855-997",1,"2015-07-18 12:11:00",1437246660,"C5",546540,1437793200,"2015-07-24 20:00:00"
"674","20154018114036-212",1,"2015-07-18 12:16:00",1437246960,"C3",1137360,1438384320,"2015-07-31 16:12:00"
"4763","20151518111558-749",2,"2015-07-18 12:16:00",1437246960,"C2",99780,1437346740,"2015-07-19 15:59:00"
"5872","20155118115127-143",1,"2015-07-18 12:20:00",1437247200,"C3",82980,1437330180,"2015-07-19 11:23:00"
"2212","20153818113831-85",1,"2015-07-18 12:31:00",1437247860,"C4",323160,1437571020,"2015-07-22 06:17:00"
"4882","20152918122930-367",2,"2015-07-18 12:35:00",1437248100,"C8",177000,1437425100,"2015-07-20 13:45:00"
"6101","20154118114130-34",1,"2015-07-18 12:35:00",1437248100,"C8",362040,1437610140,"2015-07-22 17:09:00"
"5195","20154218114238-384",1,"2015-07-18 12:41:00",1437248460,"C5",180600,1437429060,"2015-07-20 14:51:00"
"5343","20150218120246-220",1,"2015-07-18 13:10:00",1437250200,"C0",279120,1437529320,"2015-07-21 18:42:00"
"5010","20153018013026-319",2,"2015-07-18 13:35:00",1437251700,"C2",90240,1437341940,"2015-07-19 14:39:00"
"1689","20153918123921-858",1,"2015-07-18 13:38:00",1437251880,"C2",357300,1437609180,"2015-07-22 16:53:00"
"2","20153118013100-425",2,"2015-07-18 13:52:00",1437252720,"C7",283320,1437536040,"2015-07-21 20:34:00"
"1021","20151418011444-201",3,"2015-07-18 14:13:00",1437253980,"C4",278760,1437532740,"2015-07-21 19:39:00"
"4161","20154918014930-425",1,"2015-07-18 14:22:00",1437254520,"C8",91740,1437346260,"2015-07-19 15:51:00"
"206","20153318013311-102",2,"2015-07-18 14:26:00",1437254760,"C5",334560,1437589320,"2015-07-22 11:22:00"
"3300","20152118022105-958",1,"2015-07-18 14:26:00",1437254760,"C2",577800,1437832560,"2015-07-25 06:56:00"
"6183","20151518011531-224",1,"2015-07-18 14:27:00",1437254820,"C0",1220460,1438475280,"2015-08-01 17:28:00"
"4567","20152718012719-661",3,"2015-07-18 14:30:00",1437255000,"C5",253440,1437508440,"2015-07-21 12:54:00"
"4292","20152818012813-881",1,"2015-07-18 14:32:00",1437255120,"C0",409620,1437664740,"2015-07-23 08:19:00"
"4685","20151618021648-198",2,"2015-07-18 14:41:00",1437255660,"C8",108360,1437364020,"2015-07-19 20:47:00"
"2915","20154018024000-428",1,"2015-07-18 14:48:00",1437256080,"C4",233160,1437489240,"2015-07-21 07:34:00"
"6052","20150018020030-238",3,"2015-07-18 15:03:00",1437256980,"C8",344940,1437601920,"2015-07-22 14:52:00"
"4420","20154218024228-691",1,"2015-07-18 15:06:00",1437257160,"C4",510000,1437767160,"2015-07-24 12:46:00"
"4096","20152818022812-310",3,"2015-07-18 15:22:00",1437258120,"C4",163080,1437421200,"2015-07-20 12:40:00"
"2005","20150418030419-69",1,"2015-07-18 15:32:00",1437258720,"C5",273300,1437532020,"2015-07-21 19:27:00"
"2795","20154018034028-142",1,"2015-07-18 15:48:00",1437259680,"C8",365880,1437625560,"2015-07-22 21:26:00"
"3987","20154018034049-540",2,"2015-07-18 15:48:00",1437259680,"C4",265500,1437525180,"2015-07-21 17:33:00"
"3950","20153418033431-409",1,"2015-07-18 16:27:00",1437262020,"C4",87360,1437349380,"2015-07-19 16:43:00"
"4247","20150818040832-50",2,"2015-07-18 16:38:00",1437262680,"C5",683880,1437946560,"2015-07-26 14:36:00"
"5442","20151518041531-923",1,"2015-07-18 16:50:00",1437263400,"C5",138120,1437401520,"2015-07-20 07:12:00"
"3289","20152518042537-745",2,"2015-07-18 16:55:00",1437263700,"C0",102840,1437366540,"2015-07-19 21:29:00"
"4171","20150418040454-388",3,"2015-07-18 16:57:00",1437263820,"C5",259620,1437523440,"2015-07-21 17:04:00"
"3259","20151118041143-934",2,"2015-07-18 17:15:00",1437264900,"C5",923520,1438188420,"2015-07-29 09:47:00"
"6154","20152118042118-402",3,"2015-07-18 17:20:00",1437265200,"C2",169380,1437434580,"2015-07-20 16:23:00"
"6523","20155418045421-624",1,"2015-07-18 17:20:00",1437265200,"C4",599400,1437864600,"2015-07-25 15:50:00"
"304","20155918045905-885",3,"2015-07-18 17:24:00",1437265440,"C5",617880,1437883320,"2015-07-25 21:02:00"
"3435","20151318051330-957",3,"2015-07-18 17:27:00",1437265620,"C7",923460,1438189080,"2015-07-29 09:58:00"
"2739","20150818050836-609",2,"2015-07-18 17:29:00",1437265740,"C5",52080,1437317820,"2015-07-19 07:57:00"
"6120","20150818050817-70",1,"2015-07-18 17:31:00",1437265860,"C4",677220,1437943080,"2015-07-26 13:38:00"
"576","20151618051609-530",1,"2015-07-18 17:39:00",1437266340,"C5",267420,1437533760,"2015-07-21 19:56:00"
"551","20154718044706-170",1,"2015-07-18 17:42:00",1437266520,"C5",251820,1437518340,"2015-07-21 15:39:00"
"2393","20150618050611-599",2,"2015-07-18 18:01:00",1437267660,"C3",222240,1437489900,"2015-07-21 07:45:00"
"5644","20154618044618-128",1,"2015-07-18 18:01:00",1437267660,"C7",449460,1437717120,"2015-07-23 22:52:00"
"3294","20153018053053-129",2,"2015-07-18 18:07:00",1437268020,"C7",166080,1437434100,"2015-07-20 16:15:00"
"4258","20155118055120-195",1,"2015-07-18 18:15:00",1437268500,"C5",620460,1437888960,"2015-07-25 22:36:00"
"5649","20153618053610-340",1,"2015-07-18 18:31:00",1437269460,"C7",1459500,1438728960,"2015-08-04 15:56:00"
"123","20150219060243-351",3,"2015-07-19 06:34:00",1437312840,"C3",138000,1437450840,"2015-07-20 20:54:00"
"4483","20150619060603-933",1,"2015-07-19 06:35:00",1437312900,"C8",639720,1437952620,"2015-07-26 16:17:00"
"6284","20152819062830-519",2,"2015-07-19 06:44:00",1437313440,"C0",472080,1437785520,"2015-07-24 17:52:00"
"6081","20151919061928-62",3,"2015-07-19 06:51:00",1437313860,"C3",83940,1437397800,"2015-07-20 06:10:00"
"6017","20153719063729-533",1,"2015-07-19 07:03:00",1437314580,"C5",96720,1437411300,"2015-07-20 09:55:00"
"1035","20151319061333-620",1,"2015-07-19 07:11:00",1437315060,"C4",436440,1437751500,"2015-07-24 08:25:00"
"2141","20153419063421-197",2,"2015-07-19 07:15:00",1437315300,"C2",129180,1437444480,"2015-07-20 19:08:00"
"6285","20155019065049-871",3,"2015-07-19 07:47:00",1437317220,"C6",193140,1437510360,"2015-07-21 13:26:00"
"3681","20150619070601-944",3,"2015-07-19 08:12:00",1437318720,"C6",569700,1437888420,"2015-07-25 22:27:00"
"2083","20152119072136-180",1,"2015-07-19 08:30:00",1437319800,"C8",100860,1437420660,"2015-07-20 12:31:00"
"4706","20154119074113-792",1,"2015-07-19 08:46:00",1437320760,"C5",165780,1437486540,"2015-07-21 06:49:00"
"4636","20152519082511-770",2,"2015-07-19 08:51:00",1437321060,"C5",359700,1437680760,"2015-07-23 12:46:00"
"2178","20153219083225-701",1,"2015-07-19 08:55:00",1437321300,"C8",207600,1437528900,"2015-07-21 18:35:00"
"433","20150919080932-475",1,"2015-07-19 09:03:00",1437321780,"C4",439080,1437760860,"2015-07-24 11:01:00"
"3845","20150319090314-498",2,"2015-07-19 09:28:00",1437323280,"C3",95940,1437419220,"2015-07-20 12:07:00"
"2794","20155019085012-883",2,"2015-07-19 09:42:00",1437324120,"C4",377280,1437701400,"2015-07-23 18:30:00"
"4141","20154219094203-849",2,"2015-07-19 09:49:00",1437324540,"C8",84480,1437409020,"2015-07-20 09:17:00"
"2001","20155919085959-705",1,"2015-07-19 09:53:00",1437324780,"C5",80820,1437405600,"2015-07-20 08:20:00"
"155","20155219085255-410",1,"2015-07-19 09:56:00",1437324960,"C2",110340,1437435300,"2015-07-20 16:35:00"
"3131","20152219092238-393",3,"2015-07-19 10:01:00",1437325260,"C2",279780,1437605040,"2015-07-22 15:44:00"
"453","20152119092102-380",1,"2015-07-19 10:19:00",1437326340,"C7",72600,1437398940,"2015-07-20 06:29:00"
"444","20151119091154-119",3,"2015-07-19 10:20:00",1437326400,"C0",1068900,1438395300,"2015-07-31 19:15:00"
"5409","20153219093219-284",1,"2015-07-19 10:21:00",1437326460,"C7",616680,1437943140,"2015-07-26 13:39:00"
"1971","20151019101010-336",1,"2015-07-19 10:55:00",1437328500,"C8",517200,1437845700,"2015-07-25 10:35:00"
"635","20155619105610-134",2,"2015-07-19 10:58:00",1437328680,"C6",300180,1437628860,"2015-07-22 22:21:00"
"1957","20155519095518-431",3,"2015-07-19 11:01:00",1437328860,"C0",294780,1437623640,"2015-07-22 20:54:00"
"5208","20153519103528-888",2,"2015-07-19 11:12:00",1437329520,"C0",124800,1437454320,"2015-07-20 21:52:00"
"4927","20151019101012-506",1,"2015-07-19 11:13:00",1437329580,"C5",546540,1437876120,"2015-07-25 19:02:00"
"5635","20155319105326-404",2,"2015-07-19 11:18:00",1437329880,"C5",167640,1437497520,"2015-07-21 09:52:00"
"12","20154219104241-223",1,"2015-07-19 11:21:00",1437330060,"C2",183960,1437514020,"2015-07-21 14:27:00"
"6087","20150619110604-788",1,"2015-07-19 11:32:00",1437330720,"C5",282720,1437613440,"2015-07-22 18:04:00"
"1218","20153819103829-614",1,"2015-07-19 11:37:00",1437331020,"C6",422280,1437753300,"2015-07-24 08:55:00"
"4494","20152019112015-444",3,"2015-07-19 11:45:00",1437331500,"C4",185400,1437516900,"2015-07-21 15:15:00"
"1682","20155019115035-365",1,"2015-07-19 12:11:00",1437333060,"C7",630600,1437963660,"2015-07-26 19:21:00"
"2209","20154219114228-262",2,"2015-07-19 12:12:00",1437333120,"C8",113520,1437446640,"2015-07-20 19:44:00"
"3792","20152819112852-444",2,"2015-07-19 12:35:00",1437334500,"C5",714360,1438048860,"2015-07-27 19:01:00"
"2173","20150719120749-370",1,"2015-07-19 13:01:00",1437336060,"C8",192540,1437528600,"2015-07-21 18:30:00"
"2046","20150319120301-287",3,"2015-07-19 13:02:00",1437336120,"C7",332760,1437668880,"2015-07-23 09:28:00"
"5068","20152819122847-981",1,"2015-07-19 13:03:00",1437336180,"C7",67740,1437403920,"2015-07-20 07:52:00"
"3364","20150219120223-913",1,"2015-07-19 13:09:00",1437336540,"C4",548700,1437885240,"2015-07-25 21:34:00"
"978","20152919122944-137",3,"2015-07-19 13:17:00",1437337020,"C8",588000,1437925020,"2015-07-26 08:37:00"
"6491","20150119010140-843",3,"2015-07-19 13:24:00",1437337440,"C4",109200,1437446640,"2015-07-20 19:44:00"
"6549","20150019010017-785",2,"2015-07-19 13:26:00",1437337560,"C4",244440,1437582000,"2015-07-22 09:20:00"
"420","20155519125535-358",1,"2015-07-19 13:33:00",1437337980,"C6",451860,1437789840,"2015-07-24 19:04:00"
"639","20153712013720-181",3,"2015-07-19 13:38:00",1437338280,"C6",205800,1437544080,"2015-07-21 22:48:00"
"5062","20155719125713-529",1,"2015-07-19 13:54:00",1437339240,"C4",241680,1437580920,"2015-07-22 09:02:00"
"4263","20150019010004-372",1,"2015-07-19 13:58:00",1437339480,"C7",203640,1437543120,"2015-07-21 22:32:00"
"5996","20153419013456-499",2,"2015-07-19 14:07:00",1437340020,"C2",424440,1437764460,"2015-07-24 12:01:00"
"1759","20151019011020-645",3,"2015-07-19 14:16:00",1437340560,"C3",368460,1437709020,"2015-07-23 20:37:00"
"4117","20150319020304-688",1,"2015-07-19 14:40:00",1437342000,"C0",112320,1437454320,"2015-07-20 21:52:00"
"6344","20154819014838-806",2,"2015-07-19 14:42:00",1437342120,"C5",82200,1437424320,"2015-07-20 13:32:00"
"1299","20151519021534-355",3,"2015-07-19 15:11:00",1437343860,"C4",100920,1437444780,"2015-07-20 19:13:00"
"1846","20152419022425-210",1,"2015-07-19 15:13:00",1437343980,"C7",355740,1437699720,"2015-07-23 18:02:00"
"3001","20154719024718-326",1,"2015-07-19 15:13:00",1437343980,"C5",236640,1437580620,"2015-07-22 08:57:00"
"6500","20155119025114-185",2,"2015-07-19 15:25:00",1437344700,"C8",327780,1437672480,"2015-07-23 10:28:00"
"939","20153519023513-548",3,"2015-07-19 15:36:00",1437345360,"C2",432420,1437777780,"2015-07-24 15:43:00"
"2857","20151119031125-461",2,"2015-07-19 15:54:00",1437346440,"C2",333780,1437680220,"2015-07-23 12:37:00"
"855","20153019033053-367",2,"2015-07-19 15:58:00",1437346680,"C8",256560,1437603240,"2015-07-22 15:14:00"
"6475","20155219035228-248",1,"2015-07-19 15:59:00",1437346740,"C8",68400,1437415140,"2015-07-20 10:59:00"
"1474","20154919034934-127",2,"2015-07-19 16:10:00",1437347400,"C8",51960,1437399360,"2015-07-20 06:36:00"
"5511","20154519034526-395",1,"2015-07-19 16:21:00",1437348060,"C3",100560,1437448620,"2015-07-20 20:17:00"
"2665","20155319035337-279",1,"2015-07-19 16:27:00",1437348420,"C4",83640,1437432060,"2015-07-20 15:41:00"
"2380","20150619040651-207",2,"2015-07-19 16:36:00",1437348960,"C5",424500,1437773460,"2015-07-24 14:31:00"
"2061","20150519040533-38",2,"2015-07-19 16:41:00",1437349260,"C2",107820,1437457080,"2015-07-20 22:38:00"
"1437","20153019043019-743",2,"2015-07-19 16:51:00",1437349860,"C8",107940,1437457800,"2015-07-20 22:50:00"
"5363","20153219043201-719",1,"2015-07-19 17:06:00",1437350760,"C7",104220,1437454980,"2015-07-20 22:03:00"
"2167","20154819044802-78",2,"2015-07-19 17:10:00",1437351000,"C8",245100,1437596100,"2015-07-22 13:15:00"
"4736","20151319041336-619",2,"2015-07-19 17:10:00",1437351000,"C6",83160,1437434160,"2015-07-20 16:16:00"
"2295","20151219051238-555",2,"2015-07-19 17:15:00",1437351300,"C6",870420,1438221720,"2015-07-29 19:02:00"
"4374","20151719041725-731",1,"2015-07-19 17:16:00",1437351360,"C6",328260,1437679620,"2015-07-23 12:27:00"
"2587","20152119042123-730",2,"2015-07-19 17:19:00",1437351540,"C5",235020,1437586560,"2015-07-22 10:36:00"
"3465","20152819042821-876",1,"2015-07-19 17:31:00",1437352260,"C5",151740,1437504000,"2015-07-21 11:40:00"
"1823","20154319044337-154",1,"2015-07-19 17:37:00",1437352620,"C8",358440,1437711060,"2015-07-23 21:11:00"
"904","20152619052654-46",3,"2015-07-19 17:53:00",1437353580,"C4",759060,1438112640,"2015-07-28 12:44:00"
"1803","20153819053827-500",3,"2015-07-19 18:08:00",1437354480,"C6",1396500,1438750980,"2015-08-04 22:03:00"
"2880","20153719053715-589",3,"2015-07-19 18:11:00",1437354660,"C0",83280,1437437940,"2015-07-20 17:19:00"
"1487","20154619054626-112",2,"2015-07-19 18:14:00",1437354840,"C8",81900,1437436740,"2015-07-20 16:59:00"
"1852","20153919053954-565",1,"2015-07-19 18:14:00",1437354840,"C3",139200,1437494040,"2015-07-21 08:54:00"
"5039","20153619053636-962",1,"2015-07-19 18:43:00",1437356580,"C2",524880,1437881460,"2015-07-25 20:31:00"
"1073","20155419055407-635",2,"2015-07-19 18:46:00",1437356760,"C4",96180,1437452940,"2015-07-20 21:29:00"
"6355","20152020062024-190",1,"2015-07-20 06:27:00",1437398820,"C8",302520,1437701340,"2015-07-23 18:29:00"
"4553","20154320064328-347",2,"2015-07-20 07:15:00",1437401700,"C2",644100,1438045800,"2015-07-27 18:10:00"
"1714","20154520064525-417",3,"2015-07-20 07:43:00",1437403380,"C7",137220,1437540600,"2015-07-21 21:50:00"
"4470","20155820065827-219",2,"2015-07-20 08:02:00",1437404520,"C2",130080,1437534600,"2015-07-21 20:10:00"
"4905","20150920070902-234",1,"2015-07-20 08:08:00",1437404880,"C6",808920,1438213800,"2015-07-29 16:50:00"
"1671","20153320073331-255",1,"2015-07-20 08:44:00",1437407040,"C0",366780,1437773820,"2015-07-24 14:37:00"
"4820","20151920081908-214",2,"2015-07-20 08:45:00",1437407100,"C4",168540,1437575640,"2015-07-22 07:34:00"
"1255","20153320083339-666",1,"2015-07-20 09:03:00",1437408180,"C8",440940,1437849120,"2015-07-25 11:32:00"
"4189","20151920081921-606",3,"2015-07-20 09:13:00",1437408780,"C5",117960,1437526740,"2015-07-21 17:59:00"
"2369","20150820090811-228",2,"2015-07-20 09:23:00",1437409380,"C0",133380,1437542760,"2015-07-21 22:26:00"
"1610","20150920090915-26",2,"2015-07-20 09:32:00",1437409920,"C8",76260,1437486180,"2015-07-21 06:43:00"
"4992","20150820090851-701",2,"2015-07-20 10:02:00",1437411720,"C8",113460,1437525180,"2015-07-21 17:33:00"
"4367","20150420100416-232",1,"2015-07-20 10:06:00",1437411960,"C6",1407900,1438819860,"2015-08-05 17:11:00"
"4237","20150420090410-374",3,"2015-07-20 10:09:00",1437412140,"C4",77160,1437489300,"2015-07-21 07:35:00"
"1522","20150820090832-399",3,"2015-07-20 10:10:00",1437412200,"C5",537180,1437949380,"2015-07-26 15:23:00"
"79","20151720091715-120",1,"2015-07-20 10:15:00",1437412500,"C8",273780,1437686280,"2015-07-23 14:18:00"
"4013","20151520101518-94",3,"2015-07-20 10:22:00",1437412920,"C8",92160,1437505080,"2015-07-21 11:58:00"
"2814","20151820101849-472",2,"2015-07-20 10:26:00",1437413160,"C4",111660,1437524820,"2015-07-21 17:27:00"
"2689","20155720095723-531",2,"2015-07-20 10:31:00",1437413460,"C6",385380,1437798840,"2015-07-24 21:34:00"
"236","20155320095336-544",2,"2015-07-20 10:32:00",1437413520,"C2",114480,1437528000,"2015-07-21 18:20:00"
"864","20152520092520-405",2,"2015-07-20 10:33:00",1437413580,"C3",124440,1437538020,"2015-07-21 21:07:00"
"5052","20151620101652-108",1,"2015-07-20 10:37:00",1437413820,"C7",83400,1437497220,"2015-07-21 09:47:00"
"1195","20154120094127-321",3,"2015-07-20 10:49:00",1437414540,"C5",605040,1438019580,"2015-07-27 10:53:00"
"1954","20151820101815-744",2,"2015-07-20 11:10:00",1437415800,"C5",69660,1437485460,"2015-07-21 06:31:00"
"4732","20150720100717-213",1,"2015-07-20 11:14:00",1437416040,"C0",607260,1438023300,"2015-07-27 11:55:00"
"4344","20151920101907-951",1,"2015-07-20 11:26:00",1437416760,"C2",72000,1437488760,"2015-07-21 07:26:00"
"38","20155520105535-51",1,"2015-07-20 11:53:00",1437418380,"C8",449040,1437867420,"2015-07-25 16:37:00"
"2302","20155620115651-849",1,"2015-07-20 12:03:00",1437418980,"C8",268980,1437687960,"2015-07-23 14:46:00"
"4502","20154920114956-385",1,"2015-07-20 12:50:00",1437421800,"C2",512880,1437934680,"2015-07-26 11:18:00"
"870","20155420115417-321",1,"2015-07-20 12:57:00",1437422220,"C2",768360,1438190580,"2015-07-29 10:23:00"
"3323","20155820075838-714",1,"2015-07-20 13:04:00",1437422640,"C5",241920,1437664560,"2015-07-23 08:16:00"
"3343","20150320010324-914",2,"2015-07-20 13:09:00",1437422940,"C2",151920,1437574860,"2015-07-22 07:21:00"
"5458","20155620125614-440",1,"2015-07-20 13:29:00",1437424140,"C4",366540,1437790680,"2015-07-24 19:18:00"
"800","20154120014128-465",1,"2015-07-20 14:33:00",1437427980,"C5",173580,1437601560,"2015-07-22 14:46:00"
"4143","20153520013555-33",1,"2015-07-20 14:36:00",1437428160,"C5",524700,1437952860,"2015-07-26 16:21:00"
"336","20154320014344-198",1,"2015-07-20 14:42:00",1437428520,"C5",538080,1437966600,"2015-07-26 20:10:00"
"3377","20151020031037-765",2,"2015-07-20 15:22:00",1437430920,"C3",58560,1437489480,"2015-07-21 07:38:00"
"2866","20153220023240-486",1,"2015-07-20 15:25:00",1437431100,"C5",486960,1437918060,"2015-07-26 06:41:00"
"1865","20154020024044-998",3,"2015-07-20 15:31:00",1437431460,"C5",242940,1437674400,"2015-07-23 11:00:00"
"2913","20150620030629-901",1,"2015-07-20 15:50:00",1437432600,"C8",245580,1437678180,"2015-07-23 12:03:00"
"2324","20151420041437-875",1,"2015-07-20 16:20:00",1437434400,"C2",86640,1437521040,"2015-07-21 16:24:00"
"3088","20152120032107-809",1,"2015-07-20 16:29:00",1437434940,"C2",51240,1437486180,"2015-07-21 06:43:00"
"2215","20155020045059-811",1,"2015-07-20 17:20:00",1437438000,"C5",770400,1438208400,"2015-07-29 15:20:00"
"5413","20151820041854-851",3,"2015-07-20 17:31:00",1437438660,"C2",144120,1437582780,"2015-07-22 09:33:00"
"5007","20155520045513-443",2,"2015-07-20 17:52:00",1437439920,"C8",249660,1437689580,"2015-07-23 15:13:00"
"3671","20153220053251-142",3,"2015-07-20 18:17:00",1437441420,"C8",619920,1438061340,"2015-07-27 22:29:00"
"1060","20155920055919-29",1,"2015-07-20 19:13:00",1437444780,"C7",49020,1437493800,"2015-07-21 08:50:00"
"4248","20152421062416-977",1,"2015-07-21 06:30:00",1437485400,"C4",559620,1438045020,"2015-07-27 17:57:00"
"3375","20150221060206-207",2,"2015-07-21 06:34:00",1437485640,"C2",142080,1437627720,"2015-07-22 22:02:00"
"1324","20152021062038-745",2,"2015-07-21 06:52:00",1437486720,"C4",209580,1437696300,"2015-07-23 17:05:00"
"2226","20152221072217-797",1,"2015-07-21 07:56:00",1437490560,"C7",220320,1437710880,"2015-07-23 21:08:00"
"2570","20151621071645-193",3,"2015-07-21 08:10:00",1437491400,"C5",259200,1437750600,"2015-07-24 08:10:00"
"5217","20152421072403-434",3,"2015-07-21 08:13:00",1437491580,"C8",129960,1437621540,"2015-07-22 20:19:00"
"1383","20150021080000-521",3,"2015-07-21 08:25:00",1437492300,"C3",470640,1437962940,"2015-07-26 19:09:00"
"6315","20155221075249-459",3,"2015-07-21 08:51:00",1437493860,"C6",609180,1438103040,"2015-07-28 10:04:00"
"4163","20152721082743-391",1,"2015-07-21 08:55:00",1437494100,"C4",129300,1437623400,"2015-07-22 20:50:00"
"3805","20150321080345-584",2,"2015-07-21 09:01:00",1437494460,"C4",302100,1437796560,"2015-07-24 20:56:00"
"4827","20152921082952-995",2,"2015-07-21 09:09:00",1437494940,"C1",444300,1437939240,"2015-07-26 12:34:00"
"1934","20153021083029-997",3,"2015-07-21 09:26:00",1437495960,"C8",109680,1437605640,"2015-07-22 15:54:00"
"5153","20153521083522-988",1,"2015-07-21 09:32:00",1437496320,"C5",127380,1437623700,"2015-07-22 20:55:00"
"6400","20151621091605-465",1,"2015-07-21 09:33:00",1437496380,"C7",382020,1437878400,"2015-07-25 19:40:00"
"6300","20151221091244-979",2,"2015-07-21 09:35:00",1437496500,"C7",430500,1437927000,"2015-07-26 09:10:00"
"1292","20152921092932-891",1,"2015-07-21 09:54:00",1437497640,"C5",246960,1437744600,"2015-07-24 06:30:00"
"5944","20154121094145-294",1,"2015-07-21 10:00:00",1437498000,"C0",691740,1438189740,"2015-07-29 10:09:00"
"2974","20152221102210-862",1,"2015-07-21 10:55:00",1437501300,"C0",125820,1437627120,"2015-07-22 21:52:00"
"2661","20153521103532-680",3,"2015-07-21 11:36:00",1437503760,"C4",288300,1437792060,"2015-07-24 19:41:00"
"2021","20151721111744-664",1,"2015-07-21 11:41:00",1437504060,"C8",174660,1437678720,"2015-07-23 12:12:00"
"5676","20153721113747-248",3,"2015-07-21 12:01:00",1437505260,"C4",99480,1437604740,"2015-07-22 15:39:00"
"4053","20150521120547-745",1,"2015-07-21 12:32:00",1437507120,"C8",273120,1437780240,"2015-07-24 16:24:00"
"2071","20151121121126-475",1,"2015-07-21 12:37:00",1437507420,"C5",83580,1437591000,"2015-07-22 11:50:00"
"142","20154821124856-434",3,"2015-07-21 13:10:00",1437509400,"C8",874560,1438383960,"2015-07-31 16:06:00"
"6354","20151621121625-608",3,"2015-07-21 13:11:00",1437509460,"C8",103380,1437612840,"2015-07-22 17:54:00"
"4265","20155521125533-941",1,"2015-07-21 13:24:00",1437510240,"C5",763560,1438273800,"2015-07-30 09:30:00"
"4155","20152421122448-609",1,"2015-07-21 13:31:00",1437510660,"C2",370500,1437881160,"2015-07-25 20:26:00"
"2383","20151021011021-123",3,"2015-07-21 13:42:00",1437511320,"C5",974400,1438485720,"2015-08-01 20:22:00"
"3649","20151521011536-810",2,"2015-07-21 13:45:00",1437511500,"C8",86640,1437598140,"2015-07-22 13:49:00"
"3941","20155021015058-471",1,"2015-07-21 13:53:00",1437511980,"C6",505560,1438017540,"2015-07-27 10:19:00"
"5233","20151621011611-3",2,"2015-07-21 14:09:00",1437512940,"C4",232740,1437745680,"2015-07-24 06:48:00"
"4320","20155121015153-897",1,"2015-07-21 14:18:00",1437513480,"C5",264720,1437778200,"2015-07-24 15:50:00"
"1475","20150121020117-781",1,"2015-07-21 14:30:00",1437514200,"C5",346140,1437860340,"2015-07-25 14:39:00"
"2729","20154821024843-807",2,"2015-07-21 14:55:00",1437515700,"C8",75600,1437591300,"2015-07-22 11:55:00"
"4435","20151921021945-394",3,"2015-07-21 14:57:00",1437515820,"C0",169620,1437685440,"2015-07-23 14:04:00"
"6192","20151421031443-290",2,"2015-07-21 15:35:00",1437518100,"C7",599940,1438118040,"2015-07-28 14:14:00"
"5200","20151121031117-949",1,"2015-07-21 15:41:00",1437518460,"C4",240060,1437758520,"2015-07-24 10:22:00"
"844","20153321033321-89",1,"2015-07-21 16:01:00",1437519660,"C5",324000,1437843660,"2015-07-25 10:01:00"
"6467","20151621031648-283",2,"2015-07-21 16:22:00",1437520920,"C4",65880,1437586800,"2015-07-22 10:40:00"
"1564","20154421044450-831",3,"2015-07-21 16:52:00",1437522720,"C4",396960,1437919680,"2015-07-26 07:08:00"
"5408","20154421044426-552",1,"2015-07-21 16:58:00",1437523080,"C7",171960,1437695040,"2015-07-23 16:44:00"
"5803","20153121043157-485",1,"2015-07-21 17:01:00",1437523260,"C8",222240,1437745500,"2015-07-24 06:45:00"
"3568","20154021044054-397",2,"2015-07-21 17:03:00",1437523380,"C5",49620,1437573000,"2015-07-22 06:50:00"
"6396","20154721044741-483",2,"2015-07-21 17:13:00",1437523980,"C4",413820,1437937800,"2015-07-26 12:10:00"
"4582","20154821044806-248",2,"2015-07-21 17:14:00",1437524040,"C4",430500,1437954540,"2015-07-26 16:49:00"
"2392","20152821042813-361",2,"2015-07-21 17:26:00",1437524760,"C3",233220,1437757980,"2015-07-24 10:13:00"
"631","20152021052037-513",2,"2015-07-21 17:45:00",1437525900,"C5",130620,1437656520,"2015-07-23 06:02:00"
"6138","20153821043846-584",2,"2015-07-21 17:47:00",1437526020,"C8",326940,1437852960,"2015-07-25 12:36:00"
"243","20151921051948-603",3,"2015-07-21 17:53:00",1437526380,"C0",81480,1437607860,"2015-07-22 16:31:00"
"5397","20151222061237-438",3,"2015-07-22 06:42:00",1437572520,"C3",219660,1437792180,"2015-07-24 19:43:00"
"5588","20153122063134-260",1,"2015-07-22 06:53:00",1437573180,"C5",907320,1438480500,"2015-08-01 18:55:00"
"2214","20153322063340-765",3,"2015-07-22 07:27:00",1437575220,"C4",222840,1437798060,"2015-07-24 21:21:00"
"1425","20153322063352-729",2,"2015-07-22 07:32:00",1437575520,"C4",348840,1437924360,"2015-07-26 08:26:00"
"2458","20150922070941-505",3,"2015-07-22 07:40:00",1437576000,"C4",120780,1437696780,"2015-07-23 17:13:00"
"1249","20153522073506-41",1,"2015-07-22 08:01:00",1437577260,"C5",175560,1437752820,"2015-07-24 08:47:00"
"3320","20153022073058-275",1,"2015-07-22 08:01:00",1437577260,"C8",186060,1437763320,"2015-07-24 11:42:00"
"4085","20153922073948-796",1,"2015-07-22 08:11:00",1437577860,"C3",220500,1437798360,"2015-07-24 21:26:00"
"5920","20151522081519-492",2,"2015-07-22 08:22:00",1437578520,"C4",100680,1437679200,"2015-07-23 12:20:00"
"3250","20152922072911-283",2,"2015-07-22 08:26:00",1437578760,"C5",214380,1437793140,"2015-07-24 19:59:00"
"4766","20152922072959-445",3,"2015-07-22 08:31:00",1437579060,"C0",212100,1437791160,"2015-07-24 19:26:00"
"5613","20153222073236-42",1,"2015-07-22 08:33:00",1437579180,"C4",280980,1437860160,"2015-07-25 14:36:00"
"3201","20153322083304-339",2,"2015-07-22 08:38:00",1437579480,"C2",288180,1437867660,"2015-07-25 16:41:00"
"212","20154122074105-174",2,"2015-07-22 08:39:00",1437579540,"C3",308760,1437888300,"2015-07-25 22:25:00"
"4219","20152022082028-22",2,"2015-07-22 08:41:00",1437579660,"C5",783240,1438362900,"2015-07-31 10:15:00"
"2265","20155822075801-949",1,"2015-07-22 08:57:00",1437580620,"C7",634020,1438214640,"2015-07-29 17:04:00"
"5016","20153622083653-391",1,"2015-07-22 09:05:00",1437581100,"C5",427740,1438008840,"2015-07-27 07:54:00"
"5595","20154422084401-555",2,"2015-07-22 09:11:00",1437581460,"C5",101340,1437682800,"2015-07-23 13:20:00"
"2073","20150722090733-194",1,"2015-07-22 09:15:00",1437581700,"C4",177960,1437759660,"2015-07-24 10:41:00"
"2397","20155722085740-393",1,"2015-07-22 09:28:00",1437582480,"C0",257880,1437840360,"2015-07-25 09:06:00"
"5658","20154922084949-200",3,"2015-07-22 09:31:00",1437582660,"C0",106860,1437689520,"2015-07-23 15:12:00"
"885","20150022090025-737",1,"2015-07-22 09:34:00",1437582840,"C8",101040,1437683880,"2015-07-23 13:38:00"
"1679","20153722083744-703",1,"2015-07-22 09:35:00",1437582900,"C4",298980,1437881880,"2015-07-25 20:38:00"
"5477","20151522091559-339",1,"2015-07-22 09:46:00",1437583560,"C0",207480,1437791040,"2015-07-24 19:24:00"
"796","20151722091759-375",2,"2015-07-22 09:55:00",1437584100,"C0",78600,1437662700,"2015-07-23 07:45:00"
"4192","20150922090902-582",3,"2015-07-22 10:14:00",1437585240,"C7",344160,1437929400,"2015-07-26 09:50:00"
"3951","20151322091316-1",2,"2015-07-22 10:20:00",1437585600,"C8",476040,1438061640,"2015-07-27 22:34:00"
"1654","20155522095506-197",2,"2015-07-22 10:32:00",1437586320,"C7",174480,1437760800,"2015-07-24 11:00:00"
"226","20152322092332-533",3,"2015-07-22 10:34:00",1437586440,"C0",74940,1437661380,"2015-07-23 07:23:00"
"6333","20151322101302-482",1,"2015-07-22 10:35:00",1437586500,"C5",211380,1437797880,"2015-07-24 21:18:00"
"5305","20153122093107-869",1,"2015-07-22 10:36:00",1437586560,"C5",196080,1437782640,"2015-07-24 17:04:00"
"1696","20150122100136-869",1,"2015-07-22 10:37:00",1437586620,"C2",515520,1438102140,"2015-07-28 09:49:00"
"5983","20151722101713-627",2,"2015-07-22 10:38:00",1437586680,"C5",77280,1437663960,"2015-07-23 08:06:00"
"2532","20153222103251-804",1,"2015-07-22 11:01:00",1437588060,"C5",765480,1438353540,"2015-07-31 07:39:00"
"533","20153622103615-743",2,"2015-07-22 11:05:00",1437588300,"C4",194220,1437782520,"2015-07-24 17:02:00"
"1263","20154022104050-662",1,"2015-07-22 11:13:00",1437588780,"C5",358440,1437947220,"2015-07-26 14:47:00"
"318","20150722110714-462",3,"2015-07-22 11:17:00",1437589020,"C3",98040,1437687060,"2015-07-23 14:31:00"
"5119","20150922110928-182",1,"2015-07-22 11:32:00",1437589920,"C5",168900,1437758820,"2015-07-24 10:27:00"
"1185","20154622104622-839",1,"2015-07-22 11:44:00",1437590640,"C3",261780,1437852420,"2015-07-25 12:27:00"
"392","20154922104905-300",1,"2015-07-22 11:46:00",1437590760,"C7",180120,1437770880,"2015-07-24 13:48:00"
"2466","20150022110023-715",2,"2015-07-22 11:50:00",1437591000,"C5",1194960,1438785960,"2015-08-05 07:46:00"
"2077","20153722113733-394",1,"2015-07-22 11:52:00",1437591120,"C0",85560,1437676680,"2015-07-23 11:38:00"
"3254","20150722110730-245",1,"2015-07-22 12:09:00",1437592140,"C8",368040,1437960180,"2015-07-26 18:23:00"
"1640","20154822114816-84",1,"2015-07-22 12:10:00",1437592200,"C7",75420,1437667620,"2015-07-23 09:07:00"
"2930","20155822115853-505",1,"2015-07-22 12:18:00",1437592680,"C7",330360,1437923040,"2015-07-26 08:04:00"
"5336","20151922121927-280",2,"2015-07-22 12:44:00",1437594240,"C5",168120,1437762360,"2015-07-24 11:26:00"
"1241","20153722113716-211",1,"2015-07-22 12:48:00",1437594480,"C2",269100,1437863580,"2015-07-25 15:33:00"
"5592","20150422010448-761",1,"2015-07-22 13:34:00",1437597240,"C6",453060,1438050300,"2015-07-27 19:25:00"
"3398","20151422011417-46",1,"2015-07-22 13:49:00",1437598140,"C7",112920,1437711060,"2015-07-23 21:11:00"
"3944","20150922010936-575",1,"2015-07-22 14:01:00",1437598860,"C4",191880,1437790740,"2015-07-24 19:19:00"
"3050","20153922013946-38",3,"2015-07-22 14:20:00",1437600000,"C2",174000,1437774000,"2015-07-24 14:40:00"
"5097","20155622015608-652",1,"2015-07-22 14:56:00",1437602160,"C5",403740,1438005900,"2015-07-27 07:05:00"
"1792","20153722023710-935",2,"2015-07-22 15:06:00",1437602760,"C0",440520,1438043280,"2015-07-27 17:28:00"
"4926","20155722025727-208",1,"2015-07-22 15:22:00",1437603720,"C8",75360,1437679080,"2015-07-23 12:18:00"
"6240","20152922022915-661",2,"2015-07-22 15:31:00",1437604260,"C5",182940,1437787200,"2015-07-24 18:20:00"
"2589","20155222035235-759",1,"2015-07-22 15:59:00",1437605940,"C8",80880,1437686820,"2015-07-23 14:27:00"
"4598","20155222025217-753",1,"2015-07-22 15:59:00",1437605940,"C8",321240,1437927180,"2015-07-26 09:13:00"
"1555","20150922030934-439",1,"2015-07-22 16:00:00",1437606000,"C8",517500,1438123500,"2015-07-28 15:45:00"
"3731","20150722040729-834",1,"2015-07-22 16:13:00",1437606780,"C2",160800,1437767580,"2015-07-24 12:53:00"
"4852","20152322032341-450",1,"2015-07-22 16:19:00",1437607140,"C5",535200,1438142340,"2015-07-28 20:59:00"
"5860","20151622041646-326",1,"2015-07-22 16:23:00",1437607380,"C8",281100,1437888480,"2015-07-25 22:28:00"
"1025","20150022040009-518",1,"2015-07-22 16:58:00",1437609480,"C0",522240,1438131720,"2015-07-28 18:02:00"
"3367","20151522041501-365",1,"2015-07-22 17:05:00",1437609900,"C4",229620,1437839520,"2015-07-25 08:52:00"
"581","20150822040848-819",1,"2015-07-22 17:13:00",1437610380,"C5",709800,1438320180,"2015-07-30 22:23:00"
"1830","20150122050120-946",1,"2015-07-22 17:27:00",1437611220,"C4",349140,1437960360,"2015-07-26 18:26:00"
"3062","20151322051315-282",1,"2015-07-22 17:38:00",1437611880,"C8",58500,1437670380,"2015-07-23 09:53:00"
"5522","20153322053343-539",1,"2015-07-22 17:39:00",1437611940,"C2",420900,1438032840,"2015-07-27 14:34:00"
"3077","20154622054623-743",3,"2015-07-22 18:00:00",1437613200,"C7",775320,1438388520,"2015-07-31 17:22:00"
"68","20151722051720-973",1,"2015-07-22 18:14:00",1437614040,"C3",347280,1437961320,"2015-07-26 18:42:00"
"2419","20155522055527-809",1,"2015-07-22 18:29:00",1437614940,"C0",84060,1437699000,"2015-07-23 17:50:00"
"5461","20154122054140-30",1,"2015-07-22 18:47:00",1437616020,"C5",132840,1437748860,"2015-07-24 07:41:00"
"4816","20151523061521-500",1,"2015-07-23 06:21:00",1437657660,"C4",95400,1437753060,"2015-07-24 08:51:00"
"1829","20150723060758-760",1,"2015-07-23 06:35:00",1437658500,"C8",960900,1438619400,"2015-08-03 09:30:00"
"3262","20150823060803-803",1,"2015-07-23 07:03:00",1437660180,"C3",264120,1437924300,"2015-07-26 08:25:00"
"5900","20150123070109-172",2,"2015-07-23 07:09:00",1437660540,"C4",170640,1437831180,"2015-07-25 06:33:00"
"1775","20155023065033-796",3,"2015-07-23 07:18:00",1437661080,"C4",141000,1437802080,"2015-07-24 22:28:00"
"2391","20154323064305-880",1,"2015-07-23 07:19:00",1437661140,"C0",139920,1437801060,"2015-07-24 22:11:00"
"4729","20153123063158-685",1,"2015-07-23 07:29:00",1437661740,"C0",101940,1437763680,"2015-07-24 11:48:00"
"1989","20153023063031-787",1,"2015-07-23 07:30:00",1437661800,"C4",607560,1438269360,"2015-07-30 08:16:00"
"4530","20150723070741-205",2,"2015-07-23 07:40:00",1437662400,"C5",80580,1437742980,"2015-07-24 06:03:00"
"2388","20153423073421-295",3,"2015-07-23 07:41:00",1437662460,"C8",342660,1438005120,"2015-07-27 06:52:00"
"4098","20154823074803-769",1,"2015-07-23 07:55:00",1437663300,"C4",178860,1437842160,"2015-07-25 09:36:00"
"1518","20151623071615-935",2,"2015-07-23 07:57:00",1437663420,"C0",270120,1437933540,"2015-07-26 10:59:00"
"1922","20152423072412-875",1,"2015-07-23 08:02:00",1437663720,"C0",373080,1438036800,"2015-07-27 15:40:00"
"4771","20153623073647-385",3,"2015-07-23 08:39:00",1437665940,"C5",89640,1437755580,"2015-07-24 09:33:00"
"3206","20154423074437-690",2,"2015-07-23 08:53:00",1437666780,"C2",288840,1437955620,"2015-07-26 17:07:00"
"6030","20155323075349-302",2,"2015-07-23 09:06:00",1437667560,"C0",133740,1437801300,"2015-07-24 22:15:00"
"3443","20154023084005-11",1,"2015-07-23 09:07:00",1437667620,"C4",218100,1437885720,"2015-07-25 21:42:00"
"2158","20153523083548-153",1,"2015-07-23 09:15:00",1437668100,"C2",108060,1437776160,"2015-07-24 15:16:00"
"3939","20151723091752-582",1,"2015-07-23 09:25:00",1437668700,"C4",461280,1438129980,"2015-07-28 17:33:00"
"2891","20151523091548-948",2,"2015-07-23 09:39:00",1437669540,"C4",91560,1437761100,"2015-07-24 11:05:00"
"3067","20151623091621-956",1,"2015-07-23 09:50:00",1437670200,"C2",119340,1437789540,"2015-07-24 18:59:00"
"2846","20150923090925-163",3,"2015-07-23 10:04:00",1437671040,"C5",79740,1437750780,"2015-07-24 08:13:00"
"6028","20150223090243-726",3,"2015-07-23 10:13:00",1437671580,"C0",90960,1437762540,"2015-07-24 11:29:00"
"2195","20154423094459-117",2,"2015-07-23 10:16:00",1437671760,"C3",366720,1438038480,"2015-07-27 16:08:00"
"6525","20155623095618-430",1,"2015-07-23 10:19:00",1437671940,"C5",619080,1438291020,"2015-07-30 14:17:00"
"3923","20152823092842-19",1,"2015-07-23 10:28:00",1437672480,"C5",301860,1437974340,"2015-07-26 22:19:00"
"5581","20152923092919-201",1,"2015-07-23 10:35:00",1437672900,"C7",731160,1438404060,"2015-07-31 21:41:00"
"5391","20153723103744-695",1,"2015-07-23 11:05:00",1437674700,"C3",89700,1437764400,"2015-07-24 12:00:00"
"1637","20154623104653-166",1,"2015-07-23 11:08:00",1437674880,"C5",807840,1438482720,"2015-08-01 19:32:00"
"2092","20152123102144-807",1,"2015-07-23 11:15:00",1437675300,"C5",207900,1437883200,"2015-07-25 21:00:00"
"2971","20152723112739-990",3,"2015-07-23 11:34:00",1437676440,"C8",99720,1437776160,"2015-07-24 15:16:00"
"14","20152923102955-348",2,"2015-07-23 11:36:00",1437676560,"C8",77100,1437753660,"2015-07-24 09:01:00"
"2810","20153123103101-33",2,"2015-07-23 11:37:00",1437676620,"C8",83760,1437760380,"2015-07-24 10:53:00"
"2741","20153623113600-392",1,"2015-07-23 11:55:00",1437677700,"C6",244020,1437921720,"2015-07-26 07:42:00"
"2793","20150223110226-578",1,"2015-07-23 11:57:00",1437677820,"C5",201180,1437879000,"2015-07-25 19:50:00"
"6465","20153223113200-303",1,"2015-07-23 12:04:00",1437678240,"C3",334380,1438012620,"2015-07-27 08:57:00"
"5605","20150623110625-496",3,"2015-07-23 12:05:00",1437678300,"C4",173400,1437851700,"2015-07-25 12:15:00"
"4874","20155823115812-779",1,"2015-07-23 12:26:00",1437679560,"C4",107460,1437787020,"2015-07-24 18:17:00"
"4626","20151923121906-266",3,"2015-07-23 12:46:00",1437680760,"C5",197640,1437878400,"2015-07-25 19:40:00"
"6422","20152023122039-382",1,"2015-07-23 12:51:00",1437681060,"C7",370320,1438051380,"2015-07-27 19:43:00"
"4911","20154323124336-960",3,"2015-07-23 13:11:00",1437682260,"C8",1228560,1438910820,"2015-08-06 18:27:00"
"4540","20152823122846-410",1,"2015-07-23 13:36:00",1437683760,"C4",120060,1437803820,"2015-07-24 22:57:00"
"5561","20154523124510-943",1,"2015-07-23 13:44:00",1437684240,"C4",148320,1437832560,"2015-07-25 06:56:00"
"4084","20152123012154-34",2,"2015-07-23 13:50:00",1437684600,"C5",376560,1438061160,"2015-07-27 22:26:00"
"5826","20153723013743-159",1,"2015-07-23 14:08:00",1437685680,"C5",338580,1438024260,"2015-07-27 12:11:00"
"4474","20150523010518-241",1,"2015-07-23 14:09:00",1437685740,"C2",58320,1437744060,"2015-07-24 06:21:00"
"2356","20150923010916-544",3,"2015-07-23 14:10:00",1437685800,"C0",88740,1437774540,"2015-07-24 14:49:00"
"231","20155223015236-307",3,"2015-07-23 14:15:00",1437686100,"C8",429180,1438115280,"2015-07-28 13:28:00"
"1718","20154423014424-392",1,"2015-07-23 14:16:00",1437686160,"C2",691620,1438377780,"2015-07-31 14:23:00"
"1945","20153423013422-332",2,"2015-07-23 14:19:00",1437686340,"C8",75420,1437761760,"2015-07-24 11:16:00"
"5707","20155623015620-828",1,"2015-07-23 14:22:00",1437686520,"C5",116400,1437802920,"2015-07-24 22:42:00"
"4197","20155123015131-999",1,"2015-07-23 14:25:00",1437686700,"C5",158400,1437845100,"2015-07-25 10:25:00"
"3986","20153423013440-640",1,"2015-07-23 14:34:00",1437687240,"C3",68520,1437755760,"2015-07-24 09:36:00"
"678","20155423015434-702",2,"2015-07-23 15:00:00",1437688800,"C8",237240,1437926040,"2015-07-26 08:54:00"
"4668","20155323025342-343",1,"2015-07-23 15:17:00",1437689820,"C8",586740,1438276560,"2015-07-30 10:16:00"
"5933","20151723021731-685",3,"2015-07-23 15:22:00",1437690120,"C5",263160,1437953280,"2015-07-26 16:28:00"
"4812","20150323030348-749",1,"2015-07-23 15:28:00",1437690480,"C4",618600,1438309080,"2015-07-30 19:18:00"
"5326","20151823021857-278",3,"2015-07-23 15:31:00",1437690660,"C0",271020,1437961680,"2015-07-26 18:48:00"
"3230","20155723025701-227",1,"2015-07-23 15:37:00",1437691020,"C2",150180,1437841200,"2015-07-25 09:20:00"
"2042","20151823031815-439",1,"2015-07-23 16:21:00",1437693660,"C4",52020,1437745680,"2015-07-24 06:48:00"
"242","20151923041923-108",2,"2015-07-23 16:26:00",1437693960,"C8",146220,1437840180,"2015-07-25 09:03:00"
"4571","20153323043307-820",2,"2015-07-23 16:40:00",1437694800,"C8",434760,1438129560,"2015-07-28 17:26:00"
"4307","20151023041017-423",1,"2015-07-23 16:48:00",1437695280,"C2",518760,1438214040,"2015-07-29 16:54:00"
"4448","20155123035157-563",2,"2015-07-23 16:51:00",1437695460,"C2",101280,1437796740,"2015-07-24 20:59:00"
"114","20155723035703-81",1,"2015-07-23 17:06:00",1437696360,"C0",951180,1438647540,"2015-08-03 17:19:00"
"4653","20154023044021-772",2,"2015-07-23 17:09:00",1437696540,"C3",158340,1437854880,"2015-07-25 13:08:00"
"5907","20152923052943-630",1,"2015-07-23 17:52:00",1437699120,"C5",183180,1437882300,"2015-07-25 20:45:00"
"3447","20150923050915-668",1,"2015-07-23 18:19:00",1437700740,"C0",64320,1437765060,"2015-07-24 12:11:00"
"838","20155723045734-820",1,"2015-07-23 19:36:00",1437705360,"C4",1301280,1439006640,"2015-08-07 21:04:00"
"258","20150624060606-582",1,"2015-07-24 06:20:00",1437744000,"C7",231060,1437975060,"2015-07-26 22:31:00"
"5279","20153324063329-147",1,"2015-07-24 06:35:00",1437744900,"C6",84660,1437829560,"2015-07-25 06:06:00"
"3656","20152024062006-883",3,"2015-07-24 06:48:00",1437745680,"C5",299340,1438045020,"2015-07-27 17:57:00"
"6113","20150324060332-594",2,"2015-07-24 06:55:00",1437746100,"C8",282960,1438029060,"2015-07-27 13:31:00"
"3689","20151924061907-803",1,"2015-07-24 07:18:00",1437747480,"C2",538260,1438285740,"2015-07-30 12:49:00"
"4990","20155424065455-846",2,"2015-07-24 07:28:00",1437748080,"C7",96960,1437845040,"2015-07-25 10:24:00"
"1680","20152724062710-421",1,"2015-07-24 07:35:00",1437748500,"C2",645300,1438393800,"2015-07-31 18:50:00"
"2946","20155724065712-217",1,"2015-07-24 07:38:00",1437748680,"C2",131220,1437879900,"2015-07-25 20:05:00"
"252","20153624073615-56",1,"2015-07-24 08:07:00",1437750420,"C3",224040,1437974460,"2015-07-26 22:21:00"
"1210","20151724081751-413",2,"2015-07-24 08:25:00",1437751500,"C4",78900,1437830400,"2015-07-25 06:20:00"
"6379","20152524072545-996",1,"2015-07-24 08:33:00",1437751980,"C6",205920,1437957900,"2015-07-26 17:45:00"
"74","20152824082844-651",3,"2015-07-24 08:35:00",1437752100,"C8",262980,1438015080,"2015-07-27 09:38:00"
"3076","20150624080630-565",1,"2015-07-24 08:57:00",1437753420,"C8",303900,1438057320,"2015-07-27 21:22:00"
"1821","20153924083911-558",2,"2015-07-24 09:00:00",1437753600,"C5",341760,1438095360,"2015-07-28 07:56:00"
"3345","20153324083337-471",3,"2015-07-24 09:03:00",1437753780,"C2",89280,1437843060,"2015-07-25 09:51:00"
"3079","20151124081114-91",1,"2015-07-24 09:06:00",1437753960,"C8",268680,1438022640,"2015-07-27 11:44:00"
"1834","20153324083347-572",2,"2015-07-24 09:08:00",1437754080,"C2",1071600,1438825680,"2015-08-05 18:48:00"
"3456","20155824085808-856",3,"2015-07-24 09:29:00",1437755340,"C7",271200,1438026540,"2015-07-27 12:49:00"
"2998","20150124090106-75",1,"2015-07-24 09:38:00",1437755880,"C3",212100,1437967980,"2015-07-26 20:33:00"
"70","20151924091930-39",1,"2015-07-24 09:46:00",1437756360,"C5",288840,1438045200,"2015-07-27 18:00:00"
"315","20153624093600-684",1,"2015-07-24 10:31:00",1437759060,"C5",379980,1438139040,"2015-07-28 20:04:00"
"896","20151824101840-224",2,"2015-07-24 10:44:00",1437759840,"C8",344760,1438104600,"2015-07-28 10:30:00"
"6527","20152624102605-26",1,"2015-07-24 10:46:00",1437759960,"C8",268800,1438028760,"2015-07-27 13:26:00"
"1659","20150224100248-221",1,"2015-07-24 10:48:00",1437760080,"C8",215040,1437975120,"2015-07-26 22:32:00"
"4866","20153424103412-281",2,"2015-07-24 10:56:00",1437760560,"C5",183480,1437944040,"2015-07-26 13:54:00"
"4152","20155424105453-864",1,"2015-07-24 11:14:00",1437761640,"C1",212400,1437974040,"2015-07-26 22:14:00"
"5044","20150024110036-855",1,"2015-07-24 11:35:00",1437762900,"C3",848760,1438611660,"2015-08-03 07:21:00"
"4565","20154124104119-137",3,"2015-07-24 11:37:00",1437763020,"C8",93960,1437856980,"2015-07-25 13:43:00"
"1460","20153024113026-294",2,"2015-07-24 11:52:00",1437763920,"C5",162600,1437926520,"2015-07-26 09:02:00"
"1782","20151124111122-818",1,"2015-07-24 11:53:00",1437763980,"C2",280860,1438044840,"2015-07-27 17:54:00"
"1479","20155524115511-739",3,"2015-07-24 12:27:00",1437766020,"C6",533460,1438299480,"2015-07-30 16:38:00"
"4233","20153124113131-106",2,"2015-07-24 12:31:00",1437766260,"C4",182340,1437948600,"2015-07-26 15:10:00"
"2052","20154524114509-609",1,"2015-07-24 12:38:00",1437766680,"C5",119760,1437886440,"2015-07-25 21:54:00"
"2631","20152724112733-858",1,"2015-07-24 12:38:00",1437766680,"C0",602580,1438369260,"2015-07-31 12:01:00"
"2678","20151824121833-994",1,"2015-07-24 12:39:00",1437766740,"C6",332160,1438098900,"2015-07-28 08:55:00"
"4713","20151224121210-614",2,"2015-07-24 12:39:00",1437766740,"C5",163080,1437929820,"2015-07-26 09:57:00"
"6228","20152924112938-506",3,"2015-07-24 12:46:00",1437767160,"C0",466020,1438233180,"2015-07-29 22:13:00"
"3665","20155624115628-693",1,"2015-07-24 12:49:00",1437767340,"C5",326940,1438094280,"2015-07-28 07:38:00"
"1786","20153424123435-575",2,"2015-07-24 12:50:00",1437767400,"C7",193320,1437960720,"2015-07-26 18:32:00"
"642","20154724114756-664",2,"2015-07-24 12:58:00",1437767880,"C6",64920,1437832800,"2015-07-25 07:00:00"
"1308","20150624120647-627",3,"2015-07-24 13:01:00",1437768060,"C6",502380,1438270440,"2015-07-30 08:34:00"
"5347","20153224123257-617",1,"2015-07-24 13:03:00",1437768180,"C5",254880,1438023060,"2015-07-27 11:51:00"
"37","20150924120946-229",1,"2015-07-24 13:11:00",1437768660,"C3",605100,1438373760,"2015-07-31 13:16:00"
"3688","20152824012815-413",1,"2015-07-24 13:57:00",1437771420,"C2",201900,1437973320,"2015-07-26 22:02:00"
"1752","20154112014114-381",1,"2015-07-24 14:02:00",1437771720,"C6",203280,1437975000,"2015-07-26 22:30:00"
"1467","20150724010756-126",2,"2015-07-24 14:03:00",1437771780,"C6",245160,1438016940,"2015-07-27 10:09:00"
"162","20154324014347-139",1,"2015-07-24 14:08:00",1437772080,"C5",79740,1437851820,"2015-07-25 12:17:00"
"5127","20155724015759-778",1,"2015-07-24 14:19:00",1437772740,"C7",233760,1438006500,"2015-07-27 07:15:00"
"1393","20152224012227-459",3,"2015-07-24 14:21:00",1437772860,"C5",371760,1438144620,"2015-07-28 21:37:00"
"1756","20154924014948-415",1,"2015-07-24 14:23:00",1437772980,"C6",97080,1437870060,"2015-07-25 17:21:00"
"1814","20155724015737-87",3,"2015-07-24 14:24:00",1437773040,"C3",275040,1438048080,"2015-07-27 18:48:00"
"78","20155824015804-38",1,"2015-07-24 14:25:00",1437773100,"C4",318900,1438092000,"2015-07-28 07:00:00"
"1364","20151424021410-748",3,"2015-07-24 14:33:00",1437773580,"C7",150720,1437924300,"2015-07-26 08:25:00"
"2543","20152724022714-969",3,"2015-07-24 14:34:00",1437773640,"C4",173820,1437947460,"2015-07-26 14:51:00"
"3735","20155824015823-693",1,"2015-07-24 14:40:00",1437774000,"C2",969000,1438743000,"2015-08-04 19:50:00"
"3886","20154324024355-579",3,"2015-07-24 14:51:00",1437774660,"C8",56340,1437831000,"2015-07-25 06:30:00"
"1311","20153724023747-163",1,"2015-07-24 14:54:00",1437774840,"C7",710340,1438485180,"2015-08-01 20:13:00"
"159","20155424015436-907",3,"2015-07-24 15:07:00",1437775620,"C2",77820,1437853440,"2015-07-25 12:44:00"
"5745","20155724025757-642",2,"2015-07-24 15:32:00",1437777120,"C5",151860,1437928980,"2015-07-26 09:43:00"
"4607","20154519024544-322",2,"2015-07-24 15:33:00",1437777180,"C4",202800,1437979980,"2015-07-26 23:53:00"
"5100","20155924015914-772",2,"2015-07-24 15:42:00",1437777720,"C6",87660,1437865380,"2015-07-25 16:03:00"
"450","20154224024247-121",2,"2015-07-24 15:44:00",1437777840,"C2",362100,1438139940,"2015-07-28 20:19:00"
"5513","20155924025958-524",2,"2015-07-24 15:44:00",1437777840,"C8",681720,1438459560,"2015-08-01 13:06:00"
"1276","20154224024243-441",1,"2015-07-24 15:48:00",1437778080,"C4",767460,1438545540,"2015-08-02 12:59:00"
"1835","20155224025254-187",1,"2015-07-24 15:50:00",1437778200,"C4",140640,1437918840,"2015-07-26 06:54:00"
"4861","20152524032503-334",3,"2015-07-24 15:52:00",1437778320,"C4",175800,1437954120,"2015-07-26 16:42:00"
"976","20153324033341-637",2,"2015-07-24 15:56:00",1437778560,"C4",238680,1438017240,"2015-07-27 10:14:00"
"1764","20150624030614-941",1,"2015-07-24 16:01:00",1437778860,"C8",64800,1437843660,"2015-07-25 10:01:00"
"1256","20155124035131-240",1,"2015-07-24 16:14:00",1437779640,"C7",541440,1438321080,"2015-07-30 22:38:00"
"2828","20151724031732-555",1,"2015-07-24 16:18:00",1437779880,"C7",421080,1438200960,"2015-07-29 13:16:00"
"5689","20151624031658-684",3,"2015-07-24 16:18:00",1437779880,"C8",160920,1437940800,"2015-07-26 13:00:00"
"569","20152724032744-453",2,"2015-07-24 16:21:00",1437780060,"C8",501900,1438281960,"2015-07-30 11:46:00"
"4774","20151124031108-240",1,"2015-07-24 16:21:00",1437780060,"C2",80340,1437860400,"2015-07-25 14:40:00"
"1447","20152924032913-724",1,"2015-07-24 16:25:00",1437780300,"C3",1087800,1438868100,"2015-08-06 06:35:00"
"6038","20151824041829-872",1,"2015-07-24 16:32:00",1437780720,"C0",611580,1438392300,"2015-07-31 18:25:00"
"4123","20154824034807-478",2,"2015-07-24 16:51:00",1437781860,"C5",276540,1438058400,"2015-07-27 21:40:00"
"3023","20151324041317-432",1,"2015-07-24 16:52:00",1437781920,"C7",267120,1438049040,"2015-07-27 19:04:00"
"1106","20154824044810-764",1,"2015-07-24 16:55:00",1437782100,"C8",50460,1437832560,"2015-07-25 06:56:00"
"4891","20153824043829-635",3,"2015-07-24 17:08:00",1437782880,"C8",80580,1437863460,"2015-07-25 15:31:00"
"4657","20150624050603-927",3,"2015-07-24 17:13:00",1437783180,"C8",323760,1438106940,"2015-07-28 11:09:00"
"1936","20150524040536-313",1,"2015-07-24 17:19:00",1437783540,"C2",590640,1438374180,"2015-07-31 13:23:00"
"2435","20154024044050-101",2,"2015-07-24 17:21:00",1437783660,"C2",318240,1438101900,"2015-07-28 09:45:00"
"493","20155024045011-587",3,"2015-07-24 17:24:00",1437783840,"C0",1211280,1438995120,"2015-08-07 17:52:00"
"4224","20150124050126-399",3,"2015-07-24 17:53:00",1437785580,"C8",145020,1437930600,"2015-07-26 10:10:00"
"3762","20155724055744-118",2,"2015-07-24 18:59:00",1437789540,"C7",141240,1437930780,"2015-07-26 10:13:00"
"2087","20153225063218-391",1,"2015-07-25 06:54:00",1437832440,"C5",711780,1438544220,"2015-08-02 12:37:00"
"5584","20150325060300-912",1,"2015-07-25 07:00:00",1437832800,"C4",110940,1437943740,"2015-07-26 13:49:00"
"5896","20150425060412-481",2,"2015-07-25 07:10:00",1437833400,"C8",306540,1438139940,"2015-07-28 20:19:00"
"6027","20150825070821-784",2,"2015-07-25 07:30:00",1437834600,"C4",137040,1437971640,"2015-07-26 21:34:00"
"3110","20151125071146-648",2,"2015-07-25 07:43:00",1437835380,"C8",440880,1438276260,"2015-07-30 10:11:00"
"8","20155525065551-662",1,"2015-07-25 07:56:00",1437836160,"C8",196260,1438032420,"2015-07-27 14:27:00"
"4720","20151025071006-134",3,"2015-07-25 08:06:00",1437836760,"C6",224340,1438061100,"2015-07-27 22:25:00"
"3968","20150925070901-487",2,"2015-07-25 08:15:00",1437837300,"C0",211200,1438048500,"2015-07-27 18:55:00"
"3806","20154925074924-66",1,"2015-07-25 08:20:00",1437837600,"C7",783720,1438621320,"2015-08-03 10:02:00"
"4472","20155825075830-372",3,"2015-07-25 08:38:00",1437838680,"C0",289260,1438127940,"2015-07-28 16:59:00"
"4049","20150125080138-74",3,"2015-07-25 08:50:00",1437839400,"C7",357120,1438196520,"2015-07-29 12:02:00"
"816","20155325075339-490",2,"2015-07-25 08:51:00",1437839460,"C5",301200,1438140660,"2015-07-28 20:31:00"
"6108","20155725075727-219",1,"2015-07-25 08:55:00",1437839700,"C4",179880,1438019580,"2015-07-27 10:53:00"
"607","20152225082250-866",2,"2015-07-25 09:33:00",1437841980,"C0",652380,1438494360,"2015-08-01 22:46:00"
"911","20154625084640-549",1,"2015-07-25 09:39:00",1437842340,"C4",81480,1437923820,"2015-07-26 08:17:00"
"269","20153025093014-930",1,"2015-07-25 09:58:00",1437843480,"C4",253320,1438096800,"2015-07-28 08:20:00"
"2218","20151225091206-465",2,"2015-07-25 10:10:00",1437844200,"C2",301680,1438145880,"2015-07-28 21:58:00"
"3431","20151225091237-930",1,"2015-07-25 10:13:00",1437844380,"C5",793080,1438637460,"2015-08-03 14:31:00"
"465","20154425094430-276",1,"2015-07-25 10:14:00",1437844440,"C2",638520,1438482960,"2015-08-01 19:36:00"
"92","20152125092114-567",1,"2015-07-25 10:16:00",1437844560,"C5",345120,1438189680,"2015-07-29 10:08:00"
"6128","20153225093249-352",1,"2015-07-25 10:21:00",1437844860,"C8",92340,1437937200,"2015-07-26 12:00:00"
"239","20152625102655-249",1,"2015-07-25 10:51:00",1437846660,"C4",78780,1437925440,"2015-07-26 08:44:00"
"1516","20155825095828-312",3,"2015-07-25 10:51:00",1437846660,"C7",120840,1437967500,"2015-07-26 20:25:00"
"2161","20150925110937-663",3,"2015-07-25 11:11:00",1437847860,"C6",426540,1438274400,"2015-07-30 09:40:00"
"3158","20154625104616-641",2,"2015-07-25 11:13:00",1437847980,"C5",271740,1438119720,"2015-07-28 14:42:00"
"3222","20152925102911-696",3,"2015-07-25 11:16:00",1437848160,"C7",368280,1438216440,"2015-07-29 17:34:00"
"1473","20154825104838-640",2,"2015-07-25 11:18:00",1437848280,"C5",103260,1437951540,"2015-07-26 15:59:00"
"1998","20152525102559-950",2,"2015-07-25 11:26:00",1437848760,"C7",125400,1437974160,"2015-07-26 22:16:00"
"872","20151425111443-882",3,"2015-07-25 12:06:00",1437851160,"C5",289140,1438140300,"2015-07-28 20:25:00"
"2659","20150825110832-749",1,"2015-07-25 12:09:00",1437851340,"C5",437100,1438288440,"2015-07-30 13:34:00"
"1119","20155525115532-571",1,"2015-07-25 12:25:00",1437852300,"C0",431520,1438283820,"2015-07-30 12:17:00"
"5155","20151125121136-226",2,"2015-07-25 12:38:00",1437853080,"C5",179700,1438032780,"2015-07-27 14:33:00"
"969","20154725114714-121",3,"2015-07-25 12:41:00",1437853260,"C7",80520,1437933780,"2015-07-26 11:03:00"
"4958","20154625114655-96",1,"2015-07-25 12:48:00",1437853680,"C8",2625840,1440479520,"2015-08-24 22:12:00"
"2893","20154325114323-182",1,"2015-07-25 12:49:00",1437853740,"C0",156480,1438010220,"2015-07-27 08:17:00"
"2666","20154025124046-991",1,"2015-07-25 13:08:00",1437854880,"C3",62580,1437917460,"2015-07-26 06:31:00"
"5929","20153325123355-404",1,"2015-07-25 13:23:00",1437855780,"C6",635220,1438491000,"2015-08-01 21:50:00"
"5164","20150325010306-666",3,"2015-07-25 13:31:00",1437856260,"C4",439680,1438295940,"2015-07-30 15:39:00"
"4894","20150725010752-511",1,"2015-07-25 14:01:00",1437858060,"C4",176160,1438034220,"2015-07-27 14:57:00"
"5934","20150425010459-670",1,"2015-07-25 14:12:00",1437858720,"C3",111360,1437970080,"2015-07-26 21:08:00"
"3379","20155625015640-843",2,"2015-07-25 14:23:00",1437859380,"C5",230820,1438090200,"2015-07-28 06:30:00"
"5781","20155025015032-304",3,"2015-07-25 14:45:00",1437860700,"C8",145020,1438005720,"2015-07-27 07:02:00"
"3091","20155625015640-270",2,"2015-07-25 14:55:00",1437861300,"C0",153180,1438014480,"2015-07-27 09:28:00"
"1370","20153925023931-202",2,"2015-07-25 15:02:00",1437861720,"C5",151980,1438013700,"2015-07-27 09:15:00"
"3933","20155825015847-776",3,"2015-07-25 15:10:00",1437862200,"C2",62820,1437925020,"2015-07-26 08:37:00"
"2969","20153525023538-936",2,"2015-07-25 15:34:00",1437863640,"C6",271440,1438135080,"2015-07-28 18:58:00"
"1283","20151025031037-733",1,"2015-07-25 15:42:00",1437864120,"C4",760140,1438624260,"2015-08-03 10:51:00"
"913","20155525025541-454",1,"2015-07-25 15:47:00",1437864420,"C5",367740,1438232160,"2015-07-29 21:56:00"
"3750","20155225025231-666",2,"2015-07-25 15:50:00",1437864600,"C4",65880,1437930480,"2015-07-26 10:08:00"
"6349","20154525024508-630",2,"2015-07-25 15:50:00",1437864600,"C5",243120,1438107720,"2015-07-28 11:22:00"
"4888","20152925032929-380",1,"2015-07-25 15:53:00",1437864780,"C5",1180440,1439045220,"2015-08-08 07:47:00"
"3290","20150725030751-337",1,"2015-07-25 15:59:00",1437865140,"C4",81420,1437946560,"2015-07-26 14:36:00"
"6385","20153125033101-388",2,"2015-07-25 16:02:00",1437865320,"C7",93180,1437958500,"2015-07-26 17:55:00"
"2960","20151225031208-655",1,"2015-07-25 16:12:00",1437865920,"C5",263580,1438129500,"2015-07-28 17:25:00"
"6439","20155925035953-311",2,"2015-07-25 16:33:00",1437867180,"C0",500520,1438367700,"2015-07-31 11:35:00"
"2189","20155325045321-836",1,"2015-07-25 17:07:00",1437869220,"C0",327120,1438196340,"2015-07-29 11:59:00"
"5970","20150825040838-487",1,"2015-07-25 17:07:00",1437869220,"C7",188220,1438057440,"2015-07-27 21:24:00"
"1406","20150725040701-369",2,"2015-07-25 17:08:00",1437869280,"C5",75900,1437945180,"2015-07-26 14:13:00"
"1471","20152525042519-381",2,"2015-07-25 17:08:00",1437869280,"C2",100140,1437969420,"2015-07-26 20:57:00"
"1861","20151725041726-478",2,"2015-07-25 17:13:00",1437869580,"C3",161460,1438031040,"2015-07-27 14:04:00"
"5074","20150825050807-78",1,"2015-07-25 17:14:00",1437869640,"C4",338760,1438208400,"2015-07-29 15:20:00"
"6387","20155525045542-362",3,"2015-07-25 17:23:00",1437870180,"C5",538320,1438408500,"2015-07-31 22:55:00"
"3130","20150425050434-33",1,"2015-07-25 17:26:00",1437870360,"C6",532320,1438402680,"2015-07-31 21:18:00"
"5984","20154225044228-490",2,"2015-07-25 17:30:00",1437870600,"C8",184020,1438054620,"2015-07-27 20:37:00"
"4009","20150925050919-689",3,"2015-07-25 17:33:00",1437870780,"C7",182520,1438053300,"2015-07-27 20:15:00"
"1877","20155525045517-999",1,"2015-07-25 17:45:00",1437871500,"C5",191040,1438062540,"2015-07-27 22:49:00"
"1083","20154125044106-999",1,"2015-07-25 17:53:00",1437871980,"C2",178800,1438050780,"2015-07-27 19:33:00"
"3837","20150525050525-344",3,"2015-07-25 18:10:00",1437873000,"C0",310560,1438183560,"2015-07-29 08:26:00"
"1967","20154525054551-322",1,"2015-07-25 18:11:00",1437873060,"C5",87480,1437960540,"2015-07-26 18:29:00"
"39","20154625054615-85",3,"2015-07-25 18:20:00",1437873600,"C2",309540,1438183140,"2015-07-29 08:19:00"
"4721","20154725054747-248",2,"2015-07-25 18:38:00",1437874680,"C4",488220,1438362900,"2015-07-31 10:15:00"
"3143","20155625055644-429",1,"2015-07-25 19:01:00",1437876060,"C2",77880,1437953940,"2015-07-26 16:39:00"
"3927","20150526060526-540",2,"2015-07-26 06:21:00",1437916860,"C0",480420,1438397280,"2015-07-31 19:48:00"
"2261","20151726061756-646",1,"2015-07-26 06:46:00",1437918360,"C4",637380,1438555740,"2015-08-02 15:49:00"
"4666","20154626064610-637",1,"2015-07-26 06:53:00",1437918780,"C8",119580,1438038360,"2015-07-27 16:06:00"
"6149","20152626062625-468",1,"2015-07-26 06:53:00",1437918780,"C5",143700,1438062480,"2015-07-27 22:48:00"
"6029","20152426062434-212",1,"2015-07-26 06:58:00",1437919080,"C7",210480,1438129560,"2015-07-28 17:26:00"
"3536","20153526063512-278",1,"2015-07-26 06:59:00",1437919140,"C8",188340,1438107480,"2015-07-28 11:18:00"
"4506","20154726064756-747",1,"2015-07-26 07:03:00",1437919380,"C7",200160,1438119540,"2015-07-28 14:39:00"
"57","20155726065746-437",3,"2015-07-26 07:32:00",1437921120,"C7",113580,1438034700,"2015-07-27 15:05:00"
"6389","20150426070452-144",1,"2015-07-26 07:33:00",1437921180,"C8",84240,1438005420,"2015-07-27 06:57:00"
"3428","20150626070610-771",1,"2015-07-26 07:34:00",1437921240,"C4",382860,1438304100,"2015-07-30 17:55:00"
"280","20154826064823-183",1,"2015-07-26 07:43:00",1437921780,"C4",812580,1438734360,"2015-08-04 17:26:00"
"6160","20154626064612-785",1,"2015-07-26 07:45:00",1437921900,"C4",739080,1438660980,"2015-08-03 21:03:00"
"940","20153726073704-996",3,"2015-07-26 08:06:00",1437923160,"C5",133680,1438056840,"2015-07-27 21:14:00"
"3756","20151826071854-437",1,"2015-07-26 08:10:00",1437923400,"C8",280500,1438203900,"2015-07-29 14:05:00"
"1401","20153826073859-860",3,"2015-07-26 08:32:00",1437924720,"C5",455580,1438380300,"2015-07-31 15:05:00"
"2338","20153226073247-72",1,"2015-07-26 08:32:00",1437924720,"C2",88560,1438013280,"2015-07-27 09:08:00"
"5629","20151526081503-628",1,"2015-07-26 08:50:00",1437925800,"C2",1287900,1439213700,"2015-08-10 06:35:00"
"6182","20155426075432-816",2,"2015-07-26 08:50:00",1437925800,"C4",278040,1438203840,"2015-07-29 14:04:00"
"1902","20155726085710-998",2,"2015-07-26 09:04:00",1437926640,"C4",463680,1438390320,"2015-07-31 17:52:00"
"4148","20152526082520-23",3,"2015-07-26 09:21:00",1437927660,"C5",192720,1438120380,"2015-07-28 14:53:00"
"4302","20150326090318-883",1,"2015-07-26 09:32:00",1437928320,"C5",477660,1438405980,"2015-07-31 22:13:00"
"6510","20155426095420-438",2,"2015-07-26 10:01:00",1437930060,"C8",106260,1438036320,"2015-07-27 15:32:00"
"4107","20151926091952-816",3,"2015-07-26 10:07:00",1437930420,"C8",465960,1438396380,"2015-07-31 19:33:00"
"137","20150826100844-912",2,"2015-07-26 10:38:00",1437932280,"C5",95700,1438027980,"2015-07-27 13:13:00"
"5905","20152126102142-711",1,"2015-07-26 10:50:00",1437933000,"C8",337080,1438270080,"2015-07-30 08:28:00"
"2076","20155626095622-144",3,"2015-07-26 10:54:00",1437933240,"C3",116040,1438049280,"2015-07-27 19:08:00"
"727","20155926095918-705",1,"2015-07-26 10:56:00",1437933360,"C4",123600,1438056960,"2015-07-27 21:16:00"
"4341","20155326105308-899",1,"2015-07-26 10:58:00",1437933480,"C2",684480,1438617960,"2015-08-03 09:06:00"
"1883","20150026110014-327",3,"2015-07-26 11:24:00",1437935040,"C5",94680,1438029720,"2015-07-27 13:42:00"
"579","20151726101752-323",2,"2015-07-26 11:26:00",1437935160,"C3",936000,1438871160,"2015-08-06 07:26:00"
"333","20150726110738-643",1,"2015-07-26 11:39:00",1437935940,"C4",558660,1438494600,"2015-08-01 22:50:00"
"1994","20151426111428-477",2,"2015-07-26 11:46:00",1437936360,"C2",185760,1438122120,"2015-07-28 15:22:00"
"4006","20154726114709-355",1,"2015-07-26 12:40:00",1437939600,"C4",170820,1438110420,"2015-07-28 12:07:00"
"649","20151826121830-361",3,"2015-07-26 12:43:00",1437939780,"C5",863040,1438802820,"2015-08-05 12:27:00"
"2348","20151626121657-196",2,"2015-07-26 12:50:00",1437940200,"C3",188100,1438128300,"2015-07-28 17:05:00"
"804","20154826114830-851",2,"2015-07-26 12:54:00",1437940440,"C4",343080,1438283520,"2015-07-30 12:12:00"
"6413","20155026125036-291",2,"2015-07-26 12:57:00",1437940620,"C2",282300,1438222920,"2015-07-29 19:22:00"
"991","20155926125915-298",3,"2015-07-26 13:05:00",1437941100,"C8",351600,1438292700,"2015-07-30 14:45:00"
"2989","20154926124932-480",1,"2015-07-26 13:14:00",1437941640,"C7",63600,1438005240,"2015-07-27 06:54:00"
"761","20155526125517-937",1,"2015-07-26 13:19:00",1437941940,"C8",112800,1438054740,"2015-07-27 20:39:00"
"6494","20154926124914-356",1,"2015-07-26 13:26:00",1437942360,"C2",204780,1438147140,"2015-07-28 22:19:00"
"640","20153712013720-181",3,"2015-07-26 13:28:00",1437942480,"C6",206700,1438149180,"2015-07-28 22:53:00"
"5911","20153126013121-122",3,"2015-07-26 13:55:00",1437944100,"C7",93540,1438037640,"2015-07-27 15:54:00"
"4793","20155226125229-218",3,"2015-07-26 14:01:00",1437944460,"C3",79680,1438024140,"2015-07-27 12:09:00"
"145","20150826010800-879",1,"2015-07-26 14:02:00",1437944520,"C4",951180,1438895700,"2015-08-06 14:15:00"
"1441","20155026015047-456",2,"2015-07-26 14:25:00",1437945900,"C3",438600,1438384500,"2015-07-31 16:15:00"
"2638","20151426021410-715",1,"2015-07-26 14:26:00",1437945960,"C3",451860,1438397820,"2015-07-31 19:57:00"
"4140","20152326012317-940",1,"2015-07-26 14:31:00",1437946260,"C8",1136160,1439082420,"2015-08-08 18:07:00"
"6371","20155726015743-944",2,"2015-07-26 14:31:00",1437946260,"C2",348480,1438294740,"2015-07-30 15:19:00"
"3757","20151626021639-5",1,"2015-07-26 14:43:00",1437946980,"C4",406320,1438353300,"2015-07-31 07:35:00"
"4862","20153726023718-952",1,"2015-07-26 14:47:00",1437947220,"C3",177540,1438124760,"2015-07-28 16:06:00"
"3281","20153126023103-958",2,"2015-07-26 14:48:00",1437947280,"C7",795420,1438742700,"2015-08-04 19:45:00"
"5966","20154726014714-186",2,"2015-07-26 14:55:00",1437947700,"C4",95280,1438042980,"2015-07-27 17:23:00"
"1374","20152926022953-770",1,"2015-07-26 14:56:00",1437947760,"C3",143160,1438090920,"2015-07-28 06:42:00"
"5149","20154526024508-653",1,"2015-07-26 15:12:00",1437948720,"C8",58740,1438007460,"2015-07-27 07:31:00"
"4671","20150726030718-420",2,"2015-07-26 15:13:00",1437948780,"C8",761040,1438709820,"2015-08-04 10:37:00"
"1805","20152626022659-583",1,"2015-07-26 15:22:00",1437949320,"C8",183300,1438132620,"2015-07-28 18:17:00"
"1580","20151826021816-332",1,"2015-07-26 15:24:00",1437949440,"C2",79560,1438029000,"2015-07-27 13:30:00"
"3302","20154026024058-952",2,"2015-07-26 15:32:00",1437949920,"C4",177120,1438127040,"2015-07-28 16:44:00"
"316","20155526025520-19",1,"2015-07-26 15:33:00",1437949980,"C3",235020,1438185000,"2015-07-29 08:50:00"
"341","20151326031334-997",1,"2015-07-26 15:40:00",1437950400,"C8",95280,1438045680,"2015-07-27 18:08:00"
"5124","20154126024158-664",2,"2015-07-26 15:43:00",1437950580,"C3",150240,1438100820,"2015-07-28 09:27:00"
"538","20152126032100-410",3,"2015-07-26 15:50:00",1437951000,"C4",73080,1438024080,"2015-07-27 12:08:00"
"434","20152626032621-951",3,"2015-07-26 16:02:00",1437951720,"C3",411900,1438363620,"2015-07-31 10:27:00"
"909","20152726032711-587",1,"2015-07-26 16:20:00",1437952800,"C8",267360,1438220160,"2015-07-29 18:36:00"
"5573","20153226033231-156",3,"2015-07-26 16:23:00",1437952980,"C4",319680,1438272660,"2015-07-30 09:11:00"
"4903","20154326034342-937",2,"2015-07-26 16:42:00",1437954120,"C0",99960,1438054080,"2015-07-27 20:28:00"
"1244","20150126050104-378",1,"2015-07-26 17:08:00",1437955680,"C4",754080,1438709760,"2015-08-04 10:36:00"
"544","20153526043555-14",1,"2015-07-26 17:20:00",1437956400,"C8",491820,1438448220,"2015-08-01 09:57:00"
"2517","20151526051501-87",1,"2015-07-26 17:21:00",1437956460,"C4",75420,1438031880,"2015-07-27 14:18:00"
"6215","20152726042723-397",1,"2015-07-26 17:22:00",1437956520,"C8",86220,1438042740,"2015-07-27 17:19:00"
"1813","20152026042055-270",1,"2015-07-26 17:24:00",1437956640,"C3",309300,1438265940,"2015-07-30 07:19:00"
"5504","20150126050104-905",3,"2015-07-26 17:31:00",1437957060,"C5",692220,1438649280,"2015-08-03 17:48:00"
"3615","20154426054401-248",1,"2015-07-26 17:50:00",1437958200,"C8",857820,1438816020,"2015-08-05 16:07:00"
"110","20154226054249-628",1,"2015-07-26 18:08:00",1437959280,"C4",350580,1438309860,"2015-07-30 19:31:00"
"2102","20153026053002-255",3,"2015-07-26 18:22:00",1437960120,"C4",45300,1438005420,"2015-07-27 06:57:00"
"3242","20154626054643-936",2,"2015-07-26 18:37:00",1437961020,"C4",95700,1438056720,"2015-07-27 21:12:00"
"5832","20153526053516-741",2,"2015-07-26 18:40:00",1437961200,"C2",229560,1438190760,"2015-07-29 10:26:00"
"3743","20155826055856-580",1,"2015-07-26 19:05:00",1437962700,"C6",762660,1438725360,"2015-08-04 14:56:00"
"2740","20150427060448-246",3,"2015-07-27 06:21:00",1438003260,"C7",529800,1438533060,"2015-08-02 09:31:00"
"5987","20151127061136-939",2,"2015-07-27 06:40:00",1438004400,"C5",344400,1438348800,"2015-07-31 06:20:00"
"3902","20150827060823-4",1,"2015-07-27 06:46:00",1438004760,"C2",215280,1438220040,"2015-07-29 18:34:00"
"5157","20152027062003-395",2,"2015-07-27 06:57:00",1438005420,"C0",275880,1438281300,"2015-07-30 11:35:00"
"2712","20154527064556-11",3,"2015-07-27 07:09:00",1438006140,"C5",687840,1438693980,"2015-08-04 06:13:00"
"466","20150727060728-239",1,"2015-07-27 07:12:00",1438006320,"C4",464640,1438470960,"2015-08-01 16:16:00"
"2131","20150727070729-782",1,"2015-07-27 07:13:00",1438006380,"C2",374400,1438380780,"2015-07-31 15:13:00"
"910","20155427065441-961",1,"2015-07-27 07:31:00",1438007460,"C0",201720,1438209180,"2015-07-29 15:33:00"
"619","20152027072040-298",1,"2015-07-27 07:34:00",1438007640,"C7",227400,1438235040,"2015-07-29 22:44:00"
"4092","20155027085049-858",2,"2015-07-27 08:57:00",1438012620,"C8",90960,1438103580,"2015-07-28 10:13:00"
"6553","20151727081750-912",1,"2015-07-27 09:04:00",1438013040,"C8",174360,1438187400,"2015-07-29 09:30:00"
"4665","20153927083929-384",1,"2015-07-27 09:10:00",1438013400,"C4",119400,1438132800,"2015-07-28 18:20:00"
"4133","20155227085257-55",1,"2015-07-27 09:24:00",1438014240,"C2",202620,1438216860,"2015-07-29 17:41:00"
"6073","20154927084959-505",2,"2015-07-27 09:27:00",1438014420,"C0",912600,1438927020,"2015-08-06 22:57:00"
"3528","20151127091156-609",3,"2015-07-27 09:35:00",1438014900,"C8",83100,1438098000,"2015-07-28 08:40:00"
"4881","20153927083928-87",1,"2015-07-27 09:37:00",1438015020,"C4",550560,1438565580,"2015-08-02 18:33:00"
"1860","20154127084151-732",2,"2015-07-27 09:39:00",1438015140,"C3",117840,1438132980,"2015-07-28 18:23:00"
"4832","20154127094129-318",1,"2015-07-27 10:09:00",1438016940,"C4",422220,1438439160,"2015-08-01 07:26:00"
"5775","20150327100356-183",1,"2015-07-27 10:33:00",1438018380,"C5",329400,1438347780,"2015-07-31 06:03:00"
"2875","20155327105347-925",1,"2015-07-27 11:16:00",1438020960,"C8",70500,1438091460,"2015-07-28 06:51:00"
"1484","20152127102149-247",2,"2015-07-27 11:18:00",1438021080,"C5",466020,1438487100,"2015-08-01 20:45:00"
"1845","20150127110109-336",1,"2015-07-27 11:51:00",1438023060,"C8",284940,1438308000,"2015-07-30 19:00:00"
"3030","20151627111655-590",1,"2015-07-27 11:55:00",1438023300,"C7",553020,1438576320,"2015-08-02 21:32:00"
"2011","20154127114159-870",2,"2015-07-27 12:52:00",1438026720,"C3",416940,1438443660,"2015-08-01 08:41:00"
"5462","20155227125212-315",3,"2015-07-27 13:11:00",1438027860,"C7",507540,1438535400,"2015-08-02 10:10:00"
"354","20153327123320-68",1,"2015-07-27 13:29:00",1438028940,"C6",87540,1438116480,"2015-07-28 13:48:00"
"6147","20152027122000-634",2,"2015-07-27 13:34:00",1438029240,"C2",264060,1438293300,"2015-07-30 14:55:00"
"4981","20154127124144-803",3,"2015-07-27 13:43:00",1438029780,"C2",281400,1438311180,"2015-07-30 19:53:00"
"1138","20155827015856-404",3,"2015-07-27 14:25:00",1438032300,"C5",174420,1438206720,"2015-07-29 14:52:00"
"5811","20154027014057-847",1,"2015-07-27 14:25:00",1438032300,"C8",329880,1438362180,"2015-07-31 10:03:00"
"1092","20154627014626-335",2,"2015-07-27 14:46:00",1438033560,"C0",403800,1438437360,"2015-08-01 06:56:00"
"4972","20152727032734-400",2,"2015-07-27 15:35:00",1438036500,"C8",166920,1438203420,"2015-07-29 13:57:00"
"5452","20153827023814-492",1,"2015-07-27 15:37:00",1438036620,"C8",411780,1438448400,"2015-08-01 10:00:00"
"3373","20154427024429-109",1,"2015-07-27 15:38:00",1438036680,"C4",247680,1438284360,"2015-07-30 12:26:00"
"2781","20152027032011-806",2,"2015-07-27 15:50:00",1438037400,"C2",441600,1438479000,"2015-08-01 18:30:00"
"250","20153227033233-52",1,"2015-07-27 16:04:00",1438038240,"C4",69120,1438107360,"2015-07-28 11:16:00"
"1588","20152227032235-207",1,"2015-07-27 16:27:00",1438039620,"C0",66060,1438105680,"2015-07-28 10:48:00"
"6358","20151227041255-244",3,"2015-07-27 16:30:00",1438039800,"C0",506760,1438546560,"2015-08-02 13:16:00"
"3510","20153827043838-171",1,"2015-07-27 17:09:00",1438042140,"C0",405540,1438447680,"2015-08-01 09:48:00"
"799","20150527050515-636",2,"2015-07-27 17:32:00",1438043520,"C8",319440,1438362960,"2015-07-31 10:16:00"
"3052","20155027045016-281",2,"2015-07-27 17:48:00",1438044480,"C5",240240,1438284720,"2015-07-30 12:32:00"
"2488","20154227054208-498",1,"2015-07-27 18:26:00",1438046760,"C8",998700,1439045460,"2015-08-08 07:51:00"
"4074","20154527054509-903",1,"2015-07-27 18:41:00",1438047660,"C3",341940,1438389600,"2015-07-31 17:40:00"
"3815","20155627055642-893",2,"2015-07-27 18:53:00",1438048380,"C5",49440,1438097820,"2015-07-28 08:37:00"
"3900","20150328060314-923",1,"2015-07-28 06:34:00",1438090440,"C6",610920,1438701360,"2015-08-04 08:16:00"
"1084","20152028062056-368",3,"2015-07-28 06:57:00",1438091820,"C0",346020,1438437840,"2015-08-01 07:04:00"
"4284","20151028061026-297",3,"2015-07-28 07:07:00",1438092420,"C6",1227780,1439320200,"2015-08-11 12:10:00"
"4840","20151528061539-192",1,"2015-07-28 07:10:00",1438092600,"C8",362880,1438455480,"2015-08-01 11:58:00"
"2750","20153328073330-51",1,"2015-07-28 07:41:00",1438094460,"C4",115800,1438210260,"2015-07-29 15:51:00"
"929","20151128071144-68",3,"2015-07-28 07:48:00",1438094880,"C2",264180,1438359060,"2015-07-31 09:11:00"
"4825","20154228074250-471",3,"2015-07-28 07:49:00",1438094940,"C4",600300,1438695240,"2015-08-04 06:34:00"
"3390","20154728064727-282",3,"2015-07-28 07:51:00",1438095060,"C5",367740,1438462800,"2015-08-01 14:00:00"
"4738","20152128072158-862",1,"2015-07-28 07:59:00",1438095540,"C2",172980,1438268520,"2015-07-30 08:02:00"
"792","20153828073820-71",1,"2015-07-28 08:04:00",1438095840,"C8",387120,1438482960,"2015-08-01 19:36:00"
"3855","20152028072036-773",3,"2015-07-28 08:16:00",1438096560,"C5",112560,1438209120,"2015-07-29 15:32:00"
"2034","20150328070321-554",1,"2015-07-28 08:21:00",1438096860,"C0",288480,1438385340,"2015-07-31 16:29:00"
"471","20150528080517-604",1,"2015-07-28 08:23:00",1438096980,"C6",95160,1438192140,"2015-07-29 10:49:00"
"1901","20153628063656-228",3,"2015-07-28 08:29:00",1438097340,"C4",864600,1438961940,"2015-08-07 08:39:00"
"6294","20154028074004-866",1,"2015-07-28 08:33:00",1438097580,"C5",129720,1438227300,"2015-07-29 20:35:00"
"6111","20151028081039-84",1,"2015-07-28 08:34:00",1438097640,"C5",621900,1438719540,"2015-08-04 13:19:00"
"5193","20152628082657-500",3,"2015-07-28 08:52:00",1438098720,"C5",202920,1438301640,"2015-07-30 17:14:00"
"932","20154028084056-791",2,"2015-07-28 09:07:00",1438099620,"C5",610860,1438710480,"2015-08-04 10:48:00"
"3885","20150828090834-36",2,"2015-07-28 09:35:00",1438101300,"C5",182160,1438283460,"2015-07-30 12:11:00"
"187","20151328091352-263",1,"2015-07-28 09:40:00",1438101600,"C5",99180,1438200780,"2015-07-29 13:13:00"
"6126","20153628093659-387",1,"2015-07-28 09:59:00",1438102740,"C5",201720,1438304460,"2015-07-30 18:01:00"
"1272","20153028093055-321",3,"2015-07-28 10:03:00",1438102980,"C4",377940,1438480920,"2015-08-01 19:02:00"
"4623","20150828090847-178",1,"2015-07-28 10:03:00",1438102980,"C8",113580,1438216560,"2015-07-29 17:36:00"
"5569","20154428094403-173",1,"2015-07-28 10:04:00",1438103040,"C7",126420,1438229460,"2015-07-29 21:11:00"
"3814","20154728094759-13",2,"2015-07-28 10:15:00",1438103700,"C5",368160,1438471860,"2015-08-01 16:31:00"
"5396","20152728102719-723",3,"2015-07-28 10:33:00",1438104780,"C2",546660,1438651440,"2015-08-03 18:24:00"
"3791","20152928092934-717",3,"2015-07-28 10:41:00",1438105260,"C2",174000,1438279260,"2015-07-30 11:01:00"
"1761","20155028105016-754",3,"2015-07-28 11:20:00",1438107600,"C2",191940,1438299540,"2015-07-30 16:39:00"
"1130","20154428104404-828",1,"2015-07-28 11:28:00",1438108080,"C8",281400,1438389480,"2015-07-31 17:38:00"
"4370","20151428111428-181",3,"2015-07-28 11:43:00",1438108980,"C8",210120,1438319100,"2015-07-30 22:05:00"
"6198","20151728111711-22",1,"2015-07-28 11:48:00",1438109280,"C5",257940,1438367220,"2015-07-31 11:27:00"
"6410","20151028111000-621",2,"2015-07-28 12:00:00",1438110000,"C6",264960,1438374960,"2015-07-31 13:36:00"
"1123","20152928122936-347",2,"2015-07-28 13:02:00",1438113720,"C5",168120,1438281840,"2015-07-30 11:44:00"
"194","20154428124429-300",2,"2015-07-28 13:17:00",1438114620,"C7",61080,1438175700,"2015-07-29 06:15:00"
"4188","20152528012542-188",1,"2015-07-28 13:32:00",1438115520,"C4",101940,1438217460,"2015-07-29 17:51:00"
"6213","20155328125314-729",1,"2015-07-28 13:47:00",1438116420,"C5",84600,1438201020,"2015-07-29 13:17:00"
"3977","20155028125010-618",1,"2015-07-28 13:49:00",1438116540,"C5",272520,1438389060,"2015-07-31 17:31:00"
"4061","20150228010235-447",2,"2015-07-28 14:04:00",1438117440,"C3",154500,1438271940,"2015-07-30 08:59:00"
"2463","20150228020203-565",3,"2015-07-28 14:10:00",1438117800,"C4",509160,1438626960,"2015-08-03 11:36:00"
"2622","20152028022013-691",1,"2015-07-28 14:39:00",1438119540,"C6",68100,1438187640,"2015-07-29 09:34:00"
"1326","20153228033232-771",1,"2015-07-28 15:37:00",1438123020,"C2",93600,1438216620,"2015-07-29 17:37:00"
"3471","20151428031458-998",1,"2015-07-28 15:37:00",1438123020,"C8",97500,1438220520,"2015-07-29 18:42:00"
"859","20151528041551-821",1,"2015-07-28 16:48:00",1438127280,"C7",521520,1438648800,"2015-08-03 17:40:00"
"5185","20154828034832-528",2,"2015-07-28 16:57:00",1438127820,"C2",513840,1438641660,"2015-08-03 15:41:00"
"2431","20150228040218-159",1,"2015-07-28 17:00:00",1438128000,"C5",181080,1438309080,"2015-07-30 19:18:00"
"6297","20152328052341-673",3,"2015-07-28 17:29:00",1438129740,"C2",597120,1438726860,"2015-08-04 15:21:00"
"5908","20153228043201-577",2,"2015-07-28 17:35:00",1438130100,"C2",353520,1438483620,"2015-08-01 19:47:00"
"625","20151828051857-513",3,"2015-07-28 17:54:00",1438131240,"C2",273840,1438405080,"2015-07-31 21:58:00"
"4686","20153928053942-429",3,"2015-07-28 17:56:00",1438131360,"C0",408780,1438540140,"2015-08-02 11:29:00"
"2964","20154328044302-517",2,"2015-07-28 17:58:00",1438131480,"C7",848460,1438979940,"2015-08-07 13:39:00"
"2926","20151128051129-591",1,"2015-07-28 18:08:00",1438132080,"C8",78780,1438210860,"2015-07-29 16:01:00"
"4052","20153928053902-838",1,"2015-07-28 18:39:00",1438133940,"C5",770460,1438904400,"2015-08-06 16:40:00"
"293","20155628055649-858",1,"2015-07-28 19:11:00",1438135860,"C0",51960,1438187820,"2015-07-29 09:37:00"
"5169","20154728034746-685",2,"2015-07-28 20:24:00",1438140240,"C4",59520,1438199760,"2015-07-29 12:56:00"
"5294","20154029064002-238",1,"2015-07-29 06:46:00",1438177560,"C4",274860,1438452420,"2015-08-01 11:07:00"
"5698","20153029063040-935",2,"2015-07-29 07:21:00",1438179660,"C5",217020,1438396680,"2015-07-31 19:38:00"
"3650","20155929065908-355",1,"2015-07-29 07:32:00",1438180320,"C7",121800,1438302120,"2015-07-30 17:22:00"
"791","20151029071056-312",1,"2015-07-29 07:35:00",1438180500,"C8",91680,1438272180,"2015-07-30 09:03:00"
"4577","20151729071748-127",1,"2015-07-29 07:51:00",1438181460,"C8",731880,1438913340,"2015-08-06 19:09:00"
"1418","20150129070156-888",1,"2015-07-29 07:59:00",1438181940,"C4",355440,1438537380,"2015-08-02 10:43:00"
"4288","20150429080442-199",2,"2015-07-29 08:07:00",1438182420,"C6",741780,1438924200,"2015-08-06 22:10:00"
"670","20150029080012-457",2,"2015-07-29 08:22:00",1438183320,"C5",93720,1438277040,"2015-07-30 10:24:00"
"5434","20154729074714-800",2,"2015-07-29 08:37:00",1438184220,"C8",351840,1438536060,"2015-08-02 10:21:00"
"3423","20153329073300-377",1,"2015-07-29 08:44:00",1438184640,"C6",255720,1438440360,"2015-08-01 07:46:00"
"3306","20150329080354-90",3,"2015-07-29 09:02:00",1438185720,"C4",182040,1438367760,"2015-07-31 11:36:00"
"4868","20155529075511-496",1,"2015-07-29 09:11:00",1438186260,"C0",216900,1438403160,"2015-07-31 21:26:00"
"2023","20150929080924-256",2,"2015-07-29 09:17:00",1438186620,"C5",110460,1438297080,"2015-07-30 15:58:00"
"4202","20155829085817-23",1,"2015-07-29 09:18:00",1438186680,"C8",726000,1438912680,"2015-08-06 18:58:00"
"4961","20150929090919-621",1,"2015-07-29 09:32:00",1438187520,"C8",542220,1438729740,"2015-08-04 16:09:00"
"4008","20155129085126-994",2,"2015-07-29 09:39:00",1438187940,"C7",118260,1438306200,"2015-07-30 18:30:00"
"2994","20152529092534-521",3,"2015-07-29 09:47:00",1438188420,"C8",131880,1438320300,"2015-07-30 22:25:00"
"1104","20155229095223-993",1,"2015-07-29 09:54:00",1438188840,"C6",196680,1438385520,"2015-07-31 16:32:00"
"4855","20150629090627-62",2,"2015-07-29 10:15:00",1438190100,"C0",129300,1438319400,"2015-07-30 22:10:00"
"4301","20151729091748-733",1,"2015-07-29 10:16:00",1438190160,"C6",649680,1438839840,"2015-08-05 22:44:00"
"5181","20155529095550-67",1,"2015-07-29 10:16:00",1438190160,"C8",594480,1438784640,"2015-08-05 07:24:00"
"6255","20155729095756-876",3,"2015-07-29 10:21:00",1438190460,"C5",127620,1438318080,"2015-07-30 21:48:00"
"4599","20153629093621-951",1,"2015-07-29 10:33:00",1438191180,"C4",166440,1438357620,"2015-07-31 08:47:00"
"4215","20153729093742-70",1,"2015-07-29 10:37:00",1438191420,"C4",196560,1438387980,"2015-07-31 17:13:00"
"1535","20150829100839-801",1,"2015-07-29 10:38:00",1438191480,"C2",180840,1438372320,"2015-07-31 12:52:00"
"5136","20155229095213-604",1,"2015-07-29 10:48:00",1438192080,"C5",91860,1438283940,"2015-07-30 12:19:00"
"3439","20152829102829-430",2,"2015-07-29 10:53:00",1438192380,"C5",260280,1438452660,"2015-08-01 11:11:00"
"5685","20151129101109-424",3,"2015-07-29 11:02:00",1438192920,"C6",291240,1438484160,"2015-08-01 19:56:00"
"468","20151329101325-617",2,"2015-07-29 11:17:00",1438193820,"C5",293100,1438486920,"2015-08-01 20:42:00"
"2506","20151929111952-130",2,"2015-07-29 11:42:00",1438195320,"C4",288660,1438483980,"2015-08-01 19:53:00"
"2726","20154229104255-661",3,"2015-07-29 11:44:00",1438195440,"C0",262680,1438458120,"2015-08-01 12:42:00"
"3710","20151929111950-606",1,"2015-07-29 12:01:00",1438196460,"C2",367860,1438564320,"2015-08-02 18:12:00"
"1668","20150829110854-562",2,"2015-07-29 12:05:00",1438196700,"C4",85320,1438282020,"2015-07-30 11:47:00"
"2565","20151329111340-193",2,"2015-07-29 12:07:00",1438196820,"C5",210300,1438407120,"2015-07-31 22:32:00"
"4806","20151429111451-30",3,"2015-07-29 12:19:00",1438197540,"C5",170760,1438368300,"2015-07-31 11:45:00"
"1075","20155829125801-230",2,"2015-07-29 13:27:00",1438201620,"C0",786540,1438988160,"2015-08-07 15:56:00"
"393","20153829123844-783",3,"2015-07-29 13:46:00",1438202760,"C8",601560,1438804320,"2015-08-05 12:52:00"
"1528","20154429124439-546",3,"2015-07-29 13:51:00",1438203060,"C0",117900,1438320960,"2015-07-30 22:36:00"
"23","20151829011833-716",1,"2015-07-29 13:54:00",1438203240,"C1",949200,1439152440,"2015-08-09 13:34:00"
"5483","20150429010400-59",1,"2015-07-29 14:08:00",1438204080,"C8",201540,1438405620,"2015-07-31 22:07:00"
"3111","20153129013121-858",2,"2015-07-29 14:23:00",1438204980,"C5",323880,1438528860,"2015-08-02 08:21:00"
"2284","20150329030344-472",2,"2015-07-29 15:42:00",1438209720,"C0",250980,1438460700,"2015-08-01 13:25:00"
"584","20153029033042-152",1,"2015-07-29 15:46:00",1438209960,"C7",169320,1438379280,"2015-07-31 14:48:00"
"3070","20152329032334-147",3,"2015-07-29 15:51:00",1438210260,"C5",1111020,1439321280,"2015-08-11 12:28:00"
"5176","20151029031046-528",2,"2015-07-29 15:52:00",1438210320,"C0",179340,1438389660,"2015-07-31 17:41:00"
"1741","20154629034645-799",1,"2015-07-29 16:04:00",1438211040,"C7",508440,1438719480,"2015-08-04 13:18:00"
"2594","20154129034133-355",1,"2015-07-29 16:09:00",1438211340,"C5",90240,1438301580,"2015-07-30 17:13:00"
"5161","20151529031505-215",2,"2015-07-29 16:10:00",1438211400,"C3",60240,1438271640,"2015-07-30 08:54:00"
"4005","20153129033116-421",1,"2015-07-29 16:28:00",1438212480,"C4",320820,1438533300,"2015-08-02 09:35:00"
"2037","20155029035009-826",1,"2015-07-29 16:51:00",1438213860,"C8",361680,1438575540,"2015-08-02 21:19:00"
"3072","20155029045031-175",2,"2015-07-29 17:01:00",1438214460,"C3",134220,1438348680,"2015-07-31 06:18:00"
"6560","20153229043251-293",1,"2015-07-29 17:08:00",1438214880,"C2",517020,1438731900,"2015-08-04 16:45:00"
"1472","20155129045107-400",2,"2015-07-29 17:28:00",1438216080,"C3",90120,1438306200,"2015-07-30 18:30:00"
"6219","20151329051347-815",3,"2015-07-29 17:37:00",1438216620,"C8",96300,1438312920,"2015-07-30 20:22:00"
"2680","20155529045530-793",2,"2015-07-29 18:05:00",1438218300,"C2",129660,1438347960,"2015-07-31 06:06:00"
"33","20154729054707-256",2,"2015-07-29 18:11:00",1438218660,"C4",252660,1438471320,"2015-08-01 16:22:00"
"5244","20155129055147-431",1,"2015-07-29 18:15:00",1438218900,"C8",309720,1438528620,"2015-08-02 08:17:00"
"3473","20153329053307-752",2,"2015-07-29 18:30:00",1438219800,"C5",52320,1438272120,"2015-07-30 09:02:00"
"6102","20153829053832-818",2,"2015-07-29 18:30:00",1438219800,"C4",581160,1438800960,"2015-08-05 11:56:00"
"2349","20152830062810-554",1,"2015-07-30 07:08:00",1438265280,"C2",294360,1438559640,"2015-08-02 16:54:00"
"5318","20151730061703-165",2,"2015-07-30 07:11:00",1438265460,"C5",92160,1438357620,"2015-07-31 08:47:00"
"1928","20155830065855-504",3,"2015-07-30 07:52:00",1438267920,"C6",171180,1438439100,"2015-08-01 07:25:00"
"311","20155030075000-793",2,"2015-07-30 08:22:00",1438269720,"C5",522840,1438792560,"2015-08-05 09:36:00"
"5959","20152130072111-229",2,"2015-07-30 08:24:00",1438269840,"C0",301320,1438571160,"2015-08-02 20:06:00"
"5289","20152830082817-542",1,"2015-07-30 08:30:00",1438270200,"C6",181920,1438452120,"2015-08-01 11:02:00"
"5949","20151630081603-922",1,"2015-07-30 08:43:00",1438270980,"C4",969000,1439239980,"2015-08-10 13:53:00"
"139","20152830082847-300",2,"2015-07-30 08:49:00",1438271340,"C8",223500,1438494840,"2015-08-01 22:54:00"
"6227","20152530082532-866",3,"2015-07-30 08:55:00",1438271700,"C4",457140,1438728840,"2015-08-04 15:54:00"
"4332","20155730085755-371",1,"2015-07-30 09:12:00",1438272720,"C7",200820,1438473540,"2015-08-01 16:59:00"
"2418","20153430083434-174",1,"2015-07-30 09:41:00",1438274460,"C0",360480,1438634940,"2015-08-03 13:49:00"
"4758","20150430090433-512",2,"2015-07-30 10:05:00",1438275900,"C2",707760,1438983660,"2015-08-07 14:41:00"
"248","20150030100046-714",2,"2015-07-30 10:22:00",1438276920,"C7",347220,1438624140,"2015-08-03 10:49:00"
"2108","20155330095316-775",3,"2015-07-30 10:34:00",1438277640,"C0",264600,1438542240,"2015-08-02 12:04:00"
"3793","20154030094014-979",1,"2015-07-30 10:53:00",1438278780,"C2",160380,1438439160,"2015-08-01 07:26:00"
"1622","20155330095334-363",2,"2015-07-30 10:59:00",1438279140,"C4",96720,1438375860,"2015-07-31 13:51:00"
"3574","20150530110520-639",3,"2015-07-30 11:10:00",1438279800,"C2",113760,1438393560,"2015-07-31 18:46:00"
"2852","20152630102651-351",3,"2015-07-30 11:13:00",1438279980,"C8",367560,1438647540,"2015-08-03 17:19:00"
"5916","20154530104517-465",1,"2015-07-30 11:22:00",1438280520,"C0",79140,1438359660,"2015-07-31 09:21:00"
"5763","20150430110428-833",2,"2015-07-30 11:53:00",1438282380,"C7",190740,1438473120,"2015-08-01 16:52:00"
"3298","20152330112343-14",1,"2015-07-30 11:57:00",1438282620,"C8",88260,1438370880,"2015-07-31 12:28:00"
"3106","20152330112320-637",1,"2015-07-30 11:58:00",1438282680,"C2",69240,1438351920,"2015-07-31 07:12:00"
"4468","20152030112000-524",1,"2015-07-30 12:03:00",1438282980,"C2",162060,1438445040,"2015-08-01 09:04:00"
"1319","20155630105651-729",2,"2015-07-30 12:09:00",1438283340,"C2",79680,1438363020,"2015-07-31 10:17:00"
"1312","20152030112009-638",2,"2015-07-30 12:16:00",1438283760,"C8",238920,1438522680,"2015-08-02 06:38:00"
"588","20152330112343-461",1,"2015-07-30 12:30:00",1438284600,"C2",179220,1438463820,"2015-08-01 14:17:00"
"4753","20155430115403-341",1,"2015-07-30 12:33:00",1438284780,"C0",93120,1438377900,"2015-07-31 14:25:00"
"2782","20154130124118-316",1,"2015-07-30 13:00:00",1438286400,"C7",114600,1438401000,"2015-07-31 20:50:00"
"2876","20150130120133-197",2,"2015-07-30 13:00:00",1438286400,"C4",348360,1438634760,"2015-08-03 13:46:00"
"121","20155330125308-863",3,"2015-07-30 13:24:00",1438287840,"C2",255780,1438543620,"2015-08-02 12:27:00"
"2907","20151730011708-691",3,"2015-07-30 13:38:00",1438288680,"C5",234660,1438523340,"2015-08-02 06:49:00"
"1391","20153730013710-947",1,"2015-07-30 13:49:00",1438289340,"C3",152700,1438442040,"2015-08-01 08:14:00"
"1250","20154630124653-489",1,"2015-07-30 13:50:00",1438289400,"C4",253020,1438542420,"2015-08-02 12:07:00"
"3869","20155230015235-98",1,"2015-07-30 14:26:00",1438291560,"C2",528060,1438819620,"2015-08-05 17:07:00"
"5881","20150530020556-90",1,"2015-07-30 14:30:00",1438291800,"C5",269580,1438561380,"2015-08-02 17:23:00"
"5293","20152430012458-590",1,"2015-07-30 14:33:00",1438291980,"C2",364260,1438656240,"2015-08-03 19:44:00"
"367","20154330014342-384",2,"2015-07-30 14:38:00",1438292280,"C8",359580,1438651860,"2015-08-03 18:31:00"
"1198","20154530024516-715",3,"2015-07-30 14:51:00",1438293060,"C2",1152360,1439445420,"2015-08-12 22:57:00"
"1825","20151230021228-117",1,"2015-07-30 14:51:00",1438293060,"C2",259440,1438552500,"2015-08-02 14:55:00"
"164","20152830022802-299",1,"2015-07-30 14:58:00",1438293480,"C2",103320,1438396800,"2015-07-31 19:40:00"
"1368","20155230025233-218",1,"2015-07-30 15:11:00",1438294260,"C6",58980,1438353240,"2015-07-31 07:34:00"
"5280","20154830024817-212",3,"2015-07-30 15:17:00",1438294620,"C5",520800,1438815420,"2015-08-05 15:57:00"
"6356","20152830032844-398",2,"2015-07-30 15:35:00",1438295700,"C8",101280,1438396980,"2015-07-31 19:43:00"
"2467","20150730030734-264",1,"2015-07-30 15:41:00",1438296060,"C2",195720,1438491780,"2015-08-01 22:03:00"
"5011","20152430032437-581",2,"2015-07-30 15:47:00",1438296420,"C5",170040,1438466460,"2015-08-01 15:01:00"
"5367","20152030032051-557",2,"2015-07-30 15:51:00",1438296660,"C4",262920,1438559580,"2015-08-02 16:53:00"
"3868","20155530035556-433",2,"2015-07-30 16:02:00",1438297320,"C8",349800,1438647120,"2015-08-03 17:12:00"
"2803","20150130030134-783",1,"2015-07-30 16:11:00",1438297860,"C7",104220,1438402080,"2015-07-31 21:08:00"
"1780","20154530034541-167",1,"2015-07-30 16:12:00",1438297920,"C5",190320,1438488240,"2015-08-01 21:04:00"
"1634","20155130035117-109",3,"2015-07-30 16:16:00",1438298160,"C5",143520,1438441680,"2015-08-01 08:08:00"
"2172","20154430034428-915",1,"2015-07-30 16:45:00",1438299900,"C2",2040180,1440340080,"2015-08-23 07:28:00"
"1992","20154830034853-516",3,"2015-07-30 17:01:00",1438300860,"C2",831780,1439132640,"2015-08-09 08:04:00"
"2114","20151330041314-275",2,"2015-07-30 17:08:00",1438301280,"C3",136020,1438437300,"2015-08-01 06:55:00"
"3960","20153930043916-979",1,"2015-07-30 17:17:00",1438301820,"C3",704940,1439006760,"2015-08-07 21:06:00"
"1303","20151630041632-789",1,"2015-07-30 17:18:00",1438301880,"C2",241560,1438543440,"2015-08-02 12:24:00"
"3911","20154930044907-211",1,"2015-07-30 17:46:00",1438303560,"C4",69660,1438373220,"2015-07-31 13:07:00"
"1120","20150330050315-215",1,"2015-07-30 17:55:00",1438304100,"C5",232800,1438536900,"2015-08-02 10:35:00"
"3501","20150030050037-993",1,"2015-07-30 18:01:00",1438304460,"C4",49500,1438353960,"2015-07-31 07:46:00"
"5853","20153530053501-879",2,"2015-07-30 18:08:00",1438304880,"C8",150660,1438455540,"2015-08-01 11:59:00"
"2651","20154530054541-361",2,"2015-07-30 18:11:00",1438305060,"C5",84780,1438389840,"2015-07-31 17:44:00"
"498","20154430054442-410",2,"2015-07-30 18:37:00",1438306620,"C8",157380,1438464000,"2015-08-01 14:20:00"
"482","20150231060233-191",1,"2015-07-31 06:29:00",1438349340,"C5",127860,1438477200,"2015-08-01 18:00:00"
"4745","20150031060051-429",1,"2015-07-31 06:32:00",1438349520,"C5",364320,1438713840,"2015-08-04 11:44:00"
"197","20152931062933-133",2,"2015-07-31 07:00:00",1438351200,"C3",133380,1438484580,"2015-08-01 20:03:00"
"2373","20154131064108-797",1,"2015-07-31 07:20:00",1438352400,"C2",259740,1438612140,"2015-08-03 07:29:00"
"3182","20152531072521-938",3,"2015-07-31 07:54:00",1438354440,"C4",269520,1438623960,"2015-08-03 10:46:00"
"3275","20153431073442-374",1,"2015-07-31 07:55:00",1438354500,"C8",175740,1438530240,"2015-08-02 08:44:00"
"202","20155531065512-853",2,"2015-07-31 08:02:00",1438354920,"C3",365220,1438720140,"2015-08-04 13:29:00"
"319","20151031071048-450",1,"2015-07-31 08:02:00",1438354920,"C5",174240,1438529160,"2015-08-02 08:26:00"
"6084","20152731082747-677",1,"2015-07-31 08:34:00",1438356840,"C2",79740,1438436580,"2015-08-01 06:43:00"
"3862","20151231081203-407",2,"2015-07-31 08:42:00",1438357320,"C4",131880,1438489200,"2015-08-01 21:20:00"
"1233","20152031082031-756",1,"2015-07-31 08:44:00",1438357440,"C4",891360,1439248800,"2015-08-10 16:20:00"
"3760","20152131082145-700",2,"2015-07-31 08:54:00",1438358040,"C6",87240,1438445280,"2015-08-01 09:08:00"
"3997","20153731083734-496",1,"2015-07-31 09:11:00",1438359060,"C5",375180,1438734240,"2015-08-04 17:24:00"
"4271","20152831082802-61",1,"2015-07-31 09:21:00",1438359660,"C6",128280,1438487940,"2015-08-01 20:59:00"
"117","20152631082611-613",2,"2015-07-31 09:24:00",1438359840,"C7",803700,1439163540,"2015-08-09 16:39:00"
"2873","20154231084240-825",2,"2015-07-31 09:41:00",1438360860,"C7",177060,1438537920,"2015-08-02 10:52:00"
"1226","20152231092234-568",1,"2015-07-31 10:13:00",1438362780,"C5",876420,1439239200,"2015-08-10 13:40:00"
"1949","20154831094847-710",1,"2015-07-31 10:15:00",1438362900,"C8",111120,1438474020,"2015-08-01 17:07:00"
"3995","20152831092837-751",1,"2015-07-31 10:18:00",1438363080,"C8",204660,1438567740,"2015-08-02 19:09:00"
"4169","20152031092038-925",1,"2015-07-31 10:19:00",1438363140,"C7",470160,1438833300,"2015-08-05 20:55:00"
"3955","20151431101444-411",1,"2015-07-31 10:36:00",1438364160,"C5",188520,1438552680,"2015-08-02 14:58:00"
"6204","20151031101009-945",1,"2015-07-31 10:43:00",1438364580,"C4",89880,1438454460,"2015-08-01 11:41:00"
"448","20153731093738-268",2,"2015-07-31 10:46:00",1438364760,"C8",196440,1438561200,"2015-08-02 17:20:00"
"5325","20152031102058-485",1,"2015-07-31 10:52:00",1438365120,"C4",89820,1438454940,"2015-08-01 11:49:00"
"2242","20152331102327-0",1,"2015-07-31 11:23:00",1438366980,"C7",159240,1438526220,"2015-08-02 07:37:00"
"5831","20155631105647-912",2,"2015-07-31 11:32:00",1438367520,"C6",430740,1438798260,"2015-08-05 11:11:00"
"6498","20153431103412-743",1,"2015-07-31 11:35:00",1438367700,"C4",76080,1438443780,"2015-08-01 08:43:00"
"5684","20154431104451-420",2,"2015-07-31 11:36:00",1438367760,"C8",193920,1438561680,"2015-08-02 17:28:00"
"1590","20153531103551-510",1,"2015-07-31 11:46:00",1438368360,"C2",105660,1438474020,"2015-08-01 17:07:00"
"1465","20152631112623-34",3,"2015-07-31 12:11:00",1438369860,"C8",287160,1438657020,"2015-08-03 19:57:00"
"676","20155631115626-437",3,"2015-07-31 12:18:00",1438370280,"C5",252900,1438623180,"2015-08-03 10:33:00"
"495","20150231120236-701",1,"2015-07-31 12:36:00",1438371360,"C7",246600,1438617960,"2015-08-03 09:06:00"
"2764","20151231121203-449",2,"2015-07-31 12:37:00",1438371420,"C5",64920,1438436340,"2015-08-01 06:39:00"
"2199","20155531115507-502",2,"2015-07-31 12:43:00",1438371780,"C8",169620,1438541400,"2015-08-02 11:50:00"
"2455","20153931123943-847",3,"2015-07-31 13:03:00",1438372980,"C5",100140,1438473120,"2015-08-01 16:52:00"
"216","20154431124424-721",1,"2015-07-31 13:08:00",1438373280,"C7",197520,1438570800,"2015-08-02 20:00:00"
"1098","20150231010230-879",1,"2015-07-31 13:08:00",1438373280,"C8",69840,1438443120,"2015-08-01 08:32:00"
"4377","20154431124423-688",2,"2015-07-31 13:11:00",1438373460,"C4",81000,1438454460,"2015-08-01 11:41:00"
"5631","20150831010810-141",1,"2015-07-31 13:14:00",1438373640,"C2",289620,1438663260,"2015-08-03 21:41:00"
"1259","20155631125645-432",1,"2015-07-31 13:23:00",1438374180,"C4",85440,1438459620,"2015-08-01 13:07:00"
"2842","20155431125443-408",1,"2015-07-31 13:28:00",1438374480,"C0",199200,1438573680,"2015-08-02 20:48:00"
"3022","20153931123938-639",2,"2015-07-31 13:50:00",1438375800,"C6",258660,1438634460,"2015-08-03 13:41:00"
"5431","20154731124720-805",1,"2015-07-31 13:50:00",1438375800,"C5",111600,1438487400,"2015-08-01 20:50:00"
"1416","20150231010233-845",1,"2015-07-31 13:53:00",1438375980,"C7",940080,1439316060,"2015-08-11 11:01:00"
"5734","20155705025759-63",1,"2015-07-31 13:55:00",1438376100,"C3",2090460,1440466560,"2015-08-24 18:36:00"
"953","20155431125412-835",3,"2015-07-31 14:01:00",1438376460,"C0",789420,1439165880,"2015-08-09 17:18:00"
"1669","20155731015742-412",1,"2015-07-31 14:31:00",1438378260,"C5",253860,1438632120,"2015-08-03 13:02:00"
"233","20151731021708-898",2,"2015-07-31 14:32:00",1438378320,"C0",167700,1438546020,"2015-08-02 13:07:00"
"748","20151031021043-605",2,"2015-07-31 14:38:00",1438378680,"C5",252000,1438630680,"2015-08-03 12:38:00"
"3719","20151531021539-858",2,"2015-07-31 14:44:00",1438379040,"C8",279120,1438658160,"2015-08-03 20:16:00"
"3327","20154231024256-741",2,"2015-07-31 14:49:00",1438379340,"C8",1539600,1439918940,"2015-08-18 10:29:00"
"2247","20154931014916-410",2,"2015-07-31 14:51:00",1438379460,"C0",115440,1438494900,"2015-08-01 22:55:00"
"2157","20154931024946-567",1,"2015-07-31 15:05:00",1438380300,"C7",417480,1438797780,"2015-08-05 11:03:00"
"3351","20150031030030-236",1,"2015-07-31 15:07:00",1438380420,"C2",92100,1438472520,"2015-08-01 16:42:00"
"2186","20150431030458-145",3,"2015-07-31 15:11:00",1438380660,"C4",284700,1438665360,"2015-08-03 22:16:00"
"5057","20151431021452-330",1,"2015-07-31 15:18:00",1438381080,"C5",75120,1438456200,"2015-08-01 12:10:00"
"148","20151231031233-897",2,"2015-07-31 15:24:00",1438381440,"C3",159000,1438540440,"2015-08-02 11:34:00"
"1248","20152431022403-301",2,"2015-07-31 15:33:00",1438381980,"C0",52380,1438434360,"2015-08-01 06:06:00"
"4999","20150831030801-105",2,"2015-07-31 15:38:00",1438382280,"C4",360900,1438743180,"2015-08-04 19:53:00"
"4608","20154519024544-322",2,"2015-07-31 15:40:00",1438382400,"C4",202980,1438585380,"2015-08-03 00:03:00"
"5135","20151631031602-96",2,"2015-07-31 15:56:00",1438383360,"C7",182220,1438565580,"2015-08-02 18:33:00"
"2879","20154931034945-124",3,"2015-07-31 16:03:00",1438383780,"C7",63060,1438446840,"2015-08-01 09:34:00"
"688","20155431025449-131",3,"2015-07-31 16:06:00",1438383960,"C2",97020,1438480980,"2015-08-01 19:03:00"
"487","20150531030537-639",1,"2015-07-31 16:08:00",1438384080,"C5",367020,1438751100,"2015-08-04 22:05:00"
"3235","20152331032358-34",3,"2015-07-31 16:17:00",1438384620,"C6",98640,1438483260,"2015-08-01 19:41:00"
"2804","20153731033739-510",2,"2015-07-31 16:43:00",1438386180,"C4",184380,1438570560,"2015-08-02 19:56:00"
"4974","20152731042731-228",3,"2015-07-31 16:48:00",1438386480,"C5",834120,1439220600,"2015-08-10 08:30:00"
"3493","20152031042004-676",2,"2015-07-31 17:13:00",1438387980,"C4",336540,1438724520,"2015-08-04 14:42:00"
"6320","20151431041410-501",3,"2015-07-31 17:19:00",1438388340,"C4",165000,1438553340,"2015-08-02 15:09:00"
"526","20155431045446-47",1,"2015-07-31 17:20:00",1438388400,"C3",144780,1438533180,"2015-08-02 09:33:00"
"778","20151731051740-917",3,"2015-07-31 17:23:00",1438388580,"C2",424260,1438812840,"2015-08-05 15:14:00"
"5892","20152131042143-820",2,"2015-07-31 17:30:00",1438389000,"C8",159420,1438548420,"2015-08-02 13:47:00"
"2433","20153631043604-397",2,"2015-07-31 17:34:00",1438389240,"C5",270960,1438660200,"2015-08-03 20:50:00"
"193","20154731044702-403",1,"2015-07-31 17:47:00",1438390020,"C8",303180,1438693200,"2015-08-04 06:00:00"
"5776","20155731045731-907",1,"2015-07-31 17:49:00",1438390140,"C8",534420,1438924560,"2015-08-06 22:16:00"
"1379","20155631045627-683",1,"2015-07-31 18:01:00",1438390860,"C4",178920,1438569780,"2015-08-02 19:43:00"
"138","20152131052130-113",1,"2015-07-31 18:12:00",1438391520,"C5",561900,1438953420,"2015-08-07 06:17:00"
"4954","20153931053905-915",2,"2015-07-31 18:17:00",1438391820,"C3",476580,1438868400,"2015-08-06 06:40:00"
"1003","20154931054946-146",1,"2015-07-31 18:22:00",1438392120,"C8",324360,1438716480,"2015-08-04 12:28:00"
"2414","20155731055752-472",2,"2015-07-31 18:48:00",1438393680,"C4",78660,1438472340,"2015-08-01 16:39:00"
"5277","20150701060721-840",1,"2015-08-01 06:13:00",1438434780,"C2",227340,1438662120,"2015-08-03 21:22:00"
"2840","20150201060238-845",2,"2015-08-01 06:15:00",1438434900,"C3",105180,1438540080,"2015-08-02 11:28:00"
"2401","20151201061251-794",3,"2015-08-01 06:35:00",1438436100,"C6",279300,1438715400,"2015-08-04 12:10:00"
"5861","20152901062908-724",1,"2015-08-01 06:35:00",1438436100,"C2",264780,1438700880,"2015-08-04 08:08:00"
"6178","20153801063819-939",1,"2015-08-01 06:58:00",1438437480,"C5",310080,1438747560,"2015-08-04 21:06:00"
"721","20155501065521-181",2,"2015-08-01 07:01:00",1438437660,"C8",219300,1438656960,"2015-08-03 19:56:00"
"5712","20153201063205-376",1,"2015-08-01 07:04:00",1438437840,"C6",131760,1438569600,"2015-08-02 19:40:00"
"3896","20150201070216-808",2,"2015-08-01 07:09:00",1438438140,"C4",775800,1439213940,"2015-08-10 06:39:00"
"2996","20150701070729-336",1,"2015-08-01 07:37:00",1438439820,"C5",226080,1438665900,"2015-08-03 22:25:00"
"4054","20152101072110-270",1,"2015-08-01 07:44:00",1438440240,"C5",809160,1439249400,"2015-08-10 16:30:00"
"1286","20151501071532-943",3,"2015-08-01 07:50:00",1438440600,"C3",786060,1439226660,"2015-08-10 10:11:00"
"4856","20150001070006-104",1,"2015-08-01 07:55:00",1438440900,"C5",477360,1438918260,"2015-08-06 20:31:00"
"5616","20152501072548-463",3,"2015-08-01 07:57:00",1438441020,"C7",361200,1438802220,"2015-08-05 12:17:00"
"5403","20150501070559-328",3,"2015-08-01 08:03:00",1438441380,"C6",532740,1438974120,"2015-08-07 12:02:00"
"5021","20150401070439-330",1,"2015-08-01 08:10:00",1438441800,"C4",96900,1438538700,"2015-08-02 11:05:00"
"694","20155601065611-898",2,"2015-08-01 08:12:00",1438441920,"C2",114240,1438556160,"2015-08-02 15:56:00"
"500","20150201080243-358",2,"2015-08-01 08:24:00",1438442640,"C5",198720,1438641360,"2015-08-03 15:36:00"
"4165","20153401073445-361",2,"2015-08-01 08:32:00",1438443120,"C0",187200,1438630320,"2015-08-03 12:32:00"
"6106","20154301074308-402",1,"2015-08-01 08:34:00",1438443240,"C8",97320,1438540560,"2015-08-02 11:36:00"
"1618","20153501083518-306",1,"2015-08-01 08:42:00",1438443720,"C8",90000,1438533720,"2015-08-02 09:42:00"
"3569","20150901080955-679",1,"2015-08-01 08:46:00",1438443960,"C3",124860,1438568820,"2015-08-02 19:27:00"
"2297","20151101081109-505",3,"2015-08-01 09:06:00",1438445160,"C5",96120,1438541280,"2015-08-02 11:48:00"
"4957","20153601083623-683",1,"2015-08-01 09:19:00",1438445940,"C8",248400,1438694340,"2015-08-04 06:19:00"
"1289","20155701085744-294",1,"2015-08-01 09:32:00",1438446720,"C5",171420,1438618140,"2015-08-03 09:09:00"
"3119","20154801084801-486",2,"2015-08-01 09:39:00",1438447140,"C4",883260,1439330400,"2015-08-11 15:00:00"
"4403","20150501090516-171",3,"2015-08-01 09:39:00",1438447140,"C2",86880,1438534020,"2015-08-02 09:47:00"
"208","20154501084500-257",2,"2015-08-01 09:41:00",1438447260,"C4",193920,1438641180,"2015-08-03 15:33:00"
"734","20151901091942-196",1,"2015-08-01 09:43:00",1438447380,"C4",167040,1438614420,"2015-08-03 08:07:00"
"1543","20153701093702-509",1,"2015-08-01 10:10:00",1438449000,"C2",564180,1439013180,"2015-08-07 22:53:00"
"3741","20151001091013-536",1,"2015-08-01 10:18:00",1438449480,"C2",98940,1438548420,"2015-08-02 13:47:00"
"1399","20150001100019-538",1,"2015-08-01 10:37:00",1438450620,"C6",73260,1438523880,"2015-08-02 06:58:00"
"6366","20154001094026-804",3,"2015-08-01 10:47:00",1438451220,"C2",416460,1438867680,"2015-08-06 06:28:00"
"629","20153601103622-897",1,"2015-08-01 10:55:00",1438451700,"C6",99300,1438551000,"2015-08-02 14:30:00"
"1049","20154201104219-611",1,"2015-08-01 11:09:00",1438452540,"C4",96180,1438548720,"2015-08-02 13:52:00"
"2039","20154801104828-144",2,"2015-08-01 11:15:00",1438452900,"C5",80640,1438533540,"2015-08-02 09:39:00"
"3660","20154701104706-898",1,"2015-08-01 11:20:00",1438453200,"C2",180480,1438633680,"2015-08-03 13:28:00"
"6275","20151601101604-955",2,"2015-08-01 11:21:00",1438453260,"C0",80160,1438533420,"2015-08-02 09:37:00"
"1010","20152801102848-547",2,"2015-08-01 11:44:00",1438454640,"C2",296280,1438750920,"2015-08-04 22:02:00"
"372","20155401115443-339",2,"2015-08-01 12:12:00",1438456320,"C7",108960,1438565280,"2015-08-02 18:28:00"
"2182","20150801120848-517",1,"2015-08-01 12:34:00",1438457640,"C5",68760,1438526400,"2015-08-02 07:40:00"
"3779","20152001122012-967",1,"2015-08-01 12:47:00",1438458420,"C8",275520,1438733940,"2015-08-04 17:19:00"
"1770","20154901124955-525",2,"2015-08-01 12:56:00",1438458960,"C4",162000,1438620960,"2015-08-03 09:56:00"
"2133","20153401123448-154",1,"2015-08-01 12:57:00",1438459020,"C5",254220,1438713240,"2015-08-04 11:34:00"
"3430","20155501115503-638",2,"2015-08-01 13:01:00",1438459260,"C8",149160,1438608420,"2015-08-03 06:27:00"
"5033","20155601125604-18",1,"2015-08-01 13:09:00",1438459740,"C7",180660,1438640400,"2015-08-03 15:20:00"
"2770","20150901120957-839",1,"2015-08-01 13:10:00",1438459800,"C3",610800,1439070600,"2015-08-08 14:50:00"
"264","20151201121236-41",1,"2015-08-01 13:21:00",1438460460,"C3",1190220,1439650680,"2015-08-15 07:58:00"
"5590","20152001012059-836",1,"2015-08-01 13:27:00",1438460820,"C4",79740,1438540560,"2015-08-02 11:36:00"
"722","20155401015444-439",1,"2015-08-01 14:02:00",1438462920,"C4",152640,1438615560,"2015-08-03 08:26:00"
"6346","20150701020723-76",1,"2015-08-01 14:13:00",1438463580,"C4",784860,1439248440,"2015-08-10 16:14:00"
"2548","20152001012016-668",3,"2015-08-01 14:14:00",1438463640,"C5",591540,1439055180,"2015-08-08 10:33:00"
"2437","20151301021340-472",2,"2015-08-01 14:18:00",1438463880,"C2",105000,1438568880,"2015-08-02 19:28:00"
"2549","20152101012104-141",1,"2015-08-01 14:32:00",1438464720,"C2",103680,1438568400,"2015-08-02 19:20:00"
"4111","20153201013211-268",3,"2015-08-01 14:45:00",1438465500,"C2",681780,1439147280,"2015-08-09 12:08:00"
"134","20155701025756-944",2,"2015-08-01 15:06:00",1438466760,"C4",69480,1438536240,"2015-08-02 10:24:00"
"72","20153601023624-894",1,"2015-08-01 15:07:00",1438466820,"C3",873120,1439339940,"2015-08-11 17:39:00"
"2220","20151201031214-85",1,"2015-08-01 16:04:00",1438470240,"C4",434340,1438904580,"2015-08-06 16:43:00"
"3592","20155201035213-815",2,"2015-08-01 16:06:00",1438470360,"C0",103080,1438573440,"2015-08-02 20:44:00"
"1340","20152501032501-316",1,"2015-08-01 16:23:00",1438471380,"C7",160080,1438631460,"2015-08-03 12:51:00"
"359","20151001041055-580",1,"2015-08-01 16:24:00",1438471440,"C7",278460,1438749900,"2015-08-04 21:45:00"
"4479","20152801032847-862",2,"2015-08-01 16:27:00",1438471620,"C6",275880,1438747500,"2015-08-04 21:05:00"
"5950","20150901040932-288",1,"2015-08-01 17:03:00",1438473780,"C8",534300,1439008080,"2015-08-07 21:28:00"
"954","20153701043709-900",1,"2015-08-01 17:40:00",1438476000,"C2",437700,1438913700,"2015-08-06 19:15:00"
"253","20155101045148-763",2,"2015-08-01 17:56:00",1438476960,"C5",311040,1438788000,"2015-08-05 08:20:00"
"720","20151001051049-770",1,"2015-08-01 18:07:00",1438477620,"C3",71820,1438549440,"2015-08-02 14:04:00"
"5435","20151501051519-505",1,"2015-08-01 18:18:00",1438478280,"C6",131520,1438609800,"2015-08-03 06:50:00"
"3832","20152801052822-733",1,"2015-08-01 18:26:00",1438478760,"C4",331980,1438810740,"2015-08-05 14:39:00"
"5210","20155301055312-754",2,"2015-08-01 18:53:00",1438480380,"C0",656280,1439136660,"2015-08-09 09:11:00"
"6083","20152502062553-799",3,"2015-08-02 06:36:00",1438522560,"C3",1210740,1439733300,"2015-08-16 06:55:00"
"3265","20153102063100-491",1,"2015-08-02 06:38:00",1438522680,"C4",281040,1438803720,"2015-08-05 12:42:00"
"1833","20151902061935-596",3,"2015-08-02 06:57:00",1438523820,"C0",117900,1438641720,"2015-08-03 15:42:00"
"3848","20150802060812-197",2,"2015-08-02 07:06:00",1438524360,"C4",526260,1439050620,"2015-08-08 09:17:00"
"3463","20150902060920-793",2,"2015-08-02 07:10:00",1438524600,"C7",714780,1439239380,"2015-08-10 13:43:00"
"5678","20151002071039-91",1,"2015-08-02 07:16:00",1438524960,"C8",297780,1438822740,"2015-08-05 17:59:00"
"4887","20151102061116-400",1,"2015-08-02 07:22:00",1438525320,"C0",367500,1438892820,"2015-08-06 13:27:00"
"3821","20150602070645-93",1,"2015-08-02 07:40:00",1438526400,"C5",643440,1439169840,"2015-08-09 18:24:00"
"3831","20154202074243-737",1,"2015-08-02 08:07:00",1438528020,"C4",311640,1438839660,"2015-08-05 22:41:00"
"1462","20150102080153-960",2,"2015-08-02 08:25:00",1438529100,"C5",260520,1438789620,"2015-08-05 08:47:00"
"5570","20152102082141-663",1,"2015-08-02 08:42:00",1438530120,"C7",253740,1438783860,"2015-08-05 07:11:00"
"5","20154502084548-823",3,"2015-08-02 09:02:00",1438531320,"C0",103620,1438634940,"2015-08-03 13:49:00"
"531","20150802090855-889",2,"2015-08-02 09:11:00",1438531860,"C6",194940,1438726800,"2015-08-04 15:20:00"
"4259","20154702084714-863",1,"2015-08-02 09:13:00",1438531980,"C5",341340,1438873320,"2015-08-06 08:02:00"
"5358","20154302084358-573",1,"2015-08-02 09:25:00",1438532700,"C2",107100,1438639800,"2015-08-03 15:10:00"
"5129","20150802090811-979",1,"2015-08-02 09:35:00",1438533300,"C5",110160,1438643460,"2015-08-03 16:11:00"
"5148","20153402093448-712",1,"2015-08-02 09:40:00",1438533600,"C2",199680,1438733280,"2015-08-04 17:08:00"
"6180","20153002083005-261",1,"2015-08-02 09:45:00",1438533900,"C7",104580,1438638480,"2015-08-03 14:48:00"
"4455","20152502092544-104",1,"2015-08-02 09:48:00",1438534080,"C8",446340,1438980420,"2015-08-07 13:47:00"
"3820","20154302094310-152",1,"2015-08-02 09:58:00",1438534680,"C7",438780,1438973460,"2015-08-07 11:51:00"
"2452","20151902091944-855",3,"2015-08-02 10:20:00",1438536000,"C4",819120,1439355120,"2015-08-11 21:52:00"
"1136","20154502094535-864",3,"2015-08-02 10:43:00",1438537380,"C2",254340,1438791720,"2015-08-05 09:22:00"
"4538","20152102102155-887",1,"2015-08-02 10:49:00",1438537740,"C5",550320,1439088060,"2015-08-08 19:41:00"
"5372","20151502101538-958",1,"2015-08-02 11:07:00",1438538820,"C8",421740,1438960560,"2015-08-07 08:16:00"
"765","20155602105614-229",1,"2015-08-02 11:21:00",1438539660,"C4",78060,1438617720,"2015-08-03 09:02:00"
"3103","20151202101257-746",1,"2015-08-02 11:26:00",1438539960,"C0",82560,1438622520,"2015-08-03 10:22:00"
"637","20152502112545-83",1,"2015-08-02 11:33:00",1438540380,"C4",118080,1438658460,"2015-08-03 20:21:00"
"5266","20153402113431-964",2,"2015-08-02 11:41:00",1438540860,"C4",116880,1438657740,"2015-08-03 20:09:00"
"6321","20150902110946-207",1,"2015-08-02 12:11:00",1438542660,"C7",88920,1438631580,"2015-08-03 12:53:00"
"4384","20151102121127-564",2,"2015-08-02 12:17:00",1438543020,"C2",97980,1438641000,"2015-08-03 15:30:00"
"3636","20150002120037-795",1,"2015-08-02 13:00:00",1438545600,"C5",283560,1438829160,"2015-08-05 19:46:00"
"3246","20150302120354-207",2,"2015-08-02 13:01:00",1438545660,"C4",148440,1438694100,"2015-08-04 06:15:00"
"4249","20151502121513-669",1,"2015-08-02 13:07:00",1438546020,"C6",893520,1439439540,"2015-08-12 21:19:00"
"5393","20153302123354-327",1,"2015-08-02 13:07:00",1438546020,"C8",235440,1438781460,"2015-08-05 06:31:00"
"1436","20151302121348-104",1,"2015-08-02 13:13:00",1438546380,"C7",274560,1438820940,"2015-08-05 17:29:00"
"5769","20152302122333-628",2,"2015-08-02 13:20:00",1438546800,"C8",525540,1439072340,"2015-08-08 15:19:00"
"641","20153712013720-181",3,"2015-08-02 13:51:00",1438548660,"C6",203940,1438752600,"2015-08-04 22:30:00"
"5633","20155602125643-208",2,"2015-08-02 13:52:00",1438548720,"C5",171540,1438720260,"2015-08-04 13:31:00"
"1405","20150702020734-303",1,"2015-08-02 14:13:00",1438549980,"C2",501960,1439051940,"2015-08-08 09:39:00"
"4385","20151902011959-320",1,"2015-08-02 14:24:00",1438550640,"C3",112140,1438662780,"2015-08-03 21:33:00"
"5046","20154602014652-42",1,"2015-08-02 14:35:00",1438551300,"C7",231180,1438782480,"2015-08-05 06:48:00"
"5082","20151002021015-986",1,"2015-08-02 14:37:00",1438551420,"C5",282720,1438834140,"2015-08-05 21:09:00"
"4579","20150702020750-193",2,"2015-08-02 14:42:00",1438551720,"C0",116160,1438667880,"2015-08-03 22:58:00"
"3887","20153402013445-750",1,"2015-08-02 14:51:00",1438552260,"C0",186120,1438738380,"2015-08-04 18:33:00"
"6311","20150102020155-899",1,"2015-08-02 14:57:00",1438552620,"C4",82740,1438635360,"2015-08-03 13:56:00"
"3336","20151502021555-920",2,"2015-08-02 15:03:00",1438552980,"C8",691560,1439244540,"2015-08-10 15:09:00"
"5104","20155202025227-496",1,"2015-08-02 15:23:00",1438554180,"C3",167280,1438721460,"2015-08-04 13:51:00"
"2498","20155502025511-119",2,"2015-08-02 15:24:00",1438554240,"C2",84360,1438638600,"2015-08-03 14:50:00"
"424","20153602033634-853",1,"2015-08-02 15:58:00",1438556280,"C5",70980,1438627260,"2015-08-03 11:41:00"
"4822","20154202034222-47",2,"2015-08-02 16:05:00",1438556700,"C4",64500,1438621200,"2015-08-03 10:00:00"
"1245","20150202040220-736",3,"2015-08-02 16:25:00",1438557900,"C4",527880,1439085780,"2015-08-08 19:03:00"
"345","20151002041036-991",1,"2015-08-02 16:36:00",1438558560,"C3",277560,1438836120,"2015-08-05 21:42:00"
"3348","20154402034422-248",1,"2015-08-02 16:41:00",1438558860,"C8",710220,1439269080,"2015-08-10 21:58:00"
"2286","20154402034401-435",2,"2015-08-02 16:52:00",1438559520,"C8",91080,1438650600,"2015-08-03 18:10:00"
"1024","20150702040744-309",2,"2015-08-02 17:01:00",1438560060,"C5",145980,1438706040,"2015-08-04 09:34:00"
"6006","20154902034953-35",3,"2015-08-02 17:03:00",1438560180,"C2",1199220,1439759400,"2015-08-16 14:10:00"
"1453","20153602043658-257",3,"2015-08-02 17:10:00",1438560600,"C6",268380,1438828980,"2015-08-05 19:43:00"
"4044","20155402045434-428",2,"2015-08-02 17:20:00",1438561200,"C5",272520,1438833720,"2015-08-05 21:02:00"
"805","20155602045649-200",1,"2015-08-02 17:22:00",1438561320,"C4",862260,1439423580,"2015-08-12 16:53:00"
"1357","20153102043137-348",1,"2015-08-02 17:26:00",1438561560,"C5",221100,1438782660,"2015-08-05 06:51:00"
"6406","20153802043859-167",1,"2015-08-02 17:43:00",1438562580,"C3",102840,1438665420,"2015-08-03 22:17:00"
"5201","20153802053827-252",1,"2015-08-02 17:45:00",1438562700,"C2",45360,1438608060,"2015-08-03 06:21:00"
"3614","20155102045128-941",1,"2015-08-02 17:52:00",1438563120,"C7",75780,1438638900,"2015-08-03 14:55:00"
"4995","20153802053822-860",3,"2015-08-02 17:52:00",1438563120,"C7",53520,1438616640,"2015-08-03 08:44:00"
"3470","20154502054501-178",1,"2015-08-02 17:53:00",1438563180,"C4",75360,1438638540,"2015-08-03 14:49:00"
"878","20153602053648-835",1,"2015-08-02 18:00:00",1438563600,"C5",158820,1438722420,"2015-08-04 14:07:00"
"5439","20155702055701-405",3,"2015-08-02 18:20:00",1438564800,"C7",135420,1438700220,"2015-08-04 07:57:00"
"4126","20153402053419-365",1,"2015-08-02 18:34:00",1438565640,"C4",601740,1439167380,"2015-08-09 17:43:00"
"994","20151603061654-187",1,"2015-08-03 06:57:00",1438610220,"C2",121140,1438731360,"2015-08-04 16:36:00"
"2010","20150503070532-763",3,"2015-08-03 07:12:00",1438611120,"C4",348780,1438959900,"2015-08-07 08:05:00"
"1020","20153503063500-934",2,"2015-08-03 07:24:00",1438611840,"C7",177540,1438789380,"2015-08-05 08:43:00"
"871","20153103063126-891",3,"2015-08-03 07:29:00",1438612140,"C3",399360,1439011500,"2015-08-07 22:25:00"
"2030","20153703073756-936",1,"2015-08-03 07:49:00",1438613340,"C3",555000,1439168340,"2015-08-09 17:59:00"
"3839","20154303074311-913",1,"2015-08-03 08:05:00",1438614300,"C4",558240,1439172540,"2015-08-09 19:09:00"
"432","20155903065939-454",3,"2015-08-03 08:09:00",1438614540,"C8",133080,1438747620,"2015-08-04 21:07:00"
"1293","20151403071408-116",2,"2015-08-03 08:15:00",1438614900,"C5",369420,1438984320,"2015-08-07 14:52:00"
"5328","20151303081343-855",1,"2015-08-03 08:20:00",1438615200,"C4",469920,1439085120,"2015-08-08 18:52:00"
"5332","20155903075911-687",1,"2015-08-03 08:30:00",1438615800,"C2",509940,1439125740,"2015-08-09 06:09:00"
"486","20150503080511-131",2,"2015-08-03 08:38:00",1438616280,"C6",383280,1438999560,"2015-08-07 19:06:00"
"5843","20151503081552-98",2,"2015-08-03 08:38:00",1438616280,"C8",342240,1438958520,"2015-08-07 07:42:00"
"5370","20153403083413-579",3,"2015-08-03 08:47:00",1438616820,"C3",468540,1439085360,"2015-08-08 18:56:00"
"222","20155303075313-600",1,"2015-08-03 08:49:00",1438616940,"C6",369540,1438986480,"2015-08-07 15:28:00"
"4113","20154903084903-690",2,"2015-08-03 09:06:00",1438617960,"C0",101880,1438719840,"2015-08-04 13:24:00"
"3560","20154103084118-72",1,"2015-08-03 09:08:00",1438618080,"C8",288240,1438906320,"2015-08-06 17:12:00"
"2949","20152803082807-792",1,"2015-08-03 09:31:00",1438619460,"C6",99180,1438718640,"2015-08-04 13:04:00"
"3472","20151303091355-495",3,"2015-08-03 09:40:00",1438620000,"C5",214920,1438834920,"2015-08-05 21:22:00"
"3163","20152603092611-468",1,"2015-08-03 09:52:00",1438620720,"C4",804240,1439424960,"2015-08-12 17:16:00"
"2278","20150303100354-126",2,"2015-08-03 10:27:00",1438622820,"C5",342900,1438965720,"2015-08-07 09:42:00"
"4442","20151003111052-171",1,"2015-08-03 11:17:00",1438625820,"C4",364320,1438990140,"2015-08-07 16:29:00"
"718","20153003103059-290",3,"2015-08-03 11:34:00",1438626840,"C0",347520,1438974360,"2015-08-07 12:06:00"
"6155","20150603110619-327",2,"2015-08-03 11:35:00",1438626900,"C5",781320,1439408220,"2015-08-12 12:37:00"
"1853","20153203113245-908",1,"2015-08-03 11:57:00",1438628220,"C5",211440,1438839660,"2015-08-05 22:41:00"
"6218","20153303113325-724",1,"2015-08-03 12:10:00",1438629000,"C0",434880,1439063880,"2015-08-08 12:58:00"
"5891","20152703012733-565",3,"2015-08-03 13:30:00",1438633800,"C6",63420,1438697220,"2015-08-04 07:07:00"
"818","20151003011029-293",3,"2015-08-03 13:33:00",1438633980,"C5",78900,1438712880,"2015-08-04 11:28:00"
"3266","20153903123925-684",1,"2015-08-03 13:40:00",1438634400,"C0",535200,1439169600,"2015-08-09 18:20:00"
"3024","20154803014805-523",1,"2015-08-03 14:16:00",1438636560,"C8",667980,1439304540,"2015-08-11 07:49:00"
"95","20151103021143-224",1,"2015-08-03 14:23:00",1438636980,"C3",114540,1438751520,"2015-08-04 22:12:00"
"2615","20155403015401-677",2,"2015-08-03 14:55:00",1438638900,"C2",233880,1438872780,"2015-08-06 07:53:00"
"2272","20152803022825-787",3,"2015-08-03 14:59:00",1438639140,"C3",329280,1438968420,"2015-08-07 10:27:00"
"4549","20150503030532-116",1,"2015-08-03 15:24:00",1438640640,"C6",109740,1438750380,"2015-08-04 21:53:00"
"4589","20154303024314-609",1,"2015-08-03 15:39:00",1438641540,"C7",103020,1438744560,"2015-08-04 20:16:00"
"5395","20152903032937-233",3,"2015-08-03 15:51:00",1438642260,"C5",227100,1438869360,"2015-08-06 06:56:00"
"6301","20151103031107-509",1,"2015-08-03 16:27:00",1438644420,"C2",656700,1439301120,"2015-08-11 06:52:00"
"1435","20150503040553-197",2,"2015-08-03 16:56:00",1438646160,"C7",244560,1438890720,"2015-08-06 12:52:00"
"3891","20154703044754-258",3,"2015-08-03 17:20:00",1438647600,"C4",481140,1439128740,"2015-08-09 06:59:00"
"1681","20153803043831-603",2,"2015-08-03 17:36:00",1438648560,"C8",315360,1438963920,"2015-08-07 09:12:00"
"4418","20150903050915-821",1,"2015-08-03 18:07:00",1438650420,"C5",152400,1438802820,"2015-08-05 12:27:00"
"3534","20153603053617-529",3,"2015-08-03 18:08:00",1438650480,"C8",253680,1438904160,"2015-08-06 16:36:00"
"5856","20155703045756-537",1,"2015-08-03 18:08:00",1438650480,"C2",828840,1439479320,"2015-08-13 08:22:00"
"2815","20154403054427-199",2,"2015-08-03 18:22:00",1438651320,"C7",149280,1438800600,"2015-08-05 11:50:00"
"793","20153603053623-213",1,"2015-08-03 18:29:00",1438651740,"C5",321780,1438973520,"2015-08-07 11:52:00"
"6071","20155703055759-244",2,"2015-08-03 18:57:00",1438653420,"C2",62760,1438716180,"2015-08-04 12:23:00"
"2112","20150904060946-997",1,"2015-08-04 06:40:00",1438695600,"C0",130320,1438825920,"2015-08-05 18:52:00"
"5617","20151704061733-850",1,"2015-08-04 06:43:00",1438695780,"C8",109680,1438805460,"2015-08-05 13:11:00"
"4417","20152304062326-36",1,"2015-08-04 07:30:00",1438698600,"C3",465540,1439164140,"2015-08-09 16:49:00"
"4223","20154604064624-746",1,"2015-08-04 07:46:00",1438699560,"C3",2525460,1441225020,"2015-09-02 13:17:00"
"509","20155304065306-536",1,"2015-08-04 07:59:00",1438700340,"C5",473760,1439174100,"2015-08-09 19:35:00"
"2980","20153604073602-444",1,"2015-08-04 08:03:00",1438700580,"C5",461220,1439161800,"2015-08-09 16:10:00"
"2914","20153604073634-474",1,"2015-08-04 08:11:00",1438701060,"C0",215160,1438916220,"2015-08-06 19:57:00"
"3007","20155504075536-383",1,"2015-08-04 08:48:00",1438703280,"C5",395700,1439098980,"2015-08-08 22:43:00"
"5258","20151104081118-17",1,"2015-08-04 08:50:00",1438703400,"C2",772260,1439475660,"2015-08-13 07:21:00"
"4086","20155704085706-777",3,"2015-08-04 09:23:00",1438705380,"C4",527040,1439232420,"2015-08-10 11:47:00"
"6304","20152304092306-366",2,"2015-08-04 09:58:00",1438707480,"C8",469440,1439176920,"2015-08-09 20:22:00"
"3803","20155804085814-147",1,"2015-08-04 10:03:00",1438707780,"C5",103140,1438810920,"2015-08-05 14:42:00"
"1559","20154504094510-630",1,"2015-08-04 10:06:00",1438707960,"C5",526740,1439234700,"2015-08-10 12:25:00"
"6018","20155304095343-996",2,"2015-08-04 10:10:00",1438708200,"C7",292500,1439000700,"2015-08-07 19:25:00"
"4443","20150904090957-319",2,"2015-08-04 10:11:00",1438708260,"C3",216360,1438924620,"2015-08-06 22:17:00"
"4368","20150804090809-57",2,"2015-08-04 10:19:00",1438708740,"C2",255420,1438964160,"2015-08-07 09:16:00"
"4897","20155304095307-596",2,"2015-08-04 10:57:00",1438711020,"C4",196020,1438907040,"2015-08-06 17:24:00"
"4436","20153004113046-680",3,"2015-08-04 11:38:00",1438713480,"C4",69000,1438782480,"2015-08-05 06:48:00"
"5582","20155904105919-416",1,"2015-08-04 11:50:00",1438714200,"C8",428340,1439142540,"2015-08-09 10:49:00"
"4756","20150704110737-327",1,"2015-08-04 12:16:00",1438715760,"C5",117480,1438833240,"2015-08-05 20:54:00"
"4218","20150104120123-255",2,"2015-08-04 12:50:00",1438717800,"C7",321420,1439039220,"2015-08-08 06:07:00"
"3241","20152804122805-486",2,"2015-08-04 12:57:00",1438718220,"C4",76320,1438794540,"2015-08-05 10:09:00"
"5760","20150704010749-266",1,"2015-08-04 13:21:00",1438719660,"C7",241140,1438960800,"2015-08-07 08:20:00"
"5784","20155204125243-368",2,"2015-08-04 13:48:00",1438721280,"C8",65940,1438787220,"2015-08-05 08:07:00"
"5524","20155304125320-819",1,"2015-08-04 13:54:00",1438721640,"C2",260820,1438982460,"2015-08-07 14:21:00"
"186","20152304012310-843",1,"2015-08-04 13:56:00",1438721760,"C4",237840,1438959600,"2015-08-07 08:00:00"
"5879","20153804013823-112",1,"2015-08-04 13:59:00",1438721940,"C8",713100,1439435040,"2015-08-12 20:04:00"
"1177","20153004013007-217",3,"2015-08-04 14:02:00",1438722120,"C8",336120,1439058240,"2015-08-08 11:24:00"
"330","20152704022721-344",2,"2015-08-04 14:35:00",1438724100,"C8",282300,1439006400,"2015-08-07 21:00:00"
"103","20151804021836-532",1,"2015-08-04 14:46:00",1438724760,"C5",747660,1439472420,"2015-08-13 06:27:00"
"5425","20155904015930-845",3,"2015-08-04 14:57:00",1438725420,"C4",107640,1438833060,"2015-08-05 20:51:00"
"4379","20155904025922-23",1,"2015-08-04 15:05:00",1438725900,"C2",181500,1438907400,"2015-08-06 17:30:00"
"6381","20153604033631-714",3,"2015-08-04 15:42:00",1438728120,"C4",1537200,1440265320,"2015-08-22 10:42:00"
"1874","20153204023235-178",1,"2015-08-04 15:50:00",1438728600,"C2",320400,1439049000,"2015-08-08 08:50:00"
"5520","20154604024619-103",1,"2015-08-04 15:51:00",1438728660,"C3",368280,1439096940,"2015-08-08 22:09:00"
"5870","20150604040619-38",1,"2015-08-04 16:08:00",1438729680,"C6",256200,1438985880,"2015-08-07 15:18:00"
"4794","20155004035020-880",3,"2015-08-04 16:34:00",1438731240,"C8",63060,1438794300,"2015-08-05 10:05:00"
"6186","20150804040846-173",1,"2015-08-04 16:34:00",1438731240,"C3",359040,1439090280,"2015-08-08 20:18:00"
"2367","20154604044619-717",2,"2015-08-04 16:49:00",1438732140,"C6",277080,1439009220,"2015-08-07 21:47:00"
"413","20151804041847-645",3,"2015-08-04 17:16:00",1438733760,"C7",266340,1439000100,"2015-08-07 19:15:00"
"4156","20150104050127-736",1,"2015-08-04 17:40:00",1438735200,"C0",83640,1438818840,"2015-08-05 16:54:00"
"5812","20155204055205-222",3,"2015-08-04 18:49:00",1438739340,"C6",429300,1439168640,"2015-08-09 18:04:00"
"2271","20152905062952-3",1,"2015-08-05 06:37:00",1438781820,"C4",183300,1438965120,"2015-08-07 09:32:00"
"5247","20153205073220-30",1,"2015-08-05 07:37:00",1438785420,"C2",978300,1439763720,"2015-08-16 15:22:00"
"321","20155305065314-246",1,"2015-08-05 08:03:00",1438786980,"C3",255660,1439042640,"2015-08-08 07:04:00"
"2095","20150805070853-118",3,"2015-08-05 08:16:00",1438787760,"C4",906540,1439694300,"2015-08-15 20:05:00"
"3817","20153705073720-86",2,"2015-08-05 08:29:00",1438788540,"C5",353100,1439141640,"2015-08-09 10:34:00"
"4280","20152805082823-737",2,"2015-08-05 08:58:00",1438790280,"C5",280920,1439071200,"2015-08-08 15:00:00"
"4204","20155805085848-703",3,"2015-08-05 09:38:00",1438792680,"C7",124140,1438916820,"2015-08-06 20:07:00"
"4178","20150605090648-40",1,"2015-08-05 10:10:00",1438794600,"C2",691140,1439485740,"2015-08-13 10:09:00"
"2043","20152005092011-809",1,"2015-08-05 10:19:00",1438795140,"C6",247080,1439042220,"2015-08-08 06:57:00"
"3737","20155205095236-132",1,"2015-08-05 10:28:00",1438795680,"C2",284940,1439080620,"2015-08-08 17:37:00"
"3500","20151505101551-848",3,"2015-08-05 10:42:00",1438796520,"C5",530760,1439327280,"2015-08-11 14:08:00"
"3161","20154805094814-860",2,"2015-08-05 10:53:00",1438797180,"C5",195660,1438992840,"2015-08-07 17:14:00"
"4227","20150305100328-487",3,"2015-08-05 10:56:00",1438797360,"C6",721380,1439518740,"2015-08-13 19:19:00"
"1094","20151805101809-893",1,"2015-08-05 11:14:00",1438798440,"C8",82020,1438880460,"2015-08-06 10:01:00"
"1820","20153705113718-477",2,"2015-08-05 12:01:00",1438801260,"C8",1379880,1440181140,"2015-08-21 11:19:00"
"1879","20152305112331-211",1,"2015-08-05 12:34:00",1438803240,"C7",121440,1438924680,"2015-08-06 22:18:00"
"853","20153005123012-657",1,"2015-08-05 12:55:00",1438804500,"C8",424380,1439228880,"2015-08-10 10:48:00"
"6150","20152405122407-516",1,"2015-08-05 12:56:00",1438804560,"C8",246660,1439051220,"2015-08-08 09:27:00"
"2097","20150405120404-360",2,"2015-08-05 12:58:00",1438804680,"C8",99360,1438904040,"2015-08-06 16:34:00"
"5240","20155405125402-226",1,"2015-08-05 13:49:00",1438807740,"C8",176340,1438984080,"2015-08-07 14:48:00"
"1050","20152805012826-73",1,"2015-08-05 14:03:00",1438808580,"C2",338580,1439147160,"2015-08-09 12:06:00"
"483","20150805020849-559",1,"2015-08-05 15:04:00",1438812240,"C8",405360,1439217600,"2015-08-10 07:40:00"
"4127","20150205030232-909",1,"2015-08-05 15:08:00",1438812480,"C8",626880,1439439360,"2015-08-12 21:16:00"
"1078","20154605024652-886",1,"2015-08-05 15:20:00",1438813200,"C0",142620,1438955820,"2015-08-07 06:57:00"
"3233","20154505024531-4",2,"2015-08-05 15:36:00",1438814160,"C6",74760,1438888920,"2015-08-06 12:22:00"
"6282","20154105024125-706",2,"2015-08-05 15:39:00",1438814340,"C4",428220,1439242560,"2015-08-10 14:36:00"
"3314","20155505035539-722",3,"2015-08-05 16:02:00",1438815720,"C2",86940,1438902660,"2015-08-06 16:11:00"
"4176","20151305041332-847",3,"2015-08-05 16:41:00",1438818060,"C5",360660,1439178720,"2015-08-09 20:52:00"
"3080","20154205034205-330",1,"2015-08-05 16:48:00",1438818480,"C5",52260,1438870740,"2015-08-06 07:19:00"
"1187","20152705042730-318",2,"2015-08-05 16:49:00",1438818540,"C4",90720,1438909260,"2015-08-06 18:01:00"
"4469","20150205050251-251",2,"2015-08-05 17:16:00",1438820160,"C7",269760,1439089920,"2015-08-08 20:12:00"
"2124","20154705044710-733",2,"2015-08-05 17:38:00",1438821480,"C6",46800,1438868280,"2015-08-06 06:38:00"
"2713","20152205052223-701",2,"2015-08-05 18:18:00",1438823880,"C5",69360,1438893240,"2015-08-06 13:34:00"
"2371","20151206061257-541",2,"2015-08-06 06:37:00",1438868220,"C4",370320,1439238540,"2015-08-10 13:29:00"
"2664","20153706063755-802",1,"2015-08-06 06:52:00",1438869120,"C0",472380,1439341500,"2015-08-11 18:05:00"
"2737","20153206063215-204",1,"2015-08-06 07:32:00",1438871520,"C8",571440,1439442960,"2015-08-12 22:16:00"
"5750","20151106071155-474",1,"2015-08-06 07:46:00",1438872360,"C7",104100,1438976460,"2015-08-07 12:41:00"
"5220","20155706065753-746",1,"2015-08-06 08:07:00",1438873620,"C0",957540,1439831160,"2015-08-17 10:06:00"
"2075","20150006080007-531",3,"2015-08-06 08:21:00",1438874460,"C7",471000,1439345460,"2015-08-11 19:11:00"
"5290","20150206080226-163",1,"2015-08-06 08:32:00",1438875120,"C5",99300,1438974420,"2015-08-07 12:07:00"
"3547","20151606081628-560",1,"2015-08-06 08:49:00",1438876140,"C3",185280,1439061420,"2015-08-08 12:17:00"
"3280","20150506080545-327",1,"2015-08-06 08:56:00",1438876560,"C4",597060,1439473620,"2015-08-13 06:47:00"
"1854","20152106092141-219",1,"2015-08-06 09:47:00",1438879620,"C5",125400,1439005020,"2015-08-07 20:37:00"
"3566","20150606090640-663",1,"2015-08-06 10:22:00",1438881720,"C0",166680,1439048400,"2015-08-08 08:40:00"
"3524","20155206095205-734",1,"2015-08-06 10:44:00",1438883040,"C5",165900,1439048940,"2015-08-08 08:49:00"
"6298","20154906094920-919",1,"2015-08-06 10:59:00",1438883940,"C3",213360,1439097300,"2015-08-08 22:15:00"
"4934","20151806101819-946",1,"2015-08-06 11:19:00",1438885140,"C6",166440,1439051580,"2015-08-08 09:33:00"
"4659","20150206110226-989",2,"2015-08-06 11:29:00",1438885740,"C4",79620,1438965360,"2015-08-07 09:36:00"
"5753","20152706112749-394",2,"2015-08-06 11:35:00",1438886100,"C4",121920,1439008020,"2015-08-07 21:27:00"
"2519","20153406113422-942",1,"2015-08-06 11:59:00",1438887540,"C8",346500,1439234040,"2015-08-10 12:14:00"
"2588","20153706123753-969",1,"2015-08-06 12:48:00",1438890480,"C3",462960,1439353440,"2015-08-11 21:24:00"
"4299","20150906120952-835",1,"2015-08-06 13:02:00",1438891320,"C5",428280,1439319600,"2015-08-11 12:00:00"
"3723","20150406120449-237",1,"2015-08-06 13:20:00",1438892400,"C2",718980,1439611380,"2015-08-14 21:03:00"
"1972","20154006014046-882",1,"2015-08-06 14:17:00",1438895820,"C2",171300,1439067120,"2015-08-08 13:52:00"
"6447","20153306013342-878",3,"2015-08-06 14:29:00",1438896540,"C7",631860,1439528400,"2015-08-13 22:00:00"
"3589","20152606022653-437",3,"2015-08-06 14:41:00",1438897260,"C7",259200,1439156460,"2015-08-09 14:41:00"
"1819","20154906014902-527",1,"2015-08-06 14:55:00",1438898100,"C5",183480,1439081580,"2015-08-08 17:53:00"
"6462","20151506031520-642",2,"2015-08-06 15:26:00",1438899960,"C3",331860,1439231820,"2015-08-10 11:37:00"
"1305","20153206033254-715",2,"2015-08-06 15:39:00",1438900740,"C4",90600,1438991340,"2015-08-07 16:49:00"
"5374","20150906030915-616",1,"2015-08-06 15:42:00",1438900920,"C3",962340,1439863260,"2015-08-17 19:01:00"
"2254","20150106030143-319",1,"2015-08-06 16:10:00",1438902600,"C2",158520,1439061120,"2015-08-08 12:12:00"
"3502","20150406040417-783",1,"2015-08-06 16:12:00",1438902720,"C8",65820,1438968540,"2015-08-07 10:29:00"
"2399","20151106031107-912",2,"2015-08-06 16:24:00",1438903440,"C2",55620,1438959060,"2015-08-07 07:51:00"
"6199","20155206035248-482",3,"2015-08-06 16:56:00",1438905360,"C0",147540,1439052900,"2015-08-08 09:55:00"
"1683","20154706044711-22",1,"2015-08-06 16:57:00",1438905420,"C3",54000,1438959420,"2015-08-07 07:57:00"
"2402","20155706045723-418",1,"2015-08-06 17:03:00",1438905780,"C8",147420,1439053200,"2015-08-08 10:00:00"
"3175","20154606044639-126",3,"2015-08-06 17:19:00",1438906740,"C3",749040,1439655780,"2015-08-15 09:23:00"
"4097","20155506045534-554",1,"2015-08-06 17:22:00",1438906920,"C5",1036140,1439943060,"2015-08-18 17:11:00"
"1429","20153906043931-40",2,"2015-08-06 17:34:00",1438907640,"C8",236700,1439144340,"2015-08-09 11:19:00"
"2116","20153606053617-896",3,"2015-08-06 17:43:00",1438908180,"C8",161640,1439069820,"2015-08-08 14:37:00"
"5472","20150606050653-525",1,"2015-08-06 18:01:00",1438909260,"C4",44880,1438954140,"2015-08-07 06:29:00"
"2817","20155906055936-524",1,"2015-08-06 18:06:00",1438909560,"C2",64080,1438973640,"2015-08-07 11:54:00"
"2708","20151607061640-872",1,"2015-08-07 06:33:00",1438954380,"C7",120540,1439074920,"2015-08-08 16:02:00"
"6503","20150707060746-607",2,"2015-08-07 06:35:00",1438954500,"C8",228180,1439182680,"2015-08-09 21:58:00"
"1294","20153707063710-587",1,"2015-08-07 07:06:00",1438956360,"C8",257040,1439213400,"2015-08-10 06:30:00"
"480","20151607071627-500",1,"2015-08-07 07:39:00",1438958340,"C4",541920,1439500260,"2015-08-13 14:11:00"
"2055","20151407071448-332",1,"2015-08-07 07:49:00",1438958940,"C8",96360,1439055300,"2015-08-08 10:35:00"
"3704","20154507064517-275",1,"2015-08-07 07:49:00",1438958940,"C4",103500,1439062440,"2015-08-08 12:34:00"
"2470","20152707072751-974",1,"2015-08-07 08:21:00",1438960860,"C8",130560,1439091420,"2015-08-08 20:37:00"
"1523","20150207080240-722",1,"2015-08-07 08:25:00",1438961100,"C8",554820,1439515920,"2015-08-13 18:32:00"
"2438","20152507072524-315",2,"2015-08-07 08:30:00",1438961400,"C3",210540,1439171940,"2015-08-09 18:59:00"
"658","20152207072213-862",3,"2015-08-07 08:33:00",1438961580,"C0",216120,1439177700,"2015-08-09 20:35:00"
"5243","20154107074130-137",2,"2015-08-07 08:35:00",1438961700,"C8",802860,1439764560,"2015-08-16 15:36:00"
"5837","20150807080814-971",1,"2015-08-07 08:36:00",1438961760,"C8",379260,1439341020,"2015-08-11 17:57:00"
"4082","20152507082537-2",1,"2015-08-07 08:55:00",1438962900,"C8",354780,1439317680,"2015-08-11 11:28:00"
"6483","20155707085753-292",2,"2015-08-07 09:39:00",1438965540,"C0",684720,1439650260,"2015-08-15 07:51:00"
"1979","20152607092603-350",2,"2015-08-07 09:47:00",1438966020,"C6",457020,1439423040,"2015-08-12 16:44:00"
"837","20153707093749-951",2,"2015-08-07 10:08:00",1438967280,"C3",119400,1439086680,"2015-08-08 19:18:00"
"6274","20150207100218-368",1,"2015-08-07 10:09:00",1438967340,"C8",164880,1439132220,"2015-08-09 07:57:00"
"1859","20154607094631-516",2,"2015-08-07 10:15:00",1438967700,"C5",434640,1439402340,"2015-08-12 10:59:00"
"834","20155407095436-165",2,"2015-08-07 10:16:00",1438967760,"C4",106260,1439074020,"2015-08-08 15:47:00"
"4491","20155407095431-303",3,"2015-08-07 10:28:00",1438968480,"C5",111300,1439079780,"2015-08-08 17:23:00"
"3966","20153207093226-553",1,"2015-08-07 10:36:00",1438968960,"C5",558840,1439527800,"2015-08-13 21:50:00"
"4230","20152707102724-384",1,"2015-08-07 10:50:00",1438969800,"C8",333960,1439303760,"2015-08-11 07:36:00"
"5953","20150207100246-511",1,"2015-08-07 10:50:00",1438969800,"C8",188400,1439158200,"2015-08-09 15:10:00"
"4177","20153107103116-521",1,"2015-08-07 10:52:00",1438969920,"C8",622200,1439592120,"2015-08-14 15:42:00"
"4641","20155807095823-910",3,"2015-08-07 10:52:00",1438969920,"C5",278340,1439248260,"2015-08-10 16:11:00"
"3181","20150207100251-836",1,"2015-08-07 11:10:00",1438971000,"C2",165900,1439136900,"2015-08-09 09:15:00"
"4072","20152007102018-450",1,"2015-08-07 11:10:00",1438971000,"C7",122100,1439093100,"2015-08-08 21:05:00"
"4507","20154407104408-451",2,"2015-08-07 11:14:00",1438971240,"C4",331380,1439302620,"2015-08-11 07:17:00"
"402","20153007113051-98",2,"2015-08-07 11:54:00",1438973640,"C5",431460,1439405100,"2015-08-12 11:45:00"
"6286","20155307115300-161",1,"2015-08-07 12:22:00",1438975320,"C4",70740,1439046060,"2015-08-08 08:01:00"
"4735","20154207114257-472",1,"2015-08-07 12:44:00",1438976640,"C4",624300,1439600940,"2015-08-14 18:09:00"
"2436","20153107123119-251",1,"2015-08-07 12:52:00",1438977120,"C8",248040,1439225160,"2015-08-10 09:46:00"
"6559","20151307121323-821",1,"2015-08-07 13:15:00",1438978500,"C4",118140,1439096640,"2015-08-08 22:04:00"
"5622","20153707123730-758",3,"2015-08-07 13:23:00",1438978980,"C6",169740,1439148720,"2015-08-09 12:32:00"
"373","20155807125802-565",1,"2015-08-07 13:27:00",1438979220,"C0",92280,1439071500,"2015-08-08 15:05:00"
"2249","20152207122249-225",3,"2015-08-07 13:30:00",1438979400,"C4",191460,1439170860,"2015-08-09 18:41:00"
"543","20155707125735-181",2,"2015-08-07 13:34:00",1438979640,"C2",245400,1439225040,"2015-08-10 09:44:00"
"2364","20154107124142-501",1,"2015-08-07 13:37:00",1438979820,"C8",117360,1439097180,"2015-08-08 22:13:00"
"5469","20151607011652-132",2,"2015-08-07 13:40:00",1438980000,"C5",197340,1439177340,"2015-08-09 20:29:00"
"4484","20154307124354-819",2,"2015-08-07 13:41:00",1438980060,"C5",117900,1439097960,"2015-08-08 22:26:00"
"2301","20151907011919-265",1,"2015-08-07 13:46:00",1438980360,"C4",755220,1439735580,"2015-08-16 07:33:00"
"5362","20151907011912-142",1,"2015-08-07 13:47:00",1438980420,"C5",356220,1439336640,"2015-08-11 16:44:00"
"4803","20151007011028-996",1,"2015-08-07 13:55:00",1438980900,"C8",76920,1439057820,"2015-08-08 11:17:00"
"4561","20154407014405-908",2,"2015-08-07 14:15:00",1438982100,"C8",256020,1439238120,"2015-08-10 13:22:00"
"2644","20155607015659-126",2,"2015-08-07 14:20:00",1438982400,"C7",81900,1439064300,"2015-08-08 13:05:00"
"2134","20150007020012-126",1,"2015-08-07 14:28:00",1438982880,"C3",492480,1439475360,"2015-08-13 07:16:00"
"3114","20152707022754-808",3,"2015-08-07 14:30:00",1438983000,"C6",165780,1439148780,"2015-08-09 12:33:00"
"5014","20151907021947-595",2,"2015-08-07 14:35:00",1438983300,"C0",159540,1439142840,"2015-08-09 10:54:00"
"6368","20154707014750-447",2,"2015-08-07 14:40:00",1438983600,"C5",191520,1439175120,"2015-08-09 19:52:00"
"6118","20152407022444-628",1,"2015-08-07 14:57:00",1438984620,"C5",180420,1439165040,"2015-08-09 17:04:00"
"1921","20150707020749-480",2,"2015-08-07 15:07:00",1438985220,"C2",264000,1439249220,"2015-08-10 16:27:00"
"578","20151307021320-869",1,"2015-08-07 15:11:00",1438985460,"C2",99360,1439084820,"2015-08-08 18:47:00"
"1862","20150307020308-823",1,"2015-08-07 15:12:00",1438985520,"C6",68580,1439054100,"2015-08-08 10:15:00"
"2385","20155507025512-789",2,"2015-08-07 15:20:00",1438986000,"C5",104640,1439090640,"2015-08-08 20:24:00"
"4773","20155107025107-822",1,"2015-08-07 15:23:00",1438986180,"C8",276480,1439262660,"2015-08-10 20:11:00"
"3419","20150207030221-800",2,"2015-08-07 15:27:00",1438986420,"C4",323820,1439310240,"2015-08-11 09:24:00"
"5094","20150607030644-318",1,"2015-08-07 15:37:00",1438987020,"C3",1200300,1440187320,"2015-08-21 13:02:00"
"4693","20152307032337-327",1,"2015-08-07 15:47:00",1438987620,"C4",575940,1439563560,"2015-08-14 07:46:00"
"363","20153107033125-767",1,"2015-08-07 15:53:00",1438987980,"C5",63120,1439051100,"2015-08-08 09:25:00"
"4609","20154519024544-322",2,"2015-08-07 15:55:00",1438988100,"C4",200880,1439188980,"2015-08-09 23:43:00"
"382","20151507031539-411",3,"2015-08-07 16:14:00",1438989240,"C7",333600,1439322840,"2015-08-11 12:54:00"
"1607","20151707041712-312",3,"2015-08-07 16:23:00",1438989780,"C8",181680,1439171460,"2015-08-09 18:51:00"
"559","20153507033523-248",2,"2015-08-07 16:30:00",1438990200,"C6",86760,1439076960,"2015-08-08 16:36:00"
"4496","20150607040626-348",2,"2015-08-07 16:38:00",1438990680,"C0",54000,1439044680,"2015-08-08 07:38:00"
"5106","20152307042315-347",2,"2015-08-07 16:41:00",1438990860,"C0",323580,1439314440,"2015-08-11 10:34:00"
"2723","20152107042148-742",1,"2015-08-07 16:57:00",1438991820,"C2",679140,1439670960,"2015-08-15 13:36:00"
"5484","20150607050608-159",2,"2015-08-07 17:11:00",1438992660,"C2",140400,1439133060,"2015-08-09 08:11:00"
"3191","20151507041515-490",1,"2015-08-07 17:12:00",1438992720,"C3",187560,1439180280,"2015-08-09 21:18:00"
"522","20150407050402-325",1,"2015-08-07 17:16:00",1438992960,"C3",451020,1439443980,"2015-08-12 22:33:00"
"2807","20150107050116-884",2,"2015-08-07 17:54:00",1438995240,"C7",593700,1439588940,"2015-08-14 14:49:00"
"2634","20150307050341-35",3,"2015-08-07 17:59:00",1438995540,"C7",259140,1439254680,"2015-08-10 17:58:00"
"2330","20153607053604-567",2,"2015-08-07 18:36:00",1438997760,"C3",57300,1439055060,"2015-08-08 10:31:00"
"3170","20155807055827-460",2,"2015-08-07 19:07:00",1438999620,"C3",411960,1439411580,"2015-08-12 13:33:00"
"1743","20152207052205-192",1,"2015-08-07 19:58:00",1439002680,"C2",96060,1439098740,"2015-08-08 22:39:00"
"6217","20151608061603-479",1,"2015-08-08 06:42:00",1439041320,"C8",367020,1439408340,"2015-08-12 12:39:00"
"912","20153308073320-351",1,"2015-08-08 07:41:00",1439044860,"C8",89880,1439134740,"2015-08-09 08:39:00"
"4716","20154408074420-516",1,"2015-08-08 07:59:00",1439045940,"C7",89760,1439135700,"2015-08-09 08:55:00"
"5521","20150908080923-414",3,"2015-08-08 08:15:00",1439046900,"C4",604080,1439650980,"2015-08-15 08:03:00"
"6451","20155208075242-780",3,"2015-08-08 08:24:00",1439047440,"C4",180780,1439228220,"2015-08-10 10:37:00"
"6209","20152608082638-702",2,"2015-08-08 08:33:00",1439047980,"C4",194760,1439242740,"2015-08-10 14:39:00"
"673","20155508075512-365",1,"2015-08-08 08:59:00",1439049540,"C2",458460,1439508000,"2015-08-13 16:20:00"
"3842","20150308080350-359",2,"2015-08-08 09:07:00",1439050020,"C4",294660,1439344680,"2015-08-11 18:58:00"
"66","20152508082517-666",1,"2015-08-08 09:17:00",1439050620,"C5",739020,1439789640,"2015-08-16 22:34:00"
"973","20155208085206-672",2,"2015-08-08 09:22:00",1439050920,"C5",300600,1439351520,"2015-08-11 20:52:00"
"2663","20151608091658-472",1,"2015-08-08 09:31:00",1439051460,"C7",101340,1439152800,"2015-08-09 13:40:00"
"2822","20153208083206-395",2,"2015-08-08 09:34:00",1439051640,"C5",79320,1439130960,"2015-08-09 07:36:00"
"3883","20150708090712-967",1,"2015-08-08 10:13:00",1439053980,"C2",337140,1439391120,"2015-08-12 07:52:00"
"4953","20152008102034-994",1,"2015-08-08 10:45:00",1439055900,"C8",69300,1439125200,"2015-08-09 06:00:00"
"2905","20151708101713-388",1,"2015-08-08 10:50:00",1439056200,"C5",387000,1439443200,"2015-08-12 22:20:00"
"4331","20150208100221-140",3,"2015-08-08 10:58:00",1439056680,"C7",112980,1439169660,"2015-08-09 18:21:00"
"6519","20151308101333-914",2,"2015-08-08 11:18:00",1439057880,"C0",1028280,1440086160,"2015-08-20 08:56:00"
"2834","20155308105343-910",1,"2015-08-08 11:27:00",1439058420,"C8",330900,1439389320,"2015-08-12 07:22:00"
"6148","20154708104711-651",2,"2015-08-08 11:28:00",1439058480,"C0",370380,1439428860,"2015-08-12 18:21:00"
"5895","20152208112234-845",1,"2015-08-08 11:29:00",1439058540,"C8",728820,1439787360,"2015-08-16 21:56:00"
"3679","20151908111910-929",1,"2015-08-08 11:42:00",1439059320,"C5",1389300,1440448620,"2015-08-24 13:37:00"
"93","20154508114523-645",1,"2015-08-08 11:50:00",1439059800,"C2",204720,1439264520,"2015-08-10 20:42:00"
"1345","20150108120140-67",1,"2015-08-08 12:30:00",1439062200,"C5",68460,1439130660,"2015-08-09 07:31:00"
"2734","20152108122142-303",2,"2015-08-08 12:48:00",1439063280,"C5",1396680,1440459960,"2015-08-24 16:46:00"
"4106","20153208123237-878",1,"2015-08-08 12:48:00",1439063280,"C0",345300,1439408580,"2015-08-12 12:43:00"
"6431","20154408124457-555",2,"2015-08-08 13:06:00",1439064360,"C5",267120,1439331480,"2015-08-11 15:18:00"
"85","20154008014020-3",2,"2015-08-08 14:05:00",1439067900,"C3",268500,1439336400,"2015-08-11 16:40:00"
"1960","20155108015134-360",3,"2015-08-08 14:15:00",1439068500,"C5",105780,1439174280,"2015-08-09 19:38:00"
"5968","20152208012227-661",3,"2015-08-08 14:17:00",1439068620,"C6",274560,1439343180,"2015-08-11 18:33:00"
"936","20154108014126-563",1,"2015-08-08 14:47:00",1439070420,"C6",537840,1439608260,"2015-08-14 20:11:00"
"2716","20150908020926-913",2,"2015-08-08 15:10:00",1439071800,"C2",715920,1439787720,"2015-08-16 22:02:00"
"1905","20155908025917-368",1,"2015-08-08 15:17:00",1439072220,"C6",260100,1439332320,"2015-08-11 15:32:00"
"2243","20155308025321-11",1,"2015-08-08 15:19:00",1439072340,"C5",930900,1440003240,"2015-08-19 09:54:00"
"881","20153508033513-874",1,"2015-08-08 15:41:00",1439073660,"C2",92940,1439166600,"2015-08-09 17:30:00"
"5333","20155508035530-98",1,"2015-08-08 16:25:00",1439076300,"C0",96120,1439172420,"2015-08-09 19:07:00"
"1439","20152008042053-423",1,"2015-08-08 16:37:00",1439077020,"C7",325380,1439402400,"2015-08-12 11:00:00"
"684","20154108034131-291",1,"2015-08-08 16:41:00",1439077260,"C5",178440,1439255700,"2015-08-10 18:15:00"
"3764","20154708044705-32",1,"2015-08-08 16:53:00",1439077980,"C8",239040,1439317020,"2015-08-11 11:17:00"
"5702","20154008044039-692",1,"2015-08-08 17:06:00",1439078760,"C5",105060,1439183820,"2015-08-09 22:17:00"
"299","20154408044436-655",2,"2015-08-08 17:09:00",1439078940,"C5",846600,1439925540,"2015-08-18 12:19:00"
"2885","20151308041318-416",1,"2015-08-08 17:14:00",1439079240,"C3",278940,1439358180,"2015-08-11 22:43:00"
"6214","20155308045321-417",1,"2015-08-08 17:22:00",1439079720,"C8",104640,1439184360,"2015-08-09 22:26:00"
"2441","20150208050254-21",2,"2015-08-08 17:23:00",1439079780,"C5",968940,1440048720,"2015-08-19 22:32:00"
"3938","20154708044711-639",1,"2015-08-08 17:28:00",1439080080,"C2",96780,1439176860,"2015-08-09 20:21:00"
"1375","20151808051800-604",1,"2015-08-08 17:51:00",1439081460,"C7",78420,1439159880,"2015-08-09 15:38:00"
"5602","20152408052435-531",2,"2015-08-08 17:52:00",1439081520,"C5",237780,1439319300,"2015-08-11 11:55:00"
"1424","20155008055031-646",1,"2015-08-08 17:57:00",1439081820,"C8",270360,1439352180,"2015-08-11 21:03:00"
"1306","20153108053138-793",1,"2015-08-08 18:04:00",1439082240,"C0",82800,1439165040,"2015-08-09 17:04:00"
"3676","20153408043401-757",3,"2015-08-08 18:14:00",1439082840,"C5",51240,1439134080,"2015-08-09 08:28:00"
"4524","20150108050153-619",3,"2015-08-08 18:17:00",1439083020,"C0",92160,1439175180,"2015-08-09 19:53:00"
"5051","20153508053556-774",1,"2015-08-08 18:41:00",1439084460,"C3",319260,1439403720,"2015-08-12 11:22:00"
"1202","20150109060133-67",1,"2015-08-09 06:07:00",1439125620,"C2",99900,1439225520,"2015-08-10 09:52:00"
"4731","20150809060853-307",2,"2015-08-09 06:42:00",1439127720,"C8",272880,1439400600,"2015-08-12 10:30:00"
"5888","20150009060037-852",1,"2015-08-09 06:54:00",1439128440,"C7",919140,1440047580,"2015-08-19 22:13:00"
"916","20155209065239-593",1,"2015-08-09 07:17:00",1439129820,"C5",119340,1439249160,"2015-08-10 16:26:00"
"5672","20153509063553-817",3,"2015-08-09 07:32:00",1439130720,"C8",697560,1439828280,"2015-08-17 09:18:00"
"4405","20152509072510-961",1,"2015-08-09 07:51:00",1439131860,"C4",196020,1439327880,"2015-08-11 14:18:00"
"5546","20152109072151-681",1,"2015-08-09 08:15:00",1439133300,"C8",204240,1439337540,"2015-08-11 16:59:00"
"652","20154009074056-552",1,"2015-08-09 08:28:00",1439134080,"C8",132120,1439266200,"2015-08-10 21:10:00"
"2009","20154909074911-878",1,"2015-08-09 08:42:00",1439134920,"C6",195540,1439330460,"2015-08-11 15:01:00"
"5341","20153209083207-54",1,"2015-08-09 09:26:00",1439137560,"C5",385920,1439523480,"2015-08-13 20:38:00"
"4622","20150409090411-319",1,"2015-08-09 09:27:00",1439137620,"C5",532740,1439670360,"2015-08-15 13:26:00"
"237","20153209093250-358",3,"2015-08-09 09:55:00",1439139300,"C8",1138320,1440277620,"2015-08-22 14:07:00"
"5187","20150109100114-5",3,"2015-08-09 11:00:00",1439143200,"C5",213060,1439356260,"2015-08-11 22:11:00"
"1336","20155409095404-1",1,"2015-08-09 11:04:00",1439143440,"C3",290520,1439433960,"2015-08-12 19:46:00"
"3","20150909100908-893",1,"2015-08-09 11:07:00",1439143620,"C5",128820,1439272440,"2015-08-10 22:54:00"
"2376","20151409101410-293",2,"2015-08-09 11:12:00",1439143920,"C4",251880,1439395800,"2015-08-12 09:10:00"
"225","20151109101115-984",1,"2015-08-09 11:19:00",1439144340,"C4",86700,1439231040,"2015-08-10 11:24:00"
"3668","20155009105054-571",2,"2015-08-09 11:24:00",1439144640,"C2",674880,1439819520,"2015-08-17 06:52:00"
"4051","20150509110512-433",2,"2015-08-09 11:28:00",1439144880,"C5",290340,1439435220,"2015-08-12 20:07:00"
"3624","20153309103304-690",1,"2015-08-09 11:29:00",1439144940,"C8",1450440,1440595380,"2015-08-26 06:23:00"
"4552","20152609102611-783",1,"2015-08-09 11:32:00",1439145120,"C3",528960,1439674080,"2015-08-15 14:28:00"
"817","20151409111437-111",2,"2015-08-09 11:39:00",1439145540,"C7",295620,1439441160,"2015-08-12 21:46:00"
"3356","20154509104501-59",2,"2015-08-09 11:51:00",1439146260,"C0",416340,1439562600,"2015-08-14 07:30:00"
"906","20152209112223-837",2,"2015-08-09 11:52:00",1439146320,"C0",66660,1439212980,"2015-08-10 06:23:00"
"4387","20151209111219-195",2,"2015-08-09 11:52:00",1439146320,"C7",331320,1439477640,"2015-08-13 07:54:00"
"5846","20155509115514-291",1,"2015-08-09 12:20:00",1439148000,"C5",107640,1439255640,"2015-08-10 18:14:00"
"102","20155109115123-786",1,"2015-08-09 12:25:00",1439148300,"C4",259680,1439407980,"2015-08-12 12:33:00"
"1662","20153509113502-414",1,"2015-08-09 12:27:00",1439148420,"C4",194820,1439343240,"2015-08-11 18:34:00"
"3480","20150909120927-426",1,"2015-08-09 12:32:00",1439148720,"C6",773400,1439922120,"2015-08-18 11:22:00"
"5295","20153209113252-119",1,"2015-08-09 12:36:00",1439148960,"C4",361500,1439510460,"2015-08-13 17:01:00"
"5387","20150709120708-806",3,"2015-08-09 12:39:00",1439149140,"C5",104820,1439253960,"2015-08-10 17:46:00"
"4242","20153609113649-758",1,"2015-08-09 12:42:00",1439149320,"C4",81300,1439230620,"2015-08-10 11:17:00"
"3172","20154809114818-832",1,"2015-08-09 13:00:00",1439150400,"C7",178800,1439329200,"2015-08-11 14:40:00"
"3555","20151809121805-29",1,"2015-08-09 13:13:00",1439151180,"C8",444180,1439595360,"2015-08-14 16:36:00"
"4977","20153909123939-465",3,"2015-08-09 13:16:00",1439151360,"C3",78180,1439229540,"2015-08-10 10:59:00"
"1055","20150509010550-822",2,"2015-08-09 13:42:00",1439152920,"C3",158100,1439311020,"2015-08-11 09:37:00"
"3784","20150809010801-971",1,"2015-08-09 13:44:00",1439153040,"C2",169980,1439323020,"2015-08-11 12:57:00"
"2398","20153409013402-796",1,"2015-08-09 13:58:00",1439153880,"C5",489780,1439643660,"2015-08-15 06:01:00"
"5523","20154109014116-716",2,"2015-08-09 14:18:00",1439155080,"C2",88320,1439243400,"2015-08-10 14:50:00"
"3481","20152109022102-894",3,"2015-08-09 14:28:00",1439155680,"C4",266100,1439421780,"2015-08-12 16:23:00"
"2263","20153609013658-819",3,"2015-08-09 14:32:00",1439155920,"C5",168180,1439324100,"2015-08-11 13:15:00"
"965","20150509020558-681",1,"2015-08-09 15:11:00",1439158260,"C7",145560,1439303820,"2015-08-11 07:37:00"
"2508","20150609030606-244",1,"2015-08-09 15:28:00",1439159280,"C6",251640,1439410920,"2015-08-12 13:22:00"
"4323","20153209023251-83",1,"2015-08-09 15:35:00",1439159700,"C8",62880,1439222580,"2015-08-10 09:03:00"
"1807","20152009032045-131",3,"2015-08-09 15:50:00",1439160600,"C0",668220,1439828820,"2015-08-17 09:27:00"
"232","20153609033627-164",2,"2015-08-09 15:53:00",1439160780,"C0",66060,1439226840,"2015-08-10 10:14:00"
"416","20153509033522-770",1,"2015-08-09 15:58:00",1439161080,"C5",363780,1439524860,"2015-08-13 21:01:00"
"46","20150109040106-69",3,"2015-08-09 16:33:00",1439163180,"C8",70620,1439233800,"2015-08-10 12:10:00"
"2798","20154709044740-841",1,"2015-08-09 17:09:00",1439165340,"C4",89580,1439254920,"2015-08-10 18:02:00"
"5069","20154709044702-412",3,"2015-08-09 17:12:00",1439165520,"C7",261480,1439427000,"2015-08-12 17:50:00"
"4824","20154309044344-578",3,"2015-08-09 17:15:00",1439165700,"C6",49380,1439215080,"2015-08-10 06:58:00"
"5962","20151309041300-869",1,"2015-08-09 17:17:00",1439165820,"C3",81180,1439247000,"2015-08-10 15:50:00"
"76","20152309042301-368",2,"2015-08-09 17:19:00",1439165940,"C4",157560,1439323500,"2015-08-11 13:05:00"
"438","20153109043127-486",3,"2015-08-09 17:31:00",1439166660,"C2",352620,1439519280,"2015-08-13 19:28:00"
"2940","20154209044216-651",2,"2015-08-09 17:34:00",1439166840,"C5",70260,1439237100,"2015-08-10 13:05:00"
"4486","20151309051316-267",3,"2015-08-09 17:39:00",1439167140,"C5",55800,1439222940,"2015-08-10 09:09:00"
"4487","20152109052119-324",1,"2015-08-09 17:39:00",1439167140,"C6",150840,1439317980,"2015-08-11 11:33:00"
"6490","20151409051437-834",2,"2015-08-09 17:41:00",1439167260,"C4",57540,1439224800,"2015-08-10 09:40:00"
"3479","20150609050629-558",3,"2015-08-09 17:58:00",1439168280,"C6",54300,1439222580,"2015-08-10 09:03:00"
"6303","20154309054331-529",3,"2015-08-09 18:01:00",1439168460,"C6",57900,1439226360,"2015-08-10 10:06:00"
"4100","20152509052554-869",1,"2015-08-09 18:06:00",1439168760,"C2",253500,1439422260,"2015-08-12 16:31:00"
"1022","20151909051914-299",1,"2015-08-09 18:29:00",1439170140,"C7",865500,1440035640,"2015-08-19 18:54:00"
"5114","20155409055424-104",1,"2015-08-09 18:48:00",1439171280,"C4",485280,1439656560,"2015-08-15 09:36:00"
"1111","20150309030327-506",3,"2015-08-09 19:00:00",1439172000,"C5",53580,1439225580,"2015-08-10 09:53:00"
"4105","20152010062058-60",1,"2015-08-10 06:53:00",1439214780,"C4",221760,1439436540,"2015-08-12 20:29:00"
"3060","20151410061424-60",1,"2015-08-10 07:07:00",1439215620,"C5",126420,1439342040,"2015-08-11 18:14:00"
"2562","20152310062340-347",1,"2015-08-10 07:13:00",1439215980,"C7",114000,1439329980,"2015-08-11 14:53:00"
"693","20155410075450-130",1,"2015-08-10 08:01:00",1439218860,"C2",483900,1439702760,"2015-08-15 22:26:00"
"4534","20150010080005-370",1,"2015-08-10 08:06:00",1439219160,"C4",103560,1439322720,"2015-08-11 12:52:00"
"3346","20153710073716-970",1,"2015-08-10 08:07:00",1439219220,"C3",85020,1439304240,"2015-08-11 07:44:00"
"6409","20153310073359-286",3,"2015-08-10 08:10:00",1439219400,"C2",88200,1439307600,"2015-08-11 08:40:00"
"3722","20155110075150-591",1,"2015-08-10 09:00:00",1439222400,"C6",454560,1439676960,"2015-08-15 15:16:00"
"4236","20150610080607-677",1,"2015-08-10 09:11:00",1439223060,"C6",207420,1439430480,"2015-08-12 18:48:00"
"566","20152510092527-332",1,"2015-08-10 09:32:00",1439224320,"C8",439560,1439663880,"2015-08-15 11:38:00"
"6417","20151110101156-652",2,"2015-08-10 10:34:00",1439228040,"C5",100500,1439328540,"2015-08-11 14:29:00"
"6442","20150210100228-734",1,"2015-08-10 10:45:00",1439228700,"C2",431940,1439660640,"2015-08-15 10:44:00"
"383","20155210105230-671",1,"2015-08-10 11:20:00",1439230800,"C4",1329120,1440559920,"2015-08-25 20:32:00"
"5038","20153110103147-254",3,"2015-08-10 11:28:00",1439231280,"C6",449100,1439680380,"2015-08-15 16:13:00"
"4809","20153310103325-597",3,"2015-08-10 11:31:00",1439231460,"C3",1708800,1440940260,"2015-08-30 06:11:00"
"5608","20153910113938-766",3,"2015-08-10 11:46:00",1439232360,"C8",189300,1439421660,"2015-08-12 16:21:00"
"1454","20155310105320-51",2,"2015-08-10 11:52:00",1439232720,"C8",510180,1439742900,"2015-08-16 09:35:00"
"1541","20152610112615-740",1,"2015-08-10 11:55:00",1439232900,"C2",187140,1439420040,"2015-08-12 15:54:00"
"281","20151710111713-168",3,"2015-08-10 12:03:00",1439233380,"C8",107040,1439340420,"2015-08-11 17:47:00"
"2547","20151910111953-81",2,"2015-08-10 12:22:00",1439234520,"C4",327360,1439561880,"2015-08-14 07:18:00"
"5108","20154510114523-240",1,"2015-08-10 12:44:00",1439235840,"C4",369600,1439605440,"2015-08-14 19:24:00"
"3474","20153610123659-887",3,"2015-08-10 13:16:00",1439237760,"C7",66120,1439303880,"2015-08-11 07:38:00"
"2643","20152710122745-528",1,"2015-08-10 13:31:00",1439238660,"C3",1486500,1440725160,"2015-08-27 18:26:00"
"169","20155810125837-406",1,"2015-08-10 13:34:00",1439238840,"C0",351120,1439589960,"2015-08-14 15:06:00"
"2122","20154810124843-713",3,"2015-08-10 13:51:00",1439239860,"C2",514800,1439754660,"2015-08-16 12:51:00"
"1509","20151210021258-493",1,"2015-08-10 14:19:00",1439241540,"C4",111420,1439352960,"2015-08-11 21:16:00"
"4437","20153710023738-627",1,"2015-08-10 14:44:00",1439243040,"C4",283020,1439526060,"2015-08-13 21:21:00"
"1970","20154910024932-203",1,"2015-08-10 15:14:00",1439244840,"C5",233640,1439478480,"2015-08-13 08:08:00"
"6348","20152710022715-872",1,"2015-08-10 15:24:00",1439245440,"C7",95460,1439340900,"2015-08-11 17:55:00"
"2843","20151910031914-568",1,"2015-08-10 15:25:00",1439245500,"C8",352200,1439597700,"2015-08-14 17:15:00"
"1253","20155010025035-931",3,"2015-08-10 15:49:00",1439246940,"C5",183660,1439430600,"2015-08-12 18:50:00"
"3071","20154610024627-393",3,"2015-08-10 15:49:00",1439246940,"C8",87540,1439334480,"2015-08-11 16:08:00"
"3165","20150110030105-67",3,"2015-08-10 15:56:00",1439247360,"C7",595740,1439843100,"2015-08-17 13:25:00"
"2231","20153910033927-41",1,"2015-08-10 16:11:00",1439248260,"C5",946860,1440195120,"2015-08-21 15:12:00"
"5589","20155910035914-610",3,"2015-08-10 16:24:00",1439249040,"C8",228540,1439477580,"2015-08-13 07:53:00"
"4057","20155410035426-585",1,"2015-08-10 16:48:00",1439250480,"C8",81660,1439332140,"2015-08-11 15:29:00"
"4748","20150010040007-631",2,"2015-08-10 16:51:00",1439250660,"C6",95220,1439345880,"2015-08-11 19:18:00"
"5816","20150510040554-767",1,"2015-08-10 17:08:00",1439251680,"C2",311520,1439563200,"2015-08-14 07:40:00"
"5075","20151510051559-717",1,"2015-08-10 17:22:00",1439252520,"C2",224760,1439477280,"2015-08-13 07:48:00"
"884","20153010043052-895",2,"2015-08-10 17:34:00",1439253240,"C3",61320,1439314560,"2015-08-11 10:36:00"
"1952","20150310050337-557",1,"2015-08-10 17:42:00",1439253720,"C3",83100,1439336820,"2015-08-11 16:47:00"
"5252","20154310044355-435",1,"2015-08-10 17:49:00",1439254140,"C8",443400,1439697540,"2015-08-15 20:59:00"
"6173","20154310044352-738",1,"2015-08-10 17:50:00",1439254200,"C3",255600,1439509800,"2015-08-13 16:50:00"
"1524","20155310055324-613",1,"2015-08-10 17:59:00",1439254740,"C2",251340,1439506080,"2015-08-13 15:48:00"
"442","20155710055728-180",3,"2015-08-10 18:24:00",1439256240,"C4",60780,1439317020,"2015-08-11 11:17:00"
"2407","20155410055413-237",2,"2015-08-10 18:28:00",1439256480,"C6",418980,1439675460,"2015-08-15 14:51:00"
"5445","20153310053343-896",3,"2015-08-10 18:31:00",1439256660,"C4",155460,1439412120,"2015-08-12 13:42:00"
"2345","20155610055653-905",2,"2015-08-10 18:33:00",1439256780,"C3",90960,1439347740,"2015-08-11 19:49:00"
"2903","20151211061241-520",1,"2015-08-11 06:14:00",1439298840,"C6",207000,1439505840,"2015-08-13 15:44:00"
"2147","20150911060927-249",2,"2015-08-11 06:15:00",1439298900,"C8",191940,1439490840,"2015-08-13 11:34:00"
"2515","20152911062908-132",3,"2015-08-11 07:00:00",1439301600,"C2",138600,1439440200,"2015-08-12 21:30:00"
"3138","20154711064710-266",3,"2015-08-11 07:08:00",1439302080,"C7",113220,1439415300,"2015-08-12 14:35:00"
"3034","20153711063717-524",1,"2015-08-11 07:38:00",1439303880,"C5",198120,1439502000,"2015-08-13 14:40:00"
"1507","20151711071703-72",1,"2015-08-11 07:45:00",1439304300,"C8",266460,1439570760,"2015-08-14 09:46:00"
"5399","20152211072207-967",1,"2015-08-11 07:45:00",1439304300,"C7",169860,1439474160,"2015-08-13 06:56:00"
"5411","20153711073708-752",1,"2015-08-11 08:35:00",1439307300,"C7",299220,1439606520,"2015-08-14 19:42:00"
"4033","20150911080911-37",2,"2015-08-11 08:38:00",1439307480,"C4",298980,1439606460,"2015-08-14 19:41:00"
"1203","20150511080548-765",3,"2015-08-11 08:44:00",1439307840,"C3",364620,1439672460,"2015-08-15 14:01:00"
"1166","20151511081530-342",1,"2015-08-11 08:47:00",1439308020,"C2",131640,1439439660,"2015-08-12 21:21:00"
"1975","20155211075244-304",1,"2015-08-11 08:57:00",1439308620,"C4",170940,1439479560,"2015-08-13 08:26:00"
"4550","20155611085614-73",1,"2015-08-11 09:19:00",1439309940,"C4",161160,1439471100,"2015-08-13 06:05:00"
"2408","20151211091201-575",2,"2015-08-11 09:28:00",1439310480,"C7",295560,1439606040,"2015-08-14 19:34:00"
"163","20153011093025-374",1,"2015-08-11 10:03:00",1439312580,"C4",92400,1439404980,"2015-08-12 11:43:00"
"3151","20153711093723-390",1,"2015-08-11 10:39:00",1439314740,"C5",121680,1439436420,"2015-08-12 20:27:00"
"1722","20154211104241-339",1,"2015-08-11 11:04:00",1439316240,"C5",68700,1439384940,"2015-08-12 06:09:00"
"6370","20155511105504-943",1,"2015-08-11 11:06:00",1439316360,"C3",792720,1440109080,"2015-08-20 15:18:00"
"4311","20153411103429-694",1,"2015-08-11 11:29:00",1439317740,"C8",386640,1439704380,"2015-08-15 22:53:00"
"5517","20151511111500-654",3,"2015-08-11 11:36:00",1439318160,"C7",597900,1439916060,"2015-08-18 09:41:00"
"6166","20150411120449-453",2,"2015-08-11 12:28:00",1439321280,"C4",122520,1439443800,"2015-08-12 22:30:00"
"2992","20153311113346-259",1,"2015-08-11 12:36:00",1439321760,"C4",170340,1439492100,"2015-08-13 11:55:00"
"1239","20153811123837-345",3,"2015-08-11 13:08:00",1439323680,"C6",180420,1439504100,"2015-08-13 15:15:00"
"2937","20153711013755-30",1,"2015-08-11 13:59:00",1439326740,"C4",66000,1439392740,"2015-08-12 08:19:00"
"2334","20154011014002-294",1,"2015-08-11 14:15:00",1439327700,"C0",184020,1439511720,"2015-08-13 17:22:00"
"5792","20150411020405-25",3,"2015-08-11 14:31:00",1439328660,"C4",287040,1439615700,"2015-08-14 22:15:00"
"2614","20152611022615-260",1,"2015-08-11 15:28:00",1439332080,"C4",608400,1439940480,"2015-08-18 16:28:00"
"719","20151411031453-479",2,"2015-08-11 15:53:00",1439333580,"C2",522720,1439856300,"2015-08-17 17:05:00"
"3293","20155411025401-133",3,"2015-08-11 15:58:00",1439333880,"C0",758280,1440092160,"2015-08-20 10:36:00"
"1496","20154311034317-220",1,"2015-08-11 16:15:00",1439334900,"C8",314280,1439649180,"2015-08-15 07:33:00"
"3339","20154311044358-220",2,"2015-08-11 16:49:00",1439336940,"C2",172740,1439509680,"2015-08-13 16:48:00"
"2966","20150311040359-426",1,"2015-08-11 16:59:00",1439337540,"C5",252960,1439590500,"2015-08-14 15:15:00"
"5329","20153111043111-321",2,"2015-08-11 17:01:00",1439337660,"C4",308760,1439646420,"2015-08-15 06:47:00"
"1550","20151911041901-689",3,"2015-08-11 17:26:00",1439339160,"C6",69840,1439409000,"2015-08-12 12:50:00"
"3804","20152911042945-827",3,"2015-08-11 17:36:00",1439339760,"C3",826740,1440166500,"2015-08-21 07:15:00"
"5239","20153111053127-294",2,"2015-08-11 17:56:00",1439340960,"C7",134400,1439475360,"2015-08-13 07:16:00"
"1766","20155611055605-588",3,"2015-08-11 17:58:00",1439341080,"C6",776640,1440117720,"2015-08-20 17:42:00"
"2602","20151812061805-214",1,"2015-08-12 06:47:00",1439387220,"C2",288240,1439675460,"2015-08-15 14:51:00"
"1047","20150412070442-715",2,"2015-08-12 07:12:00",1439388720,"C4",714480,1440103200,"2015-08-20 13:40:00"
"308","20150312070334-705",1,"2015-08-12 07:37:00",1439390220,"C4",99420,1439489640,"2015-08-13 11:14:00"
"5497","20155012065005-217",1,"2015-08-12 07:48:00",1439390880,"C3",276780,1439667660,"2015-08-15 12:41:00"
"5420","20150112080156-678",3,"2015-08-12 08:15:00",1439392500,"C7",342900,1439735400,"2015-08-16 07:30:00"
"3915","20152712082719-296",1,"2015-08-12 08:34:00",1439393640,"C8",132180,1439525820,"2015-08-13 21:17:00"
"3100","20150112080120-851",2,"2015-08-12 08:37:00",1439393820,"C3",81900,1439475720,"2015-08-13 07:22:00"
"3021","20153012083040-807",1,"2015-08-12 08:38:00",1439393880,"C4",1402800,1440796680,"2015-08-28 14:18:00"
"5754","20151712081746-902",3,"2015-08-12 08:59:00",1439395140,"C0",515400,1439910540,"2015-08-18 08:09:00"
"1445","20151412081447-295",1,"2015-08-12 09:08:00",1439395680,"C5",517560,1439913240,"2015-08-18 08:54:00"
"2316","20154212084212-789",1,"2015-08-12 09:34:00",1439397240,"C5",617160,1440014400,"2015-08-19 13:00:00"
"4772","20154512084511-218",2,"2015-08-12 09:45:00",1439397900,"C4",454980,1439852880,"2015-08-17 16:08:00"
"5894","20153912083903-728",1,"2015-08-12 09:45:00",1439397900,"C2",212160,1439610060,"2015-08-14 20:41:00"
"1712","20153912093939-687",1,"2015-08-12 10:05:00",1439399100,"C4",643800,1440042900,"2015-08-19 20:55:00"
"922","20153412103450-486",1,"2015-08-12 10:45:00",1439401500,"C3",531000,1439932500,"2015-08-18 14:15:00"
"4918","20150112110110-857",1,"2015-08-12 11:07:00",1439402820,"C2",358500,1439761320,"2015-08-16 14:42:00"
"3922","20152312112319-869",2,"2015-08-12 11:40:00",1439404800,"C7",359400,1439764200,"2015-08-16 15:30:00"
"3025","20154212104211-65",1,"2015-08-12 11:41:00",1439404860,"C4",207120,1439611980,"2015-08-14 21:13:00"
"4677","20152212112246-498",1,"2015-08-12 11:47:00",1439405220,"C5",283860,1439689080,"2015-08-15 18:38:00"
"4444","20153112113145-165",2,"2015-08-12 12:04:00",1439406240,"C2",548340,1439954580,"2015-08-18 20:23:00"
"3851","20154312114332-412",1,"2015-08-12 12:12:00",1439406720,"C3",87120,1439493840,"2015-08-13 12:24:00"
"6019","20155812115832-295",1,"2015-08-12 12:44:00",1439408640,"C8",151980,1439560620,"2015-08-14 06:57:00"
"2722","20151612121658-752",1,"2015-08-12 13:23:00",1439410980,"C8",70080,1439481060,"2015-08-13 08:51:00"
"1672","20154912014924-804",2,"2015-08-12 13:54:00",1439412840,"C2",251400,1439664240,"2015-08-15 11:44:00"
"1300","20153312023359-569",1,"2015-08-12 14:44:00",1439415840,"C3",806520,1440222360,"2015-08-21 22:46:00"
"1129","20154812014855-638",2,"2015-08-12 14:50:00",1439416200,"C2",142260,1439558460,"2015-08-14 06:21:00"
"437","20155012025014-139",1,"2015-08-12 14:52:00",1439416320,"C6",236100,1439652420,"2015-08-15 08:27:00"
"5960","20154412024403-809",1,"2015-08-12 14:58:00",1439416680,"C7",189120,1439605800,"2015-08-14 19:30:00"
"6170","20152412032434-101",1,"2015-08-12 16:21:00",1439421660,"C4",54420,1439476080,"2015-08-13 07:28:00"
"2735","20154812034822-196",3,"2015-08-12 16:54:00",1439423640,"C3",342960,1439766600,"2015-08-16 16:10:00"
"3537","20154212044243-346",1,"2015-08-12 17:06:00",1439424360,"C7",189720,1439614080,"2015-08-14 21:48:00"
"1056","20154212044215-152",1,"2015-08-12 17:08:00",1439424480,"C4",309000,1439733480,"2015-08-16 06:58:00"
"2660","20153612043651-254",1,"2015-08-12 17:12:00",1439424720,"C8",159660,1439584380,"2015-08-14 13:33:00"
"5729","20153612043649-569",3,"2015-08-12 17:35:00",1439426100,"C3",875340,1440301440,"2015-08-22 20:44:00"
"3127","20150812050800-581",1,"2015-08-12 17:56:00",1439427360,"C7",61680,1439489040,"2015-08-13 11:04:00"
"251","20155512045556-420",3,"2015-08-12 18:02:00",1439427720,"C2",529860,1439957580,"2015-08-18 21:13:00"
"1620","20151212051226-954",3,"2015-08-12 18:08:00",1439428080,"C4",79020,1439507100,"2015-08-13 16:05:00"
"4076","20153412053414-307",3,"2015-08-12 18:23:00",1439428980,"C6",172800,1439601780,"2015-08-14 18:23:00"
"6072","20150613070601-595",2,"2015-08-13 07:12:00",1439475120,"C8",137040,1439612160,"2015-08-14 21:16:00"
"3554","20155413065431-352",1,"2015-08-13 07:52:00",1439477520,"C5",224820,1439702340,"2015-08-15 22:19:00"
"5583","20153813083855-252",1,"2015-08-13 09:02:00",1439481720,"C4",383340,1439865060,"2015-08-17 19:31:00"
"5101","20150713090739-797",1,"2015-08-13 09:30:00",1439483400,"C8",288240,1439771640,"2015-08-16 17:34:00"
"3244","20151413091400-23",3,"2015-08-13 09:48:00",1439484480,"C8",289380,1439773860,"2015-08-16 18:11:00"
"1698","20152913092907-731",1,"2015-08-13 10:02:00",1439485320,"C6",118500,1439603820,"2015-08-14 18:57:00"
"4885","20155213095235-98",2,"2015-08-13 10:15:00",1439486100,"C4",161820,1439647920,"2015-08-15 07:12:00"
"5744","20152513092548-480",1,"2015-08-13 10:28:00",1439486880,"C4",352980,1439839860,"2015-08-17 12:31:00"
"4266","20155913095938-39",1,"2015-08-13 10:58:00",1439488680,"C5",439260,1439927940,"2015-08-18 12:59:00"
"2346","20150213100239-978",2,"2015-08-13 11:04:00",1439489040,"C5",292380,1439781420,"2015-08-16 20:17:00"
"1061","20153013113037-790",1,"2015-08-13 11:41:00",1439491260,"C3",290760,1439782020,"2015-08-16 20:27:00"
"429","20150613110621-217",1,"2015-08-13 12:05:00",1439492700,"C5",429540,1439922240,"2015-08-18 11:24:00"
"806","20150113120141-485",1,"2015-08-13 12:08:00",1439492880,"C8",171060,1439663940,"2015-08-15 11:39:00"
"3183","20152913112925-155",1,"2015-08-13 12:25:00",1439493900,"C5",104520,1439598420,"2015-08-14 17:27:00"
"4294","20151913121932-661",3,"2015-08-13 12:33:00",1439494380,"C0",978180,1440472560,"2015-08-24 20:16:00"
"659","20152713122742-24",1,"2015-08-13 12:34:00",1439494440,"C8",88200,1439582640,"2015-08-14 13:04:00"
"394","20153813123814-541",1,"2015-08-13 13:36:00",1439498160,"C4",105540,1439603700,"2015-08-14 18:55:00"
"1264","20153213013249-868",1,"2015-08-13 13:55:00",1439499300,"C5",417900,1439917200,"2015-08-18 10:00:00"
"737","20154513024507-271",1,"2015-08-13 14:52:00",1439502720,"C4",1099560,1440602280,"2015-08-26 08:18:00"
"728","20152013022053-492",2,"2015-08-13 15:28:00",1439504880,"C3",245280,1439750160,"2015-08-16 11:36:00"
"3816","20153913023914-536",2,"2015-08-13 15:39:00",1439505540,"C5",258420,1439763960,"2015-08-16 15:26:00"
"3539","20155813025810-185",3,"2015-08-13 15:51:00",1439506260,"C4",171420,1439677680,"2015-08-15 15:28:00"
"4997","20151813031829-984",2,"2015-08-13 16:19:00",1439507940,"C0",63480,1439571420,"2015-08-14 09:57:00"
"3772","20151513041529-826",3,"2015-08-13 16:43:00",1439509380,"C4",80220,1439589600,"2015-08-14 15:00:00"
"2352","20155613045650-872",1,"2015-08-13 17:04:00",1439510640,"C4",59760,1439570400,"2015-08-14 09:40:00"
"5623","20152813042852-20",2,"2015-08-13 17:07:00",1439510820,"C0",397080,1439907900,"2015-08-18 07:25:00"
"6312","20150514060535-722",1,"2015-08-14 06:07:00",1439557620,"C6",394560,1439952180,"2015-08-18 19:43:00"
"185","20150714060734-528",1,"2015-08-14 06:30:00",1439559000,"C4",358320,1439917320,"2015-08-18 10:02:00"
"4088","20153214063240-340",1,"2015-08-14 06:35:00",1439559300,"C6",627420,1440186720,"2015-08-21 12:52:00"
"1900","20151714061754-756",1,"2015-08-14 06:44:00",1439559840,"C4",403260,1439963100,"2015-08-18 22:45:00"
"3598","20154314064318-347",2,"2015-08-14 06:50:00",1439560200,"C4",259980,1439820180,"2015-08-17 07:03:00"
"2347","20152314062351-552",1,"2015-08-14 06:55:00",1439560500,"C3",560460,1440120960,"2015-08-20 18:36:00"
"5758","20152814062834-4",1,"2015-08-14 07:00:00",1439560800,"C2",290520,1439851320,"2015-08-17 15:42:00"
"4759","20150414060406-461",2,"2015-08-14 07:04:00",1439561040,"C2",1306260,1440867300,"2015-08-29 09:55:00"
"4440","20154214064217-704",1,"2015-08-14 07:07:00",1439561220,"C7",1406880,1440968100,"2015-08-30 13:55:00"
"5071","20151114071121-782",2,"2015-08-14 07:26:00",1439562360,"C0",128160,1439690520,"2015-08-15 19:02:00"
"3317","20150214070255-757",1,"2015-08-14 07:34:00",1439562840,"C7",132660,1439695500,"2015-08-15 20:25:00"
"2749","20154714074732-183",3,"2015-08-14 07:54:00",1439564040,"C8",309480,1439873520,"2015-08-17 21:52:00"
"4525","20150114070109-176",2,"2015-08-14 07:56:00",1439564160,"C5",136860,1439701020,"2015-08-15 21:57:00"
"580","20155414075423-495",1,"2015-08-14 08:21:00",1439565660,"C5",201540,1439767200,"2015-08-16 16:20:00"
"5077","20152314082352-547",2,"2015-08-14 08:30:00",1439566200,"C4",458340,1440024540,"2015-08-19 15:49:00"
"2120","20155314085317-744",3,"2015-08-14 08:58:00",1439567880,"C2",184620,1439752500,"2015-08-16 12:15:00"
"6127","20150914080950-53",1,"2015-08-14 09:15:00",1439568900,"C5",170340,1439739240,"2015-08-16 08:34:00"
"1589","20151714081717-477",3,"2015-08-14 09:24:00",1439569440,"C5",130260,1439699700,"2015-08-15 21:35:00"
"3864","20150714090715-693",1,"2015-08-14 09:26:00",1439569560,"C6",365580,1439935140,"2015-08-18 14:59:00"
"1658","20150514090525-937",3,"2015-08-14 09:28:00",1439569680,"C5",88380,1439658060,"2015-08-15 10:01:00"
"1355","20150514090518-434",2,"2015-08-14 09:37:00",1439570220,"C5",203700,1439773920,"2015-08-16 18:12:00"
"5481","20150314100300-561",2,"2015-08-14 10:25:00",1439573100,"C6",112680,1439685780,"2015-08-15 17:43:00"
"3852","20155814095824-763",1,"2015-08-14 10:26:00",1439573160,"C4",114480,1439687640,"2015-08-15 18:14:00"
"4560","20150014100049-755",2,"2015-08-14 10:34:00",1439573640,"C8",346080,1439919720,"2015-08-18 10:42:00"
"2390","20153714093734-926",2,"2015-08-14 10:41:00",1439574060,"C8",725820,1440299880,"2015-08-22 20:18:00"
"3283","20153114093133-433",2,"2015-08-14 10:43:00",1439574180,"C7",70020,1439644200,"2015-08-15 06:10:00"
"810","20155114095131-368",2,"2015-08-14 11:04:00",1439575440,"C2",68640,1439644080,"2015-08-15 06:08:00"
"4969","20150514100544-988",2,"2015-08-14 11:14:00",1439576040,"C2",365940,1439941980,"2015-08-18 16:53:00"
"1707","20154114104153-864",1,"2015-08-14 11:16:00",1439576160,"C0",198840,1439775000,"2015-08-16 18:30:00"
"3989","20150214110230-668",1,"2015-08-14 11:32:00",1439577120,"C0",245280,1439822400,"2015-08-17 07:40:00"
"5009","20151514111539-957",1,"2015-08-14 11:44:00",1439577840,"C5",186900,1439764740,"2015-08-16 15:39:00"
"5796","20151514111535-583",1,"2015-08-14 11:44:00",1439577840,"C0",153720,1439731560,"2015-08-16 06:26:00"
"5174","20152414112403-762",2,"2015-08-14 11:53:00",1439578380,"C5",114900,1439693280,"2015-08-15 19:48:00"
"5555","20154614114643-419",1,"2015-08-14 11:54:00",1439578440,"C8",446280,1440024720,"2015-08-19 15:52:00"
"4276","20154514114507-203",3,"2015-08-14 12:11:00",1439579460,"C4",633060,1440212520,"2015-08-21 20:02:00"
"5446","20151114121111-116",2,"2015-08-14 12:35:00",1439580900,"C8",101460,1439682360,"2015-08-15 16:46:00"
"2171","20153614113645-637",1,"2015-08-14 12:40:00",1439581200,"C6",96840,1439678040,"2015-08-15 15:34:00"
"1493","20155514115538-38",1,"2015-08-14 12:53:00",1439581980,"C7",277920,1439859900,"2015-08-17 18:05:00"
"273","20152614122614-782",2,"2015-08-14 12:57:00",1439582220,"C6",111660,1439693880,"2015-08-15 19:58:00"
"2224","20152814122805-968",2,"2015-08-14 13:01:00",1439582460,"C0",533700,1440116160,"2015-08-20 17:16:00"
"4813","20151614121612-952",1,"2015-08-14 13:20:00",1439583600,"C6",111000,1439694600,"2015-08-15 20:10:00"
"2571","20151914011913-652",3,"2015-08-14 13:25:00",1439583900,"C2",159660,1439743560,"2015-08-16 09:46:00"
"5156","20153614123621-352",3,"2015-08-14 13:27:00",1439584020,"C4",329460,1439913480,"2015-08-18 08:58:00"
"1789","20151314011311-1",3,"2015-08-14 14:20:00",1439587200,"C2",545100,1440132300,"2015-08-20 21:45:00"
"5720","20155114015106-386",2,"2015-08-14 14:48:00",1439588880,"C6",195720,1439784600,"2015-08-16 21:10:00"
"4321","20152714022709-931",2,"2015-08-14 14:59:00",1439589540,"C5",159120,1439748660,"2015-08-16 11:11:00"
"2143","20153914023947-993",1,"2015-08-14 15:05:00",1439589900,"C4",416220,1440006120,"2015-08-19 10:42:00"
"3632","20150214020240-113",1,"2015-08-14 15:07:00",1439590020,"C2",105480,1439695500,"2015-08-15 20:25:00"
"1211","20154514024558-986",3,"2015-08-14 15:10:00",1439590200,"C5",1198440,1440788640,"2015-08-28 12:04:00"
"5221","20150014030027-293",2,"2015-08-14 15:29:00",1439591340,"C4",78240,1439669580,"2015-08-15 13:13:00"
"1837","20154014024032-779",3,"2015-08-14 15:44:00",1439592240,"C5",253200,1439845440,"2015-08-17 14:04:00"
"4610","20154519024544-322",2,"2015-08-14 15:55:00",1439592900,"C4",202080,1439794980,"2015-08-17 00:03:00"
"3826","20152614032611-671",1,"2015-08-14 15:58:00",1439593080,"C4",680400,1440273480,"2015-08-22 12:58:00"
"970","20153114033108-799",1,"2015-08-14 16:01:00",1439593260,"C8",106740,1439700000,"2015-08-15 21:40:00"
"60","20154114034126-781",1,"2015-08-14 16:05:00",1439593500,"C8",270060,1439863560,"2015-08-17 19:06:00"
"3789","20150914030948-203",2,"2015-08-14 16:05:00",1439593500,"C3",56760,1439650260,"2015-08-15 07:51:00"
"5030","20151514031512-498",1,"2015-08-14 16:14:00",1439594040,"C8",61860,1439655900,"2015-08-15 09:25:00"
"1781","20151914041953-619",1,"2015-08-14 16:44:00",1439595840,"C5",154200,1439750040,"2015-08-16 11:34:00"
"2697","20153014043029-662",2,"2015-08-14 16:59:00",1439596740,"C4",58560,1439655300,"2015-08-15 09:15:00"
"4365","20153914043919-947",1,"2015-08-14 17:04:00",1439597040,"C3",401580,1439998620,"2015-08-19 08:37:00"
"1911","20150914040900-949",2,"2015-08-14 17:06:00",1439597160,"C3",253980,1439851140,"2015-08-17 15:39:00"
"1855","20154314044331-360",2,"2015-08-14 17:10:00",1439597400,"C5",491760,1440089160,"2015-08-20 09:46:00"
"1152","20152914042953-652",3,"2015-08-14 17:21:00",1439598060,"C6",277320,1439875380,"2015-08-17 22:23:00"
"6306","20154214044236-934",2,"2015-08-14 17:23:00",1439598180,"C0",224460,1439822640,"2015-08-17 07:44:00"
"902","20155914045902-906",1,"2015-08-14 17:25:00",1439598300,"C8",189840,1439788140,"2015-08-16 22:09:00"
"4587","20154314054309-806",1,"2015-08-14 18:03:00",1439600580,"C8",857160,1440457740,"2015-08-24 16:09:00"
"2871","20151814051808-820",3,"2015-08-14 18:23:00",1439601780,"C8",1196220,1440798000,"2015-08-28 14:40:00"
"2429","20155514055529-108",1,"2015-08-14 18:34:00",1439602440,"C7",772080,1440374520,"2015-08-23 17:02:00"
"3322","20150115060113-519",3,"2015-08-15 06:36:00",1439645760,"C2",277800,1439923560,"2015-08-18 11:46:00"
"54","20150215060225-774",1,"2015-08-15 06:41:00",1439646060,"C7",818220,1440464280,"2015-08-24 17:58:00"
"784","20153915063956-914",3,"2015-08-15 06:46:00",1439646360,"C8",128940,1439775300,"2015-08-16 18:35:00"
"4717","20155615065643-355",3,"2015-08-15 07:04:00",1439647440,"C4",207780,1439855220,"2015-08-17 16:47:00"
"2079","20154315064331-937",1,"2015-08-15 07:09:00",1439647740,"C5",93540,1439741280,"2015-08-16 09:08:00"
"2829","20154515064509-76",2,"2015-08-15 07:15:00",1439648100,"C5",289620,1439937720,"2015-08-18 15:42:00"
"153","20154015074020-606",2,"2015-08-15 07:42:00",1439649720,"C6",1036200,1440685920,"2015-08-27 07:32:00"
"5940","20152115072114-129",1,"2015-08-15 07:47:00",1439650020,"C5",202440,1439852460,"2015-08-17 16:01:00"
"6521","20154415064447-909",1,"2015-08-15 07:52:00",1439650320,"C5",379740,1440030060,"2015-08-19 17:21:00"
"4322","20153315073301-37",3,"2015-08-15 07:59:00",1439650740,"C8",360840,1440011580,"2015-08-19 12:13:00"
"2954","20152915072932-837",1,"2015-08-15 08:15:00",1439651700,"C8",99480,1439751180,"2015-08-16 11:53:00"
"2144","20150115080147-541",1,"2015-08-15 08:29:00",1439652540,"C4",217560,1439870100,"2015-08-17 20:55:00"
"2975","20152415082432-673",2,"2015-08-15 08:31:00",1439652660,"C8",473400,1440126060,"2015-08-20 20:01:00"
"3176","20153115083101-873",1,"2015-08-15 09:01:00",1439654460,"C6",215280,1439869740,"2015-08-17 20:49:00"
"6443","20154115084152-940",1,"2015-08-15 09:11:00",1439655060,"C2",222060,1439877120,"2015-08-17 22:52:00"
"5794","20152215092246-386",1,"2015-08-15 09:28:00",1439656080,"C2",133680,1439789760,"2015-08-16 22:36:00"
"5229","20153715093725-365",1,"2015-08-15 09:51:00",1439657460,"C7",133080,1439790540,"2015-08-16 22:49:00"
"5304","20155115095152-620",1,"2015-08-15 10:23:00",1439659380,"C2",277380,1439936760,"2015-08-18 15:26:00"
"1560","20152315102309-132",2,"2015-08-15 10:52:00",1439661120,"C2",73800,1439734920,"2015-08-16 07:22:00"
"5389","20151515101538-806",1,"2015-08-15 11:13:00",1439662380,"C5",177720,1439840100,"2015-08-17 12:35:00"
"4064","20152015102054-215",3,"2015-08-15 11:23:00",1439662980,"C7",81420,1439744400,"2015-08-16 10:00:00"
"5117","20152015112055-777",1,"2015-08-15 11:44:00",1439664240,"C4",385500,1440049740,"2015-08-19 22:49:00"
"1617","20150515110551-961",1,"2015-08-15 12:01:00",1439665260,"C5",418500,1440083760,"2015-08-20 08:16:00"
"407","20155615105630-534",3,"2015-08-15 12:05:00",1439665500,"C8",121200,1439786700,"2015-08-16 21:45:00"
"5580","20154115114122-286",1,"2015-08-15 12:07:00",1439665620,"C5",384060,1440049680,"2015-08-19 22:48:00"
"5495","20153915113920-94",3,"2015-08-15 12:09:00",1439665740,"C5",194400,1439860140,"2015-08-17 18:09:00"
"430","20153815113857-329",3,"2015-08-15 12:10:00",1439665800,"C0",288120,1439953920,"2015-08-18 20:12:00"
"3137","20154215114244-418",2,"2015-08-15 12:16:00",1439666160,"C0",88500,1439754660,"2015-08-16 12:51:00"
"3925","20153515113516-627",3,"2015-08-15 12:22:00",1439666520,"C8",465660,1440132180,"2015-08-20 21:43:00"
"3522","20151315121331-773",1,"2015-08-15 12:28:00",1439666880,"C0",670500,1440337380,"2015-08-23 06:43:00"
"5485","20151415121445-482",1,"2015-08-15 12:38:00",1439667480,"C5",418260,1440085740,"2015-08-20 08:49:00"
"4413","20151115121122-695",3,"2015-08-15 12:41:00",1439667660,"C2",167100,1439834760,"2015-08-17 11:06:00"
"1598","20154615114635-60",1,"2015-08-15 12:46:00",1439667960,"C2",361080,1440029040,"2015-08-19 17:04:00"
"980","20154315114328-382",1,"2015-08-15 12:49:00",1439668140,"C2",369540,1440037680,"2015-08-19 19:28:00"
"189","20153115123154-557",1,"2015-08-15 12:55:00",1439668500,"C4",447000,1440115500,"2015-08-20 17:05:00"
"490","20154715114704-310",1,"2015-08-15 13:01:00",1439668860,"C2",332040,1440000900,"2015-08-19 09:15:00"
"787","20155815115806-862",3,"2015-08-15 13:02:00",1439668920,"C0",364440,1440033360,"2015-08-19 18:16:00"
"5001","20154115124146-703",3,"2015-08-15 13:09:00",1439669340,"C4",320640,1439989980,"2015-08-19 06:13:00"
"1214","20150815120847-511",1,"2015-08-15 13:10:00",1439669400,"C2",87600,1439757000,"2015-08-16 13:30:00"
"285","20155815125829-147",1,"2015-08-15 13:24:00",1439670240,"C5",65640,1439735880,"2015-08-16 07:38:00"
"4760","20151315011308-405",1,"2015-08-15 13:28:00",1439670480,"C0",88800,1439759280,"2015-08-16 14:08:00"
"3875","20154115124102-576",3,"2015-08-15 13:36:00",1439670960,"C6",544800,1440215760,"2015-08-21 20:56:00"
"2911","20150715010737-325",3,"2015-08-15 13:39:00",1439671140,"C2",523260,1440194400,"2015-08-21 15:00:00"
"6110","20154415014417-163",2,"2015-08-15 13:50:00",1439671800,"C2",172560,1439844360,"2015-08-17 13:46:00"
"3788","20152815012824-971",1,"2015-08-15 14:18:00",1439673480,"C4",792480,1440465960,"2015-08-24 18:26:00"
"4087","20150415020406-610",3,"2015-08-15 14:37:00",1439674620,"C8",198780,1439873400,"2015-08-17 21:50:00"
"5850","20152815022839-704",1,"2015-08-15 14:52:00",1439675520,"C5",400620,1440076140,"2015-08-20 06:09:00"
"1503","20150115020146-483",3,"2015-08-15 15:02:00",1439676120,"C2",66360,1439742480,"2015-08-16 09:28:00"
"1585","20151915021949-470",1,"2015-08-15 15:22:00",1439677320,"C4",333240,1440010560,"2015-08-19 11:56:00"
"99","20153915033947-108",1,"2015-08-15 16:12:00",1439680320,"C8",968040,1440648360,"2015-08-26 21:06:00"
"3913","20152815042814-977",2,"2015-08-15 16:30:00",1439681400,"C6",257520,1439938920,"2015-08-18 16:02:00"
"6239","20153915043953-171",2,"2015-08-15 16:47:00",1439682420,"C4",153840,1439836260,"2015-08-17 11:31:00"
"2464","20154115044115-752",1,"2015-08-15 16:48:00",1439682480,"C8",194640,1439877120,"2015-08-17 22:52:00"
"5977","20153315033346-643",1,"2015-08-15 16:49:00",1439682540,"C2",262620,1439945160,"2015-08-18 17:46:00"
"6360","20155615035612-506",2,"2015-08-15 17:07:00",1439683620,"C6",102900,1439786520,"2015-08-16 21:42:00"
"1540","20150615050655-209",3,"2015-08-15 17:14:00",1439684040,"C8",53880,1439737920,"2015-08-16 08:12:00"
"3490","20151115041109-804",1,"2015-08-15 17:20:00",1439684400,"C0",76200,1439760600,"2015-08-16 14:30:00"
"657","20152115052114-277",1,"2015-08-15 17:52:00",1439686320,"C6",65940,1439752260,"2015-08-16 12:11:00"
"4489","20154515054549-826",1,"2015-08-15 18:18:00",1439687880,"C8",155700,1439843580,"2015-08-17 13:33:00"
"3357","20154615054634-509",2,"2015-08-15 18:46:00",1439689560,"C2",273780,1439963340,"2015-08-18 22:49:00"
"4593","20154715054748-43",2,"2015-08-15 18:53:00",1439689980,"C2",46140,1439736120,"2015-08-16 07:42:00"
"167","20150516060520-936",2,"2015-08-16 06:37:00",1439732220,"C3",116880,1439849100,"2015-08-17 15:05:00"
"6202","20150116070109-391",1,"2015-08-16 07:03:00",1439733780,"C6",266460,1440000240,"2015-08-19 09:04:00"
"5107","20155816065857-340",1,"2015-08-16 07:06:00",1439733960,"C4",137940,1439871900,"2015-08-17 21:25:00"
"4119","20152616062617-515",1,"2015-08-16 07:17:00",1439734620,"C5",699660,1440434280,"2015-08-24 09:38:00"
"5237","20151716071747-621",1,"2015-08-16 07:23:00",1439734980,"C2",281640,1440016620,"2015-08-19 13:37:00"
"6008","20153016063017-510",3,"2015-08-16 07:26:00",1439735160,"C5",388800,1440123960,"2015-08-20 19:26:00"
"4450","20154116074134-300",3,"2015-08-16 07:48:00",1439736480,"C4",285300,1440021780,"2015-08-19 15:03:00"
"3942","20153316073319-342",3,"2015-08-16 07:49:00",1439736540,"C7",128760,1439865300,"2015-08-17 19:35:00"
"6266","20154716064735-828",3,"2015-08-16 07:55:00",1439736900,"C8",137700,1439874600,"2015-08-17 22:10:00"
"3579","20151616091623-588",1,"2015-08-16 09:40:00",1439743200,"C5",202320,1439945520,"2015-08-18 17:52:00"
"5313","20154216084221-101",3,"2015-08-16 09:44:00",1439743440,"C2",380640,1440124080,"2015-08-20 19:28:00"
"5773","20150016090035-720",1,"2015-08-16 09:59:00",1439744340,"C3",77760,1439822100,"2015-08-17 07:35:00"
"5619","20154116094115-530",1,"2015-08-16 10:05:00",1439744700,"C5",262020,1440006720,"2015-08-19 10:52:00"
"3696","20153816093827-264",1,"2015-08-16 10:08:00",1439744880,"C8",439380,1440184260,"2015-08-21 12:11:00"
"3171","20151416101435-915",1,"2015-08-16 10:20:00",1439745600,"C8",186600,1439932200,"2015-08-18 14:10:00"
"2447","20151416101425-25",2,"2015-08-16 10:36:00",1439746560,"C5",424860,1440171420,"2015-08-21 08:37:00"
"1144","20152716102734-529",1,"2015-08-16 10:52:00",1439747520,"C7",89700,1439837220,"2015-08-17 11:47:00"
"1596","20150116100148-276",2,"2015-08-16 10:53:00",1439747580,"C4",188580,1439936160,"2015-08-18 15:16:00"
"2216","20154216104223-278",1,"2015-08-16 11:07:00",1439748420,"C5",172500,1439920920,"2015-08-18 11:02:00"
"5782","20152416102430-660",2,"2015-08-16 11:31:00",1439749860,"C8",378840,1440128700,"2015-08-20 20:45:00"
"766","20153516103511-94",1,"2015-08-16 11:40:00",1439750400,"C6",166920,1439917320,"2015-08-18 10:02:00"
"200","20150316120315-424",1,"2015-08-16 12:25:00",1439753100,"C5",178860,1439931960,"2015-08-18 14:06:00"
"5028","20150016120041-181",3,"2015-08-16 12:25:00",1439753100,"C5",188520,1439941620,"2015-08-18 16:47:00"
"3730","20151116121132-353",1,"2015-08-16 12:54:00",1439754840,"C2",260400,1440015240,"2015-08-19 13:14:00"
"3905","20152816122841-313",1,"2015-08-16 12:58:00",1439755080,"C0",95880,1439850960,"2015-08-17 15:36:00"
"4785","20154716114727-41",2,"2015-08-16 12:59:00",1439755140,"C6",163440,1439918580,"2015-08-18 10:23:00"
"2228","20153816123820-926",1,"2015-08-16 13:00:00",1439755200,"C7",264600,1440019800,"2015-08-19 14:30:00"
"4910","20154316124308-991",1,"2015-08-16 13:09:00",1439755740,"C4",151080,1439906820,"2015-08-18 07:07:00"
"5464","20151516011512-70",1,"2015-08-16 13:21:00",1439756460,"C2",260100,1440016560,"2015-08-19 13:36:00"
"4965","20150916010956-355",3,"2015-08-16 13:35:00",1439757300,"C5",255300,1440012600,"2015-08-19 12:30:00"
"2299","20153716123710-632",1,"2015-08-16 13:36:00",1439757360,"C3",275160,1440032520,"2015-08-19 18:02:00"
"3038","20153316013306-455",1,"2015-08-16 13:49:00",1439758140,"C0",184980,1439943120,"2015-08-18 17:12:00"
"3371","20152116012117-783",1,"2015-08-16 13:53:00",1439758380,"C2",150480,1439908860,"2015-08-18 07:41:00"
"3458","20152016012038-49",1,"2015-08-16 13:54:00",1439758440,"C2",156960,1439915400,"2015-08-18 09:30:00"
"5632","20153216013236-330",2,"2015-08-16 13:56:00",1439758560,"C5",405420,1440163980,"2015-08-21 06:33:00"
"3514","20154516014531-348",2,"2015-08-16 13:59:00",1439758740,"C7",280140,1440038880,"2015-08-19 19:48:00"
"6064","20153516013555-105",3,"2015-08-16 14:05:00",1439759100,"C5",513840,1440272940,"2015-08-22 12:49:00"
"2646","20150916010937-480",1,"2015-08-16 14:26:00",1439760360,"C4",176760,1439937120,"2015-08-18 15:32:00"
"4439","20151916021928-359",1,"2015-08-16 14:51:00",1439761860,"C8",62160,1439824020,"2015-08-17 08:07:00"
"370","20150616020625-232",1,"2015-08-16 15:01:00",1439762460,"C5",60300,1439822760,"2015-08-17 07:46:00"
"4791","20155616025653-750",1,"2015-08-16 15:03:00",1439762580,"C4",270720,1440033300,"2015-08-19 18:15:00"
"1404","20151716021749-651",2,"2015-08-16 15:15:00",1439763300,"C3",704520,1440467820,"2015-08-24 18:57:00"
"3384","20154316024349-453",2,"2015-08-16 15:47:00",1439765220,"C2",596700,1440361920,"2015-08-23 13:32:00"
"3931","20155116025119-682",1,"2015-08-16 15:48:00",1439765280,"C3",60540,1439825820,"2015-08-17 08:37:00"
"3969","20152516042528-805",2,"2015-08-16 17:25:00",1439771100,"C5",423600,1440194700,"2015-08-21 15:05:00"
"337","20154016054003-520",2,"2015-08-16 18:10:00",1439773800,"C2",263460,1440037260,"2015-08-19 19:21:00"
"1128","20155216055230-781",1,"2015-08-16 18:23:00",1439774580,"C3",71580,1439846160,"2015-08-17 14:16:00"
"230","20154016054052-85",1,"2015-08-16 18:37:00",1439775420,"C6",186660,1439962080,"2015-08-18 22:28:00"
"4678","20151717061717-630",2,"2015-08-17 06:40:00",1439818800,"C4",315180,1440133980,"2015-08-20 22:13:00"
"2934","20151917071938-502",1,"2015-08-17 08:12:00",1439824320,"C4",184980,1440009300,"2015-08-19 11:35:00"
"6234","20150517080528-116",3,"2015-08-17 08:41:00",1439826060,"C2",814380,1440640440,"2015-08-26 18:54:00"
"4209","20154517084514-625",2,"2015-08-17 09:20:00",1439828400,"C6",520680,1440349080,"2015-08-23 09:58:00"
"2207","20153217083226-786",2,"2015-08-17 09:33:00",1439829180,"C0",76200,1439905380,"2015-08-18 06:43:00"
"1735","20151217101248-377",3,"2015-08-17 10:20:00",1439832000,"C8",80580,1439912580,"2015-08-18 08:43:00"
"3603","20152317092314-52",1,"2015-08-17 10:21:00",1439832060,"C6",301680,1440133740,"2015-08-20 22:09:00"
"2796","20150617100636-148",1,"2015-08-17 10:31:00",1439832660,"C5",267720,1440100380,"2015-08-20 12:53:00"
"1544","20153717103748-173",3,"2015-08-17 10:45:00",1439833500,"C4",157200,1439990700,"2015-08-19 06:25:00"
"4504","20153617103638-247",1,"2015-08-17 10:51:00",1439833860,"C7",193200,1440027060,"2015-08-19 16:31:00"
"5928","20153817093840-341",1,"2015-08-17 10:52:00",1439833920,"C7",389220,1440223140,"2015-08-21 22:59:00"
"3618","20151017101005-541",1,"2015-08-17 11:04:00",1439834640,"C5",278520,1440113160,"2015-08-20 16:26:00"
"6508","20151117101107-46",2,"2015-08-17 11:04:00",1439834640,"C5",462240,1440296880,"2015-08-22 19:28:00"
"4913","20153317103355-433",1,"2015-08-17 11:07:00",1439834820,"C5",198360,1440033180,"2015-08-19 18:13:00"
"5029","20152017102041-706",3,"2015-08-17 11:27:00",1439836020,"C0",120960,1439956980,"2015-08-18 21:03:00"
"4371","20155417105422-842",1,"2015-08-17 11:54:00",1439837640,"C4",93840,1439931480,"2015-08-18 13:58:00"
"1333","20153917113956-553",3,"2015-08-17 12:11:00",1439838660,"C2",880740,1440719400,"2015-08-27 16:50:00"
"3090","20152317122348-82",3,"2015-08-17 12:30:00",1439839800,"C2",346680,1440186480,"2015-08-21 12:48:00"
"785","20150017120055-53",2,"2015-08-17 12:31:00",1439839860,"C3",413700,1440253560,"2015-08-22 07:26:00"
"497","20151217121251-526",1,"2015-08-17 13:25:00",1439843100,"C0",198900,1440042000,"2015-08-19 20:40:00"
"5514","20155717125750-508",1,"2015-08-17 13:27:00",1439843220,"C2",377940,1440221160,"2015-08-21 22:26:00"
"5756","20152317012342-801",2,"2015-08-17 13:53:00",1439844780,"C3",90900,1439935680,"2015-08-18 15:08:00"
"44","20154917014946-993",3,"2015-08-17 13:57:00",1439845020,"C4",110220,1439955240,"2015-08-18 20:34:00"
"1313","20150917020950-55",3,"2015-08-17 14:16:00",1439846160,"C8",436860,1440283020,"2015-08-22 15:37:00"
"6361","20153017023011-609",1,"2015-08-17 14:50:00",1439848200,"C6",322200,1440170400,"2015-08-21 08:20:00"
"1477","20150817020855-736",1,"2015-08-17 15:03:00",1439848980,"C8",347940,1440196920,"2015-08-21 15:42:00"
"2650","20153517023507-15",1,"2015-08-17 15:08:00",1439849280,"C2",1196520,1441045800,"2015-08-31 11:30:00"
"6327","20154517024507-611",1,"2015-08-17 15:08:00",1439849280,"C4",68460,1439917740,"2015-08-18 10:09:00"
"4675","20150217030209-500",2,"2015-08-17 15:36:00",1439850960,"C2",76320,1439927280,"2015-08-18 12:48:00"
"5830","20153017033036-185",1,"2015-08-17 16:34:00",1439854440,"C8",234900,1440089340,"2015-08-20 09:49:00"
"4574","20153317043306-904",3,"2015-08-17 17:30:00",1439857800,"C8",133080,1439990880,"2015-08-19 06:28:00"
"3094","20154117054153-286",2,"2015-08-17 17:49:00",1439858940,"C8",92760,1439951700,"2015-08-18 19:35:00"
"1006","20151817051852-380",1,"2015-08-17 17:50:00",1439859000,"C3",183600,1440042600,"2015-08-19 20:50:00"
"4020","20153117053105-892",1,"2015-08-17 18:28:00",1439861280,"C7",224820,1440086100,"2015-08-20 08:55:00"
"2294","20151318061334-243",2,"2015-08-18 06:30:00",1439904600,"C0",131580,1440036180,"2015-08-19 19:03:00"
"2762","20155618065604-631",2,"2015-08-18 07:10:00",1439907000,"C7",124080,1440031080,"2015-08-19 17:38:00"
"5797","20154518064540-758",1,"2015-08-18 07:15:00",1439907300,"C3",486660,1440393960,"2015-08-23 22:26:00"
"620","20153318063343-519",1,"2015-08-18 07:29:00",1439908140,"C4",219420,1440127560,"2015-08-20 20:26:00"
"856","20152018072024-196",1,"2015-08-18 07:33:00",1439908380,"C3",353580,1440261960,"2015-08-22 09:46:00"
"2601","20154618074635-802",2,"2015-08-18 07:48:00",1439909280,"C6",722580,1440631860,"2015-08-26 16:31:00"
"366","20155418075447-174",2,"2015-08-18 08:20:00",1439911200,"C5",271440,1440182640,"2015-08-21 11:44:00"
"5489","20155518075547-219",1,"2015-08-18 08:20:00",1439911200,"C5",261660,1440172860,"2015-08-21 09:01:00"
"3420","20152518072549-657",3,"2015-08-18 08:38:00",1439912280,"C0",372900,1440285180,"2015-08-22 16:13:00"
"1666","20155118075124-295",1,"2015-08-18 08:41:00",1439912460,"C8",464280,1440376740,"2015-08-23 17:39:00"
"3107","20152318082356-512",1,"2015-08-18 08:46:00",1439912760,"C5",93240,1440006000,"2015-08-19 10:40:00"
"2406","20155618075600-258",1,"2015-08-18 08:55:00",1439913300,"C4",122460,1440035760,"2015-08-19 18:56:00"
"782","20154918094949-366",1,"2015-08-18 09:55:00",1439916900,"C2",625260,1440542160,"2015-08-25 15:36:00"
"1015","20151318101343-137",1,"2015-08-18 10:35:00",1439919300,"C4",113700,1440033000,"2015-08-19 18:10:00"
"2416","20151018101055-192",2,"2015-08-18 10:36:00",1439919360,"C8",187560,1440106920,"2015-08-20 14:42:00"
"5774","20151218101204-383",3,"2015-08-18 10:39:00",1439919540,"C5",99540,1440019080,"2015-08-19 14:18:00"
"494","20151818101826-629",3,"2015-08-18 10:45:00",1439919900,"C5",862980,1440782880,"2015-08-28 10:28:00"
"3494","20152718102756-727",1,"2015-08-18 11:00:00",1439920800,"C7",438180,1440358980,"2015-08-23 12:43:00"
"6222","20154518104543-3",1,"2015-08-18 11:14:00",1439921640,"C5",106380,1440028020,"2015-08-19 16:47:00"
"6049","20150018110057-525",1,"2015-08-18 11:28:00",1439922480,"C4",178200,1440100680,"2015-08-20 12:58:00"
"830","20152318102340-546",2,"2015-08-18 11:32:00",1439922720,"C8",81120,1440003840,"2015-08-19 10:04:00"
"2767","20155018105000-729",2,"2015-08-18 11:48:00",1439923680,"C4",289260,1440212940,"2015-08-21 20:09:00"
"833","20155418105443-181",1,"2015-08-18 11:56:00",1439924160,"C4",240480,1440164640,"2015-08-21 06:44:00"
"6556","20153518113519-608",1,"2015-08-18 12:01:00",1439924460,"C3",171180,1440095640,"2015-08-20 11:34:00"
"1520","20155118115128-12",1,"2015-08-18 12:17:00",1439925420,"C5",208560,1440133980,"2015-08-20 22:13:00"
"738","20150418120408-87",3,"2015-08-18 12:23:00",1439925780,"C6",170880,1440096660,"2015-08-20 11:51:00"
"2169","20153118113152-842",2,"2015-08-18 12:27:00",1439926020,"C5",897300,1440823320,"2015-08-28 21:42:00"
"4136","20153818123807-188",1,"2015-08-18 12:40:00",1439926800,"C6",98940,1440025740,"2015-08-19 16:09:00"
"690","20153118123109-283",1,"2015-08-18 13:36:00",1439930160,"C0",74460,1440004620,"2015-08-19 10:17:00"
"3518","20151518011542-627",3,"2015-08-18 13:36:00",1439930160,"C5",82560,1440012720,"2015-08-19 12:32:00"
"5355","20155418015419-112",1,"2015-08-18 14:11:00",1439932260,"C7",359580,1440291840,"2015-08-22 18:04:00"
"1225","20150218020205-444",1,"2015-08-18 14:12:00",1439932320,"C3",365580,1440297900,"2015-08-22 19:45:00"
"4272","20155018015058-838",1,"2015-08-18 14:13:00",1439932380,"C5",153240,1440085620,"2015-08-20 08:47:00"
"1156","20151318021301-158",2,"2015-08-18 14:55:00",1439934900,"C2",670800,1440605700,"2015-08-26 09:15:00"
"5491","20153418023443-272",2,"2015-08-18 14:56:00",1439934960,"C5",90480,1440025440,"2015-08-19 16:04:00"
"1612","20151518031527-459",2,"2015-08-18 15:17:00",1439936220,"C6",861480,1440797700,"2015-08-28 14:35:00"
"2877","20152118032137-233",2,"2015-08-18 15:28:00",1439936880,"C4",110220,1440047100,"2015-08-19 22:05:00"
"63","20154018024040-960",1,"2015-08-18 15:40:00",1439937600,"C5",581400,1440519000,"2015-08-25 09:10:00"
"1331","20155618025650-853",1,"2015-08-18 15:51:00",1439938260,"C4",80520,1440018780,"2015-08-19 14:13:00"
"2521","20150518040539-572",3,"2015-08-18 16:10:00",1439939400,"C2",96780,1440036180,"2015-08-19 19:03:00"
"2049","20152218052241-425",1,"2015-08-18 17:29:00",1439944140,"C2",425340,1440369480,"2015-08-23 15:38:00"
"2993","20155318045348-403",2,"2015-08-18 17:29:00",1439944140,"C3",182520,1440126660,"2015-08-20 20:11:00"
"2268","20154418044437-34",2,"2015-08-18 17:40:00",1439944800,"C5",174840,1440119640,"2015-08-20 18:14:00"
"1266","20151518051530-830",1,"2015-08-18 17:43:00",1439944980,"C8",239220,1440184200,"2015-08-21 12:10:00"
"5787","20152119062102-718",1,"2015-08-19 07:17:00",1439993820,"C4",128820,1440122640,"2015-08-20 19:04:00"
"1382","20152619072610-850",2,"2015-08-19 07:32:00",1439994720,"C2",554280,1440549000,"2015-08-25 17:30:00"
"2636","20150919070956-883",1,"2015-08-19 08:15:00",1439997300,"C8",198420,1440195720,"2015-08-21 15:22:00"
"3943","20155219075248-264",1,"2015-08-19 08:26:00",1439997960,"C5",171000,1440168960,"2015-08-21 07:56:00"
"6220","20154119074133-741",2,"2015-08-19 08:43:00",1439998980,"C3",218880,1440217860,"2015-08-21 21:31:00"
"245","20152919082940-780",2,"2015-08-19 08:52:00",1439999520,"C4",395760,1440395280,"2015-08-23 22:48:00"
"2761","20154419084429-25",1,"2015-08-19 09:22:00",1440001320,"C3",439860,1440441180,"2015-08-24 11:33:00"
"981","20153219093204-479",1,"2015-08-19 09:49:00",1440002940,"C0",297240,1440300180,"2015-08-22 20:23:00"
"2701","20152719102718-287",1,"2015-08-19 10:33:00",1440005580,"C2",601560,1440607140,"2015-08-26 09:39:00"
"1366","20153519093544-845",1,"2015-08-19 10:42:00",1440006120,"C6",936840,1440942960,"2015-08-30 06:56:00"
"1069","20154319104353-504",3,"2015-08-19 11:46:00",1440009960,"C8",71040,1440081000,"2015-08-20 07:30:00"
"3974","20152219112242-277",1,"2015-08-19 11:49:00",1440010140,"C4",371460,1440381600,"2015-08-23 19:00:00"
"594","20155119115134-6",1,"2015-08-19 12:47:00",1440013620,"C8",175140,1440188760,"2015-08-21 13:26:00"
"5994","20150019010055-677",1,"2015-08-19 13:31:00",1440016260,"C4",288240,1440304500,"2015-08-22 21:35:00"
"3637","20155619125653-865",1,"2015-08-19 13:32:00",1440016320,"C3",501000,1440517320,"2015-08-25 08:42:00"
"3881","20153519123507-498",1,"2015-08-19 13:36:00",1440016560,"C5",159600,1440176160,"2015-08-21 09:56:00"
"2728","20153119123113-587",3,"2015-08-19 13:39:00",1440016740,"C8",440340,1440457080,"2015-08-24 15:58:00"
"2591","20155419125408-510",1,"2015-08-19 13:52:00",1440017520,"C7",796320,1440813840,"2015-08-28 19:04:00"
"2127","20155919125917-79",2,"2015-08-19 13:58:00",1440017880,"C0",96780,1440114660,"2015-08-20 16:51:00"
"4908","20153119013102-317",1,"2015-08-19 14:38:00",1440020280,"C2",760800,1440781080,"2015-08-28 09:58:00"
"3670","20155819015821-968",1,"2015-08-19 14:50:00",1440021000,"C6",315600,1440336600,"2015-08-23 06:30:00"
"942","20152919022949-193",2,"2015-08-19 14:55:00",1440021300,"C5",273540,1440294840,"2015-08-22 18:54:00"
"3551","20154919024910-736",3,"2015-08-19 15:39:00",1440023940,"C8",342480,1440366420,"2015-08-23 14:47:00"
"3540","20152719032729-250",1,"2015-08-19 15:43:00",1440024180,"C0",356520,1440380700,"2015-08-23 18:45:00"
"4281","20152419032457-473",2,"2015-08-19 15:52:00",1440024720,"C5",626100,1440650820,"2015-08-26 21:47:00"
"4358","20153219033258-970",3,"2015-08-19 15:57:00",1440025020,"C5",57900,1440082920,"2015-08-20 08:02:00"
"6269","20150419040419-734",1,"2015-08-19 16:30:00",1440027000,"C4",186120,1440213120,"2015-08-21 20:12:00"
"1489","20150019040039-358",1,"2015-08-19 17:04:00",1440029040,"C6",695400,1440724440,"2015-08-27 18:14:00"
"2031","20152019052023-769",1,"2015-08-19 17:49:00",1440031740,"C5",57660,1440089400,"2015-08-20 09:50:00"
"4850","20151919051957-409",3,"2015-08-19 18:23:00",1440033780,"C2",185940,1440219720,"2015-08-21 22:02:00"
"6263","20151220061227-950",1,"2015-08-20 06:42:00",1440078120,"C8",88860,1440166980,"2015-08-21 07:23:00"
"1265","20151620061621-385",1,"2015-08-20 06:44:00",1440078240,"C4",393780,1440472020,"2015-08-24 20:07:00"
"5747","20150420070433-947",1,"2015-08-20 07:30:00",1440081000,"C4",602940,1440683940,"2015-08-27 06:59:00"
"3257","20155920065907-68",2,"2015-08-20 07:39:00",1440081540,"C7",124140,1440205680,"2015-08-21 18:08:00"
"775","20153920073940-995",1,"2015-08-20 07:47:00",1440082020,"C8",219420,1440301440,"2015-08-22 20:44:00"
"2086","20152120072110-350",2,"2015-08-20 07:47:00",1440082020,"C5",695700,1440777720,"2015-08-28 09:02:00"
"574","20155320075307-202",1,"2015-08-20 08:13:00",1440083580,"C5",294600,1440378180,"2015-08-23 18:03:00"
"5276","20154920074921-321",1,"2015-08-20 08:18:00",1440083880,"C5",92820,1440176700,"2015-08-21 10:05:00"
"767","20150220080208-953",1,"2015-08-20 08:24:00",1440084240,"C5",84240,1440168480,"2015-08-21 07:48:00"
"5249","20150420090434-499",1,"2015-08-20 09:23:00",1440087780,"C6",91080,1440178860,"2015-08-21 10:41:00"
"4081","20152220092213-786",3,"2015-08-20 09:27:00",1440088020,"C2",466260,1440554280,"2015-08-25 18:58:00"
"4962","20150020090018-839",1,"2015-08-20 09:35:00",1440088500,"C6",446580,1440535080,"2015-08-25 13:38:00"
"3249","20153620083607-408",1,"2015-08-20 09:36:00",1440088560,"C6",73680,1440162240,"2015-08-21 06:04:00"
"1470","20155220085241-907",1,"2015-08-20 09:54:00",1440089640,"C8",80100,1440169740,"2015-08-21 08:09:00"
"2422","20150920090938-107",1,"2015-08-20 10:11:00",1440090660,"C5",352560,1440443220,"2015-08-24 12:07:00"
"4860","20154120094138-417",2,"2015-08-20 10:11:00",1440090660,"C0",353160,1440443820,"2015-08-24 12:17:00"
"5836","20154420094443-603",3,"2015-08-20 10:17:00",1440091020,"C6",72120,1440163140,"2015-08-21 06:19:00"
"1464","20150720100758-108",2,"2015-08-20 10:39:00",1440092340,"C7",103080,1440195420,"2015-08-21 15:17:00"
"5130","20154320094352-113",3,"2015-08-20 10:44:00",1440092640,"C8",85980,1440178620,"2015-08-21 10:37:00"
"5772","20151320101309-415",1,"2015-08-20 11:19:00",1440094740,"C5",207120,1440301860,"2015-08-22 20:51:00"
"1576","20151520101518-905",1,"2015-08-20 11:21:00",1440094860,"C4",164340,1440259200,"2015-08-22 09:00:00"
"5378","20150920110938-724",2,"2015-08-20 11:34:00",1440095640,"C3",429360,1440525000,"2015-08-25 10:50:00"
"3672","20152720112739-23",1,"2015-08-20 11:52:00",1440096720,"C4",256920,1440353640,"2015-08-23 11:14:00"
"3745","20153220113237-70",2,"2015-08-20 12:00:00",1440097200,"C5",1647720,1441744920,"2015-09-08 13:42:00"
"1057","20152120122138-42",1,"2015-08-20 12:52:00",1440100320,"C7",365280,1440465600,"2015-08-24 18:20:00"
"3602","20152420122408-685",3,"2015-08-20 13:19:00",1440101940,"C5",278280,1440380220,"2015-08-23 18:37:00"
"2719","20153720123722-777",2,"2015-08-20 13:42:00",1440103320,"C0",750480,1440853800,"2015-08-29 06:10:00"
"4624","20150420010418-650",1,"2015-08-20 14:16:00",1440105360,"C3",961980,1441067340,"2015-08-31 17:29:00"
"5147","20150620030643-457",2,"2015-08-20 15:13:00",1440108780,"C4",188760,1440297540,"2015-08-22 19:39:00"
"3304","20154620024644-66",2,"2015-08-20 15:18:00",1440109080,"C8",313980,1440423060,"2015-08-24 06:31:00"
"5398","20152520022515-874",2,"2015-08-20 15:19:00",1440109140,"C5",315600,1440424740,"2015-08-24 06:59:00"
"1216","20155820025827-627",2,"2015-08-20 15:20:00",1440109200,"C5",175440,1440284640,"2015-08-22 16:04:00"
"4166","20152620032609-833",1,"2015-08-20 16:34:00",1440113640,"C0",181080,1440294720,"2015-08-22 18:52:00"
"3147","20152220042220-374",1,"2015-08-20 16:46:00",1440114360,"C5",104640,1440219000,"2015-08-21 21:50:00"
"2819","20154920044949-964",2,"2015-08-20 16:56:00",1440114960,"C4",1209840,1441324800,"2015-09-03 17:00:00"
"1840","20154920044939-697",2,"2015-08-20 17:13:00",1440115980,"C5",91140,1440207120,"2015-08-21 18:32:00"
"1776","20155620045633-63",3,"2015-08-20 17:23:00",1440116580,"C4",156060,1440272640,"2015-08-22 12:44:00"
"983","20151420051444-405",2,"2015-08-20 17:49:00",1440118140,"C2",253800,1440371940,"2015-08-23 16:19:00"
"40","20155720055708-822",1,"2015-08-20 18:45:00",1440121500,"C8",412920,1440534420,"2015-08-25 13:27:00"
"4662","20155120055142-403",1,"2015-08-20 18:55:00",1440122100,"C4",590460,1440712560,"2015-08-27 14:56:00"
"4715","20150121060147-159",1,"2015-08-21 06:22:00",1440163320,"C8",288540,1440451860,"2015-08-24 14:31:00"
"4510","20152621062629-429",2,"2015-08-21 07:24:00",1440167040,"C5",539100,1440706140,"2015-08-27 13:09:00"
"4724","20152021072036-530",2,"2015-08-21 07:27:00",1440167220,"C8",205260,1440372480,"2015-08-23 16:28:00"
"3013","20154021074026-934",1,"2015-08-21 08:06:00",1440169560,"C8",298980,1440468540,"2015-08-24 19:09:00"
"2791","20154321074307-245",2,"2015-08-21 08:43:00",1440171780,"C2",187860,1440359640,"2015-08-23 12:54:00"
"2612","20153721083755-788",3,"2015-08-21 08:45:00",1440171900,"C8",131640,1440303540,"2015-08-22 21:19:00"
"414","20150321080317-281",1,"2015-08-21 09:05:00",1440173100,"C4",269400,1440442500,"2015-08-24 11:55:00"
"4638","20152221092251-883",2,"2015-08-21 09:47:00",1440175620,"C7",299220,1440474840,"2015-08-24 20:54:00"
"736","20150421090407-354",2,"2015-08-21 10:03:00",1440176580,"C7",99540,1440276120,"2015-08-22 13:42:00"
"4229","20150721100700-126",1,"2015-08-21 10:36:00",1440178560,"C5",370800,1440549360,"2015-08-25 17:36:00"
"3828","20151821101831-698",1,"2015-08-21 10:55:00",1440179700,"C6",429900,1440609600,"2015-08-26 10:20:00"
"3916","20155321105314-535",2,"2015-08-21 11:31:00",1440181860,"C2",93240,1440275100,"2015-08-22 13:25:00"
"4364","20150821110852-676",1,"2015-08-21 12:14:00",1440184440,"C0",272220,1440456660,"2015-08-24 15:51:00"
"5056","20155321115343-478",1,"2015-08-21 12:24:00",1440185040,"C8",247620,1440432660,"2015-08-24 09:11:00"
"2754","20155321125321-407",2,"2015-08-21 12:55:00",1440186900,"C6",63780,1440250680,"2015-08-22 06:38:00"
"992","20150921120902-568",2,"2015-08-21 12:57:00",1440187020,"C7",252420,1440439440,"2015-08-24 11:04:00"
"6229","20151021011047-387",1,"2015-08-21 13:18:00",1440188280,"C4",98460,1440286740,"2015-08-22 16:39:00"
"2064","20153221123200-816",1,"2015-08-21 13:24:00",1440188640,"C4",332100,1440520740,"2015-08-25 09:39:00"
"1410","20150321010307-127",1,"2015-08-21 13:31:00",1440189060,"C5",671880,1440860940,"2015-08-29 08:09:00"
"2415","20150721010748-517",1,"2015-08-21 13:39:00",1440189540,"C5",91200,1440280740,"2015-08-22 14:59:00"
"5232","20154221124220-61",1,"2015-08-21 13:46:00",1440189960,"C3",245280,1440435240,"2015-08-24 09:54:00"
"1117","20154821124817-368",1,"2015-08-21 13:50:00",1440190200,"C7",434040,1440624240,"2015-08-26 14:24:00"
"1145","20150221010241-26",3,"2015-08-21 14:06:00",1440191160,"C5",631380,1440822540,"2015-08-28 21:29:00"
"4547","20151221021214-964",2,"2015-08-21 14:36:00",1440192960,"C4",67980,1440260940,"2015-08-22 09:29:00"
"2081","20153921023939-728",2,"2015-08-21 14:50:00",1440193800,"C3",184620,1440378420,"2015-08-23 18:07:00"
"421","20154421024437-278",2,"2015-08-21 14:59:00",1440194340,"C0",450060,1440644400,"2015-08-26 20:00:00"
"5319","20153221023253-382",1,"2015-08-21 15:05:00",1440194700,"C4",507300,1440702000,"2015-08-27 12:00:00"
"6474","20150821020810-335",3,"2015-08-21 15:08:00",1440194880,"C6",452220,1440647100,"2015-08-26 20:45:00"
"3258","20150121030143-599",1,"2015-08-21 15:25:00",1440195900,"C5",195600,1440391500,"2015-08-23 21:45:00"
"4611","20154519024544-322",2,"2015-08-21 15:39:00",1440196740,"C4",201780,1440398520,"2015-08-23 23:42:00"
"5272","20153521033513-856",2,"2015-08-21 15:41:00",1440196860,"C2",238920,1440435780,"2015-08-24 10:03:00"
"744","20151521031525-991",1,"2015-08-21 15:50:00",1440197400,"C2",238080,1440435480,"2015-08-24 09:58:00"
"1116","20152321032356-54",2,"2015-08-21 15:55:00",1440197700,"C3",1129680,1441327380,"2015-09-03 17:43:00"
"2789","20152821032823-470",3,"2015-08-21 15:59:00",1440197940,"C2",679860,1440877800,"2015-08-29 12:50:00"
"1546","20155621035652-898",2,"2015-08-21 16:18:00",1440199080,"C8",176580,1440375660,"2015-08-23 17:21:00"
"3685","20151721041729-734",1,"2015-08-21 16:52:00",1440201120,"C0",99180,1440300300,"2015-08-22 20:25:00"
"2502","20150521040525-743",1,"2015-08-21 16:57:00",1440201420,"C4",72540,1440273960,"2015-08-22 13:06:00"
"5982","20153721043705-857",2,"2015-08-21 17:00:00",1440201600,"C4",192600,1440394200,"2015-08-23 22:30:00"
"1906","20154521044507-247",1,"2015-08-21 17:08:00",1440202080,"C8",438600,1440640680,"2015-08-26 18:58:00"
"2786","20154821044824-752",1,"2015-08-21 17:15:00",1440202500,"C5",486600,1440689100,"2015-08-27 08:25:00"
"151","20155621045635-67",1,"2015-08-21 17:32:00",1440203520,"C2",669720,1440873240,"2015-08-29 11:34:00"
"5865","20153621043606-60",3,"2015-08-21 17:44:00",1440204240,"C3",219240,1440423480,"2015-08-24 06:38:00"
"5140","20154521054515-644",2,"2015-08-21 17:50:00",1440204600,"C2",180240,1440384840,"2015-08-23 19:54:00"
"86","20155721045702-819",1,"2015-08-21 17:59:00",1440205140,"C4",152040,1440357180,"2015-08-23 12:13:00"
"5719","20153521053544-115",3,"2015-08-21 17:59:00",1440205140,"C8",256020,1440461160,"2015-08-24 17:06:00"
"3286","20150721050735-636",3,"2015-08-21 18:05:00",1440205500,"C8",129840,1440335340,"2015-08-23 06:09:00"
"813","20152522062547-875",1,"2015-08-22 06:31:00",1440250260,"C2",355320,1440605580,"2015-08-26 09:13:00"
"6530","20151722061712-453",1,"2015-08-22 06:45:00",1440251100,"C5",301740,1440552840,"2015-08-25 18:34:00"
"1826","20154222064210-989",2,"2015-08-22 07:10:00",1440252600,"C4",221760,1440474360,"2015-08-24 20:46:00"
"6280","20155622065626-576",1,"2015-08-22 07:31:00",1440253860,"C8",228360,1440482220,"2015-08-24 22:57:00"
"2933","20153222073210-586",1,"2015-08-22 07:40:00",1440254400,"C4",300240,1440554640,"2015-08-25 19:04:00"
"3888","20155922065913-325",2,"2015-08-22 08:04:00",1440255840,"C5",204600,1440460440,"2015-08-24 16:54:00"
"6156","20151622071609-320",1,"2015-08-22 08:09:00",1440256140,"C5",1694220,1441950360,"2015-09-10 22:46:00"
"2070","20155022075049-151",3,"2015-08-22 08:12:00",1440256320,"C1",168420,1440424740,"2015-08-24 06:59:00"
"6548","20154522074508-296",3,"2015-08-22 08:12:00",1440256320,"C5",525900,1440782220,"2015-08-28 10:17:00"
"938","20151522081515-994",1,"2015-08-22 08:17:00",1440256620,"C6",120120,1440376740,"2015-08-23 17:39:00"
"4621","20152322072348-123",1,"2015-08-22 08:23:00",1440256980,"C8",359940,1440616920,"2015-08-26 12:22:00"
"2758","20151122081111-931",3,"2015-08-22 08:33:00",1440257580,"C5",80640,1440338220,"2015-08-23 06:57:00"
"2596","20152122082127-299",1,"2015-08-22 08:37:00",1440257820,"C7",108540,1440366360,"2015-08-23 14:46:00"
"2586","20151122081111-220",1,"2015-08-22 09:04:00",1440259440,"C4",94140,1440353580,"2015-08-23 11:13:00"
"3683","20151622081618-495",1,"2015-08-22 09:04:00",1440259440,"C8",1322400,1441581840,"2015-09-06 16:24:00"
"4283","20152822082859-49",3,"2015-08-22 09:29:00",1440260940,"C5",113280,1440374220,"2015-08-23 16:57:00"
"1910","20150122090127-897",1,"2015-08-22 09:34:00",1440261240,"C3",452340,1440713580,"2015-08-27 15:13:00"
"4893","20155822095826-155",2,"2015-08-22 10:06:00",1440263160,"C8",211260,1440474420,"2015-08-24 20:47:00"
"2251","20153622093633-893",2,"2015-08-22 10:32:00",1440264720,"C4",451560,1440716280,"2015-08-27 15:58:00"
"6245","20154922094908-595",1,"2015-08-22 10:32:00",1440264720,"C0",1060980,1441325700,"2015-09-03 17:15:00"
"256","20151622101656-331",2,"2015-08-22 10:37:00",1440265020,"C5",439920,1440704940,"2015-08-27 12:49:00"
"4733","20155722095743-296",1,"2015-08-22 10:41:00",1440265260,"C8",444660,1440709920,"2015-08-27 14:12:00"
"3584","20151622101630-477",1,"2015-08-22 10:46:00",1440265560,"C4",703500,1440969060,"2015-08-30 14:11:00"
"6121","20150822100824-378",2,"2015-08-22 11:02:00",1440266520,"C5",367620,1440634140,"2015-08-26 17:09:00"
"974","20151422101430-872",1,"2015-08-22 11:14:00",1440267240,"C2",518580,1440785820,"2015-08-28 11:17:00"
"3818","20150122110107-735",2,"2015-08-22 11:29:00",1440268140,"C4",297300,1440565440,"2015-08-25 22:04:00"
"1783","20150322110349-365",1,"2015-08-22 11:39:00",1440268740,"C2",189060,1440457800,"2015-08-24 16:10:00"
"4312","20151322111353-436",3,"2015-08-22 11:46:00",1440269160,"C3",643320,1440912480,"2015-08-29 22:28:00"
"840","20153622113605-844",1,"2015-08-22 11:58:00",1440269880,"C5",471660,1440741540,"2015-08-27 22:59:00"
"3383","20150922110914-684",2,"2015-08-22 12:00:00",1440270000,"C8",535440,1440805440,"2015-08-28 16:44:00"
"4801","20153622113627-960",2,"2015-08-22 12:04:00",1440270240,"C8",285600,1440555840,"2015-08-25 19:24:00"
"2208","20153122113109-139",3,"2015-08-22 12:06:00",1440270360,"C2",294300,1440564660,"2015-08-25 21:51:00"
"2002","20153922113902-456",1,"2015-08-22 12:12:00",1440270720,"C7",203880,1440474600,"2015-08-24 20:50:00"
"3932","20151822111847-102",3,"2015-08-22 12:15:00",1440270900,"C4",619440,1440890340,"2015-08-29 16:19:00"
"2004","20154722114730-650",1,"2015-08-22 12:20:00",1440271200,"C5",289560,1440560760,"2015-08-25 20:46:00"
"5087","20151822111805-247",1,"2015-08-22 12:25:00",1440271500,"C5",94800,1440366300,"2015-08-23 14:45:00"
"5995","20152822122853-937",2,"2015-08-22 12:35:00",1440272100,"C4",274920,1440547020,"2015-08-25 16:57:00"
"6191","20154422124407-513",1,"2015-08-22 13:16:00",1440274560,"C0",242580,1440517140,"2015-08-25 08:39:00"
"215","20153022123027-88",2,"2015-08-22 13:41:00",1440276060,"C2",372780,1440648840,"2015-08-26 21:14:00"
"5109","20152622012613-387",2,"2015-08-22 13:55:00",1440276900,"C2",636240,1440913140,"2015-08-29 22:39:00"
"3069","20152422012450-156",1,"2015-08-22 14:29:00",1440278940,"C0",175320,1440454260,"2015-08-24 15:11:00"
"2910","20153822023828-796",2,"2015-08-22 14:46:00",1440279960,"C4",78000,1440357960,"2015-08-23 12:26:00"
"3967","20151722021752-58",1,"2015-08-22 14:48:00",1440280080,"C5",231540,1440511620,"2015-08-25 07:07:00"
"4707","20150322020344-232",2,"2015-08-22 15:06:00",1440281160,"C3",283500,1440564660,"2015-08-25 21:51:00"
"2861","20152322022341-751",2,"2015-08-22 15:10:00",1440281400,"C6",54900,1440336300,"2015-08-23 06:25:00"
"2939","20151022031032-538",2,"2015-08-22 15:18:00",1440281880,"C8",400440,1440682320,"2015-08-27 06:32:00"
"3159","20151122021140-914",1,"2015-08-22 15:29:00",1440282540,"C0",63660,1440346200,"2015-08-23 09:10:00"
"3006","20150622030637-276",1,"2015-08-22 15:38:00",1440283080,"C4",885480,1441168560,"2015-09-01 21:36:00"
"347","20154122034142-353",2,"2015-08-22 15:48:00",1440283680,"C8",235920,1440519600,"2015-08-25 09:20:00"
"3623","20154222034228-99",1,"2015-08-22 16:08:00",1440284880,"C8",170220,1440455100,"2015-08-24 15:25:00"
"2384","20150722040736-505",1,"2015-08-22 16:14:00",1440285240,"C4",51780,1440337020,"2015-08-23 06:37:00"
"3468","20152322042319-725",2,"2015-08-22 16:29:00",1440286140,"C4",60300,1440346440,"2015-08-23 09:14:00"
"6152","20150822040817-521",3,"2015-08-22 16:36:00",1440286560,"C8",96240,1440382800,"2015-08-23 19:20:00"
"3752","20152122042102-592",3,"2015-08-22 16:42:00",1440286920,"C7",267120,1440554040,"2015-08-25 18:54:00"
"175","20155922035939-710",2,"2015-08-22 17:03:00",1440288180,"C5",185400,1440473580,"2015-08-24 20:33:00"
"788","20153022043047-509",2,"2015-08-22 17:07:00",1440288420,"C0",70200,1440358620,"2015-08-23 12:37:00"
"1081","20153122043149-695",2,"2015-08-22 17:11:00",1440288660,"C0",231600,1440520260,"2015-08-25 09:31:00"
"5828","20155922045901-406",1,"2015-08-22 17:31:00",1440289860,"C3",309600,1440599460,"2015-08-26 07:31:00"
"2113","20154322044336-436",2,"2015-08-22 17:34:00",1440290040,"C7",395280,1440685320,"2015-08-27 07:22:00"
"5261","20154622044617-838",2,"2015-08-22 17:43:00",1440290580,"C2",242100,1440532680,"2015-08-25 12:58:00"
"6430","20155922045952-606",2,"2015-08-22 18:01:00",1440291660,"C5",133500,1440425160,"2015-08-24 07:06:00"
"1149","20155122055108-85",1,"2015-08-22 18:50:00",1440294600,"C2",238740,1440533340,"2015-08-25 13:09:00"
"3919","20150223060208-554",3,"2015-08-23 06:16:00",1440335760,"C7",103680,1440439440,"2015-08-24 11:04:00"
"314","20151823061856-404",2,"2015-08-23 06:45:00",1440337500,"C4",444360,1440781860,"2015-08-28 10:11:00"
"888","20154023064009-80",1,"2015-08-23 06:46:00",1440337560,"C2",269820,1440607380,"2015-08-26 09:43:00"
"5170","20153223063219-462",1,"2015-08-23 06:54:00",1440338040,"C6",201360,1440539400,"2015-08-25 14:50:00"
"3433","20153123063116-913",2,"2015-08-23 06:57:00",1440338220,"C5",215100,1440553320,"2015-08-25 18:42:00"
"2054","20155323065317-442",1,"2015-08-23 07:22:00",1440339720,"C3",224700,1440564420,"2015-08-25 21:47:00"
"218","20152523062510-74",2,"2015-08-23 07:23:00",1440339780,"C5",264780,1440604560,"2015-08-26 08:56:00"
"706","20153423063429-324",3,"2015-08-23 07:42:00",1440340920,"C2",257700,1440598620,"2015-08-26 07:17:00"
"2362","20151823071855-858",2,"2015-08-23 07:45:00",1440341100,"C8",469620,1440810720,"2015-08-28 18:12:00"
"3705","20155223065200-218",2,"2015-08-23 07:59:00",1440341940,"C5",614280,1440956220,"2015-08-30 10:37:00"
"3053","20150223080232-126",2,"2015-08-23 08:29:00",1440343740,"C4",186600,1440530340,"2015-08-25 12:19:00"
"5587","20154723074706-99",1,"2015-08-23 08:53:00",1440345180,"C3",709980,1441055160,"2015-08-31 14:06:00"
"2978","20154323084319-194",2,"2015-08-23 09:10:00",1440346200,"C5",290160,1440636360,"2015-08-26 17:46:00"
"2125","20151023091027-655",3,"2015-08-23 09:16:00",1440346560,"C2",101520,1440448080,"2015-08-24 13:28:00"
"2329","20153823083813-827",1,"2015-08-23 09:39:00",1440347940,"C3",254400,1440602340,"2015-08-26 08:19:00"
"5805","20152123092103-610",1,"2015-08-23 09:53:00",1440348780,"C3",1119480,1441468260,"2015-09-05 08:51:00"
"5885","20155823085830-345",1,"2015-08-23 10:01:00",1440349260,"C0",303600,1440652860,"2015-08-26 22:21:00"
"4936","20154623094608-73",2,"2015-08-23 10:06:00",1440349560,"C7",257820,1440607380,"2015-08-26 09:43:00"
"3758","20150123100107-508",1,"2015-08-23 10:28:00",1440350880,"C8",108780,1440459660,"2015-08-24 16:41:00"
"536","20153723093753-818",3,"2015-08-23 10:51:00",1440352260,"C0",336240,1440688500,"2015-08-27 08:15:00"
"119","20153723103750-402",3,"2015-08-23 10:53:00",1440352380,"C0",169860,1440522240,"2015-08-25 10:04:00"
"2499","20154223104254-46",1,"2015-08-23 11:09:00",1440353340,"C4",1247640,1441600980,"2015-09-06 21:43:00"
"4042","20155023105006-119",2,"2015-08-23 11:33:00",1440354780,"C2",673560,1441028340,"2015-08-31 06:39:00"
"2350","20154823104821-280",3,"2015-08-23 11:54:00",1440356040,"C2",241920,1440597960,"2015-08-26 07:06:00"
"2321","20150223110259-667",1,"2015-08-23 12:00:00",1440356400,"C2",76440,1440432840,"2015-08-24 09:14:00"
"1536","20153223113254-722",1,"2015-08-23 12:01:00",1440356460,"C3",66300,1440422760,"2015-08-24 06:26:00"
"1157","20153523113541-168",2,"2015-08-23 12:48:00",1440359280,"C3",332340,1440691620,"2015-08-27 09:07:00"
"5092","20155823115852-975",2,"2015-08-23 12:49:00",1440359340,"C4",153780,1440513120,"2015-08-25 07:32:00"
"5407","20153023123036-30",3,"2015-08-23 13:27:00",1440361620,"C5",804000,1441165620,"2015-09-01 20:47:00"
"5926","20154923124957-839",2,"2015-08-23 13:29:00",1440361740,"C0",251520,1440613260,"2015-08-26 11:21:00"
"1147","20150823010813-63",1,"2015-08-23 13:32:00",1440361920,"C7",455940,1440817860,"2015-08-28 20:11:00"
"1395","20152723012751-951",1,"2015-08-23 13:50:00",1440363000,"C4",149460,1440512460,"2015-08-25 07:21:00"
"1127","20150423020418-599",2,"2015-08-23 14:10:00",1440364200,"C8",328080,1440692280,"2015-08-27 09:18:00"
"5299","20155123015147-690",2,"2015-08-23 14:24:00",1440365040,"C5",195540,1440560580,"2015-08-25 20:43:00"
"583","20152023022026-39",1,"2015-08-23 14:41:00",1440366060,"C7",86580,1440452640,"2015-08-24 14:44:00"
"6322","20154623014627-670",2,"2015-08-23 14:48:00",1440366480,"C5",517920,1440884400,"2015-08-29 14:40:00"
"1693","20150023030012-350",3,"2015-08-23 15:13:00",1440367980,"C7",112980,1440480960,"2015-08-24 22:36:00"
"6093","20155523025523-457",2,"2015-08-23 15:40:00",1440369600,"C8",198600,1440568200,"2015-08-25 22:50:00"
"2059","20150723030707-46",2,"2015-08-23 15:42:00",1440369720,"C2",68100,1440437820,"2015-08-24 10:37:00"
"2850","20155023025023-616",3,"2015-08-23 15:54:00",1440370440,"C8",104100,1440474540,"2015-08-24 20:49:00"
"3487","20155323025342-437",3,"2015-08-23 16:01:00",1440370860,"C5",224880,1440595740,"2015-08-26 06:29:00"
"3604","20151523031533-237",1,"2015-08-23 16:01:00",1440370860,"C6",61020,1440431880,"2015-08-24 08:58:00"
"2318","20152723032741-851",1,"2015-08-23 16:26:00",1440372360,"C8",657540,1441029900,"2015-08-31 07:05:00"
"3957","20151623041622-269",2,"2015-08-23 16:28:00",1440372480,"C3",60180,1440432660,"2015-08-24 09:11:00"
"3066","20152123032134-92",2,"2015-08-23 16:29:00",1440372540,"C8",237000,1440609540,"2015-08-26 10:19:00"
"5131","20150423040436-953",1,"2015-08-23 16:31:00",1440372660,"C5",53100,1440425760,"2015-08-24 07:16:00"
"4533","20154423044431-936",2,"2015-08-23 17:02:00",1440374520,"C0",335160,1440709680,"2015-08-27 14:08:00"
"1495","20152023042040-26",2,"2015-08-23 17:23:00",1440375780,"C3",1127700,1441503480,"2015-09-05 18:38:00"
"3413","20150323050310-883",1,"2015-08-23 17:27:00",1440376020,"C4",529740,1440905760,"2015-08-29 20:36:00"
"2776","20154223044243-199",2,"2015-08-23 17:29:00",1440376140,"C6",55500,1440431640,"2015-08-24 08:54:00"
"4575","20153523043519-62",1,"2015-08-23 17:29:00",1440376140,"C8",163320,1440539460,"2015-08-25 14:51:00"
"883","20153423043438-15",3,"2015-08-23 17:34:00",1440376440,"C2",258240,1440634680,"2015-08-26 17:18:00"
"854","20154023044028-20",1,"2015-08-23 17:46:00",1440377160,"C0",655980,1441033140,"2015-08-31 07:59:00"
"4412","20153023053020-213",2,"2015-08-23 17:49:00",1440377340,"C7",67260,1440444600,"2015-08-24 12:30:00"
"2963","20151723051709-947",1,"2015-08-23 17:55:00",1440377700,"C2",49380,1440427080,"2015-08-24 07:38:00"
"2146","20150423050415-924",1,"2015-08-23 18:03:00",1440378180,"C5",77640,1440455820,"2015-08-24 15:37:00"
"2928","20153123053121-598",2,"2015-08-23 18:05:00",1440378300,"C0",80400,1440458700,"2015-08-24 16:25:00"
"6526","20150223050200-237",3,"2015-08-23 18:08:00",1440378480,"C2",344040,1440722520,"2015-08-27 17:42:00"
"6168","20150724060708-783",2,"2015-08-24 06:28:00",1440422880,"C5",230160,1440653040,"2015-08-26 22:24:00"
"984","20151924061918-27",2,"2015-08-24 06:44:00",1440423840,"C5",140580,1440564420,"2015-08-25 21:47:00"
"6230","20151724061714-521",1,"2015-08-24 06:49:00",1440424140,"C7",121200,1440545340,"2015-08-25 16:29:00"
"5621","20152124062158-615",1,"2015-08-24 07:00:00",1440424800,"C0",295080,1440719880,"2015-08-27 16:58:00"
"1552","20153124063149-216",1,"2015-08-24 07:02:00",1440424920,"C3",104760,1440529680,"2015-08-25 12:08:00"
"3438","20151624061651-753",1,"2015-08-24 07:30:00",1440426600,"C2",451440,1440878040,"2015-08-29 12:54:00"
"5216","20153624073607-630",3,"2015-08-24 07:44:00",1440427440,"C4",96420,1440523860,"2015-08-25 10:31:00"
"5598","20150724070715-550",3,"2015-08-24 08:14:00",1440429240,"C4",90060,1440519300,"2015-08-25 09:15:00"
"4863","20152824082829-991",3,"2015-08-24 09:02:00",1440432120,"C4",220080,1440652200,"2015-08-26 22:10:00"
"1731","20151124081137-232",2,"2015-08-24 09:15:00",1440432900,"C2",254700,1440687600,"2015-08-27 08:00:00"
"615","20153224093211-44",1,"2015-08-24 09:37:00",1440434220,"C2",1679040,1442113260,"2015-09-12 20:01:00"
"80","20152424092415-398",2,"2015-08-24 09:56:00",1440435360,"C3",182340,1440617700,"2015-08-26 12:35:00"
"1649","20153924093924-473",1,"2015-08-24 10:37:00",1440437820,"C5",97680,1440535500,"2015-08-25 13:45:00"
"5285","20151224101227-56",1,"2015-08-24 11:07:00",1440439620,"C6",987840,1441427460,"2015-09-04 21:31:00"
"2412","20151624101641-279",3,"2015-08-24 11:25:00",1440440700,"C8",68820,1440509520,"2015-08-25 06:32:00"
"3775","20155024105003-765",2,"2015-08-24 11:46:00",1440441960,"C5",709500,1441151460,"2015-09-01 16:51:00"
"4478","20154224114240-680",1,"2015-08-24 11:47:00",1440442020,"C2",535620,1440977640,"2015-08-30 16:34:00"
"552","20151024111054-335",3,"2015-08-24 12:05:00",1440443100,"C8",112620,1440555720,"2015-08-25 19:22:00"
"3149","20155424115433-691",1,"2015-08-24 12:19:00",1440443940,"C5",688260,1441132200,"2015-09-01 11:30:00"
"5223","20150024120056-588",1,"2015-08-24 12:33:00",1440444780,"C3",175440,1440620220,"2015-08-26 13:17:00"
"1053","20153024123008-70",1,"2015-08-24 12:52:00",1440445920,"C5",178920,1440624840,"2015-08-26 14:34:00"
"2952","20150024010045-514",3,"2015-08-24 13:02:00",1440446520,"C6",291180,1440737700,"2015-08-27 21:55:00"
"3505","20151824121846-361",2,"2015-08-24 13:20:00",1440447600,"C2",240000,1440687600,"2015-08-27 08:00:00"
"1760","20150224010242-67",1,"2015-08-24 13:26:00",1440447960,"C8",197700,1440645660,"2015-08-26 20:21:00"
"5361","20154224124203-336",1,"2015-08-24 13:41:00",1440448860,"C8",176700,1440625560,"2015-08-26 14:46:00"
"4026","20153124123117-215",2,"2015-08-24 13:46:00",1440449160,"C0",240240,1440689400,"2015-08-27 08:30:00"
"355","20150524010519-501",2,"2015-08-24 13:57:00",1440449820,"C4",91500,1440541320,"2015-08-25 15:22:00"
"301","20150424020445-861",2,"2015-08-24 14:10:00",1440450600,"C8",203580,1440654180,"2015-08-26 22:43:00"
"6520","20150724010736-623",1,"2015-08-24 14:10:00",1440450600,"C2",170520,1440621120,"2015-08-26 13:32:00"
"4695","20154424014431-732",1,"2015-08-24 14:17:00",1440451020,"C3",261480,1440712500,"2015-08-27 14:55:00"
"3162","20155024015018-365",3,"2015-08-24 14:22:00",1440451320,"C8",277500,1440728820,"2015-08-27 19:27:00"
"4083","20155724015758-338",2,"2015-08-24 14:23:00",1440451380,"C5",76380,1440527760,"2015-08-25 11:36:00"
"1606","20153024013035-807",3,"2015-08-24 14:36:00",1440452160,"C7",408120,1440860280,"2015-08-29 07:58:00"
"3271","20153824013848-746",1,"2015-08-24 14:44:00",1440452640,"C8",201480,1440654120,"2015-08-26 22:42:00"
"1604","20155024015031-756",3,"2015-08-24 14:56:00",1440453360,"C3",373620,1440826980,"2015-08-28 22:43:00"
"3297","20154124024130-878",1,"2015-08-24 15:06:00",1440453960,"C5",228180,1440682140,"2015-08-27 06:29:00"
"5817","20154124024118-504",1,"2015-08-24 15:08:00",1440454080,"C8",157500,1440611580,"2015-08-26 10:53:00"
"2878","20153824023857-53",3,"2015-08-24 15:43:00",1440456180,"C5",680220,1441136400,"2015-09-01 12:40:00"
"2625","20152024032005-799",2,"2015-08-24 15:47:00",1440456420,"C5",257820,1440714240,"2015-08-27 15:24:00"
"224","20154024034000-968",2,"2015-08-24 16:06:00",1440457560,"C3",244800,1440702360,"2015-08-27 12:06:00"
"1556","20152424032429-194",2,"2015-08-24 16:29:00",1440458940,"C4",323820,1440782760,"2015-08-28 10:26:00"
"4277","20150024040008-576",3,"2015-08-24 16:32:00",1440459120,"C7",325560,1440784680,"2015-08-28 10:58:00"
"1269","20153224043244-563",1,"2015-08-24 16:38:00",1440459480,"C2",87840,1440547320,"2015-08-25 17:02:00"
"3019","20152424042420-968",1,"2015-08-24 16:54:00",1440460440,"C5",49320,1440509760,"2015-08-25 06:36:00"
"3496","20150124040121-291",1,"2015-08-24 16:54:00",1440460440,"C5",232440,1440692880,"2015-08-27 09:28:00"
"6373","20154524044536-939",3,"2015-08-24 17:11:00",1440461460,"C4",74700,1440536160,"2015-08-25 13:56:00"
"662","20154524044508-686",1,"2015-08-24 17:13:00",1440461580,"C8",162840,1440624420,"2015-08-26 14:27:00"
"2884","20151224041242-581",2,"2015-08-24 17:13:00",1440461580,"C2",222420,1440684000,"2015-08-27 07:00:00"
"623","20154124044141-426",3,"2015-08-24 17:19:00",1440461940,"C7",161580,1440623520,"2015-08-26 14:12:00"
"527","20152524042528-383",1,"2015-08-24 17:20:00",1440462000,"C6",168840,1440630840,"2015-08-26 16:14:00"
"4424","20151324041323-86",1,"2015-08-24 17:20:00",1440462000,"C0",271920,1440733920,"2015-08-27 20:52:00"
"1641","20151624051659-955",3,"2015-08-24 17:36:00",1440462960,"C6",534060,1440997020,"2015-08-30 21:57:00"
"4640","20153224043258-562",2,"2015-08-24 17:42:00",1440463320,"C3",604200,1441067520,"2015-08-31 17:32:00"
"5789","20151824051853-291",1,"2015-08-24 17:49:00",1440463740,"C4",321420,1440785160,"2015-08-28 11:06:00"
"6","20155924055911-559",1,"2015-08-24 18:09:00",1440464940,"C3",254580,1440719520,"2015-08-27 16:52:00"
"28","20153024053044-807",2,"2015-08-24 18:09:00",1440464940,"C2",67080,1440532020,"2015-08-25 12:47:00"
"5735","20155705025759-63",1,"2015-08-24 19:00:00",1440468000,"C5",2040240,1442508240,"2015-09-17 09:44:00"
"5098","20152125062113-255",1,"2015-08-25 06:59:00",1440511140,"C7",185640,1440696780,"2015-08-27 10:33:00"
"2692","20152025062036-525",1,"2015-08-25 07:27:00",1440512820,"C5",635640,1441148460,"2015-09-01 16:01:00"
"1304","20153625063605-688",1,"2015-08-25 07:36:00",1440513360,"C2",570240,1441083600,"2015-08-31 22:00:00"
"4869","20154625064609-206",1,"2015-08-25 07:40:00",1440513600,"C5",304320,1440817920,"2015-08-28 20:12:00"
"5152","20154325074316-323",2,"2015-08-25 07:50:00",1440514200,"C8",224880,1440739080,"2015-08-27 22:18:00"
"4002","20154725064714-647",2,"2015-08-25 08:04:00",1440515040,"C0",461400,1440976440,"2015-08-30 16:14:00"
"513","20154125074157-46",3,"2015-08-25 08:11:00",1440515460,"C8",1001040,1441516500,"2015-09-05 22:15:00"
"431","20151225071221-449",2,"2015-08-25 08:15:00",1440515700,"C4",113220,1440628920,"2015-08-26 15:42:00"
"5417","20151725071716-115",1,"2015-08-25 08:16:00",1440515760,"C6",197400,1440713160,"2015-08-27 15:06:00"
"1362","20152425092455-910",1,"2015-08-25 09:30:00",1440520200,"C2",123180,1440643380,"2015-08-26 19:43:00"
"5791","20152625082631-507",1,"2015-08-25 09:31:00",1440520260,"C4",112140,1440632400,"2015-08-26 16:40:00"
"952","20154025094008-773",2,"2015-08-25 09:46:00",1440521160,"C4",80520,1440601680,"2015-08-26 08:08:00"
"240","20152925092904-816",1,"2015-08-25 09:52:00",1440521520,"C8",261240,1440782760,"2015-08-28 10:26:00"
"2198","20152825092803-463",1,"2015-08-25 10:19:00",1440523140,"C4",101700,1440624840,"2015-08-26 14:34:00"
"4071","20155925095934-285",2,"2015-08-25 10:26:00",1440523560,"C5",95760,1440619320,"2015-08-26 13:02:00"
"3748","20155825095843-923",2,"2015-08-25 10:28:00",1440523680,"C0",79920,1440603600,"2015-08-26 08:40:00"
"5518","20153425093430-367",2,"2015-08-25 10:44:00",1440524640,"C0",282060,1440806700,"2015-08-28 17:05:00"
"1044","20152925102939-681",1,"2015-08-25 11:00:00",1440525600,"C3",87780,1440613380,"2015-08-26 11:23:00"
"4790","20155125115109-261",1,"2015-08-25 12:19:00",1440530340,"C4",469560,1440999900,"2015-08-30 22:45:00"
"5935","20154425114422-810",2,"2015-08-25 12:49:00",1440532140,"C3",242340,1440774480,"2015-08-28 08:08:00"
"4070","20151125121147-666",1,"2015-08-25 13:20:00",1440534000,"C7",871500,1441405500,"2015-09-04 15:25:00"
"1227","20153825123835-385",1,"2015-08-25 13:39:00",1440535140,"C8",897180,1441432320,"2015-09-04 22:52:00"
"3625","20150625010640-723",1,"2015-08-25 13:42:00",1440535320,"C6",149160,1440684480,"2015-08-27 07:08:00"
"4542","20153925013947-835",3,"2015-08-25 13:48:00",1440535680,"C4",112500,1440648180,"2015-08-26 21:03:00"
"2564","20152225012231-425",3,"2015-08-25 14:05:00",1440536700,"C2",280380,1440817080,"2015-08-28 19:58:00"
"6125","20153125013133-452",1,"2015-08-25 14:06:00",1440536760,"C8",457620,1440994380,"2015-08-30 21:13:00"
"756","20151625011628-348",1,"2015-08-25 14:14:00",1440537240,"C6",116400,1440653640,"2015-08-26 22:34:00"
"1643","20151625021627-767",2,"2015-08-25 14:24:00",1440537840,"C4",95940,1440633780,"2015-08-26 17:03:00"
"4419","20154825014843-884",2,"2015-08-25 14:41:00",1440538860,"C5",200640,1440739500,"2015-08-27 22:25:00"
"3451","20153125013101-836",2,"2015-08-25 14:42:00",1440538920,"C7",617400,1441156320,"2015-09-01 18:12:00"
"3664","20152225022204-845",1,"2015-08-25 15:04:00",1440540240,"C2",79800,1440620040,"2015-08-26 13:14:00"
"489","20152325032338-563",2,"2015-08-25 15:38:00",1440542280,"C0",179700,1440721980,"2015-08-27 17:33:00"
"6292","20155625025623-196",3,"2015-08-25 16:00:00",1440543600,"C5",82200,1440625800,"2015-08-26 14:50:00"
"4872","20151525031532-107",1,"2015-08-25 16:11:00",1440544260,"C7",1293480,1441837740,"2015-09-09 15:29:00"
"4770","20151625031626-950",2,"2015-08-25 16:20:00",1440544800,"C7",315360,1440860160,"2015-08-29 07:56:00"
"5006","20155725035758-59",3,"2015-08-25 16:30:00",1440545400,"C4",235860,1440781260,"2015-08-28 10:01:00"
"6145","20151225041253-640",2,"2015-08-25 16:40:00",1440546000,"C5",676980,1441222980,"2015-09-02 12:43:00"
"6453","20153925033936-464",2,"2015-08-25 16:41:00",1440546060,"C0",279600,1440825660,"2015-08-28 22:21:00"
"3153","20155125045126-764",1,"2015-08-25 16:53:00",1440546780,"C6",776880,1441323660,"2015-09-03 16:41:00"
"5577","20151925041908-320",3,"2015-08-25 17:27:00",1440548820,"C8",450720,1440999540,"2015-08-30 22:39:00"
"3596","20150525050544-558",2,"2015-08-25 18:11:00",1440551460,"C5",142320,1440693780,"2015-08-27 09:43:00"
"1068","20152125052113-381",3,"2015-08-25 18:28:00",1440552480,"C8",135300,1440687780,"2015-08-27 08:03:00"
"1342","20151626071648-759",1,"2015-08-26 07:42:00",1440600120,"C5",138720,1440738840,"2015-08-27 22:14:00"
"6201","20150026070015-698",1,"2015-08-26 07:56:00",1440600960,"C8",120480,1440721440,"2015-08-27 17:24:00"
"4397","20153926083902-744",2,"2015-08-26 08:59:00",1440604740,"C6",277080,1440881820,"2015-08-29 13:57:00"
"2056","20150226090228-180",3,"2015-08-26 09:40:00",1440607200,"C0",469140,1441076340,"2015-08-31 19:59:00"
"4988","20151426091421-412",2,"2015-08-26 09:48:00",1440607680,"C5",301920,1440909600,"2015-08-29 21:40:00"
"5669","20152826092847-177",1,"2015-08-26 09:54:00",1440608040,"C5",96720,1440704760,"2015-08-27 12:46:00"
"266","20154126094133-632",1,"2015-08-26 10:04:00",1440608640,"C5",304140,1440912780,"2015-08-29 22:33:00"
"2132","20151026091044-859",2,"2015-08-26 10:08:00",1440608880,"C7",362700,1440971580,"2015-08-30 14:53:00"
"3801","20154026094053-772",2,"2015-08-26 10:49:00",1440611340,"C7",215820,1440827160,"2015-08-28 22:46:00"
"4293","20153926103929-911",2,"2015-08-26 11:03:00",1440612180,"C4",263940,1440876120,"2015-08-29 12:22:00"
"4817","20155326105306-68",1,"2015-08-26 11:22:00",1440613320,"C3",295020,1440908340,"2015-08-29 21:19:00"
"6543","20155726105718-69",3,"2015-08-26 11:26:00",1440613560,"C5",295200,1440908760,"2015-08-29 21:26:00"
"875","20152826112825-682",3,"2015-08-26 11:34:00",1440614040,"C8",120480,1440734520,"2015-08-27 21:02:00"
"5653","20154926104933-124",1,"2015-08-26 11:37:00",1440614220,"C8",287880,1440902100,"2015-08-29 19:35:00"
"5015","20152126112132-235",1,"2015-08-26 11:41:00",1440614460,"C6",861180,1441475640,"2015-09-05 10:54:00"
"3958","20154026104009-242",2,"2015-08-26 11:46:00",1440614760,"C3",584160,1441198920,"2015-09-02 06:02:00"
"3865","20151726111704-117",1,"2015-08-26 11:50:00",1440615000,"C5",805080,1441420080,"2015-09-04 19:28:00"
"127","20150426120423-659",1,"2015-08-26 12:28:00",1440617280,"C5",686340,1441303620,"2015-09-03 11:07:00"
"3284","20151226121233-295",2,"2015-08-26 13:12:00",1440619920,"C5",121500,1440741420,"2015-08-27 22:57:00"
"2449","20150426010444-611",1,"2015-08-26 13:19:00",1440620340,"C7",87780,1440708120,"2015-08-27 13:42:00"
"4752","20155926125912-498",2,"2015-08-26 13:23:00",1440620580,"C4",87660,1440708240,"2015-08-27 13:44:00"
"4554","20155926125956-991",3,"2015-08-26 13:50:00",1440622200,"C7",849780,1441471980,"2015-09-05 09:53:00"
"6058","20152726012729-506",2,"2015-08-26 13:53:00",1440622380,"C8",149520,1440771900,"2015-08-28 07:25:00"
"2598","20155526015529-809",1,"2015-08-26 14:18:00",1440623880,"C5",97500,1440721380,"2015-08-27 17:23:00"
"6278","20155026015014-82",1,"2015-08-26 14:25:00",1440624300,"C7",504780,1441129080,"2015-09-01 10:38:00"
"3570","20155426015439-228",3,"2015-08-26 14:31:00",1440624660,"C7",515340,1441140000,"2015-09-01 13:40:00"
"4744","20154726024709-573",2,"2015-08-26 14:55:00",1440626100,"C4",763020,1441389120,"2015-09-04 10:52:00"
"919","20154626024603-797",1,"2015-08-26 15:18:00",1440627480,"C3",243960,1440871440,"2015-08-29 11:04:00"
"4767","20153426023405-923",2,"2015-08-26 15:33:00",1440628380,"C2",91200,1440719580,"2015-08-27 16:53:00"
"1678","20151326031310-457",1,"2015-08-26 15:42:00",1440628920,"C8",71040,1440699960,"2015-08-27 11:26:00"
"1721","20153426033412-312",3,"2015-08-26 15:44:00",1440629040,"C3",345600,1440974640,"2015-08-30 15:44:00"
"415","20155126025133-294",1,"2015-08-26 15:45:00",1440629100,"C4",252720,1440881820,"2015-08-29 13:57:00"
"4876","20151326031321-981",2,"2015-08-26 16:08:00",1440630480,"C8",196260,1440826740,"2015-08-28 22:39:00"
"73","20151026041051-922",1,"2015-08-26 16:47:00",1440632820,"C0",490680,1441123500,"2015-09-01 09:05:00"
"3744","20152726042751-686",1,"2015-08-26 16:49:00",1440632940,"C5",316320,1440949260,"2015-08-30 08:41:00"
"5473","20155326035314-70",1,"2015-08-26 16:58:00",1440633480,"C3",242760,1440876240,"2015-08-29 12:24:00"
"4711","20154826044849-501",1,"2015-08-26 17:13:00",1440634380,"C8",883140,1441517520,"2015-09-05 22:32:00"
"1365","20150326050302-149",2,"2015-08-26 17:19:00",1440634740,"C7",162120,1440796860,"2015-08-28 14:21:00"
"4000","20155926045943-896",2,"2015-08-26 17:22:00",1440634920,"C8",427560,1441062480,"2015-08-31 16:08:00"
"667","20154226054229-220",2,"2015-08-26 17:48:00",1440636480,"C2",519960,1441156440,"2015-09-01 18:14:00"
"2481","20153026053028-239",2,"2015-08-26 17:51:00",1440636660,"C8",165900,1440802560,"2015-08-28 15:56:00"
"3089","20153326053328-53",1,"2015-08-26 18:07:00",1440637620,"C4",89700,1440727320,"2015-08-27 19:02:00"
"4933","20155026055055-745",3,"2015-08-26 18:22:00",1440638520,"C3",350760,1440989280,"2015-08-30 19:48:00"
"5270","20150227060225-629",2,"2015-08-27 06:08:00",1440680880,"C4",123480,1440804360,"2015-08-28 16:26:00"
"1132","20153227063207-318",1,"2015-08-27 06:40:00",1440682800,"C8",359340,1441042140,"2015-08-31 10:29:00"
"6325","20150827060827-565",1,"2015-08-27 07:17:00",1440685020,"C2",571860,1441256880,"2015-09-02 22:08:00"
"3890","20150227070212-936",2,"2015-08-27 07:32:00",1440685920,"C3",287820,1440973740,"2015-08-30 15:29:00"
"1247","20153327063301-504",3,"2015-08-27 07:35:00",1440686100,"C3",139860,1440825960,"2015-08-28 22:26:00"
"1791","20155627075627-902",2,"2015-08-27 08:03:00",1440687780,"C8",217740,1440905520,"2015-08-29 20:32:00"
"98","20154027074029-955",1,"2015-08-27 08:38:00",1440689880,"C5",267780,1440957660,"2015-08-30 11:01:00"
"5287","20151727081727-53",2,"2015-08-27 08:55:00",1440690900,"C7",258840,1440949740,"2015-08-30 08:49:00"
"3700","20152327092353-670",3,"2015-08-27 09:40:00",1440693600,"C1",297900,1440991500,"2015-08-30 20:25:00"
"132","20155227095221-937",1,"2015-08-27 10:00:00",1440694800,"C4",198060,1440892860,"2015-08-29 17:01:00"
"5713","20150627100641-287",1,"2015-08-27 10:11:00",1440695460,"C2",96060,1440791520,"2015-08-28 12:52:00"
"4018","20155327095347-642",1,"2015-08-27 10:21:00",1440696060,"C5",75600,1440771660,"2015-08-28 07:21:00"
"6164","20150527100509-549",2,"2015-08-27 10:23:00",1440696180,"C6",78900,1440775080,"2015-08-28 08:18:00"
"1676","20152527092517-772",1,"2015-08-27 10:25:00",1440696300,"C3",170520,1440866820,"2015-08-29 09:47:00"
"3424","20151127101117-321",2,"2015-08-27 10:38:00",1440697080,"C4",512460,1441209540,"2015-09-02 08:59:00"
"4030","20152527102521-92",2,"2015-08-27 10:39:00",1440697140,"C0",850860,1441548000,"2015-09-06 07:00:00"
"1224","20152027102031-111",2,"2015-08-27 10:46:00",1440697560,"C4",120540,1440818100,"2015-08-28 20:15:00"
"5927","20152827102844-258",1,"2015-08-27 10:57:00",1440698220,"C8",425520,1441123740,"2015-09-01 09:09:00"
"1519","20150027100028-509",1,"2015-08-27 11:00:00",1440698400,"C3",520620,1441219020,"2015-09-02 11:37:00"
"5901","20150227100257-879",2,"2015-08-27 11:02:00",1440698520,"C2",847500,1441546020,"2015-09-06 06:27:00"
"88","20155627105645-424",3,"2015-08-27 11:17:00",1440699420,"C5",84660,1440784080,"2015-08-28 10:48:00"
"203","20153127113132-635",1,"2015-08-27 11:57:00",1440701820,"C8",411300,1441113120,"2015-09-01 06:12:00"
"2325","20150627110636-691",2,"2015-08-27 12:00:00",1440702000,"C5",412440,1441114440,"2015-09-01 06:34:00"
"5921","20153727113719-945",3,"2015-08-27 12:10:00",1440702600,"C8",425760,1441128360,"2015-09-01 10:26:00"
"5531","20150827120843-66",1,"2015-08-27 12:37:00",1440704220,"C4",105060,1440809280,"2015-08-28 17:48:00"
"5997","20151927121927-686",3,"2015-08-27 12:50:00",1440705000,"C4",249300,1440954300,"2015-08-30 10:05:00"
"2970","20151027121055-218",2,"2015-08-27 13:04:00",1440705840,"C3",256920,1440962760,"2015-08-30 12:26:00"
"586","20154227124221-606",1,"2015-08-27 13:05:00",1440705900,"C8",150540,1440856440,"2015-08-29 06:54:00"
"3457","20150127010131-864",3,"2015-08-27 13:53:00",1440708780,"C4",374820,1441083600,"2015-08-31 22:00:00"
"1527","20155627015611-22",1,"2015-08-27 14:24:00",1440710640,"C5",153540,1440864180,"2015-08-29 09:03:00"
"1639","20155727015757-542",1,"2015-08-27 14:31:00",1440711060,"C2",355200,1441066260,"2015-08-31 17:11:00"
"365","20153227023219-8",2,"2015-08-27 15:00:00",1440712800,"C8",504120,1441216920,"2015-09-02 11:02:00"
"2382","20152827022858-442",2,"2015-08-27 15:02:00",1440712920,"C2",169020,1440881940,"2015-08-29 13:59:00"
"5041","20155027025003-704",1,"2015-08-27 15:12:00",1440713520,"C8",175860,1440889380,"2015-08-29 16:03:00"
"5764","20152827022817-16",1,"2015-08-27 15:26:00",1440714360,"C8",613980,1441328340,"2015-09-03 17:59:00"
"364","20150127030133-376",1,"2015-08-27 15:31:00",1440714660,"C8",241980,1440956640,"2015-08-30 10:44:00"
"2538","20152527022531-64",2,"2015-08-27 15:39:00",1440715140,"C2",73620,1440788760,"2015-08-28 12:06:00"
"809","20154027024014-523",1,"2015-08-27 15:42:00",1440715320,"C4",244380,1440959700,"2015-08-30 11:35:00"
"950","20152627032636-64",3,"2015-08-27 16:34:00",1440718440,"C2",430260,1441148700,"2015-09-01 16:05:00"
"15","20154727034733-671",2,"2015-08-27 16:39:00",1440718740,"C5",89400,1440808140,"2015-08-28 17:29:00"
"4449","20152027042059-327",1,"2015-08-27 16:43:00",1440718980,"C7",179340,1440898320,"2015-08-29 18:32:00"
"3984","20152427042457-76",1,"2015-08-27 16:53:00",1440719580,"C4",189900,1440909480,"2015-08-29 21:38:00"
"3040","20150227050213-13",1,"2015-08-27 17:23:00",1440721380,"C7",73020,1440794400,"2015-08-28 13:40:00"
"4225","20155727045735-743",3,"2015-08-27 17:29:00",1440721740,"C4",97800,1440819540,"2015-08-28 20:39:00"
"4124","20151127051117-574",1,"2015-08-27 17:44:00",1440722640,"C6",1279620,1442002260,"2015-09-11 13:11:00"
"4523","20155727045729-105",2,"2015-08-27 17:55:00",1440723300,"C8",529860,1441253160,"2015-09-02 21:06:00"
"5821","20155427045428-734",1,"2015-08-27 17:57:00",1440723420,"C5",308580,1441032000,"2015-08-31 07:40:00"
"730","20154727044758-903",2,"2015-08-27 18:03:00",1440723780,"C2",149820,1440873600,"2015-08-29 11:40:00"
"2368","20155427055429-500",1,"2015-08-27 18:11:00",1440724260,"C7",84840,1440809100,"2015-08-28 17:45:00"
"3742","20150028060003-741",1,"2015-08-28 06:16:00",1440767760,"C0",350280,1441118040,"2015-09-01 07:34:00"
"5065","20151428061408-195",2,"2015-08-28 06:29:00",1440768540,"C0",348300,1441116840,"2015-09-01 07:14:00"
"4205","20150628060613-79",1,"2015-08-28 07:15:00",1440771300,"C0",515760,1441287060,"2015-09-03 06:31:00"
"753","20153128063125-623",1,"2015-08-28 07:16:00",1440771360,"C8",523680,1441295040,"2015-09-03 08:44:00"
"4241","20152028072051-354",2,"2015-08-28 07:27:00",1440772020,"C8",697680,1441469700,"2015-09-05 09:15:00"
"4529","20153128063145-895",2,"2015-08-28 07:29:00",1440772140,"C5",311760,1441083900,"2015-08-31 22:05:00"
"6456","20155028065044-583",2,"2015-08-28 08:00:00",1440774000,"C2",130020,1440904020,"2015-08-29 20:07:00"
"2000","20153728073721-430",1,"2015-08-28 08:08:00",1440774480,"C3",277200,1441051680,"2015-08-31 13:08:00"
"3635","20151528071513-888",1,"2015-08-28 08:13:00",1440774780,"C8",340140,1441114920,"2015-09-01 06:42:00"
"2932","20154928074942-377",1,"2015-08-28 08:14:00",1440774840,"C5",197520,1440972360,"2015-08-30 15:06:00"
"3444","20155628075607-90",1,"2015-08-28 08:38:00",1440776280,"C0",349440,1441125720,"2015-09-01 09:42:00"
"563","20150728080743-392",1,"2015-08-28 08:41:00",1440776460,"C0",84960,1440861420,"2015-08-29 08:17:00"
"5780","20152328082316-929",1,"2015-08-28 08:45:00",1440776700,"C5",136260,1440912960,"2015-08-29 22:36:00"
"4590","20153428083457-4",1,"2015-08-28 09:28:00",1440779280,"C8",1232280,1442011560,"2015-09-11 15:46:00"
"3232","20152128092124-904",3,"2015-08-28 09:41:00",1440780060,"C1",291600,1441071660,"2015-08-31 18:41:00"
"4490","20151128091137-757",1,"2015-08-28 09:41:00",1440780060,"C0",386940,1441167000,"2015-09-01 21:10:00"
"284","20150328090330-172",1,"2015-08-28 10:14:00",1440782040,"C3",164640,1440946680,"2015-08-30 07:58:00"
"5188","20154828094837-453",2,"2015-08-28 10:15:00",1440782100,"C4",297660,1441079760,"2015-08-31 20:56:00"
"5564","20153228093241-330",2,"2015-08-28 10:25:00",1440782700,"C7",340680,1441123380,"2015-09-01 09:03:00"
"6541","20153828103812-353",1,"2015-08-28 11:16:00",1440785760,"C2",104400,1440890160,"2015-08-29 16:16:00"
"1504","20152128102128-573",3,"2015-08-28 11:18:00",1440785880,"C6",81000,1440866880,"2015-08-29 09:48:00"
"3798","20155328105351-17",2,"2015-08-28 11:21:00",1440786060,"C3",119880,1440905940,"2015-08-29 20:39:00"
"4558","20152228112223-26",1,"2015-08-28 11:45:00",1440787500,"C5",182880,1440970380,"2015-08-30 14:33:00"
"622","20155228105231-492",1,"2015-08-28 12:05:00",1440788700,"C2",203100,1440991800,"2015-08-30 20:30:00"
"4907","20150228110224-816",1,"2015-08-28 12:08:00",1440788880,"C4",159600,1440948480,"2015-08-30 08:28:00"
"5145","20151628111650-794",2,"2015-08-28 12:11:00",1440789060,"C4",419760,1441208820,"2015-09-02 08:47:00"
"1587","20154428114412-322",1,"2015-08-28 12:17:00",1440789420,"C2",376680,1441166100,"2015-09-01 20:55:00"
"3338","20153228113210-234",1,"2015-08-28 12:21:00",1440789660,"C7",160800,1440950460,"2015-08-30 09:01:00"
"4103","20151928121941-484",3,"2015-08-28 12:44:00",1440791040,"C5",708480,1441499520,"2015-09-05 17:32:00"
"130","20154928114954-255",1,"2015-08-28 12:56:00",1440791760,"C5",375660,1441167420,"2015-09-01 21:17:00"
"3260","20152128122117-954",2,"2015-08-28 13:25:00",1440793500,"C5",321660,1441115160,"2015-09-01 06:46:00"
"6534","20152928122912-286",2,"2015-08-28 13:25:00",1440793500,"C5",158640,1440952140,"2015-08-30 09:29:00"
"1397","20150628010656-511",3,"2015-08-28 14:01:00",1440795660,"C5",59040,1440854700,"2015-08-29 06:25:00"
"2379","20154828014849-145",1,"2015-08-28 14:09:00",1440796140,"C5",432000,1441228140,"2015-09-02 14:09:00"
"3476","20152228012256-73",1,"2015-08-28 14:20:00",1440796800,"C6",99540,1440896340,"2015-08-29 17:59:00"
"2289","20155128015133-316",1,"2015-08-28 14:55:00",1440798900,"C6",410580,1441209480,"2015-09-02 08:58:00"
"695","20153228023246-901",2,"2015-08-28 15:04:00",1440799440,"C3",190740,1440990180,"2015-08-30 20:03:00"
"5586","20153828023832-687",3,"2015-08-28 15:04:00",1440799440,"C8",540120,1441339560,"2015-09-03 21:06:00"
"4035","20154728024720-591",3,"2015-08-28 15:12:00",1440799920,"C3",267600,1441067520,"2015-08-31 17:32:00"
"3611","20151228021221-216",1,"2015-08-28 15:20:00",1440800400,"C0",226440,1441026840,"2015-08-31 06:14:00"
"1392","20155428025436-507",2,"2015-08-28 15:46:00",1440801960,"C5",94140,1440896100,"2015-08-29 17:55:00"
"5255","20152028032005-469",2,"2015-08-28 15:46:00",1440801960,"C4",181140,1440983100,"2015-08-30 18:05:00"
"4612","20154519024544-322",2,"2015-08-28 15:51:00",1440802260,"C4",200940,1441003200,"2015-08-30 23:40:00"
"1426","20150428030425-959",2,"2015-08-28 15:56:00",1440802560,"C5",158520,1440961080,"2015-08-30 11:58:00"
"2048","20150028030051-590",3,"2015-08-28 16:03:00",1440802980,"C5",445500,1441248480,"2015-09-02 19:48:00"
"843","20150728030708-412",1,"2015-08-28 16:19:00",1440803940,"C2",342240,1441146180,"2015-09-01 15:23:00"
"6068","20153228033219-364",2,"2015-08-28 16:20:00",1440804000,"C7",105900,1440909900,"2015-08-29 21:45:00"
"1206","20151728041704-292",1,"2015-08-28 16:35:00",1440804900,"C0",107400,1440912300,"2015-08-29 22:25:00"
"3449","20153328033312-600",3,"2015-08-28 16:35:00",1440804900,"C5",943740,1441748640,"2015-09-08 14:44:00"
"3572","20154228044234-553",2,"2015-08-28 17:05:00",1440806700,"C5",782820,1441589520,"2015-09-06 18:32:00"
"3759","20152128042140-763",3,"2015-08-28 17:20:00",1440807600,"C4",137460,1440945060,"2015-08-30 07:31:00"
"5133","20151728051728-164",2,"2015-08-28 17:43:00",1440808980,"C5",347940,1441156920,"2015-09-01 18:22:00"
"3682","20154928054922-765",1,"2015-08-28 18:17:00",1440811020,"C4",148860,1440959880,"2015-08-30 11:38:00"
"1796","20155328055322-628",1,"2015-08-28 18:46:00",1440812760,"C5",223980,1441036740,"2015-08-31 08:59:00"
"5414","20152229062214-724",1,"2015-08-29 06:27:00",1440854820,"C2",435240,1441290060,"2015-09-03 07:21:00"
"6143","20153129063108-867",2,"2015-08-29 06:36:00",1440855360,"C2",1322220,1442177580,"2015-09-13 13:53:00"
"6251","20153529063501-322",2,"2015-08-29 06:43:00",1440855780,"C4",215520,1441071300,"2015-08-31 18:35:00"
"3553","20152229062233-1",1,"2015-08-29 07:11:00",1440857460,"C8",136920,1440994380,"2015-08-30 21:13:00"
"4409","20154229064247-967",1,"2015-08-29 07:13:00",1440857580,"C2",986280,1441843860,"2015-09-09 17:11:00"
"5190","20151829061839-838",1,"2015-08-29 07:13:00",1440857580,"C8",257400,1441114980,"2015-09-01 06:43:00"
"7","20150229070248-397",1,"2015-08-29 07:25:00",1440858300,"C4",269580,1441127880,"2015-09-01 10:18:00"
"5654","20155429065420-360",1,"2015-08-29 07:25:00",1440858300,"C5",348600,1441206900,"2015-09-02 08:15:00"
"6189","20154529064528-757",3,"2015-08-29 07:43:00",1440859380,"C7",263100,1441122480,"2015-09-01 08:48:00"
"2426","20153829073814-789",2,"2015-08-29 07:48:00",1440859680,"C3",303420,1441163100,"2015-09-01 20:05:00"
"5947","20151829071820-420",2,"2015-08-29 08:20:00",1440861600,"C4",375840,1441237440,"2015-09-02 16:44:00"
"2802","20152329072302-894",1,"2015-08-29 08:27:00",1440862020,"C8",1207200,1442069220,"2015-09-12 07:47:00"
"5508","20151929081907-753",2,"2015-08-29 08:42:00",1440862920,"C4",302520,1441165440,"2015-09-01 20:44:00"
"5063","20150829080825-567",2,"2015-08-29 09:04:00",1440864240,"C3",622440,1441486680,"2015-09-05 13:58:00"
"3499","20150929090940-494",1,"2015-08-29 09:34:00",1440866040,"C5",104220,1440970260,"2015-08-30 14:31:00"
"5459","20155029085047-891",3,"2015-08-29 09:41:00",1440866460,"C7",467160,1441333620,"2015-09-03 19:27:00"
"3936","20152229092222-160",2,"2015-08-29 09:49:00",1440866940,"C5",165660,1441032600,"2015-08-31 07:50:00"
"3545","20153129093103-446",1,"2015-08-29 10:04:00",1440867840,"C3",474000,1441341840,"2015-09-03 21:44:00"
"3662","20155929085958-172",2,"2015-08-29 10:09:00",1440868140,"C2",125100,1440993240,"2015-08-30 20:54:00"
"4029","20155529095519-855",2,"2015-08-29 10:12:00",1440868320,"C7",199560,1441067880,"2015-08-31 17:38:00"
"4360","20152129102109-855",2,"2015-08-29 10:28:00",1440869280,"C8",113280,1440982560,"2015-08-30 17:56:00"
"4834","20151629101604-17",2,"2015-08-29 10:29:00",1440869340,"C7",372420,1441241760,"2015-09-02 17:56:00"
"758","20152129102151-57",1,"2015-08-29 10:33:00",1440869580,"C3",612960,1441482540,"2015-09-05 12:49:00"
"3924","20153629103642-718",2,"2015-08-29 10:58:00",1440871080,"C8",97260,1440968340,"2015-08-30 13:59:00"
"6341","20151629101611-370",1,"2015-08-29 11:26:00",1440872760,"C3",85500,1440958260,"2015-08-30 11:11:00"
"2333","20150129120100-835",1,"2015-08-29 12:08:00",1440875280,"C8",324660,1441199940,"2015-09-02 06:19:00"
"4959","20151029121032-170",1,"2015-08-29 12:33:00",1440876780,"C5",514920,1441391700,"2015-09-04 11:35:00"
"5574","20155729115754-235",2,"2015-08-29 12:53:00",1440877980,"C5",275520,1441153500,"2015-09-01 17:25:00"
"3867","20150529010519-318",2,"2015-08-29 13:20:00",1440879600,"C7",198180,1441077780,"2015-08-31 20:23:00"
"1096","20153329013347-72",2,"2015-08-29 13:53:00",1440881580,"C7",61080,1440942660,"2015-08-30 06:51:00"
"6550","20153229013212-110",1,"2015-08-29 13:55:00",1440881700,"C5",418800,1441300500,"2015-09-03 10:15:00"
"1706","20155129125114-867",1,"2015-08-29 13:56:00",1440881760,"C7",244860,1441126620,"2015-09-01 09:57:00"
"1729","20155029015020-507",1,"2015-08-29 13:57:00",1440881820,"C4",258180,1441140000,"2015-09-01 13:40:00"
"427","20152629012651-157",3,"2015-08-29 14:04:00",1440882240,"C7",1283160,1442165400,"2015-09-13 10:30:00"
"3663","20153829013850-412",1,"2015-08-29 14:10:00",1440882600,"C3",870660,1441753260,"2015-09-08 16:01:00"
"4390","20154529014544-620",1,"2015-08-29 14:17:00",1440883020,"C8",77700,1440960720,"2015-08-30 11:52:00"
"6256","20152129012109-280",1,"2015-08-29 14:29:00",1440883740,"C2",105960,1440989700,"2015-08-30 19:55:00"
"5400","20152429012447-906",1,"2015-08-29 14:31:00",1440883860,"C5",241980,1441125840,"2015-09-01 09:44:00"
"1614","20154529014510-493",2,"2015-08-29 14:38:00",1440884280,"C8",158580,1441042860,"2015-08-31 10:41:00"
"3376","20153829013810-820",1,"2015-08-29 14:42:00",1440884520,"C8",1207080,1442091600,"2015-09-12 14:00:00"
"5180","20152829022835-670",3,"2015-08-29 14:51:00",1440885060,"C4",315120,1441200180,"2015-09-02 06:23:00"
"5198","20152529022528-642",2,"2015-08-29 14:58:00",1440885480,"C5",111660,1440997140,"2015-08-30 21:59:00"
"3199","20152229022224-672",1,"2015-08-29 15:27:00",1440887220,"C3",340680,1441227900,"2015-09-02 14:05:00"
"4395","20153629023651-616",2,"2015-08-29 15:29:00",1440887340,"C5",144180,1441031520,"2015-08-31 07:32:00"
"2234","20154429034402-935",3,"2015-08-29 15:46:00",1440888360,"C6",103860,1440992220,"2015-08-30 20:37:00"
"5705","20151929031948-686",2,"2015-08-29 15:50:00",1440888600,"C8",710400,1441599000,"2015-09-06 21:10:00"
"3824","20153929033958-663",1,"2015-08-29 16:02:00",1440889320,"C8",504120,1441393440,"2015-09-04 12:04:00"
"3000","20150929030929-812",1,"2015-08-29 16:10:00",1440889800,"C2",196440,1441086240,"2015-08-31 22:44:00"
"4433","20154629034625-561",1,"2015-08-29 16:14:00",1440890040,"C5",89040,1440979080,"2015-08-30 16:58:00"
"1296","20155629035637-921",1,"2015-08-29 16:18:00",1440890280,"C6",72480,1440962760,"2015-08-30 12:26:00"
"3014","20153029033048-19",2,"2015-08-29 16:33:00",1440891180,"C5",51720,1440942900,"2015-08-30 06:55:00"
"5703","20153329043300-437",2,"2015-08-29 17:07:00",1440893220,"C4",439860,1441333080,"2015-09-03 19:18:00"
"5663","20154729044749-19",1,"2015-08-29 17:11:00",1440893460,"C5",322560,1441216020,"2015-09-02 10:47:00"
"2264","20152629042632-481",1,"2015-08-29 17:14:00",1440893640,"C6",622380,1441516020,"2015-09-05 22:07:00"
"1420","20155929045919-954",2,"2015-08-29 17:28:00",1440894480,"C3",1016580,1441911060,"2015-09-10 11:51:00"
"3195","20150429050401-796",2,"2015-08-29 17:38:00",1440895080,"C2",71820,1440966900,"2015-08-30 13:35:00"
"6532","20150829050830-287",3,"2015-08-29 17:56:00",1440896160,"C8",916260,1441812420,"2015-09-09 08:27:00"
"951","20151729051759-488",1,"2015-08-29 18:07:00",1440896820,"C8",330840,1441227660,"2015-09-02 14:01:00"
"6197","20152229052214-773",3,"2015-08-29 18:30:00",1440898200,"C8",520140,1441418340,"2015-09-04 18:59:00"
"1929","20152729052719-451",1,"2015-08-29 18:34:00",1440898440,"C4",419820,1441318260,"2015-09-03 15:11:00"
"4043","20153730063725-217",1,"2015-08-30 07:09:00",1440943740,"C7",430260,1441374000,"2015-09-04 06:40:00"
"2639","20154930064934-59",2,"2015-08-30 07:10:00",1440943800,"C8",882060,1441825860,"2015-09-09 12:11:00"
"5932","20155430065423-661",3,"2015-08-30 07:27:00",1440944820,"C2",277860,1441222680,"2015-09-02 12:38:00"
"2889","20150230070206-829",1,"2015-08-30 07:38:00",1440945480,"C7",373560,1441319040,"2015-09-03 15:24:00"
"5679","20153430063422-994",1,"2015-08-30 07:39:00",1440945540,"C3",126780,1441072320,"2015-08-31 18:52:00"
"3418","20155430065457-569",1,"2015-08-30 07:49:00",1440946140,"C5",103320,1441049460,"2015-08-31 12:31:00"
"3770","20155030075008-549",2,"2015-08-30 08:11:00",1440947460,"C8",193380,1441140840,"2015-09-01 13:54:00"
"2705","20152230072211-448",3,"2015-08-30 08:12:00",1440947520,"C4",805020,1441752540,"2015-09-08 15:49:00"
"6318","20154730074747-926",1,"2015-08-30 08:20:00",1440948000,"C3",311940,1441259940,"2015-09-02 22:59:00"
"3918","20155530075533-622",2,"2015-08-30 08:24:00",1440948240,"C8",372420,1441320660,"2015-09-03 15:51:00"
"1109","20151730081700-38",2,"2015-08-30 08:27:00",1440948420,"C3",270960,1441219380,"2015-09-02 11:43:00"
"650","20150930080915-526",1,"2015-08-30 08:36:00",1440948960,"C4",355440,1441304400,"2015-09-03 11:20:00"
"5390","20155230075218-899",3,"2015-08-30 08:52:00",1440949920,"C5",134880,1441084800,"2015-08-31 22:20:00"
"1349","20152130082153-677",1,"2015-08-30 09:08:00",1440950880,"C6",167880,1441118760,"2015-09-01 07:46:00"
"5278","20152030082047-827",2,"2015-08-30 09:12:00",1440951120,"C4",170460,1441121580,"2015-09-01 08:33:00"
"5981","20154430084401-298",1,"2015-08-30 09:17:00",1440951420,"C4",533100,1441484520,"2015-09-05 13:22:00"
"6509","20151230091228-162",1,"2015-08-30 09:18:00",1440951480,"C8",95340,1441046820,"2015-08-31 11:47:00"
"4112","20150630080609-634",1,"2015-08-30 09:21:00",1440951660,"C2",444540,1441396200,"2015-09-04 12:50:00"
"171","20154930084931-614",1,"2015-08-30 09:30:00",1440952200,"C0",73800,1441026000,"2015-08-31 06:00:00"
"5878","20150730090701-127",3,"2015-08-30 09:33:00",1440952380,"C5",455280,1441407660,"2015-09-04 16:01:00"
"597","20150330090357-596",2,"2015-08-30 09:41:00",1440952860,"C7",89580,1441042440,"2015-08-31 10:34:00"
"3125","20152630092647-226",1,"2015-08-30 09:48:00",1440953280,"C7",105840,1441059120,"2015-08-31 15:12:00"
"4326","20150230100245-923",2,"2015-08-30 10:21:00",1440955260,"C6",183540,1441138800,"2015-09-01 13:20:00"
"1958","20152030102012-63",1,"2015-08-30 10:38:00",1440956280,"C0",195600,1441151880,"2015-09-01 16:58:00"
"2501","20154230094206-93",1,"2015-08-30 10:39:00",1440956340,"C5",372720,1441329060,"2015-09-03 18:11:00"
"221","20154930094911-931",1,"2015-08-30 10:44:00",1440956640,"C5",69420,1441026060,"2015-08-31 06:01:00"
"1158","20152930102944-762",1,"2015-08-30 10:54:00",1440957240,"C5",249900,1441207140,"2015-09-02 08:19:00"
"1727","20153930103903-13",1,"2015-08-30 10:57:00",1440957420,"C6",356700,1441314120,"2015-09-03 14:02:00"
"1267","20151030111021-959",1,"2015-08-30 11:17:00",1440958620,"C8",528300,1441486920,"2015-09-05 14:02:00"
"2529","20150630110633-414",1,"2015-08-30 11:41:00",1440960060,"C0",538080,1441498140,"2015-09-05 17:09:00"
"1909","20154730114701-335",3,"2015-08-30 11:49:00",1440960540,"C6",1296420,1442256960,"2015-09-14 11:56:00"
"2476","20155930115903-142",1,"2015-08-30 12:07:00",1440961620,"C4",190440,1441152060,"2015-09-01 17:01:00"
"5123","20150930110949-443",1,"2015-08-30 12:12:00",1440961920,"C0",350640,1441312560,"2015-09-03 13:36:00"
"3711","20150030120002-677",2,"2015-08-30 12:22:00",1440962520,"C5",113820,1441076340,"2015-08-31 19:59:00"
"4172","20151930121913-276",2,"2015-08-30 12:25:00",1440962700,"C2",1131480,1442094180,"2015-09-12 14:43:00"
"3720","20152830112817-503",2,"2015-08-30 12:31:00",1440963060,"C4",119820,1441082880,"2015-08-31 21:48:00"
"2534","20153930123905-665",1,"2015-08-30 12:41:00",1440963660,"C6",182340,1441146000,"2015-09-01 15:20:00"
"6497","20152330122319-139",3,"2015-08-30 12:53:00",1440964380,"C6",206700,1441171080,"2015-09-01 22:18:00"
"1281","20154630124612-292",1,"2015-08-30 13:16:00",1440965760,"C2",147960,1441113720,"2015-09-01 06:22:00"
"1932","20150530010559-140",2,"2015-08-30 13:23:00",1440966180,"C0",110040,1441076220,"2015-08-31 19:57:00"
"1347","20152130122123-358",2,"2015-08-30 13:31:00",1440966660,"C7",252720,1441219380,"2015-09-02 11:43:00"
"1961","20153430123444-403",1,"2015-08-30 13:35:00",1440966900,"C2",163500,1441130400,"2015-09-01 11:00:00"
"852","20150430020414-999",2,"2015-08-30 14:37:00",1440970620,"C4",371820,1441342440,"2015-09-03 21:54:00"
"6267","20155430015455-513",3,"2015-08-30 14:56:00",1440971760,"C5",937620,1441909380,"2015-09-10 11:23:00"
"5725","20155230025241-974",3,"2015-08-30 15:19:00",1440973140,"C5",321720,1441294860,"2015-09-03 08:41:00"
"1924","20155130025118-645",3,"2015-08-30 15:22:00",1440973320,"C8",321900,1441295220,"2015-09-03 08:47:00"
"6013","20154330024325-110",1,"2015-08-30 15:32:00",1440973920,"C6",414060,1441387980,"2015-09-04 10:33:00"
"3695","20154030024055-701",3,"2015-08-30 15:37:00",1440974220,"C6",148980,1441123200,"2015-09-01 09:00:00"
"5770","20153230033205-767",1,"2015-08-30 15:52:00",1440975120,"C5",152040,1441127160,"2015-09-01 10:06:00"
"1966","20155330035349-797",1,"2015-08-30 16:00:00",1440975600,"C2",90780,1441066380,"2015-08-31 17:13:00"
"5558","20152030042019-172",3,"2015-08-30 16:27:00",1440977220,"C4",157800,1441135020,"2015-09-01 12:17:00"
"1808","20150930040930-759",1,"2015-08-30 16:34:00",1440977640,"C5",314820,1441292460,"2015-09-03 08:01:00"
"277","20153230043217-141",2,"2015-08-30 16:55:00",1440978900,"C5",327540,1441306440,"2015-09-03 11:54:00"
"4837","20153130043132-951",1,"2015-08-30 17:00:00",1440979200,"C5",238080,1441217280,"2015-09-02 11:08:00"
"2948","20155730045709-115",1,"2015-08-30 17:03:00",1440979380,"C2",71220,1441050600,"2015-08-31 12:50:00"
"5686","20151730041740-897",2,"2015-08-30 17:10:00",1440979800,"C8",323220,1441303020,"2015-09-03 10:57:00"
"1839","20152130042105-824",1,"2015-08-30 17:27:00",1440980820,"C2",534060,1441514880,"2015-09-05 21:48:00"
"2929","20151530051543-867",3,"2015-08-30 17:38:00",1440981480,"C5",155460,1441136940,"2015-09-01 12:49:00"
"30","20153330053323-666",3,"2015-08-30 17:40:00",1440981600,"C8",143100,1441124700,"2015-09-01 09:25:00"
"3680","20155830045808-582",1,"2015-08-30 17:46:00",1440981960,"C8",153000,1441134960,"2015-09-01 12:16:00"
"3141","20152830052802-839",2,"2015-08-30 17:55:00",1440982500,"C8",84240,1441066740,"2015-08-31 17:19:00"
"5163","20155130055132-838",1,"2015-08-30 17:57:00",1440982620,"C2",363360,1441345980,"2015-09-03 22:53:00"
"3307","20153430053418-339",3,"2015-08-30 18:02:00",1440982920,"C5",319200,1441302120,"2015-09-03 10:42:00"
"5547","20154830054857-116",3,"2015-08-30 18:18:00",1440983880,"C4",361380,1441345260,"2015-09-03 22:41:00"
"1699","20155530055509-649",2,"2015-08-30 18:24:00",1440984240,"C8",64200,1441048440,"2015-08-31 12:14:00"
"1481","20152730052714-154",2,"2015-08-30 18:27:00",1440984420,"C4",176100,1441160520,"2015-09-01 19:22:00"
"4829","20155330055334-238",3,"2015-08-30 18:46:00",1440985560,"C4",350340,1441335900,"2015-09-03 20:05:00"
"4056","20150031070053-947",1,"2015-08-31 07:06:00",1441029960,"C2",466560,1441496520,"2015-09-05 16:42:00"
"4382","20155731065708-964",2,"2015-08-31 07:20:00",1441030800,"C5",105480,1441136280,"2015-09-01 12:38:00"
"303","20153231063236-320",3,"2015-08-31 07:25:00",1441031100,"C4",388200,1441419300,"2015-09-04 19:15:00"
"1387","20152931072940-294",1,"2015-08-31 08:03:00",1441033380,"C8",305820,1441339200,"2015-09-03 21:00:00"
"2645","20153831073821-785",1,"2015-08-31 08:15:00",1441034100,"C6",301320,1441335420,"2015-09-03 19:57:00"
"4492","20152131072114-536",3,"2015-08-31 08:30:00",1441035000,"C8",83160,1441118160,"2015-09-01 07:36:00"
"5864","20152531082521-227",1,"2015-08-31 08:47:00",1441036020,"C5",183720,1441219740,"2015-09-02 11:49:00"
"349","20151131081108-573",1,"2015-08-31 08:57:00",1441036620,"C8",956640,1441993260,"2015-09-11 10:41:00"
"351","20153131083117-488",1,"2015-08-31 09:00:00",1441036800,"C5",267000,1441303800,"2015-09-03 11:10:00"
"2312","20155431095434-843",1,"2015-08-31 10:01:00",1441040460,"C4",90360,1441130820,"2015-09-01 11:07:00"
"2691","20153931093915-91",1,"2015-08-31 10:27:00",1441042020,"C7",335760,1441377780,"2015-09-04 07:43:00"
"1378","20152531102541-22",1,"2015-08-31 10:47:00",1441043220,"C4",504180,1441547400,"2015-09-06 06:50:00"
"5553","20153031103041-989",1,"2015-08-31 10:49:00",1441043340,"C6",69120,1441112460,"2015-09-01 06:01:00"
"2947","20154631104618-531",1,"2015-08-31 11:13:00",1441044780,"C4",99720,1441144500,"2015-09-01 14:55:00"
"4003","20150831110802-88",1,"2015-08-31 11:13:00",1441044780,"C2",114000,1441158780,"2015-09-01 18:53:00"
"3087","20155231105239-338",2,"2015-08-31 11:25:00",1441045500,"C6",508560,1441554060,"2015-09-06 08:41:00"
"6122","20151031111040-488",2,"2015-08-31 11:33:00",1441045980,"C5",155700,1441201680,"2015-09-02 06:48:00"
"4634","20153731113748-614",3,"2015-08-31 12:00:00",1441047600,"C4",87600,1441135200,"2015-09-01 12:20:00"
"4938","20150631110616-558",3,"2015-08-31 12:01:00",1441047660,"C6",190920,1441238580,"2015-09-02 17:03:00"
"907","20153931113929-38",1,"2015-08-31 12:16:00",1441048560,"C0",445440,1441494000,"2015-09-05 16:00:00"
"1800","20155731115721-967",1,"2015-08-31 12:22:00",1441048920,"C5",286500,1441335420,"2015-09-03 19:57:00"
"2494","20150731120739-57",1,"2015-08-31 12:30:00",1441049400,"C5",249360,1441298760,"2015-09-03 09:46:00"
"3733","20151431121439-712",1,"2015-08-31 12:57:00",1441051020,"C2",183360,1441234380,"2015-09-02 15:53:00"
"5544","20155131115159-825",3,"2015-08-31 12:57:00",1441051020,"C5",344640,1441395660,"2015-09-04 12:41:00"
"1273","20152431122444-914",2,"2015-08-31 13:00:00",1441051200,"C0",175260,1441226460,"2015-09-02 13:41:00"
"4890","20150931010941-247",1,"2015-08-31 13:44:00",1441053840,"C8",378660,1441432500,"2015-09-04 22:55:00"
"4473","20150831020803-228",1,"2015-08-31 14:14:00",1441055640,"C2",100980,1441156620,"2015-09-01 18:17:00"
"3812","20151731021746-364",1,"2015-08-31 14:47:00",1441057620,"C8",75120,1441132740,"2015-09-01 11:39:00"
"2424","20155531015543-259",2,"2015-08-31 14:51:00",1441057860,"C4",81840,1441139700,"2015-09-01 13:35:00"
"4330","20151931021927-541",3,"2015-08-31 15:15:00",1441059300,"C8",261060,1441320360,"2015-09-03 15:46:00"
"4407","20151531031549-230",1,"2015-08-31 15:23:00",1441059780,"C8",75180,1441134960,"2015-09-01 12:16:00"
"388","20151931031941-864",1,"2015-08-31 15:26:00",1441059960,"C8",685140,1441745100,"2015-09-08 13:45:00"
"141","20155331025312-334",1,"2015-08-31 15:29:00",1441060140,"C0",57480,1441117620,"2015-09-01 07:27:00"
"3715","20152731032706-323",1,"2015-08-31 15:47:00",1441061220,"C7",94740,1441155960,"2015-09-01 18:06:00"
"5834","20152231032211-936",3,"2015-08-31 15:48:00",1441061280,"C4",426060,1441487340,"2015-09-05 14:09:00"
"6141","20152531032502-40",2,"2015-08-31 15:57:00",1441061820,"C2",96240,1441158060,"2015-09-01 18:41:00"
"4923","20155931025933-274",1,"2015-08-31 15:58:00",1441061880,"C7",160020,1441221900,"2015-09-02 12:25:00"
"3992","20151631041644-215",1,"2015-08-31 16:44:00",1441064640,"C4",193500,1441258140,"2015-09-02 22:29:00"
"3248","20153331043359-711",1,"2015-08-31 17:44:00",1441068240,"C2",170040,1441238280,"2015-09-02 16:58:00"
"2366","20150631050638-897",2,"2015-08-31 18:02:00",1441069320,"C8",67680,1441137000,"2015-09-01 12:50:00"
"5952","20151431051408-107",1,"2015-08-31 18:07:00",1441069620,"C5",833820,1441903440,"2015-09-10 09:44:00"
"6070","20151531051542-946",1,"2015-08-31 18:12:00",1441069920,"C8",185160,1441255080,"2015-09-02 21:38:00"
"5986","20150701070722-706",1,"2015-09-01 07:41:00",1441118460,"C2",213000,1441331460,"2015-09-03 18:51:00"
"1124","20154201074239-177",1,"2015-09-01 08:06:00",1441119960,"C7",707400,1441827360,"2015-09-09 12:36:00"
"3157","20150001080008-525",3,"2015-09-01 08:24:00",1441121040,"C5",218280,1441339320,"2015-09-03 21:02:00"
"2253","20150701080732-301",1,"2015-09-01 08:30:00",1441121400,"C4",94020,1441215420,"2015-09-02 10:37:00"
"701","20151001081041-702",1,"2015-09-01 08:49:00",1441122540,"C0",194400,1441316940,"2015-09-03 14:49:00"
"1664","20152801082834-605",1,"2015-09-01 08:50:00",1441122600,"C8",107400,1441230000,"2015-09-02 14:40:00"
"6153","20152201082225-621",1,"2015-09-01 08:56:00",1441122960,"C8",106740,1441229700,"2015-09-02 14:35:00"
"3653","20150001090048-374",1,"2015-09-01 09:52:00",1441126320,"C8",373380,1441499700,"2015-09-05 17:35:00"
"4194","20151301091306-345",2,"2015-09-01 10:22:00",1441128120,"C8",687660,1441815780,"2015-09-09 09:23:00"
"3937","20150801100806-862",1,"2015-09-01 10:32:00",1441128720,"C8",106920,1441235640,"2015-09-02 16:14:00"
"2038","20151901101926-562",1,"2015-09-01 10:46:00",1441129560,"C8",187860,1441317420,"2015-09-03 14:57:00"
"614","20150401110417-611",1,"2015-09-01 11:41:00",1441132860,"C0",168960,1441301820,"2015-09-03 10:37:00"
"5575","20154601104625-869",1,"2015-09-01 11:45:00",1441133100,"C7",105840,1441238940,"2015-09-02 17:09:00"
"4050","20153701113748-789",1,"2015-09-01 12:09:00",1441134540,"C6",361680,1441496220,"2015-09-05 16:37:00"
"436","20151401121438-732",3,"2015-09-01 12:40:00",1441136400,"C3",792360,1441928760,"2015-09-10 16:46:00"
"6538","20152101122110-544",1,"2015-09-01 13:28:00",1441139280,"C4",113520,1441252800,"2015-09-02 21:00:00"
"2818","20150501010554-108",1,"2015-09-01 13:38:00",1441139880,"C2",96240,1441236120,"2015-09-02 16:22:00"
"133","20152001022003-999",1,"2015-09-01 14:44:00",1441143840,"C4",149580,1441293420,"2015-09-03 08:17:00"
"1577","20155801015824-240",1,"2015-09-01 14:50:00",1441144200,"C8",67020,1441211220,"2015-09-02 09:27:00"
"6392","20155501015527-544",2,"2015-09-01 14:52:00",1441144320,"C5",530280,1441674600,"2015-09-07 18:10:00"
"4637","20155201025239-418",2,"2015-09-01 15:25:00",1441146300,"C2",193500,1441339800,"2015-09-03 21:10:00"
"5224","20154501024521-895",1,"2015-09-01 15:37:00",1441147020,"C4",103500,1441250520,"2015-09-02 20:22:00"
"4454","20150501030502-599",3,"2015-09-01 15:38:00",1441147080,"C0",66420,1441213500,"2015-09-02 10:05:00"
"1164","20150201030237-485",1,"2015-09-01 15:53:00",1441147980,"C5",692700,1441840680,"2015-09-09 16:18:00"
"6436","20155701025733-561",1,"2015-09-01 15:57:00",1441148220,"C3",447780,1441596000,"2015-09-06 20:20:00"
"1080","20153801033808-197",2,"2015-09-01 16:13:00",1441149180,"C2",351420,1441500600,"2015-09-05 17:50:00"
"4676","20150601040632-151",2,"2015-09-01 16:50:00",1441151400,"C8",657480,1441808880,"2015-09-09 07:28:00"
"3892","20152801042854-889",1,"2015-09-01 16:51:00",1441151460,"C4",279720,1441431180,"2015-09-04 22:33:00"
"3287","20150001050042-811",1,"2015-09-01 17:26:00",1441153560,"C7",346200,1441499760,"2015-09-05 17:36:00"
"1017","20150301050357-768",1,"2015-09-01 18:07:00",1441156020,"C0",64080,1441220100,"2015-09-02 11:55:00"
"2832","20154701054735-930",2,"2015-09-01 18:36:00",1441157760,"C8",225540,1441383300,"2015-09-04 09:15:00"
"5869","20153901053918-352",1,"2015-09-01 18:38:00",1441157880,"C2",321780,1441479660,"2015-09-05 12:01:00"
"3042","20150302060320-142",3,"2015-09-02 06:05:00",1441199100,"C6",462300,1441661400,"2015-09-07 14:30:00"
"1499","20153102063137-742",1,"2015-09-02 06:38:00",1441201080,"C8",98820,1441299900,"2015-09-03 10:05:00"
"5298","20153202063212-217",2,"2015-09-02 07:11:00",1441203060,"C7",284340,1441487400,"2015-09-05 14:10:00"
"6535","20151302071301-31",3,"2015-09-02 08:03:00",1441206180,"C4",342360,1441548540,"2015-09-06 07:09:00"
"1432","20155602075606-537",1,"2015-09-02 08:27:00",1441207620,"C7",620880,1441828500,"2015-09-09 12:55:00"
"5548","20154702074759-377",1,"2015-09-02 08:44:00",1441208640,"C7",278340,1441486980,"2015-09-05 14:03:00"
"3453","20152202092258-284",1,"2015-09-02 09:48:00",1441212480,"C8",111480,1441323960,"2015-09-03 16:46:00"
"585","20155402095430-944",2,"2015-09-02 10:00:00",1441213200,"C2",244920,1441458120,"2015-09-05 06:02:00"
"5948","20150802090823-595",1,"2015-09-02 10:03:00",1441213380,"C4",255060,1441468440,"2015-09-05 08:54:00"
"350","20155002095022-451",2,"2015-09-02 10:45:00",1441215900,"C8",455820,1441671720,"2015-09-07 17:22:00"
"1811","20154102104114-973",2,"2015-09-02 11:02:00",1441216920,"C7",111360,1441328280,"2015-09-03 17:58:00"
"391","20150902120906-170",1,"2015-09-02 12:19:00",1441221540,"C3",266040,1441487580,"2015-09-05 14:13:00"
"4639","20151502121502-816",3,"2015-09-02 12:35:00",1441222500,"C6",108060,1441330560,"2015-09-03 18:36:00"
"1501","20154102114141-894",3,"2015-09-02 12:44:00",1441223040,"C8",155340,1441378380,"2015-09-04 07:53:00"
"276","20154202014210-253",2,"2015-09-02 13:52:00",1441227120,"C3",156600,1441383720,"2015-09-04 09:22:00"
"5875","20154102014133-632",3,"2015-09-02 14:14:00",1441228440,"C3",89760,1441318200,"2015-09-03 15:10:00"
"5120","20155302025312-112",1,"2015-09-02 15:49:00",1441234140,"C3",168960,1441403100,"2015-09-04 14:45:00"
"5969","20153802033804-576",1,"2015-09-02 16:31:00",1441236660,"C8",275760,1441512420,"2015-09-05 21:07:00"
"2605","20152602042627-350",1,"2015-09-02 16:56:00",1441238160,"C2",696000,1441934160,"2015-09-10 18:16:00"
"4315","20154102054122-35",1,"2015-09-02 17:47:00",1441241220,"C2",499140,1441740360,"2015-09-08 12:26:00"
"2812","20154402044412-377",1,"2015-09-02 17:48:00",1441241280,"C7",477900,1441719180,"2015-09-08 06:33:00"
"457","20150602050643-221",3,"2015-09-02 17:57:00",1441241820,"C4",62640,1441304460,"2015-09-03 11:21:00"
"3677","20155102055140-273",3,"2015-09-02 18:07:00",1441242420,"C0",80460,1441322880,"2015-09-03 16:28:00"
"3780","20153002053041-801",1,"2015-09-02 18:26:00",1441243560,"C3",143940,1441387500,"2015-09-04 10:25:00"
"1762","20152102052154-22",3,"2015-09-02 18:35:00",1441244100,"C2",509820,1441753920,"2015-09-08 16:12:00"
"757","20153303063323-954",1,"2015-09-03 07:06:00",1441289160,"C3",96000,1441385160,"2015-09-04 09:46:00"
"745","20154303064359-839",1,"2015-09-03 07:13:00",1441289580,"C5",954420,1442244000,"2015-09-14 08:20:00"
"6545","20152703072711-146",1,"2015-09-03 07:33:00",1441290780,"C4",305520,1441596300,"2015-09-06 20:25:00"
"4517","20150103070112-250",3,"2015-09-03 08:01:00",1441292460,"C4",276720,1441569180,"2015-09-06 12:53:00"
"4465","20152803072816-844",2,"2015-09-03 08:27:00",1441294020,"C0",436620,1441730640,"2015-09-08 09:44:00"
"3166","20151703081723-858",2,"2015-09-03 08:57:00",1441295820,"C7",625260,1441921080,"2015-09-10 14:38:00"
"3167","20154303094318-187",3,"2015-09-03 10:24:00",1441301040,"C2",124200,1441425240,"2015-09-04 20:54:00"
"5406","20151903101941-31",1,"2015-09-03 10:51:00",1441302660,"C3",102300,1441404960,"2015-09-04 15:16:00"
"4920","20154303104350-928",2,"2015-09-03 11:03:00",1441303380,"C7",105120,1441408500,"2015-09-04 16:15:00"
"5726","20151303111344-23",1,"2015-09-03 11:24:00",1441304640,"C3",84600,1441389240,"2015-09-04 10:54:00"
"6369","20154703104737-748",3,"2015-09-03 11:26:00",1441304760,"C0",882780,1442187540,"2015-09-13 16:39:00"
"361","20155603105654-700",2,"2015-09-03 11:34:00",1441305240,"C6",274920,1441580160,"2015-09-06 15:56:00"
"2608","20155103115100-856",2,"2015-09-03 12:02:00",1441306920,"C3",73740,1441380660,"2015-09-04 08:31:00"
"1832","20150403120405-547",3,"2015-09-03 12:41:00",1441309260,"C0",68460,1441377720,"2015-09-04 07:42:00"
"4183","20155303125323-651",1,"2015-09-03 13:51:00",1441313460,"C3",191100,1441504560,"2015-09-05 18:56:00"
"735","20154903014909-323",3,"2015-09-03 13:55:00",1441313700,"C8",291420,1441605120,"2015-09-06 22:52:00"
"1325","20151803011812-57",2,"2015-09-03 14:16:00",1441314960,"C6",455880,1441770840,"2015-09-08 20:54:00"
"789","20150903020949-595",1,"2015-09-03 14:45:00",1441316700,"C2",148860,1441465560,"2015-09-05 08:06:00"
"3395","20154903014907-481",2,"2015-09-03 14:48:00",1441316880,"C4",189780,1441506660,"2015-09-05 19:31:00"
"6066","20155203015220-852",3,"2015-09-03 14:55:00",1441317300,"C3",345600,1441662900,"2015-09-07 14:55:00"
"300","20150803030838-612",2,"2015-09-03 15:14:00",1441318440,"C2",79200,1441397640,"2015-09-04 13:14:00"
"1842","20155703035752-285",1,"2015-09-03 16:20:00",1441322400,"C7",429120,1441751520,"2015-09-08 15:32:00"
"5913","20153703033757-677",1,"2015-09-03 16:28:00",1441322880,"C4",52980,1441375860,"2015-09-04 07:11:00"
"5441","20150303040325-976",1,"2015-09-03 17:13:00",1441325580,"C3",260100,1441585680,"2015-09-06 17:28:00"
"2365","20153103053109-344",3,"2015-09-03 17:45:00",1441327500,"C0",682620,1442010120,"2015-09-11 15:22:00"
"2527","20155403055431-688",1,"2015-09-03 18:24:00",1441329840,"C4",218520,1441548360,"2015-09-06 07:06:00"
"5203","20152904062902-66",1,"2015-09-04 06:36:00",1441373760,"C8",397020,1441770780,"2015-09-08 20:53:00"
"4853","20153404063406-832",1,"2015-09-04 06:50:00",1441374600,"C7",97500,1441472100,"2015-09-05 09:55:00"
"2201","20150904060937-392",1,"2015-09-04 07:01:00",1441375260,"C5",271440,1441646700,"2015-09-07 10:25:00"
"3970","20151304071316-371",2,"2015-09-04 07:15:00",1441376100,"C6",211440,1441587540,"2015-09-06 17:59:00"
"1592","20154504064547-329",1,"2015-09-04 07:19:00",1441376340,"C0",114780,1441491120,"2015-09-05 15:12:00"
"1171","20152604072643-403",1,"2015-09-04 07:52:00",1441378320,"C4",647760,1442026080,"2015-09-11 19:48:00"
"821","20154904074940-639",1,"2015-09-04 08:23:00",1441380180,"C5",118620,1441498800,"2015-09-05 17:20:00"
"4342","20151804081822-193",3,"2015-09-04 08:25:00",1441380300,"C8",862800,1442243100,"2015-09-14 08:05:00"
"4500","20151904071915-758",2,"2015-09-04 08:26:00",1441380360,"C7",286800,1441667160,"2015-09-07 16:06:00"
"2088","20154304074340-809",1,"2015-09-04 08:30:00",1441380600,"C6",310620,1441691220,"2015-09-07 22:47:00"
"2287","20151004081041-724",1,"2015-09-04 08:34:00",1441380840,"C5",437220,1441818060,"2015-09-09 10:01:00"
"1052","20153604073635-88",2,"2015-09-04 08:37:00",1441381020,"C4",102600,1441483620,"2015-09-05 13:07:00"
"2355","20154704084736-736",3,"2015-09-04 09:48:00",1441385280,"C7",95460,1441480740,"2015-09-05 12:19:00"
"3247","20155304085320-560",1,"2015-09-04 09:52:00",1441385520,"C3",343860,1441729380,"2015-09-08 09:23:00"
"6167","20153304093314-219",1,"2015-09-04 09:54:00",1441385640,"C8",612180,1441997820,"2015-09-11 11:57:00"
"3609","20151704091740-106",2,"2015-09-04 10:10:00",1441386600,"C4",590220,1441976820,"2015-09-11 06:07:00"
"6011","20150904100901-193",1,"2015-09-04 10:22:00",1441387320,"C7",373200,1441760520,"2015-09-08 18:02:00"
"6224","20152504102537-658",2,"2015-09-04 11:16:00",1441390560,"C7",338580,1441729140,"2015-09-08 09:19:00"
"1575","20151504111546-565",1,"2015-09-04 11:22:00",1441390920,"C2",1277700,1442668620,"2015-09-19 06:17:00"
"6319","20155904105902-891",2,"2015-09-04 11:26:00",1441391160,"C5",106980,1441498140,"2015-09-05 17:09:00"
"1344","20150904110914-670",3,"2015-09-04 11:35:00",1441391700,"C4",93360,1441485060,"2015-09-05 13:31:00"
"3829","20154104114100-580",2,"2015-09-04 11:47:00",1441392420,"C8",119400,1441511820,"2015-09-05 20:57:00"
"2675","20155504115554-356",1,"2015-09-04 12:09:00",1441393740,"C0",95580,1441489320,"2015-09-05 14:42:00"
"1154","20151204111220-934",2,"2015-09-04 12:15:00",1441394100,"C7",275580,1441669680,"2015-09-07 16:48:00"
"2695","20152004112056-852",1,"2015-09-04 12:18:00",1441394280,"C4",634140,1442028420,"2015-09-11 20:27:00"
"3117","20153004123036-930",1,"2015-09-04 12:38:00",1441395480,"C4",517440,1441912920,"2015-09-10 12:22:00"
"3059","20150004120029-367",2,"2015-09-04 13:00:00",1441396800,"C2",724380,1442121180,"2015-09-12 22:13:00"
"389","20150204010234-9",1,"2015-09-04 13:08:00",1441397280,"C2",91440,1441488720,"2015-09-05 14:32:00"
"3134","20151304011353-532",1,"2015-09-04 13:20:00",1441398000,"C4",463680,1441861680,"2015-09-09 22:08:00"
"5288","20154804124824-880",1,"2015-09-04 13:25:00",1441398300,"C6",534900,1441933200,"2015-09-10 18:00:00"
"2139","20150404010414-57",1,"2015-09-04 13:35:00",1441398900,"C3",183540,1441582440,"2015-09-06 16:34:00"
"3123","20152404012417-940",1,"2015-09-04 14:24:00",1441401840,"C2",1364220,1442766060,"2015-09-20 09:21:00"
"1042","20150704020738-670",3,"2015-09-04 14:31:00",1441402260,"C5",233880,1441636140,"2015-09-07 07:29:00"
"2096","20150504020535-36",1,"2015-09-04 14:36:00",1441402560,"C3",273780,1441676340,"2015-09-07 18:39:00"
"4762","20153804013829-884",2,"2015-09-04 14:45:00",1441403100,"C0",150720,1441553820,"2015-09-06 08:37:00"
"105","20154504024526-617",3,"2015-09-04 14:53:00",1441403580,"C8",455220,1441858800,"2015-09-09 21:20:00"
"2409","20154404024444-783",1,"2015-09-04 15:06:00",1441404360,"C5",200160,1441604520,"2015-09-06 22:42:00"
"3198","20150004030017-259",1,"2015-09-04 15:06:00",1441404360,"C4",68820,1441473180,"2015-09-05 10:13:00"
"3959","20154904024927-977",1,"2015-09-04 15:21:00",1441405260,"C3",183360,1441588620,"2015-09-06 18:17:00"
"4892","20151204031221-340",1,"2015-09-04 15:27:00",1441405620,"C7",267300,1441672920,"2015-09-07 17:42:00"
"4613","20154519024544-322",2,"2015-09-04 15:33:00",1441405980,"C4",202620,1441608600,"2015-09-06 23:50:00"
"4963","20152104032137-992",3,"2015-09-04 15:54:00",1441407240,"C2",188280,1441595520,"2015-09-06 20:12:00"
"1363","20151004051005-26",1,"2015-09-04 17:32:00",1441413120,"C8",57540,1441470660,"2015-09-05 09:31:00"
"1290","20154404044452-704",2,"2015-09-04 17:44:00",1441413840,"C4",85620,1441499460,"2015-09-05 17:31:00"
"4253","20151804051810-974",1,"2015-09-04 17:49:00",1441414140,"C5",481020,1441895160,"2015-09-10 07:26:00"
"4919","20154704054739-174",1,"2015-09-04 17:53:00",1441414380,"C2",237780,1441652160,"2015-09-07 11:56:00"
"6484","20154804054850-394",1,"2015-09-04 18:14:00",1441415640,"C5",164100,1441579740,"2015-09-06 15:49:00"
"5234","20154504054501-314",2,"2015-09-04 18:24:00",1441416240,"C2",64200,1441480440,"2015-09-05 12:14:00"
"5047","20150105070153-470",1,"2015-09-05 07:08:00",1441462080,"C2",895620,1442357700,"2015-09-15 15:55:00"
"3004","20154805074832-890",2,"2015-09-05 08:52:00",1441468320,"C8",265920,1441734240,"2015-09-08 10:44:00"
"4243","20152605082604-337",1,"2015-09-05 08:56:00",1441468560,"C5",124020,1441592580,"2015-09-06 19:23:00"
"3118","20150605090617-10",1,"2015-09-05 09:08:00",1441469280,"C6",193080,1441662360,"2015-09-07 14:46:00"
"1032","20150605090601-376",2,"2015-09-05 09:13:00",1441469580,"C8",889920,1442359500,"2015-09-15 16:25:00"
"3620","20151705081753-773",3,"2015-09-05 09:16:00",1441469760,"C7",119640,1441589400,"2015-09-06 18:30:00"
"1867","20154405084402-280",2,"2015-09-05 09:21:00",1441470060,"C2",77460,1441547520,"2015-09-06 06:52:00"
"1736","20150605090619-525",2,"2015-09-05 09:25:00",1441470300,"C7",161400,1441631700,"2015-09-07 06:15:00"
"4512","20152705082730-727",1,"2015-09-05 09:30:00",1441470600,"C8",214560,1441685160,"2015-09-07 21:06:00"
"6460","20152405092403-279",1,"2015-09-05 09:58:00",1441472280,"C0",282480,1441754760,"2015-09-08 16:26:00"
"403","20155705085705-756",2,"2015-09-05 09:59:00",1441472340,"C2",507600,1441979940,"2015-09-11 06:59:00"
"945","20155705095723-561",1,"2015-09-05 10:54:00",1441475640,"C4",507900,1441983540,"2015-09-11 07:59:00"
"6259","20153605103654-343",1,"2015-09-05 11:01:00",1441476060,"C8",192840,1441668900,"2015-09-07 16:35:00"
"6293","20152505102537-378",3,"2015-09-05 11:02:00",1441476120,"C0",448440,1441924560,"2015-09-10 15:36:00"
"5103","20155605105623-939",1,"2015-09-05 11:25:00",1441477500,"C5",194940,1441672440,"2015-09-07 17:34:00"
"6207","20150305110318-934",2,"2015-09-05 11:29:00",1441477740,"C8",554220,1442031960,"2015-09-11 21:26:00"
"6012","20150205110228-447",2,"2015-09-05 11:55:00",1441479300,"C5",445020,1441924320,"2015-09-10 15:32:00"
"3211","20151905111924-469",2,"2015-09-05 12:28:00",1441481280,"C3",610920,1442092200,"2015-09-12 14:10:00"
"3360","20150105120114-572",3,"2015-09-05 12:55:00",1441482900,"C8",115620,1441598520,"2015-09-06 21:02:00"
"5675","20155305015326-67",1,"2015-09-05 14:07:00",1441487220,"C7",281700,1441768920,"2015-09-08 20:22:00"
"707","20155905015950-850",1,"2015-09-05 14:28:00",1441488480,"C4",577440,1442065920,"2015-09-12 06:52:00"
"2303","20155905015919-324",1,"2015-09-05 14:52:00",1441489920,"C5",180480,1441670400,"2015-09-07 17:00:00"
"5499","20155205025245-653",3,"2015-09-05 15:18:00",1441491480,"C4",452220,1441943700,"2015-09-10 20:55:00"
"3455","20151505021556-896",1,"2015-09-05 15:23:00",1441491780,"C2",631320,1442123100,"2015-09-12 22:45:00"
"4628","20153305023343-499",2,"2015-09-05 15:24:00",1441491840,"C5",365220,1441857060,"2015-09-09 20:51:00"
"4462","20153805033854-367",3,"2015-09-05 15:41:00",1441492860,"C6",241860,1441734720,"2015-09-08 10:52:00"
"6252","20153605023617-415",1,"2015-09-05 15:44:00",1441493040,"C5",103260,1441596300,"2015-09-06 20:25:00"
"6501","20154505034517-211",1,"2015-09-05 15:51:00",1441493460,"C8",410220,1441903680,"2015-09-10 09:48:00"
"452","20155005035047-766",1,"2015-09-05 15:58:00",1441493880,"C8",51960,1441545840,"2015-09-06 06:24:00"
"2445","20153605033626-803",2,"2015-09-05 16:13:00",1441494780,"C2",971520,1442466300,"2015-09-16 22:05:00"
"5710","20150805040827-754",3,"2015-09-05 17:15:00",1441498500,"C2",339960,1441838460,"2015-09-09 15:41:00"
"2510","20155205045234-468",2,"2015-09-05 17:19:00",1441498740,"C5",171660,1441670400,"2015-09-07 17:00:00"
"1238","20154105044140-645",1,"2015-09-05 17:20:00",1441498800,"C2",426720,1441925520,"2015-09-10 15:52:00"
"5641","20152205052244-453",2,"2015-09-05 17:47:00",1441500420,"C8",525180,1442025600,"2015-09-11 19:40:00"
"1051","20152505052550-320",3,"2015-09-05 17:53:00",1441500780,"C4",168720,1441669500,"2015-09-07 16:45:00"
"144","20154305054350-339",1,"2015-09-05 18:06:00",1441501560,"C5",274560,1441776120,"2015-09-08 22:22:00"
"3452","20151405051442-519",3,"2015-09-05 18:08:00",1441501680,"C7",88440,1441590120,"2015-09-06 18:42:00"
"439","20155405055439-901",1,"2015-09-05 18:18:00",1441502280,"C4",782280,1442284560,"2015-09-14 19:36:00"
"2230","20152405042448-474",2,"2015-09-05 19:27:00",1441506420,"C2",55140,1441561560,"2015-09-06 10:46:00"
"1007","20150506060512-399",1,"2015-09-06 06:31:00",1441546260,"C8",435240,1441981500,"2015-09-11 07:25:00"
"6196","20151406061442-733",2,"2015-09-06 06:40:00",1441546800,"C3",538200,1442085000,"2015-09-12 12:10:00"
"937","20155806065835-432",1,"2015-09-06 07:22:00",1441549320,"C7",117300,1441666620,"2015-09-07 15:57:00"
"4101","20152006062007-464",2,"2015-09-06 07:31:00",1441549860,"C6",301140,1441851000,"2015-09-09 19:10:00"
"5549","20150206070250-791",1,"2015-09-06 07:36:00",1441550160,"C6",394980,1441945140,"2015-09-10 21:19:00"
"3753","20151506071555-282",1,"2015-09-06 07:45:00",1441550700,"C2",119040,1441669740,"2015-09-07 16:49:00"
"6033","20151106071138-520",2,"2015-09-06 07:46:00",1441550760,"C0",343080,1441893840,"2015-09-10 07:04:00"
"603","20155806065852-717",3,"2015-09-06 07:58:00",1441551480,"C5",446520,1441998000,"2015-09-11 12:00:00"
"6335","20152006072036-68",3,"2015-09-06 08:30:00",1441553400,"C8",530460,1442083860,"2015-09-12 11:51:00"
"604","20152806082844-502",1,"2015-09-06 09:01:00",1441555260,"C8",120840,1441676100,"2015-09-07 18:35:00"
"3046","20153406083425-63",3,"2015-09-06 09:33:00",1441557180,"C2",78540,1441635720,"2015-09-07 07:22:00"
"3349","20155306085328-467",1,"2015-09-06 09:42:00",1441557720,"C8",604740,1442162460,"2015-09-13 09:41:00"
"4591","20155606085604-918",1,"2015-09-06 10:00:00",1441558800,"C3",365700,1441924500,"2015-09-10 15:35:00"
"1529","20150606090649-896",1,"2015-09-06 10:24:00",1441560240,"C0",692460,1442252700,"2015-09-14 10:45:00"
"1408","20152606102611-230",2,"2015-09-06 10:55:00",1441562100,"C2",100080,1441662180,"2015-09-07 14:43:00"
"6023","20155706095759-642",1,"2015-09-06 11:00:00",1441562400,"C5",899040,1442461440,"2015-09-16 20:44:00"
"1579","20153606103657-307",1,"2015-09-06 11:24:00",1441563840,"C7",197880,1441761720,"2015-09-08 18:22:00"
"5218","20155206105202-711",1,"2015-09-06 11:33:00",1441564380,"C0",184740,1441749120,"2015-09-08 14:52:00"
"6403","20152406112431-687",1,"2015-09-06 11:49:00",1441565340,"C5",682920,1442248260,"2015-09-14 09:31:00"
"244","20150806110838-706",1,"2015-09-06 12:00:00",1441566000,"C8",1135740,1442701740,"2015-09-19 15:29:00"
"2938","20153806113852-538",2,"2015-09-06 12:33:00",1441567980,"C5",191640,1441759620,"2015-09-08 17:47:00"
"2620","20154906114942-746",3,"2015-09-06 12:53:00",1441569180,"C7",150540,1441719720,"2015-09-08 06:42:00"
"2595","20150406120417-939",1,"2015-09-06 13:10:00",1441570200,"C4",150120,1441720320,"2015-09-08 06:52:00"
"2683","20152606012640-366",1,"2015-09-06 14:24:00",1441574640,"C4",338220,1441912860,"2015-09-10 12:21:00"
"3385","20153406023410-438",1,"2015-09-06 15:09:00",1441577340,"C0",63360,1441640700,"2015-09-07 08:45:00"
"1215","20155006025053-216",2,"2015-09-06 15:14:00",1441577640,"C4",227040,1441804680,"2015-09-09 06:18:00"
"2138","20152606032633-640",1,"2015-09-06 16:01:00",1441580460,"C2",574980,1442155440,"2015-09-13 07:44:00"
"6464","20151006031044-506",1,"2015-09-06 16:13:00",1441581180,"C6",169920,1441751100,"2015-09-08 15:25:00"
"1531","20153106033136-478",1,"2015-09-06 16:35:00",1441582500,"C0",145920,1441728420,"2015-09-08 09:07:00"
"317","20152206042213-803",1,"2015-09-06 16:45:00",1441583100,"C8",440220,1442023320,"2015-09-11 19:02:00"
"2574","20150506040523-403",1,"2015-09-06 17:06:00",1441584360,"C4",392520,1441976880,"2015-09-11 06:08:00"
"410","20155606045620-205",2,"2015-09-06 17:20:00",1441585200,"C8",744180,1442329380,"2015-09-15 08:03:00"
"3325","20151406051448-965",1,"2015-09-06 17:35:00",1441586100,"C7",274740,1441860840,"2015-09-09 21:54:00"
"5366","20150306050305-235",2,"2015-09-06 17:41:00",1441586460,"C2",177000,1441763460,"2015-09-08 18:51:00"
"2089","20152607062650-779",1,"2015-09-07 07:01:00",1441634460,"C3",305820,1441940280,"2015-09-10 19:58:00"
"2616","20154207064238-836",1,"2015-09-07 07:11:00",1441635060,"C5",137400,1441772460,"2015-09-08 21:21:00"
"1941","20153807073822-145",3,"2015-09-07 08:13:00",1441638780,"C2",175440,1441814220,"2015-09-09 08:57:00"
"703","20152407072413-469",3,"2015-09-07 08:17:00",1441639020,"C4",604980,1442244000,"2015-09-14 08:20:00"
"3017","20155307075336-227",2,"2015-09-07 08:53:00",1441641180,"C2",103680,1441744860,"2015-09-08 13:41:00"
"5687","20153007093004-81",3,"2015-09-07 09:51:00",1441644660,"C5",521820,1442166480,"2015-09-13 10:48:00"
"518","20153607093625-365",1,"2015-09-07 09:58:00",1441645080,"C5",246300,1441891380,"2015-09-10 06:23:00"
"653","20155407095443-656",2,"2015-09-07 10:25:00",1441646700,"C3",255540,1441902240,"2015-09-10 09:24:00"
"5080","20155107095150-103",2,"2015-09-07 10:36:00",1441647360,"C0",74520,1441721880,"2015-09-08 07:18:00"
"4110","20151207101219-530",2,"2015-09-07 11:06:00",1441649160,"C5",559500,1442208660,"2015-09-13 22:31:00"
"4340","20150507120531-544",2,"2015-09-07 12:32:00",1441654320,"C4",158760,1441813080,"2015-09-09 08:38:00"
"4514","20153607113603-801",3,"2015-09-07 12:37:00",1441654620,"C5",408720,1442063340,"2015-09-12 06:09:00"
"3783","20153707123722-164",1,"2015-09-07 12:52:00",1441655520,"C7",552360,1442207880,"2015-09-13 22:18:00"
"5376","20151907121926-813",2,"2015-09-07 12:57:00",1441655820,"C3",152760,1441808580,"2015-09-09 07:23:00"
"2223","20155107125121-144",2,"2015-09-07 13:03:00",1441656180,"C3",544380,1442200560,"2015-09-13 20:16:00"
"5545","20151307011356-805",2,"2015-09-07 13:44:00",1441658640,"C0",103140,1441761780,"2015-09-08 18:23:00"
"4246","20150307010338-210",2,"2015-09-07 14:09:00",1441660140,"C0",262320,1441922460,"2015-09-10 15:01:00"
"2943","20155507025528-30",2,"2015-09-07 15:02:00",1441663320,"C8",323400,1441986720,"2015-09-11 08:52:00"
"5835","20151107021135-737",3,"2015-09-07 15:05:00",1441663500,"C5",340440,1442003940,"2015-09-11 13:39:00"
"6022","20155107025120-910",2,"2015-09-07 15:05:00",1441663500,"C0",403800,1442067300,"2015-09-12 07:15:00"
"4968","20153307023355-407",1,"2015-09-07 15:35:00",1441665300,"C4",584760,1442250060,"2015-09-14 10:01:00"
"3437","20150607030612-158",1,"2015-09-07 15:46:00",1441665960,"C2",225540,1441891500,"2015-09-10 06:25:00"
"3575","20152107032156-241",1,"2015-09-07 15:57:00",1441666620,"C2",334140,1442000760,"2015-09-11 12:46:00"
"5930","20152007032057-494",3,"2015-09-07 16:23:00",1441668180,"C5",77940,1441746120,"2015-09-08 14:02:00"
"5551","20151007041045-624",1,"2015-09-07 17:19:00",1441671540,"C2",225240,1441896780,"2015-09-10 07:53:00"
"3965","20150707050739-597",2,"2015-09-07 17:40:00",1441672800,"C3",150540,1441823340,"2015-09-09 11:29:00"
"4929","20155707045739-291",1,"2015-09-07 17:50:00",1441673400,"C5",163620,1441837020,"2015-09-09 15:17:00"
"2699","20155807055837-636",2,"2015-09-07 19:01:00",1441677660,"C2",52140,1441729800,"2015-09-08 09:30:00"
"324","20150208060247-95",1,"2015-09-08 06:29:00",1441718940,"C5",105120,1441824060,"2015-09-09 11:41:00"
"989","20150108060104-840",1,"2015-09-08 06:33:00",1441719180,"C5",814740,1442533920,"2015-09-17 16:52:00"
"3606","20150108060137-927",2,"2015-09-08 07:03:00",1441720980,"C4",342300,1442063280,"2015-09-12 06:08:00"
"5662","20151108071113-261",2,"2015-09-08 07:39:00",1441723140,"C5",116880,1441840020,"2015-09-09 16:07:00"
"4563","20154208074227-295",2,"2015-09-08 07:49:00",1441723740,"C8",193020,1441916760,"2015-09-10 13:26:00"
"2862","20151808071821-441",3,"2015-09-08 08:19:00",1441725540,"C5",384240,1442109780,"2015-09-12 19:03:00"
"24","20151408071436-141",1,"2015-09-08 08:27:00",1441726020,"C2",1207620,1442933640,"2015-09-22 07:54:00"
"4966","20150008080048-814",2,"2015-09-08 08:57:00",1441727820,"C5",121680,1441849500,"2015-09-09 18:45:00"
"1547","20151108081116-912",2,"2015-09-08 09:03:00",1441728180,"C5",452460,1442180640,"2015-09-13 14:44:00"
"2897","20154508084534-828",1,"2015-09-08 09:18:00",1441729080,"C5",100620,1441829700,"2015-09-09 13:15:00"
"3239","20150408090432-622",1,"2015-09-08 09:33:00",1441729980,"C5",177480,1441907460,"2015-09-10 10:51:00"
"3319","20154808094807-64",2,"2015-09-08 09:54:00",1441731240,"C4",627780,1442359020,"2015-09-15 16:17:00"
"6268","20153008093014-166",2,"2015-09-08 09:56:00",1441731360,"C5",352620,1442083980,"2015-09-12 11:53:00"
"5845","20152608092613-41",1,"2015-09-08 10:21:00",1441732860,"C8",451800,1442184660,"2015-09-13 15:51:00"
"2530","20155608095652-395",3,"2015-09-08 10:23:00",1441732980,"C5",469680,1442202660,"2015-09-13 20:51:00"
"874","20153808113851-534",2,"2015-09-08 12:03:00",1441738980,"C8",528960,1442267940,"2015-09-14 14:59:00"
"2505","20150908120943-943",1,"2015-09-08 12:36:00",1441740960,"C8",78780,1441819740,"2015-09-09 10:29:00"
"1534","20150908120959-737",2,"2015-09-08 12:52:00",1441741920,"C0",586260,1442328180,"2015-09-15 07:43:00"
"1772","20154308124319-670",1,"2015-09-08 13:05:00",1441742700,"C5",168420,1441911120,"2015-09-10 11:52:00"
"2275","20150808010856-926",1,"2015-09-08 13:46:00",1441745160,"C3",156780,1441901940,"2015-09-10 09:19:00"
"29","20152608012606-941",1,"2015-09-08 13:57:00",1441745820,"C5",172740,1441918560,"2015-09-10 13:56:00"
"5708","20153308013340-678",2,"2015-09-08 14:06:00",1441746360,"C4",89220,1441835580,"2015-09-09 14:53:00"
"4631","20150408020442-543",1,"2015-09-08 14:36:00",1441748160,"C3",193440,1441941600,"2015-09-10 20:20:00"
"4788","20153208023216-402",2,"2015-09-08 14:37:00",1441748220,"C2",105540,1441853760,"2015-09-09 19:56:00"
"249","20153708023759-709",1,"2015-09-08 15:00:00",1441749600,"C8",428040,1442177640,"2015-09-13 13:54:00"
"2019","20152308032332-748",2,"2015-09-08 15:54:00",1441752840,"C5",262200,1442015040,"2015-09-11 16:44:00"
"5976","20150508040515-409",1,"2015-09-08 16:07:00",1441753620,"C6",70500,1441824120,"2015-09-09 11:42:00"
"3231","20152908042900-407",1,"2015-09-08 16:35:00",1441755300,"C8",191460,1441946760,"2015-09-10 21:46:00"
"3912","20152208042243-251",3,"2015-09-08 16:46:00",1441755960,"C5",98580,1441854540,"2015-09-09 20:09:00"
"4467","20155208045228-597",3,"2015-09-08 17:05:00",1441757100,"C7",277260,1442034360,"2015-09-11 22:06:00"
"6299","20152608042656-439",1,"2015-09-08 17:30:00",1441758600,"C2",94560,1441853160,"2015-09-09 19:46:00"
"606","20152208052219-435",1,"2015-09-08 17:50:00",1441759800,"C4",92340,1441852140,"2015-09-09 19:29:00"
"6134","20150209060217-820",2,"2015-09-09 06:31:00",1441805460,"C5",144900,1441950360,"2015-09-10 22:46:00"
"3797","20153809063840-685",3,"2015-09-09 07:00:00",1441807200,"C7",175680,1441982880,"2015-09-11 07:48:00"
"5874","20153909063916-316",3,"2015-09-09 07:06:00",1441807560,"C5",468600,1442276160,"2015-09-14 17:16:00"
"2041","20150609060600-167",1,"2015-09-09 07:07:00",1441807620,"C3",126480,1441934100,"2015-09-10 18:15:00"
"2063","20153209073227-920",1,"2015-09-09 08:30:00",1441812600,"C7",719160,1442531760,"2015-09-17 16:16:00"
"4692","20154409084413-801",3,"2015-09-09 09:05:00",1441814700,"C8",209340,1442024040,"2015-09-11 19:14:00"
"2074","20154309084354-984",1,"2015-09-09 09:14:00",1441815240,"C5",297120,1442112360,"2015-09-12 19:46:00"
"3880","20150409100421-849",2,"2015-09-09 10:37:00",1441820220,"C8",347400,1442167620,"2015-09-13 11:07:00"
"3366","20153709093741-767",1,"2015-09-09 10:41:00",1441820460,"C2",92580,1441913040,"2015-09-10 12:24:00"
"1624","20154309104322-867",2,"2015-09-09 11:31:00",1441823460,"C8",198660,1442022120,"2015-09-11 18:42:00"
"4213","20154209104204-174",2,"2015-09-09 11:48:00",1441824480,"C5",157680,1441982160,"2015-09-11 07:36:00"
"4930","20154509114531-556",1,"2015-09-09 12:15:00",1441826100,"C5",383700,1442209800,"2015-09-13 22:50:00"
"2085","20151309121323-469",2,"2015-09-09 12:27:00",1441826820,"C7",366420,1442193240,"2015-09-13 18:14:00"
"3506","20155609015650-953",2,"2015-09-09 14:31:00",1441834260,"C0",150120,1441984380,"2015-09-11 08:13:00"
"545","20150809030847-891",1,"2015-09-09 16:07:00",1441840020,"C2",94200,1441934220,"2015-09-10 18:17:00"
"3728","20154809034821-765",1,"2015-09-09 16:11:00",1441840260,"C5",314880,1442155140,"2015-09-13 07:39:00"
"5914","20155309035345-751",2,"2015-09-09 16:46:00",1441842360,"C6",144120,1441986480,"2015-09-11 08:48:00"
"6003","20154909044956-518",3,"2015-09-09 16:57:00",1441843020,"C4",433920,1442276940,"2015-09-14 17:29:00"
"1483","20150009040035-292",1,"2015-09-09 17:04:00",1441843440,"C3",280260,1442123700,"2015-09-12 22:55:00"
"168","20151109051100-693",3,"2015-09-09 17:38:00",1441845480,"C4",139560,1441985040,"2015-09-11 08:24:00"
"6290","20153809053851-563",1,"2015-09-09 18:01:00",1441846860,"C5",53340,1441900200,"2015-09-10 08:50:00"
"3766","20151810061830-545",1,"2015-09-10 06:51:00",1441893060,"C5",798900,1442691960,"2015-09-19 12:46:00"
"4004","20150110060107-684",1,"2015-09-10 06:58:00",1441893480,"C3",631680,1442525160,"2015-09-17 14:26:00"
"5823","20153910063931-835",2,"2015-09-10 07:44:00",1441896240,"C5",224460,1442120700,"2015-09-12 22:05:00"
"5205","20150010070052-300",2,"2015-09-10 08:01:00",1441897260,"C2",106020,1442003280,"2015-09-11 13:28:00"
"1457","20153710073725-591",2,"2015-09-10 08:43:00",1441899780,"C8",265560,1442165340,"2015-09-13 10:29:00"
"3008","20155110085148-525",2,"2015-09-10 09:28:00",1441902480,"C6",530580,1442433060,"2015-09-16 12:51:00"
"1191","20152310082337-650",1,"2015-09-10 09:32:00",1441902720,"C8",215820,1442118540,"2015-09-12 21:29:00"
"4699","20155310085325-400",2,"2015-09-10 09:33:00",1441902780,"C7",260640,1442163420,"2015-09-13 09:57:00"
"4537","20152610092600-874",1,"2015-09-10 10:18:00",1441905480,"C7",301860,1442207340,"2015-09-13 22:09:00"
"3836","20155910095936-211",1,"2015-09-10 10:33:00",1441906380,"C4",348180,1442254560,"2015-09-14 11:16:00"
"2145","20151510101536-354",2,"2015-09-10 10:38:00",1441906680,"C6",88980,1441995660,"2015-09-11 11:21:00"
"2204","20154610094644-926",2,"2015-09-10 10:41:00",1441906860,"C8",244380,1442151240,"2015-09-13 06:34:00"
"2553","20151310101330-91",1,"2015-09-10 10:46:00",1441907160,"C4",265800,1442172960,"2015-09-13 12:36:00"
"3546","20153710103741-345",1,"2015-09-10 11:07:00",1441908420,"C2",371040,1442279460,"2015-09-14 18:11:00"
"6061","20153510103519-730",2,"2015-09-10 11:35:00",1441910100,"C5",367920,1442278020,"2015-09-14 17:47:00"
"1510","20150710110737-521",1,"2015-09-10 11:38:00",1441910280,"C2",75180,1441985460,"2015-09-11 08:31:00"
"3029","20152310122351-816",3,"2015-09-10 13:18:00",1441916280,"C5",102660,1442018940,"2015-09-11 17:49:00"
"4755","20155310125342-214",2,"2015-09-10 13:27:00",1441916820,"C8",439380,1442356200,"2015-09-15 15:30:00"
"2709","20151010011010-902",3,"2015-09-10 13:44:00",1441917840,"C6",198360,1442116200,"2015-09-12 20:50:00"
"508","20154410124427-370",3,"2015-09-10 13:48:00",1441918080,"C4",99780,1442017860,"2015-09-11 17:31:00"
"714","20152610012616-238",1,"2015-09-10 14:22:00",1441920120,"C4",437640,1442357760,"2015-09-15 15:56:00"
"3097","20155810015814-86",3,"2015-09-10 14:31:00",1441920660,"C0",448200,1442368860,"2015-09-15 19:01:00"
"3525","20152310012347-406",2,"2015-09-10 14:31:00",1441920660,"C4",99300,1442019960,"2015-09-11 18:06:00"
"5402","20153710013742-178",3,"2015-09-10 14:33:00",1441920780,"C4",328560,1442249340,"2015-09-14 09:49:00"
"1739","20154510014516-824",1,"2015-09-10 14:51:00",1441921860,"C5",98700,1442020560,"2015-09-11 18:16:00"
"1316","20154610014621-394",2,"2015-09-10 15:01:00",1441922460,"C0",198960,1442121420,"2015-09-12 22:17:00"
"3947","20151710031722-962",1,"2015-09-10 15:45:00",1441925100,"C5",68520,1441993620,"2015-09-11 10:47:00"
"5646","20151910031909-576",1,"2015-09-10 15:46:00",1441925160,"C5",69660,1441994820,"2015-09-11 11:07:00"
"1423","20152310032333-876",2,"2015-09-10 15:57:00",1441925820,"C2",77700,1442003520,"2015-09-11 13:32:00"
"5419","20155710035705-492",1,"2015-09-10 16:31:00",1441927860,"C5",403260,1442331120,"2015-09-15 08:32:00"
"3081","20154010044016-420",1,"2015-09-10 17:04:00",1441929840,"C8",155040,1442084880,"2015-09-12 12:08:00"
"4991","20151810051808-730",1,"2015-09-10 18:14:00",1441934040,"C5",62520,1441996560,"2015-09-11 11:36:00"
"3778","20151711061722-116",2,"2015-09-11 06:44:00",1441979040,"C5",370500,1442349540,"2015-09-15 13:39:00"
"2471","20153211073233-705",1,"2015-09-11 07:40:00",1441982400,"C4",112200,1442094600,"2015-09-12 14:50:00"
"4781","20152211072240-895",1,"2015-09-11 07:45:00",1441982700,"C5",207900,1442190600,"2015-09-13 17:30:00"
"5768","20152611072627-207",3,"2015-09-11 07:52:00",1441983120,"C4",1402380,1443385500,"2015-09-27 13:25:00"
"4366","20154211074259-773",1,"2015-09-11 08:16:00",1441984560,"C6",133680,1442118240,"2015-09-12 21:24:00"
"2487","20154811074853-707",3,"2015-09-11 08:17:00",1441984620,"C4",510720,1442495340,"2015-09-17 06:09:00"
"2826","20155211075227-27",1,"2015-09-11 08:26:00",1441985160,"C0",114720,1442099880,"2015-09-12 16:18:00"
"4240","20154711074751-689",2,"2015-09-11 08:41:00",1441986060,"C5",356760,1442342820,"2015-09-15 11:47:00"
"34","20151211081210-391",2,"2015-09-11 08:45:00",1441986300,"C0",293640,1442279940,"2015-09-14 18:19:00"
"3928","20151611081603-412",2,"2015-09-11 08:47:00",1441986420,"C5",106740,1442093160,"2015-09-12 14:26:00"
"1448","20150811080802-300",3,"2015-09-11 09:11:00",1441987860,"C2",259200,1442247060,"2015-09-14 09:11:00"
"6004","20153911083955-135",1,"2015-09-11 09:44:00",1441989840,"C8",113040,1442102880,"2015-09-12 17:08:00"
"419","20154511094545-173",1,"2015-09-11 10:09:00",1441991340,"C4",545040,1442536380,"2015-09-17 17:33:00"
"2717","20153611093610-113",2,"2015-09-11 10:13:00",1441991580,"C2",351600,1442343180,"2015-09-15 11:53:00"
"5027","20155411105414-764",2,"2015-09-11 11:32:00",1441996320,"C3",382920,1442379240,"2015-09-15 21:54:00"
"2462","20155011115006-613",1,"2015-09-11 11:56:00",1441997760,"C2",329880,1442327640,"2015-09-15 07:34:00"
"5951","20151411121401-100",1,"2015-09-11 12:35:00",1442000100,"C5",175980,1442176080,"2015-09-13 13:28:00"
"4576","20153311123312-935",2,"2015-09-11 12:41:00",1442000460,"C4",373800,1442374260,"2015-09-15 20:31:00"
"6380","20152111122136-527",3,"2015-09-11 12:48:00",1442000880,"C5",198660,1442199540,"2015-09-13 19:59:00"
"2152","20152211122236-998",2,"2015-09-11 12:52:00",1442001120,"C4",89100,1442090220,"2015-09-12 13:37:00"
"1896","20150411120416-183",1,"2015-09-11 13:10:00",1442002200,"C8",535860,1442538060,"2015-09-17 18:01:00"
"2283","20152711122705-744",2,"2015-09-11 13:31:00",1442003460,"C8",116520,1442119980,"2015-09-12 21:53:00"
"6391","20155911015958-174",2,"2015-09-11 14:22:00",1442006520,"C5",181500,1442188020,"2015-09-13 16:47:00"
"1220","20152411022428-441",1,"2015-09-11 14:46:00",1442007960,"C4",112140,1442120100,"2015-09-12 21:55:00"
"398","20154511024505-828",1,"2015-09-11 14:47:00",1442008020,"C6",99840,1442107860,"2015-09-12 18:31:00"
"5498","20154311024355-911",1,"2015-09-11 15:00:00",1442008800,"C0",65880,1442074680,"2015-09-12 09:18:00"
"4614","20154519024544-322",2,"2015-09-11 15:40:00",1442011200,"C4",202740,1442213940,"2015-09-13 23:59:00"
"1317","20154411024426-868",2,"2015-09-11 15:43:00",1442011380,"C2",110160,1442121540,"2015-09-12 22:19:00"
"6524","20151311031311-115",1,"2015-09-11 15:44:00",1442011440,"C5",82560,1442094000,"2015-09-12 14:40:00"
"5085","20155711025756-499",3,"2015-09-11 16:14:00",1442013240,"C0",230880,1442244120,"2015-09-14 08:22:00"
"2836","20153711033732-656",2,"2015-09-11 16:36:00",1442014560,"C5",68940,1442083500,"2015-09-12 11:45:00"
"6450","20153011043031-930",1,"2015-09-11 16:46:00",1442015160,"C0",57180,1442072340,"2015-09-12 08:39:00"
"2809","20152211042208-883",1,"2015-09-11 17:14:00",1442016840,"C4",833820,1442850660,"2015-09-21 08:51:00"
"4909","20150411050432-27",1,"2015-09-11 17:32:00",1442017920,"C8",345840,1442363760,"2015-09-15 17:36:00"
"3012","20154911044919-82",1,"2015-09-11 17:42:00",1442018520,"C4",173520,1442192040,"2015-09-13 17:54:00"
"3608","20153211053257-976",2,"2015-09-11 17:55:00",1442019300,"C4",58560,1442077860,"2015-09-12 10:11:00"
"2753","20154011054033-757",2,"2015-09-11 18:01:00",1442019660,"C6",83460,1442103120,"2015-09-12 17:12:00"
"3871","20151011051048-783",1,"2015-09-11 18:15:00",1442020500,"C7",182880,1442203380,"2015-09-13 21:03:00"
"5624","20154811054808-989",1,"2015-09-11 18:53:00",1442022780,"C0",66480,1442089260,"2015-09-12 13:21:00"
"5138","20155611055631-743",2,"2015-09-11 18:58:00",1442023080,"C0",264600,1442287680,"2015-09-14 20:28:00"
"3879","20151912061915-319",1,"2015-09-12 06:49:00",1442065740,"C5",107340,1442173080,"2015-09-13 12:38:00"
"447","20155012065039-980",2,"2015-09-12 06:57:00",1442066220,"C8",262860,1442329080,"2015-09-15 07:58:00"
"4569","20151712061745-29",3,"2015-09-12 07:23:00",1442067780,"C7",311220,1442379000,"2015-09-15 21:50:00"
"4058","20155612065603-160",2,"2015-09-12 07:29:00",1442068140,"C3",207060,1442275200,"2015-09-14 17:00:00"
"3122","20152912062950-917",1,"2015-09-12 07:38:00",1442068680,"C5",179700,1442248380,"2015-09-14 09:33:00"
"1828","20150712070713-541",2,"2015-09-12 07:44:00",1442069040,"C7",983220,1443052260,"2015-09-23 16:51:00"
"1600","20154912074929-675",3,"2015-09-12 07:56:00",1442069760,"C2",541800,1442611560,"2015-09-18 14:26:00"
"1986","20151812081835-734",2,"2015-09-12 08:24:00",1442071440,"C2",308820,1442380260,"2015-09-15 22:11:00"
"3251","20151812081845-784",2,"2015-09-12 08:46:00",1442072760,"C5",190500,1442263260,"2015-09-14 13:41:00"
"3264","20154812074833-507",2,"2015-09-12 08:50:00",1442073000,"C5",257640,1442330640,"2015-09-15 08:24:00"
"3054","20154612084611-217",3,"2015-09-12 09:17:00",1442074620,"C6",112980,1442187600,"2015-09-13 16:40:00"
"5695","20154912084901-166",2,"2015-09-12 09:50:00",1442076600,"C7",622080,1442698680,"2015-09-19 14:38:00"
"3746","20150912100912-409",3,"2015-09-12 10:30:00",1442079000,"C8",213540,1442292540,"2015-09-14 21:49:00"
"3935","20152712102746-890",1,"2015-09-12 10:49:00",1442080140,"C6",262320,1442342460,"2015-09-15 11:41:00"
"2848","20154912104945-323",3,"2015-09-12 10:52:00",1442080320,"C6",281160,1442361480,"2015-09-15 16:58:00"
"4391","20153612103624-436",2,"2015-09-12 11:00:00",1442080800,"C4",116820,1442197620,"2015-09-13 19:27:00"
"6334","20153912103945-821",2,"2015-09-12 11:12:00",1442081520,"C8",383100,1442464620,"2015-09-16 21:37:00"
"6481","20150512110539-725",2,"2015-09-12 11:12:00",1442081520,"C4",551940,1442633460,"2015-09-18 20:31:00"
"1064","20154412104452-262",1,"2015-09-12 11:40:00",1442083200,"C8",75300,1442158500,"2015-09-13 08:35:00"
"5532","20151912111905-652",1,"2015-09-12 11:43:00",1442083380,"C5",977280,1443060660,"2015-09-23 19:11:00"
"2869","20153812113834-265",3,"2015-09-12 12:05:00",1442084700,"C5",211980,1442296680,"2015-09-14 22:58:00"
"5868","20154212114258-729",1,"2015-09-12 12:20:00",1442085600,"C7",98700,1442184300,"2015-09-13 15:45:00"
"5660","20155812115802-110",2,"2015-09-12 12:23:00",1442085780,"C5",117120,1442202900,"2015-09-13 20:55:00"
"4521","20153712113749-782",1,"2015-09-12 12:36:00",1442086560,"C5",259140,1442345700,"2015-09-15 12:35:00"
"4690","20154612124610-968",2,"2015-09-12 12:56:00",1442087760,"C3",291480,1442379240,"2015-09-15 21:54:00"
"5284","20152012122057-909",3,"2015-09-12 13:19:00",1442089140,"C2",236820,1442325960,"2015-09-15 07:06:00"
"3701","20152212012249-243",1,"2015-09-12 13:51:00",1442091060,"C3",116100,1442207160,"2015-09-13 22:06:00"
"4627","20150412010421-959",1,"2015-09-12 13:57:00",1442091420,"C4",100860,1442192280,"2015-09-13 17:58:00"
"5606","20151212011243-975",1,"2015-09-12 14:14:00",1442092440,"C4",96240,1442188680,"2015-09-13 16:58:00"
"4808","20154412014428-448",1,"2015-09-12 14:17:00",1442092620,"C2",447120,1442539740,"2015-09-17 18:29:00"
"1207","20152612022619-830",1,"2015-09-12 14:47:00",1442094420,"C8",354900,1442449320,"2015-09-16 17:22:00"
"2306","20150312030323-538",1,"2015-09-12 15:31:00",1442097060,"C4",149580,1442246640,"2015-09-14 09:04:00"
"1468","20153312023328-539",2,"2015-09-12 15:32:00",1442097120,"C7",84360,1442181480,"2015-09-13 14:58:00"
"1539","20151812031807-51",1,"2015-09-12 15:50:00",1442098200,"C5",607200,1442705400,"2015-09-19 16:30:00"
"3946","20153412033456-768",1,"2015-09-12 16:05:00",1442099100,"C3",83340,1442182440,"2015-09-13 15:14:00"
"4819","20150612040643-903",1,"2015-09-12 16:20:00",1442100000,"C0",243900,1442343900,"2015-09-15 12:05:00"
"4131","20153112033150-305",2,"2015-09-12 16:42:00",1442101320,"C2",453360,1442554680,"2015-09-17 22:38:00"
"6437","20153612033615-297",1,"2015-09-12 16:42:00",1442101320,"C0",76740,1442178060,"2015-09-13 14:01:00"
"6365","20152812042819-422",2,"2015-09-12 16:53:00",1442101980,"C5",77160,1442179140,"2015-09-13 14:19:00"
"2550","20152512042530-460",1,"2015-09-12 17:01:00",1442102460,"C7",61440,1442163900,"2015-09-13 10:05:00"
"5214","20155812045842-786",1,"2015-09-12 17:25:00",1442103900,"C8",142860,1442246760,"2015-09-14 09:06:00"
"5722","20155012015018-20",2,"2015-09-12 17:33:00",1442104380,"C8",71340,1442175720,"2015-09-13 13:22:00"
"4505","20150812050828-793",3,"2015-09-12 17:42:00",1442104920,"C7",49440,1442154360,"2015-09-13 07:26:00"
"1953","20154512044556-370",2,"2015-09-12 17:48:00",1442105280,"C5",165360,1442270640,"2015-09-14 15:44:00"
"2478","20155012055005-718",2,"2015-09-12 17:56:00",1442105760,"C8",264060,1442369820,"2015-09-15 19:17:00"
"6107","20152512052534-249",2,"2015-09-12 18:32:00",1442107920,"C0",398580,1442506500,"2015-09-17 09:15:00"
"4480","20150913060942-503",1,"2015-09-13 06:11:00",1442149860,"C6",105480,1442255340,"2015-09-14 11:29:00"
"5945","20150813060851-608",2,"2015-09-13 06:41:00",1442151660,"C6",91200,1442242860,"2015-09-14 08:01:00"
"3910","20151913061938-878",1,"2015-09-13 06:53:00",1442152380,"C0",102180,1442254560,"2015-09-14 11:16:00"
"4511","20151713061726-223",1,"2015-09-13 07:05:00",1442153100,"C6",131580,1442284680,"2015-09-14 19:38:00"
"6479","20150913060926-359",1,"2015-09-13 07:10:00",1442153400,"C8",185160,1442338560,"2015-09-15 10:36:00"
"2516","20151813061817-670",2,"2015-09-13 07:11:00",1442153460,"C8",137880,1442291340,"2015-09-14 21:29:00"
"4287","20151913061921-545",2,"2015-09-13 07:15:00",1442153700,"C4",293580,1442447280,"2015-09-16 16:48:00"
"1847","20152513062528-584",1,"2015-09-13 07:25:00",1442154300,"C3",712740,1442867040,"2015-09-21 13:24:00"
"4784","20153213073258-209",1,"2015-09-13 07:43:00",1442155380,"C3",391740,1442547120,"2015-09-17 20:32:00"
"2282","20151713071733-979",1,"2015-09-13 07:46:00",1442155560,"C0",302520,1442458080,"2015-09-16 19:48:00"
"4328","20155613065652-38",1,"2015-09-13 07:57:00",1442156220,"C2",116040,1442272260,"2015-09-14 16:11:00"
"2855","20150413080423-537",1,"2015-09-13 08:11:00",1442157060,"C4",475980,1442633040,"2015-09-18 20:24:00"
"4669","20150313090335-839",2,"2015-09-13 09:10:00",1442160600,"C8",109320,1442269920,"2015-09-14 15:32:00"
"1517","20155313085338-538",3,"2015-09-13 09:14:00",1442160840,"C5",211020,1442371860,"2015-09-15 19:51:00"
"4482","20153613083644-306",1,"2015-09-13 09:31:00",1442161860,"C4",197580,1442359440,"2015-09-15 16:24:00"
"6316","20152113092153-515",2,"2015-09-13 09:49:00",1442162940,"C3",162900,1442325840,"2015-09-15 07:04:00"
"6223","20153813093821-524",2,"2015-09-13 10:07:00",1442164020,"C3",77700,1442241720,"2015-09-14 07:42:00"
"5529","20150413100443-728",3,"2015-09-13 10:10:00",1442164200,"C2",593880,1442758080,"2015-09-20 07:08:00"
"6024","20152613102657-412",2,"2015-09-13 10:33:00",1442165580,"C8",79980,1442245560,"2015-09-14 08:46:00"
"925","20154213094240-842",1,"2015-09-13 10:36:00",1442165760,"C5",94320,1442260080,"2015-09-14 12:48:00"
"886","20152013102004-55",1,"2015-09-13 10:46:00",1442166360,"C4",849120,1443015480,"2015-09-23 06:38:00"
"96","20150713110726-288",1,"2015-09-13 11:13:00",1442167980,"C8",255240,1442423220,"2015-09-16 10:07:00"
"1415","20150713100753-416",1,"2015-09-13 11:15:00",1442168100,"C2",289320,1442457420,"2015-09-16 19:37:00"
"808","20151013101006-462",1,"2015-09-13 11:19:00",1442168340,"C0",74700,1442243040,"2015-09-14 08:04:00"
"5642","20155613105649-467",1,"2015-09-13 11:23:00",1442168580,"C4",253320,1442421900,"2015-09-16 09:45:00"
"3930","20150313110328-797",2,"2015-09-13 11:27:00",1442168820,"C8",246420,1442415240,"2015-09-16 07:54:00"
"1188","20152913112927-997",3,"2015-09-13 11:50:00",1442170200,"C8",186660,1442356860,"2015-09-15 15:41:00"
"2222","20152713112722-565",2,"2015-09-13 11:55:00",1442170500,"C5",254760,1442425260,"2015-09-16 10:41:00"
"3612","20151713111750-937",1,"2015-09-13 12:14:00",1442171640,"C6",541380,1442713020,"2015-09-19 18:37:00"
"101","20150613120634-302",1,"2015-09-13 12:26:00",1442172360,"C7",79800,1442252160,"2015-09-14 10:36:00"
"462","20154913114917-875",1,"2015-09-13 12:39:00",1442173140,"C6",197280,1442370420,"2015-09-15 19:27:00"
"1162","20153113123129-802",1,"2015-09-13 12:53:00",1442173980,"C5",81360,1442255340,"2015-09-14 11:29:00"
"1417","20150513120548-43",3,"2015-09-13 13:06:00",1442174760,"C5",324120,1442498880,"2015-09-17 07:08:00"
"214","20150413020432-24",3,"2015-09-13 14:25:00",1442179500,"C7",94320,1442273820,"2015-09-14 16:37:00"
"441","20150113020105-915",1,"2015-09-13 14:33:00",1442179980,"C4",75840,1442255820,"2015-09-14 11:37:00"
"2825","20153413023435-625",1,"2015-09-13 15:02:00",1442181720,"C5",240060,1442421780,"2015-09-16 09:43:00"
"928","20155913015944-240",1,"2015-09-13 15:09:00",1442182140,"C0",605880,1442788020,"2015-09-20 15:27:00"
"1200","20154713024750-774",1,"2015-09-13 15:15:00",1442182500,"C4",350820,1442533320,"2015-09-17 16:42:00"
"5876","20153113023123-668",2,"2015-09-13 15:46:00",1442184360,"C2",711240,1442895600,"2015-09-21 21:20:00"
"3224","20153113033133-51",1,"2015-09-13 15:57:00",1442185020,"C5",1223520,1443408540,"2015-09-27 19:49:00"
"3129","20153613033606-451",2,"2015-09-13 16:17:00",1442186220,"C0",611640,1442797860,"2015-09-20 18:11:00"
"3332","20151313041349-276",1,"2015-09-13 16:33:00",1442187180,"C6",579480,1442766660,"2015-09-20 09:31:00"
"1360","20152913042937-614",1,"2015-09-13 17:20:00",1442190000,"C5",70860,1442260860,"2015-09-14 13:01:00"
"115","20155213045249-101",1,"2015-09-13 17:26:00",1442190360,"C8",80700,1442271060,"2015-09-14 15:51:00"
"5506","20150213050220-905",3,"2015-09-13 17:32:00",1442190720,"C5",346020,1442536740,"2015-09-17 17:39:00"
"6211","20152013052027-811",2,"2015-09-13 17:59:00",1442192340,"C3",443160,1442635500,"2015-09-18 21:05:00"
"3513","20150314060301-241",3,"2015-09-14 06:25:00",1442237100,"C5",737820,1442974920,"2015-09-22 19:22:00"
"1605","20151814061817-293",1,"2015-09-14 07:24:00",1442240640,"C2",311580,1442552220,"2015-09-17 21:57:00"
"6021","20151614071616-110",3,"2015-09-14 07:32:00",1442241120,"C7",170820,1442411940,"2015-09-16 06:59:00"
"1976","20150414070459-536",3,"2015-09-14 07:38:00",1442241480,"C5",131100,1442372580,"2015-09-15 20:03:00"
"2051","20151114071159-705",3,"2015-09-14 07:41:00",1442241660,"C5",130920,1442372580,"2015-09-15 20:03:00"
"5207","20154114064153-342",2,"2015-09-14 07:42:00",1442241720,"C2",117480,1442359200,"2015-09-15 16:20:00"
"2358","20151814071826-934",1,"2015-09-14 08:14:00",1442243640,"C5",79200,1442322840,"2015-09-15 06:14:00"
"5165","20153014083025-418",3,"2015-09-14 09:28:00",1442248080,"C7",105720,1442353800,"2015-09-15 14:50:00"
"2252","20151814091851-213",1,"2015-09-14 09:39:00",1442248740,"C8",599340,1442848080,"2015-09-21 08:08:00"
"59","20154314084327-265",2,"2015-09-14 09:47:00",1442249220,"C0",298140,1442547360,"2015-09-17 20:36:00"
"6195","20155314095341-355",2,"2015-09-14 10:00:00",1442250000,"C4",303300,1442553300,"2015-09-17 22:15:00"
"3329","20154614094653-955",1,"2015-09-14 10:08:00",1442250480,"C8",387000,1442637480,"2015-09-18 21:38:00"
"1063","20154114094103-483",1,"2015-09-14 10:42:00",1442252520,"C4",183660,1442436180,"2015-09-16 13:43:00"
"3619","20152414102459-200",1,"2015-09-14 10:51:00",1442253060,"C5",70680,1442323740,"2015-09-15 06:29:00"
"5919","20151914101910-853",2,"2015-09-14 11:08:00",1442254080,"C7",251040,1442505120,"2015-09-17 08:52:00"
"4313","20151114111101-450",1,"2015-09-14 12:02:00",1442257320,"C7",766920,1443024240,"2015-09-23 09:04:00"
"993","20153114113153-521",2,"2015-09-14 12:31:00",1442259060,"C4",101100,1442360160,"2015-09-15 16:36:00"
"4900","20155614125629-357",2,"2015-09-14 13:02:00",1442260920,"C2",259140,1442520060,"2015-09-17 13:01:00"
"1984","20152414122415-656",2,"2015-09-14 13:16:00",1442261760,"C4",454740,1442716500,"2015-09-19 19:35:00"
"961","20150114010135-879",1,"2015-09-14 13:35:00",1442262900,"C2",495780,1442758680,"2015-09-20 07:18:00"
"1897","20153914123920-944",1,"2015-09-14 13:38:00",1442263080,"C3",248160,1442511240,"2015-09-17 10:34:00"
"2091","20154114014105-799",1,"2015-09-14 14:10:00",1442265000,"C5",185820,1442450820,"2015-09-16 17:47:00"
"2720","20152114022149-636",1,"2015-09-14 14:54:00",1442267640,"C2",66960,1442334600,"2015-09-15 09:30:00"
"1334","20154414024455-447",1,"2015-09-14 15:28:00",1442269680,"C2",346500,1442616180,"2015-09-18 15:43:00"
"1236","20153914023919-152",1,"2015-09-14 15:34:00",1442270040,"C8",81900,1442351940,"2015-09-15 14:19:00"
"3703","20151914041904-182",1,"2015-09-14 16:55:00",1442274900,"C2",175500,1442450400,"2015-09-16 17:40:00"
"4251","20150814050807-728",1,"2015-09-14 17:37:00",1442277420,"C4",233460,1442510880,"2015-09-17 10:28:00"
"6374","20150414050436-933",1,"2015-09-14 18:01:00",1442278860,"C5",232380,1442511240,"2015-09-17 10:34:00"
"5428","20153714053753-627",3,"2015-09-14 18:37:00",1442281020,"C5",266760,1442547780,"2015-09-17 20:43:00"
"1734","20152515062540-976",2,"2015-09-15 06:53:00",1442325180,"C5",261060,1442586240,"2015-09-18 07:24:00"
"811","20150815060824-848",1,"2015-09-15 07:05:00",1442325900,"C3",604560,1442930460,"2015-09-22 07:01:00"
"5528","20152815072807-909",1,"2015-09-15 07:47:00",1442328420,"C7",102480,1442430900,"2015-09-16 12:15:00"
"6045","20150215070210-159",1,"2015-09-15 07:59:00",1442329140,"C7",224340,1442553480,"2015-09-17 22:18:00"
"4305","20150615070645-876",2,"2015-09-15 08:09:00",1442329740,"C7",362640,1442692380,"2015-09-19 12:53:00"
"1458","20152715082740-609",2,"2015-09-15 08:55:00",1442332500,"C3",453420,1442785920,"2015-09-20 14:52:00"
"3622","20153115083129-294",2,"2015-09-15 09:05:00",1442333100,"C2",466920,1442800020,"2015-09-20 18:47:00"
"3391","20152215082220-506",2,"2015-09-15 09:14:00",1442333640,"C4",519780,1442853420,"2015-09-21 09:37:00"
"2353","20151815091854-333",1,"2015-09-15 10:16:00",1442337360,"C5",1499280,1443836640,"2015-10-02 18:44:00"
"5680","20155215095214-503",1,"2015-09-15 10:24:00",1442337840,"C4",334200,1442672040,"2015-09-19 07:14:00"
"553","20150315110303-677",1,"2015-09-15 11:24:00",1442341440,"C5",440940,1442782380,"2015-09-20 13:53:00"
"1850","20155815105829-773",1,"2015-09-15 11:32:00",1442341920,"C2",250680,1442592600,"2015-09-18 09:10:00"
"6343","20151715111719-318",1,"2015-09-15 11:46:00",1442342760,"C5",252300,1442595060,"2015-09-18 09:51:00"
"4060","20154415114438-543",2,"2015-09-15 11:51:00",1442343060,"C4",202680,1442545740,"2015-09-17 20:09:00"
"4250","20155015115025-738",3,"2015-09-15 12:37:00",1442345820,"C7",188160,1442533980,"2015-09-17 16:53:00"
"5213","20153515113535-847",3,"2015-09-15 12:48:00",1442346480,"C2",111060,1442457540,"2015-09-16 19:39:00"
"4282","20154815114839-956",1,"2015-09-15 12:57:00",1442347020,"C6",184860,1442531880,"2015-09-17 16:18:00"
"1514","20152115122135-105",3,"2015-09-15 12:59:00",1442347140,"C7",186660,1442533800,"2015-09-17 16:50:00"
"582","20155815115859-161",3,"2015-09-15 13:05:00",1442347500,"C3",288480,1442635980,"2015-09-18 21:13:00"
"2115","20152515012543-659",1,"2015-09-15 14:00:00",1442350800,"C2",1825860,1444176660,"2015-10-06 17:11:00"
"3113","20150115010131-543",1,"2015-09-15 14:00:00",1442350800,"C2",71940,1442422740,"2015-09-16 09:59:00"
"5597","20152615012610-377",2,"2015-09-15 14:02:00",1442350920,"C0",347700,1442698620,"2015-09-19 14:37:00"
"1011","20155615125621-835",1,"2015-09-15 14:03:00",1442350980,"C8",69540,1442420520,"2015-09-16 09:22:00"
"274","20153615013648-281",3,"2015-09-15 14:12:00",1442351520,"C2",88440,1442439960,"2015-09-16 14:46:00"
"2715","20151215011211-758",1,"2015-09-15 14:15:00",1442351700,"C5",152820,1442504520,"2015-09-17 08:42:00"
"3436","20155015015017-670",2,"2015-09-15 14:49:00",1442353740,"C3",400860,1442754600,"2015-09-20 06:10:00"
"2941","20153115023128-580",1,"2015-09-15 15:37:00",1442356620,"C8",61680,1442418300,"2015-09-16 08:45:00"
"342","20154015034053-424",3,"2015-09-15 15:48:00",1442357280,"C8",80700,1442437980,"2015-09-16 14:13:00"
"1309","20151415031434-50",1,"2015-09-15 16:13:00",1442358780,"C4",1573740,1443932520,"2015-10-03 21:22:00"
"807","20153515033550-824",1,"2015-09-15 16:27:00",1442359620,"C5",234300,1442593920,"2015-09-18 09:32:00"
"3795","20154615034637-382",1,"2015-09-15 16:31:00",1442359860,"C8",138360,1442498220,"2015-09-17 06:57:00"
"6405","20153815033847-524",3,"2015-09-15 16:32:00",1442359920,"C4",484320,1442844240,"2015-09-21 07:04:00"
"481","20155115045123-3",1,"2015-09-15 17:22:00",1442362920,"C0",576900,1442939820,"2015-09-22 09:37:00"
"1038","20155615055609-330",1,"2015-09-15 18:12:00",1442365920,"C7",90300,1442456220,"2015-09-16 19:17:00"
"3526","20154916064951-160",1,"2015-09-16 07:42:00",1442414520,"C5",464460,1442878980,"2015-09-21 16:43:00"
"2617","20150016070037-632",3,"2015-09-16 07:48:00",1442414880,"C7",253380,1442668260,"2015-09-19 06:11:00"
"501","20151116071131-16",1,"2015-09-16 07:49:00",1442414940,"C2",183360,1442598300,"2015-09-18 10:45:00"
"1773","20153116073142-631",2,"2015-09-16 07:55:00",1442415300,"C4",96060,1442511360,"2015-09-17 10:36:00"
"4928","20152616072652-905",2,"2015-09-16 08:00:00",1442415600,"C5",185400,1442601000,"2015-09-18 11:30:00"
"860","20152716082703-974",1,"2015-09-16 08:56:00",1442418960,"C3",221640,1442640600,"2015-09-18 22:30:00"
"409","20153016083036-762",2,"2015-09-16 09:05:00",1442419500,"C3",213540,1442633040,"2015-09-18 20:24:00"
"282","20153916083923-377",1,"2015-09-16 09:41:00",1442421660,"C2",373980,1442795640,"2015-09-20 17:34:00"
"4285","20152416092443-318",2,"2015-09-16 09:48:00",1442422080,"C4",180420,1442602500,"2015-09-18 11:55:00"
"4518","20154616084623-195",1,"2015-09-16 10:03:00",1442422980,"C2",263340,1442686320,"2015-09-19 11:12:00"
"1753","20155116095155-952",2,"2015-09-16 10:27:00",1442424420,"C3",348420,1442772840,"2015-09-20 11:14:00"
"6463","20151716101753-304",1,"2015-09-16 10:41:00",1442425260,"C8",156420,1442581680,"2015-09-18 06:08:00"
"6309","20154316094311-12",1,"2015-09-16 10:43:00",1442425380,"C4",94440,1442519820,"2015-09-17 12:57:00"
"1339","20155316115321-402",3,"2015-09-16 12:01:00",1442430060,"C8",159420,1442589480,"2015-09-18 08:18:00"
"4978","20152616112648-695",2,"2015-09-16 12:02:00",1442430120,"C6",96120,1442526240,"2015-09-17 14:44:00"
"3055","20150816110851-751",2,"2015-09-16 12:12:00",1442430720,"C6",154080,1442584800,"2015-09-18 07:00:00"
"4545","20155216015253-395",2,"2015-09-16 14:17:00",1442438220,"C4",97680,1442535900,"2015-09-17 17:25:00"
"3305","20154916014936-45",2,"2015-09-16 14:20:00",1442438400,"C3",974340,1443412740,"2015-09-27 20:59:00"
"4630","20155716015705-26",3,"2015-09-16 14:20:00",1442438400,"C5",372000,1442810400,"2015-09-20 21:40:00"
"4828","20155516015509-611",2,"2015-09-16 15:01:00",1442440860,"C4",58800,1442499660,"2015-09-17 07:21:00"
"3823","20154216034256-486",2,"2015-09-16 16:41:00",1442446860,"C2",765600,1443212460,"2015-09-25 13:21:00"
"5704","20150816050832-772",1,"2015-09-16 17:14:00",1442448840,"C2",745320,1443194160,"2015-09-25 08:16:00"
"4426","20150516050501-365",2,"2015-09-16 18:07:00",1442452020,"C4",863280,1443315300,"2015-09-26 17:55:00"
"2484","20150317060312-681",2,"2015-09-17 06:36:00",1442496960,"C7",521220,1443018180,"2015-09-23 07:23:00"
"3374","20150117070118-157",1,"2015-09-17 07:35:00",1442500500,"C5",294900,1442795400,"2015-09-20 17:30:00"
"2682","20154117064148-969",1,"2015-09-17 07:46:00",1442501160,"C2",452460,1442953620,"2015-09-22 13:27:00"
"5018","20155617075624-163",1,"2015-09-17 08:25:00",1442503500,"C8",448680,1442952180,"2015-09-22 13:03:00"
"4274","20152917082955-286",3,"2015-09-17 08:44:00",1442504640,"C0",171780,1442676420,"2015-09-19 08:27:00"
"823","20155317085330-284",2,"2015-09-17 09:15:00",1442506500,"C8",112140,1442618640,"2015-09-18 16:24:00"
"2541","20153317093349-531",2,"2015-09-17 10:01:00",1442509260,"C4",252720,1442761980,"2015-09-20 08:13:00"
"2404","20155417095454-820",3,"2015-09-17 10:11:00",1442509860,"C0",263580,1442773440,"2015-09-20 11:24:00"
"4012","20155817085826-736",1,"2015-09-17 10:11:00",1442509860,"C0",535980,1443045840,"2015-09-23 15:04:00"
"946","20155417095405-70",3,"2015-09-17 10:20:00",1442510400,"C5",183300,1442693700,"2015-09-19 13:15:00"
"1875","20150117100126-822",2,"2015-09-17 10:25:00",1442510700,"C8",641760,1443152460,"2015-09-24 20:41:00"
"815","20155917095957-221",2,"2015-09-17 10:26:00",1442510760,"C8",718320,1443229080,"2015-09-25 17:58:00"
"2533","20153117093131-820",1,"2015-09-17 10:31:00",1442511060,"C7",123120,1442634180,"2015-09-18 20:43:00"
"6308","20154617094613-518",2,"2015-09-17 10:51:00",1442512260,"C3",268200,1442780460,"2015-09-20 13:21:00"
"5736","20155705025759-63",1,"2015-09-17 11:39:00",1442515140,"C0",2789940,1445305080,"2015-10-19 18:38:00"
"1114","20153317113300-397",1,"2015-09-17 11:40:00",1442515200,"C4",188220,1442703420,"2015-09-19 15:57:00"
"716","20153317113343-810",1,"2015-09-17 11:41:00",1442515260,"C4",366360,1442881620,"2015-09-21 17:27:00"
"484","20155017105034-330",2,"2015-09-17 11:49:00",1442515740,"C4",167460,1442683200,"2015-09-19 10:20:00"
"3108","20152217112251-421",3,"2015-09-17 12:16:00",1442517360,"C4",527580,1443044940,"2015-09-23 14:49:00"
"3659","20153517113533-488",2,"2015-09-17 12:21:00",1442517660,"C8",255840,1442773500,"2015-09-20 11:25:00"
"2100","20154217124209-940",2,"2015-09-17 12:57:00",1442519820,"C7",200460,1442720280,"2015-09-19 20:38:00"
"4476","20152117012105-319",3,"2015-09-17 13:28:00",1442521680,"C4",87720,1442609400,"2015-09-18 13:50:00"
"182","20150417010430-97",1,"2015-09-17 13:48:00",1442522880,"C8",183420,1442706300,"2015-09-19 16:45:00"
"4289","20150517010521-33",3,"2015-09-17 14:12:00",1442524320,"C2",109860,1442634180,"2015-09-18 20:43:00"
"1506","20153217013250-235",1,"2015-09-17 14:30:00",1442525400,"C3",236280,1442761680,"2015-09-20 08:08:00"
"2219","20153717013727-315",1,"2015-09-17 14:34:00",1442525640,"C3",255600,1442781240,"2015-09-20 13:34:00"
"4925","20151617021605-748",1,"2015-09-17 14:42:00",1442526120,"C5",874260,1443400380,"2015-09-27 17:33:00"
"1192","20151417021426-33",3,"2015-09-17 14:52:00",1442526720,"C2",240600,1442767320,"2015-09-20 09:42:00"
"1997","20154817014854-170",2,"2015-09-17 14:54:00",1442526840,"C7",146400,1442673240,"2015-09-19 07:34:00"
"5709","20154217024216-818",1,"2015-09-17 14:54:00",1442526840,"C3",146820,1442673660,"2015-09-19 07:41:00"
"1876","20151617021606-104",1,"2015-09-17 15:07:00",1442527620,"C5",104160,1442631780,"2015-09-18 20:03:00"
"3128","20150017040038-392",1,"2015-09-17 16:30:00",1442532600,"C8",421740,1442954340,"2015-09-22 13:39:00"
"6339","20153717033736-717",2,"2015-09-17 16:42:00",1442533320,"C8",94560,1442627880,"2015-09-18 18:58:00"
"331","20154717034744-602",3,"2015-09-17 16:46:00",1442533560,"C6",146100,1442679660,"2015-09-19 09:21:00"
"5447","20154917034903-850",1,"2015-09-17 16:49:00",1442533740,"C5",420300,1442954040,"2015-09-22 13:34:00"
"5766","20151817041849-523",2,"2015-09-17 16:51:00",1442533860,"C5",322860,1442856720,"2015-09-21 10:32:00"
"4536","20152717052750-615",3,"2015-09-17 17:43:00",1442536980,"C7",696300,1443233280,"2015-09-25 19:08:00"
"5852","20154817054816-243",3,"2015-09-17 18:09:00",1442538540,"C8",416520,1442955060,"2015-09-22 13:51:00"
"2240","20151917051906-622",3,"2015-09-17 18:20:00",1442539200,"C2",327960,1442867160,"2015-09-21 13:26:00"
"2576","20154917054928-183",3,"2015-09-17 18:50:00",1442541000,"C8",332760,1442873760,"2015-09-21 15:16:00"
"3582","20150918060923-118",1,"2015-09-18 06:21:00",1442582460,"C3",315120,1442897580,"2015-09-21 21:53:00"
"503","20152618062642-81",2,"2015-09-18 06:33:00",1442583180,"C4",453840,1443037020,"2015-09-23 12:37:00"
"292","20151118061145-872",2,"2015-09-18 06:43:00",1442583780,"C3",94020,1442677800,"2015-09-19 08:50:00"
"4509","20150818060847-607",1,"2015-09-18 07:02:00",1442584920,"C3",214500,1442799420,"2015-09-20 18:37:00"
"5841","20152418062434-209",1,"2015-09-18 07:28:00",1442586480,"C2",725580,1443312060,"2015-09-26 17:01:00"
"4010","20152218072255-716",1,"2015-09-18 07:56:00",1442588160,"C2",775560,1443363720,"2015-09-27 07:22:00"
"862","20150018080022-664",1,"2015-09-18 09:00:00",1442592000,"C7",110760,1442702760,"2015-09-19 15:46:00"
"2648","20150518080515-636",3,"2015-09-18 09:13:00",1442592780,"C5",363780,1442956560,"2015-09-22 14:16:00"
"847","20150518090550-442",3,"2015-09-18 09:29:00",1442593740,"C4",343680,1442937420,"2015-09-22 08:57:00"
"1636","20151018091033-267",1,"2015-09-18 09:37:00",1442594220,"C4",256080,1442850300,"2015-09-21 08:45:00"
"4347","20153218103248-711",2,"2015-09-18 10:39:00",1442597940,"C4",253860,1442851800,"2015-09-21 09:10:00"
"1793","20154518094547-315",1,"2015-09-18 10:45:00",1442598300,"C0",463680,1443061980,"2015-09-23 19:33:00"
"2693","20150018100013-569",1,"2015-09-18 11:03:00",1442599380,"C2",342300,1442941680,"2015-09-22 10:08:00"
"5666","20151118101124-666",3,"2015-09-18 11:05:00",1442599500,"C5",179040,1442778540,"2015-09-20 12:49:00"
"5550","20150818100801-621",3,"2015-09-18 11:10:00",1442599800,"C8",122460,1442722260,"2015-09-19 21:11:00"
"3466","20155318115321-937",2,"2015-09-18 11:58:00",1442602680,"C2",542580,1443145260,"2015-09-24 18:41:00"
"2967","20154818114859-137",3,"2015-09-18 12:22:00",1442604120,"C2",190260,1442794380,"2015-09-20 17:13:00"
"3843","20150818120801-625",2,"2015-09-18 12:58:00",1442606280,"C4",274680,1442880960,"2015-09-21 17:16:00"
"3729","20151818111845-978",2,"2015-09-18 13:03:00",1442606580,"C4",201360,1442807940,"2015-09-20 20:59:00"
"2773","20154218124259-772",2,"2015-09-18 13:05:00",1442606700,"C8",208080,1442814780,"2015-09-20 22:53:00"
"1851","20150818120815-803",1,"2015-09-18 13:10:00",1442607000,"C5",529560,1443136560,"2015-09-24 16:16:00"
"921","20152518012558-924",2,"2015-09-18 13:32:00",1442608320,"C4",791880,1443400200,"2015-09-27 17:30:00"
"5020","20152618022623-126",1,"2015-09-18 14:59:00",1442613540,"C2",113100,1442726640,"2015-09-19 22:24:00"
"4267","20150218020235-744",2,"2015-09-18 15:12:00",1442614320,"C8",173040,1442787360,"2015-09-20 15:16:00"
"4615","20154519024544-322",2,"2015-09-18 15:35:00",1442615700,"C4",202560,1442818260,"2015-09-20 23:51:00"
"2342","20152718042732-411",2,"2015-09-18 16:57:00",1442620620,"C3",164040,1442784660,"2015-09-20 14:31:00"
"4667","20155318045300-137",3,"2015-09-18 17:19:00",1442621940,"C4",163680,1442785620,"2015-09-20 14:47:00"
"4207","20153218053206-183",1,"2015-09-18 18:05:00",1442624700,"C0",251220,1442875920,"2015-09-21 15:52:00"
"555","20155518055520-844",3,"2015-09-18 18:32:00",1442626320,"C2",55860,1442682180,"2015-09-19 10:03:00"
"6340","20154719064707-283",2,"2015-09-19 07:04:00",1442671440,"C7",135660,1442807100,"2015-09-20 20:45:00"
"3033","20152919062956-312",2,"2015-09-19 07:08:00",1442671680,"C2",310500,1442982180,"2015-09-22 21:23:00"
"5877","20151919061903-547",1,"2015-09-19 07:15:00",1442672100,"C4",123600,1442795700,"2015-09-20 17:35:00"
"2790","20154019064052-72",2,"2015-09-19 07:46:00",1442673960,"C0",111060,1442785020,"2015-09-20 14:37:00"
"343","20155819065837-382",2,"2015-09-19 07:59:00",1442674740,"C5",792060,1443466800,"2015-09-28 12:00:00"
"5436","20155719075702-802",1,"2015-09-19 08:17:00",1442675820,"C5",357600,1443033420,"2015-09-23 11:37:00"
"75","20150419080423-232",1,"2015-09-19 08:34:00",1442676840,"C2",118560,1442795400,"2015-09-20 17:30:00"
"4973","20154319074317-573",3,"2015-09-19 08:34:00",1442676840,"C8",510420,1443187260,"2015-09-25 06:21:00"
"3095","20154719084741-65",3,"2015-09-19 09:16:00",1442679360,"C5",518520,1443197880,"2015-09-25 09:18:00"
"6035","20151019081015-655",1,"2015-09-19 09:20:00",1442679600,"C3",378060,1443057660,"2015-09-23 18:21:00"
"3809","20150119090129-183",1,"2015-09-19 09:23:00",1442679780,"C4",1202580,1443882360,"2015-10-03 07:26:00"
"1361","20154219084210-14",3,"2015-09-19 09:42:00",1442680920,"C2",249120,1442930040,"2015-09-22 06:54:00"
"81","20150419090434-489",1,"2015-09-19 10:02:00",1442682120,"C5",293520,1442975640,"2015-09-22 19:34:00"
"4090","20150319090350-88",1,"2015-09-19 10:05:00",1442682300,"C2",1242840,1443925140,"2015-10-03 19:19:00"
"760","20151619091608-327",2,"2015-09-19 10:12:00",1442682720,"C5",175680,1442858400,"2015-09-21 11:00:00"
"4503","20153319093327-65",2,"2015-09-19 10:27:00",1442683620,"C5",551460,1443235080,"2015-09-25 19:38:00"
"2069","20151219101232-863",3,"2015-09-19 10:46:00",1442684760,"C0",187200,1442871960,"2015-09-21 14:46:00"
"3105","20152519102554-161",2,"2015-09-19 11:18:00",1442686680,"C4",114480,1442801160,"2015-09-20 19:06:00"
"45","20154719104700-710",3,"2015-09-19 11:25:00",1442687100,"C7",100200,1442787300,"2015-09-20 15:15:00"
"4814","20151119111132-408",3,"2015-09-19 11:35:00",1442687700,"C5",325500,1443013200,"2015-09-23 06:00:00"
"1968","20153119113110-269",1,"2015-09-19 11:58:00",1442689080,"C5",247260,1442936340,"2015-09-22 08:39:00"
"1744","20150419110400-987",2,"2015-09-19 12:01:00",1442689260,"C8",154440,1442843700,"2015-09-21 06:55:00"
"257","20154719114724-517",2,"2015-09-19 12:15:00",1442690100,"C5",435660,1443125760,"2015-09-24 13:16:00"
"1012","20151619111656-337",2,"2015-09-19 12:18:00",1442690280,"C3",121260,1442811540,"2015-09-20 21:59:00"
"6547","20152119112147-519",1,"2015-09-19 12:25:00",1442690700,"C5",345420,1443036120,"2015-09-23 12:22:00"
"534","20154419114439-303",1,"2015-09-19 12:46:00",1442691960,"C5",111240,1442803200,"2015-09-20 19:40:00"
"2149","20150419120407-235",3,"2015-09-19 12:50:00",1442692200,"C6",79260,1442771460,"2015-09-20 10:51:00"
"4195","20154719114738-807",2,"2015-09-19 12:53:00",1442692380,"C3",452520,1443144900,"2015-09-24 18:35:00"
"5591","20155819125825-141",1,"2015-09-19 13:28:00",1442694480,"C3",263760,1442958240,"2015-09-22 14:44:00"
"2637","20150819010811-13",2,"2015-09-19 13:35:00",1442694900,"C5",153480,1442848380,"2015-09-21 08:13:00"
"3835","20151919011904-725",3,"2015-09-19 13:53:00",1442695980,"C8",99900,1442795880,"2015-09-20 17:38:00"
"6420","20151019021027-10",2,"2015-09-19 14:25:00",1442697900,"C7",376020,1443073920,"2015-09-23 22:52:00"
"972","20154819014855-670",2,"2015-09-19 14:43:00",1442698980,"C4",94380,1442793360,"2015-09-20 16:56:00"
"3429","20152119022156-795",1,"2015-09-19 14:48:00",1442699280,"C5",62940,1442762220,"2015-09-20 08:17:00"
"2121","20155419015446-344",1,"2015-09-19 14:52:00",1442699520,"C5",165240,1442864760,"2015-09-21 12:46:00"
"1260","20155019025025-685",1,"2015-09-19 14:56:00",1442699760,"C4",73680,1442773440,"2015-09-20 11:24:00"
"2557","20150819030822-252",2,"2015-09-19 15:15:00",1442700900,"C8",414360,1443115260,"2015-09-24 10:21:00"
"4618","20154419024438-705",1,"2015-09-19 15:27:00",1442701620,"C2",77400,1442779020,"2015-09-20 12:57:00"
"3530","20154119024105-829",2,"2015-09-19 15:40:00",1442702400,"C6",1122060,1443824460,"2015-10-02 15:21:00"
"1912","20151719031705-396",1,"2015-09-19 15:51:00",1442703060,"C5",507120,1443210180,"2015-09-25 12:43:00"
"3628","20155319025303-151",2,"2015-09-19 15:55:00",1442703300,"C7",55560,1442758860,"2015-09-20 07:21:00"
"4573","20150419050423-187",1,"2015-09-19 17:19:00",1442708340,"C7",331560,1443039900,"2015-09-23 13:25:00"
"4001","20150719050720-439",1,"2015-09-19 17:28:00",1442708880,"C5",58200,1442767080,"2015-09-20 09:38:00"
"6416","20153319053331-895",1,"2015-09-19 17:58:00",1442710680,"C4",331500,1443042180,"2015-09-23 14:03:00"
"2593","20154619054642-211",2,"2015-09-19 18:45:00",1442713500,"C4",84600,1442798100,"2015-09-20 18:15:00"
"1864","20152520062536-43",1,"2015-09-20 06:31:00",1442755860,"C2",216480,1442972340,"2015-09-22 18:39:00"
"1446","20152620062633-528",1,"2015-09-20 06:57:00",1442757420,"C7",225720,1442983140,"2015-09-22 21:39:00"
"1705","20153820063840-304",2,"2015-09-20 07:15:00",1442758500,"C2",988020,1443746520,"2015-10-01 17:42:00"
"3482","20151520061516-982",2,"2015-09-20 07:19:00",1442758740,"C7",216060,1442974800,"2015-09-22 19:20:00"
"1235","20153220073240-457",2,"2015-09-20 08:06:00",1442761560,"C2",392340,1443153900,"2015-09-24 21:05:00"
"4120","20152920072900-597",2,"2015-09-20 08:06:00",1442761560,"C2",214440,1442976000,"2015-09-22 19:40:00"
"6116","20151120081141-291",3,"2015-09-20 08:19:00",1442762340,"C8",125100,1442887440,"2015-09-21 19:04:00"
"2629","20150420080400-256",3,"2015-09-20 08:49:00",1442764140,"C8",309240,1443073380,"2015-09-23 22:43:00"
"5501","20152320082354-550",3,"2015-09-20 08:50:00",1442764200,"C5",510720,1443274920,"2015-09-26 06:42:00"
"3328","20151820091811-842",3,"2015-09-20 09:44:00",1442767440,"C3",113820,1442881260,"2015-09-21 17:21:00"
"5762","20153520093506-281",2,"2015-09-20 10:07:00",1442768820,"C3",258660,1443027480,"2015-09-23 09:58:00"
"1148","20152620092652-624",2,"2015-09-20 10:25:00",1442769900,"C4",169260,1442939160,"2015-09-22 09:26:00"
"5166","20152220102228-66",3,"2015-09-20 10:48:00",1442771280,"C5",103980,1442875260,"2015-09-21 15:41:00"
"1955","20152820102827-437",3,"2015-09-20 11:30:00",1442773800,"C6",108840,1442882640,"2015-09-21 17:44:00"
"6105","20151020021029-947",1,"2015-09-20 15:18:00",1442787480,"C2",199380,1442986860,"2015-09-22 22:41:00"
"1167","20154020024025-608",3,"2015-09-20 15:38:00",1442788680,"C3",68580,1442857260,"2015-09-21 10:41:00"
"1008","20150020040021-389",2,"2015-09-20 16:10:00",1442790600,"C3",52980,1442843580,"2015-09-21 06:53:00"
"2892","20152720032733-633",1,"2015-09-20 16:33:00",1442791980,"C5",189480,1442981460,"2015-09-22 21:11:00"
"3273","20150320040327-383",2,"2015-09-20 16:33:00",1442791980,"C4",141960,1442933940,"2015-09-22 07:59:00"
"5099","20152420032414-663",1,"2015-09-20 16:34:00",1442792040,"C7",93120,1442885160,"2015-09-21 18:26:00"
"4279","20154220044203-784",1,"2015-09-20 16:47:00",1442792820,"C2",71760,1442864580,"2015-09-21 12:43:00"
"3552","20152020042020-267",1,"2015-09-20 16:49:00",1442792940,"C4",73140,1442866080,"2015-09-21 13:08:00"
"5334","20155320035314-794",3,"2015-09-20 16:52:00",1442793120,"C4",70680,1442863800,"2015-09-21 12:30:00"
"6044","20152520042545-155",3,"2015-09-20 16:58:00",1442793480,"C7",587220,1443380700,"2015-09-27 12:05:00"
"2033","20154420054435-183",1,"2015-09-20 18:14:00",1442798040,"C3",159180,1442957220,"2015-09-22 14:27:00"
"3639","20155220055213-805",2,"2015-09-20 18:14:00",1442798040,"C4",247980,1443046020,"2015-09-23 15:07:00"
"6131","20155420055422-20",1,"2015-09-20 18:19:00",1442798340,"C5",690360,1443488700,"2015-09-28 18:05:00"
"3904","20155820055809-845",1,"2015-09-20 18:25:00",1442798700,"C4",526200,1443324900,"2015-09-26 20:35:00"
"2206","20154220054254-247",3,"2015-09-20 18:44:00",1442799840,"C2",92640,1442892480,"2015-09-21 20:28:00"
"2851","20150421060449-866",2,"2015-09-21 06:12:00",1442841120,"C8",349860,1443190980,"2015-09-25 07:23:00"
"6009","20154721064725-145",1,"2015-09-21 07:23:00",1442845380,"C3",992880,1443838260,"2015-10-02 19:11:00"
"5191","20153321073305-157",2,"2015-09-21 07:54:00",1442847240,"C8",544680,1443391920,"2015-09-27 15:12:00"
"5088","20155821065833-503",3,"2015-09-21 07:57:00",1442847420,"C5",301920,1443149340,"2015-09-24 19:49:00"
"6162","20153721073748-885",1,"2015-09-21 08:05:00",1442847900,"C8",219000,1443066900,"2015-09-23 20:55:00"
"4987","20155921075955-560",1,"2015-09-21 09:06:00",1442851560,"C4",207000,1443058560,"2015-09-23 18:36:00"
"2582","20151821081800-795",1,"2015-09-21 09:18:00",1442852280,"C3",1209180,1444061460,"2015-10-05 09:11:00"
"6469","20152721082747-925",1,"2015-09-21 09:19:00",1442852340,"C5",135420,1442987760,"2015-09-22 22:56:00"
"149","20150221090256-672",1,"2015-09-21 10:07:00",1442855220,"C8",71580,1442926800,"2015-09-22 06:00:00"
"6130","20155221115237-739",1,"2015-09-21 12:13:00",1442862780,"C7",122340,1442985120,"2015-09-22 22:12:00"
"3533","20151121121131-715",3,"2015-09-21 12:45:00",1442864700,"C4",354360,1443219060,"2015-09-25 15:11:00"
"3152","20155221125229-19",3,"2015-09-21 13:40:00",1442868000,"C6",454020,1443322020,"2015-09-26 19:47:00"
"5699","20151821011808-722",1,"2015-09-21 13:48:00",1442868480,"C0",608040,1443476520,"2015-09-28 14:42:00"
"636","20155221125213-371",1,"2015-09-21 13:55:00",1442868900,"C4",189660,1443058560,"2015-09-23 18:36:00"
"5746","20155921125901-834",1,"2015-09-21 13:55:00",1442868900,"C4",606960,1443475860,"2015-09-28 14:31:00"
"4691","20151521021511-720",2,"2015-09-21 14:22:00",1442870520,"C4",200340,1443070860,"2015-09-23 22:01:00"
"1959","20155121015151-176",1,"2015-09-21 14:25:00",1442870700,"C5",1313640,1444184340,"2015-10-06 19:19:00"
"3459","20151521021503-834",1,"2015-09-21 14:38:00",1442871480,"C5",455160,1443326640,"2015-09-26 21:04:00"
"3646","20154821024838-295",2,"2015-09-21 15:51:00",1442875860,"C7",318720,1443194580,"2015-09-25 08:23:00"
"3352","20153521033534-609",3,"2015-09-21 16:50:00",1442879400,"C2",222960,1443102360,"2015-09-24 06:46:00"
"1288","20152121052117-267",2,"2015-09-21 17:43:00",1442882580,"C5",777060,1443659640,"2015-09-30 17:34:00"
"6077","20153421053409-684",1,"2015-09-21 17:55:00",1442883300,"C1",435300,1443318600,"2015-09-26 18:50:00"
"2838","20150021050036-788",3,"2015-09-21 17:56:00",1442883360,"C6",87300,1442970660,"2015-09-22 18:11:00"
"1919","20151521051522-169",2,"2015-09-21 18:11:00",1442884260,"C8",67260,1442951520,"2015-09-22 12:52:00"
"35","20151521051524-864",1,"2015-09-21 18:16:00",1442884560,"C2",316740,1443201300,"2015-09-25 10:15:00"
"2733","20154421054430-525",1,"2015-09-21 18:48:00",1442886480,"C2",147480,1443033960,"2015-09-23 11:46:00"
"682","20150122060138-185",3,"2015-09-22 06:25:00",1442928300,"C5",871260,1443799560,"2015-10-02 08:26:00"
"4939","20151522061542-891",2,"2015-09-22 06:51:00",1442929860,"C0",528480,1443458340,"2015-09-28 09:39:00"
"4951","20153322063335-503",3,"2015-09-22 07:01:00",1442930460,"C4",106620,1443037080,"2015-09-23 12:38:00"
"1938","20150322060343-331",1,"2015-09-22 07:07:00",1442930820,"C5",345780,1443276600,"2015-09-26 07:10:00"
"2955","20150022080040-235",2,"2015-09-22 08:35:00",1442936100,"C3",84480,1443020580,"2015-09-23 08:03:00"
"4460","20150822080830-143",3,"2015-09-22 08:37:00",1442936220,"C4",793920,1443730140,"2015-10-01 13:09:00"
"1733","20152922082911-839",2,"2015-09-22 08:41:00",1442936460,"C3",560760,1443497220,"2015-09-28 20:27:00"
"2213","20150322080331-384",1,"2015-09-22 09:03:00",1442937780,"C5",258960,1443196740,"2015-09-25 08:59:00"
"2566","20153922083923-991",3,"2015-09-22 09:35:00",1442939700,"C4",262800,1443202500,"2015-09-25 10:35:00"
"5025","20152722082711-239",3,"2015-09-22 09:35:00",1442939700,"C2",510120,1443449820,"2015-09-28 07:17:00"
"4203","20150322090352-662",1,"2015-09-22 09:39:00",1442939940,"C0",79320,1443019260,"2015-09-23 07:41:00"
"3846","20155922085938-836",1,"2015-09-22 10:14:00",1442942040,"C2",132180,1443074220,"2015-09-23 22:57:00"
"4149","20150122100139-218",1,"2015-09-22 10:57:00",1442944620,"C5",518580,1443463200,"2015-09-28 11:00:00"
"6390","20150522100502-509",3,"2015-09-22 11:04:00",1442945040,"C7",330300,1443275340,"2015-09-26 06:49:00"
"3318","20150822100826-928",1,"2015-09-22 11:11:00",1442945460,"C5",300780,1443246240,"2015-09-25 22:44:00"
"2909","20153622103648-402",3,"2015-09-22 11:22:00",1442946120,"C8",1043520,1443989640,"2015-10-04 13:14:00"
"4235","20155822105810-579",2,"2015-09-22 12:03:00",1442948580,"C6",944460,1443893040,"2015-10-03 10:24:00"
"3009","20155722115704-142",1,"2015-09-22 12:47:00",1442951220,"C4",65760,1443016980,"2015-09-23 07:03:00"
"1870","20155122115118-223",1,"2015-09-22 12:56:00",1442951760,"C4",113940,1443065700,"2015-09-23 20:35:00"
"1594","20150722010749-2",1,"2015-09-22 13:37:00",1442954220,"C0",439740,1443393960,"2015-09-27 15:46:00"
"675","20153422023401-747",1,"2015-09-22 15:05:00",1442959500,"C2",261780,1443221280,"2015-09-25 15:48:00"
"2816","20155022025040-869",3,"2015-09-22 15:23:00",1442960580,"C6",92640,1443053220,"2015-09-23 17:07:00"
"803","20151822031835-962",2,"2015-09-22 15:42:00",1442961720,"C5",180660,1443142380,"2015-09-24 17:53:00"
"2351","20155022025025-894",2,"2015-09-22 15:56:00",1442962560,"C4",269760,1443232320,"2015-09-25 18:52:00"
"5183","20151822031808-265",1,"2015-09-22 16:26:00",1442964360,"C8",453720,1443418080,"2015-09-27 22:28:00"
"5490","20152822052837-707",2,"2015-09-22 17:35:00",1442968500,"C2",518940,1443487440,"2015-09-28 17:44:00"
"3193","20154822054838-865",1,"2015-09-22 18:19:00",1442971140,"C8",78660,1443049800,"2015-09-23 16:10:00"
"1645","20151423061421-949",2,"2015-09-23 06:36:00",1443015360,"C5",360000,1443375360,"2015-09-27 10:36:00"
"1891","20155823065837-106",1,"2015-09-23 07:46:00",1443019560,"C8",98100,1443117660,"2015-09-24 11:01:00"
"3392","20155523065557-761",2,"2015-09-23 08:08:00",1443020880,"C2",554880,1443575760,"2015-09-29 18:16:00"
"2185","20153123073146-272",1,"2015-09-23 08:24:00",1443021840,"C5",269160,1443291000,"2015-09-26 11:10:00"
"2068","20153023073030-973",1,"2015-09-23 08:30:00",1443022200,"C8",99240,1443121440,"2015-09-24 12:04:00"
"1599","20155123085147-286",1,"2015-09-23 09:42:00",1443026520,"C4",217740,1443244260,"2015-09-25 22:11:00"
"352","20153923083952-869",1,"2015-09-23 09:46:00",1443026760,"C4",513840,1443540600,"2015-09-29 08:30:00"
"5373","20150323090352-23",2,"2015-09-23 10:04:00",1443027840,"C5",190380,1443218220,"2015-09-25 14:57:00"
"4633","20151523091527-511",1,"2015-09-23 10:07:00",1443028020,"C8",295800,1443323820,"2015-09-26 20:17:00"
"1126","20155823095855-582",1,"2015-09-23 10:21:00",1443028860,"C8",892380,1443921240,"2015-10-03 18:14:00"
"2298","20153123093148-981",1,"2015-09-23 10:24:00",1443029040,"C8",99840,1443128880,"2015-09-24 14:08:00"
"3148","20153923093923-432",3,"2015-09-23 10:36:00",1443029760,"C8",108360,1443138120,"2015-09-24 16:42:00"
"4688","20150223100216-408",2,"2015-09-23 11:00:00",1443031200,"C4",105480,1443136680,"2015-09-24 16:18:00"
"511","20155123115132-660",2,"2015-09-23 11:57:00",1443034620,"C8",1537500,1444572120,"2015-10-11 07:02:00"
"1381","20151623111631-719",1,"2015-09-23 12:12:00",1443035520,"C5",101160,1443136680,"2015-09-24 16:18:00"
"570","20150723120718-938",3,"2015-09-23 12:14:00",1443035640,"C4",181080,1443216720,"2015-09-25 14:32:00"
"1969","20155923115946-322",2,"2015-09-23 12:33:00",1443036780,"C0",378660,1443415440,"2015-09-27 21:44:00"
"3511","20153723123726-448",2,"2015-09-23 13:15:00",1443039300,"C0",700020,1443739320,"2015-10-01 15:42:00"
"1513","20154823124859-777",3,"2015-09-23 13:16:00",1443039360,"C5",152340,1443191700,"2015-09-25 07:35:00"
"3032","20152523012506-74",1,"2015-09-23 14:22:00",1443043320,"C3",81960,1443125280,"2015-09-24 13:08:00"
"1817","20151823021836-870",3,"2015-09-23 15:17:00",1443046620,"C7",92400,1443139020,"2015-09-24 16:57:00"
"746","20155723025744-648",2,"2015-09-23 15:19:00",1443046740,"C5",76500,1443123240,"2015-09-24 12:34:00"
"5111","20151923031917-617",1,"2015-09-23 15:25:00",1443047100,"C2",620640,1443667740,"2015-09-30 19:49:00"
"3274","20151623041644-600",1,"2015-09-23 16:39:00",1443051540,"C6",573180,1443624720,"2015-09-30 07:52:00"
"3282","20152123052127-127",2,"2015-09-23 17:32:00",1443054720,"C3",343440,1443398160,"2015-09-27 16:56:00"
"6233","20155823045848-67",2,"2015-09-23 17:46:00",1443055560,"C8",134520,1443190080,"2015-09-25 07:08:00"
"2784","20154423044409-968",2,"2015-09-23 17:48:00",1443055680,"C2",189900,1443245580,"2015-09-25 22:33:00"
"4415","20152223052251-513",2,"2015-09-23 17:58:00",1443056280,"C2",574200,1443630480,"2015-09-30 09:28:00"
"1005","20155223045209-786",2,"2015-09-23 18:00:00",1443056400,"C2",615780,1443672180,"2015-09-30 21:03:00"
"6232","20150323050332-513",3,"2015-09-23 18:13:00",1443057180,"C3",443400,1443500580,"2015-09-28 21:23:00"
"146","20152224062251-834",2,"2015-09-24 07:23:00",1443104580,"C4",86760,1443191340,"2015-09-25 07:29:00"
"3976","20150824070825-886",3,"2015-09-24 07:42:00",1443105720,"C0",307920,1443413640,"2015-09-27 21:14:00"
"5281","20153724063727-843",2,"2015-09-24 07:45:00",1443105900,"C6",202620,1443308520,"2015-09-26 16:02:00"
"4556","20153424073437-874",2,"2015-09-24 07:58:00",1443106680,"C5",90480,1443197160,"2015-09-25 09:06:00"
"1033","20152824092833-430",3,"2015-09-24 09:35:00",1443112500,"C2",97800,1443210300,"2015-09-25 12:45:00"
"4122","20154024084056-354",2,"2015-09-24 09:46:00",1443113160,"C5",173040,1443286200,"2015-09-26 09:50:00"
"5053","20151024091033-928",2,"2015-09-24 10:02:00",1443114120,"C5",87060,1443201180,"2015-09-25 10:13:00"
"451","20151824101808-298",2,"2015-09-24 10:24:00",1443115440,"C2",126120,1443241560,"2015-09-25 21:26:00"
"4416","20153824093852-393",1,"2015-09-24 10:39:00",1443116340,"C2",122760,1443239100,"2015-09-25 20:45:00"
"6208","20155124095132-430",1,"2015-09-24 10:57:00",1443117420,"C4",332700,1443450120,"2015-09-28 07:22:00"
"2411","20155024105051-288",3,"2015-09-24 11:17:00",1443118620,"C4",213660,1443332280,"2015-09-26 22:38:00"
"1951","20153624113634-748",2,"2015-09-24 12:10:00",1443121800,"C0",178860,1443300660,"2015-09-26 13:51:00"
"4740","20152524122527-579",1,"2015-09-24 13:20:00",1443126000,"C4",118740,1443244740,"2015-09-25 22:19:00"
"4434","20154124124106-525",2,"2015-09-24 13:38:00",1443127080,"C3",257700,1443384780,"2015-09-27 13:13:00"
"3509","20154524124536-93",2,"2015-09-24 13:45:00",1443127500,"C7",265380,1443392880,"2015-09-27 15:28:00"
"4298","20154824124832-402",2,"2015-09-24 14:01:00",1443128460,"C2",111060,1443239520,"2015-09-25 20:52:00"
"5990","20154324014310-391",1,"2015-09-24 14:37:00",1443130620,"C4",97560,1443228180,"2015-09-25 17:43:00"
"1118","20152224022226-330",1,"2015-09-24 14:39:00",1443130740,"C0",445740,1443576480,"2015-09-29 18:28:00"
"4187","20152824022826-397",3,"2015-09-24 14:49:00",1443131340,"C5",611400,1443742740,"2015-10-01 16:39:00"
"1644","20152724022701-346",1,"2015-09-24 14:54:00",1443131640,"C5",107940,1443239580,"2015-09-25 20:53:00"
"2453","20153524023526-802",3,"2015-09-24 15:50:00",1443135000,"C2",109620,1443244620,"2015-09-25 22:17:00"
"612","20154824034835-889",2,"2015-09-24 16:38:00",1443137880,"C8",175980,1443313860,"2015-09-26 17:31:00"
"3092","20154524034503-939",3,"2015-09-24 17:00:00",1443139200,"C0",99600,1443238800,"2015-09-25 20:40:00"
"643","20153524043531-670",1,"2015-09-24 17:07:00",1443139620,"C8",76740,1443216360,"2015-09-25 14:26:00"
"6288","20155724045747-509",2,"2015-09-24 17:27:00",1443140820,"C8",102060,1443242880,"2015-09-25 21:48:00"
"4883","20152925062903-447",1,"2015-09-25 06:59:00",1443189540,"C2",261900,1443451440,"2015-09-28 07:44:00"
"6287","20151825061809-937",1,"2015-09-25 07:12:00",1443190320,"C5",374400,1443564720,"2015-09-29 15:12:00"
"6146","20153925063909-84",3,"2015-09-25 07:15:00",1443190500,"C2",378180,1443568680,"2015-09-29 16:18:00"
"4356","20150625070608-126",1,"2015-09-25 07:33:00",1443191580,"C4",125520,1443317100,"2015-09-26 18:25:00"
"5380","20153325073343-313",1,"2015-09-25 07:36:00",1443191760,"C6",374280,1443566040,"2015-09-29 15:34:00"
"6114","20153125073143-771",2,"2015-09-25 07:43:00",1443192180,"C3",168420,1443360600,"2015-09-27 06:30:00"
"4201","20154125074116-47",1,"2015-09-25 08:34:00",1443195240,"C5",913680,1444108920,"2015-10-05 22:22:00"
"3278","20155425085454-29",1,"2015-09-25 09:02:00",1443196920,"C8",100680,1443297600,"2015-09-26 13:00:00"
"4830","20154125084143-150",3,"2015-09-25 09:04:00",1443197040,"C8",189720,1443386760,"2015-09-27 13:46:00"
"6139","20153425083416-909",1,"2015-09-25 09:04:00",1443197040,"C3",289140,1443486180,"2015-09-28 17:23:00"
"6273","20154025084030-323",2,"2015-09-25 09:07:00",1443197220,"C5",361800,1443559020,"2015-09-29 13:37:00"
"271","20151425091439-648",2,"2015-09-25 09:17:00",1443197820,"C6",394380,1443592200,"2015-09-29 22:50:00"
"2495","20152325092328-229",1,"2015-09-25 09:52:00",1443199920,"C5",474480,1443674400,"2015-09-30 21:40:00"
"5566","20155225085241-468",2,"2015-09-25 09:59:00",1443200340,"C4",128160,1443328500,"2015-09-26 21:35:00"
"2191","20154525094552-398",1,"2015-09-25 10:19:00",1443201540,"C3",99660,1443301200,"2015-09-26 14:00:00"
"3334","20150025100041-260",3,"2015-09-25 10:40:00",1443202800,"C0",426600,1443629400,"2015-09-30 09:10:00"
"5883","20151925101910-391",2,"2015-09-25 10:50:00",1443203400,"C6",111480,1443314880,"2015-09-26 17:48:00"
"2747","20155325095328-933",2,"2015-09-25 10:53:00",1443203580,"C5",181860,1443385440,"2015-09-27 13:24:00"
"2163","20155825105841-374",1,"2015-09-25 11:06:00",1443204360,"C8",125940,1443330300,"2015-09-26 22:05:00"
"2686","20153725113714-643",2,"2015-09-25 12:06:00",1443207960,"C5",109620,1443317580,"2015-09-26 18:33:00"
"6010","20153425113451-606",2,"2015-09-25 12:33:00",1443209580,"C3",172740,1443382320,"2015-09-27 12:32:00"
"5151","20155925115933-802",2,"2015-09-25 12:41:00",1443210060,"C0",200160,1443410220,"2015-09-27 20:17:00"
"2492","20150825120831-381",1,"2015-09-25 12:43:00",1443210180,"C0",357540,1443567720,"2015-09-29 16:02:00"
"1557","20154525114509-293",1,"2015-09-25 12:44:00",1443210240,"C2",760020,1443970260,"2015-10-04 07:51:00"
"1452","20155525115508-896",2,"2015-09-25 12:53:00",1443210780,"C3",112320,1443323100,"2015-09-26 20:05:00"
"4254","20154525014533-946",1,"2015-09-25 13:52:00",1443214320,"C4",168660,1443382980,"2015-09-27 12:43:00"
"2405","20152925012926-304",2,"2015-09-25 13:53:00",1443214380,"C4",454020,1443668400,"2015-09-30 20:00:00"
"4381","20154725014705-617",2,"2015-09-25 14:09:00",1443215340,"C8",182820,1443398160,"2015-09-27 16:56:00"
"4896","20155525025528-862",2,"2015-09-25 15:23:00",1443219780,"C5",326040,1443545820,"2015-09-29 09:57:00"
"6493","20153425023446-675",1,"2015-09-25 15:28:00",1443220080,"C5",83520,1443303600,"2015-09-26 14:40:00"
"1824","20154225024250-848",1,"2015-09-25 15:36:00",1443220560,"C6",506940,1443727500,"2015-10-01 12:25:00"
"621","20153925023956-683",2,"2015-09-25 15:38:00",1443220680,"C2",667500,1443888180,"2015-10-03 09:03:00"
"6237","20150925030923-872",2,"2015-09-25 15:40:00",1443220800,"C0",179400,1443400200,"2015-09-27 17:30:00"
"4616","20154519024544-322",2,"2015-09-25 15:57:00",1443221820,"C4",200400,1443422220,"2015-09-27 23:37:00"
"4291","20154925034909-164",2,"2015-09-25 16:35:00",1443224100,"C8",170760,1443394860,"2015-09-27 16:01:00"
"2413","20151625041658-913",2,"2015-09-25 16:36:00",1443224160,"C6",426900,1443651060,"2015-09-30 15:11:00"
"3576","20150625040628-192",1,"2015-09-25 16:38:00",1443224280,"C8",182280,1443406560,"2015-09-27 19:16:00"
"591","20152325042329-787",1,"2015-09-25 16:56:00",1443225360,"C3",255720,1443481080,"2015-09-28 15:58:00"
"6236","20154825044833-35",3,"2015-09-25 17:03:00",1443225780,"C7",86460,1443312240,"2015-09-26 17:04:00"
"5730","20150825040833-548",2,"2015-09-25 17:06:00",1443225960,"C4",534240,1443760200,"2015-10-01 21:30:00"
"3209","20154525044559-95",1,"2015-09-25 17:20:00",1443226800,"C4",416400,1443643200,"2015-09-30 13:00:00"
"3866","20151225051248-279",2,"2015-09-25 17:39:00",1443227940,"C4",252060,1443480000,"2015-09-28 15:40:00"
"5211","20152725052758-524",2,"2015-09-25 18:00:00",1443229200,"C5",691260,1443920460,"2015-10-03 18:01:00"
"6271","20151825051820-653",3,"2015-09-25 18:10:00",1443229800,"C4",44640,1443274440,"2015-09-26 06:34:00"
"4960","20151026061007-244",1,"2015-09-26 06:12:00",1443273120,"C6",375840,1443648960,"2015-09-30 14:36:00"
"2759","20150926060947-3",1,"2015-09-26 06:24:00",1443273840,"C0",192000,1443465840,"2015-09-28 11:44:00"
"5887","20151026061040-488",1,"2015-09-26 06:34:00",1443274440,"C5",551940,1443826380,"2015-10-02 15:53:00"
"1663","20151526061504-680",3,"2015-09-26 06:48:00",1443275280,"C0",800460,1444075740,"2015-10-05 13:09:00"
"996","20155526065554-981",1,"2015-09-26 07:27:00",1443277620,"C2",360480,1443638100,"2015-09-30 11:35:00"
"5423","20155326075351-224",3,"2015-09-26 08:31:00",1443281460,"C7",119880,1443401340,"2015-09-27 17:49:00"
"2058","20153726083749-370",1,"2015-09-26 09:00:00",1443283200,"C7",114360,1443397560,"2015-09-27 16:46:00"
"4749","20151526081527-704",2,"2015-09-26 09:14:00",1443284040,"C2",102960,1443387000,"2015-09-27 13:50:00"
"1651","20155526085516-0",2,"2015-09-26 09:27:00",1443284820,"C4",563340,1443848160,"2015-10-02 21:56:00"
"3800","20153326083315-407",2,"2015-09-26 09:33:00",1443285180,"C4",345120,1443630300,"2015-09-30 09:25:00"
"1085","20151526091530-569",1,"2015-09-26 09:41:00",1443285660,"C5",196080,1443481740,"2015-09-28 16:09:00"
"998","20152226092250-865",1,"2015-09-26 09:51:00",1443286260,"C4",384420,1443670680,"2015-09-30 20:38:00"
"751","20150426100413-9",2,"2015-09-26 10:29:00",1443288540,"C5",793620,1444082160,"2015-10-05 14:56:00"
"5904","20150326110322-354",2,"2015-09-26 11:38:00",1443292680,"C6",99540,1443392220,"2015-09-27 15:17:00"
"5090","20155026105032-380",1,"2015-09-26 11:41:00",1443292860,"C5",243660,1443536520,"2015-09-29 07:22:00"
"3279","20150326110308-543",1,"2015-09-26 11:56:00",1443293760,"C4",108180,1443401940,"2015-09-27 17:59:00"
"4815","20153426113440-126",3,"2015-09-26 12:31:00",1443295860,"C5",156300,1443452160,"2015-09-28 07:56:00"
"1885","20150326120302-265",1,"2015-09-26 12:32:00",1443295920,"C5",71700,1443367620,"2015-09-27 08:27:00"
"5858","20150026120010-942",2,"2015-09-26 12:32:00",1443295920,"C0",350460,1443646380,"2015-09-30 13:53:00"
"5317","20153126123126-309",3,"2015-09-26 12:37:00",1443296220,"C2",183300,1443479520,"2015-09-28 15:32:00"
"3850","20150726120703-149",2,"2015-09-26 12:43:00",1443296580,"C2",295080,1443591660,"2015-09-29 22:41:00"
"2655","20152926122925-922",1,"2015-09-26 12:56:00",1443297360,"C8",115020,1443412380,"2015-09-27 20:53:00"
"572","20151826011805-225",2,"2015-09-26 13:49:00",1443300540,"C8",865440,1444165980,"2015-10-06 14:13:00"
"4543","20155726125730-585",1,"2015-09-26 13:53:00",1443300780,"C5",66540,1443367320,"2015-09-27 08:22:00"
"820","20152826012855-73",3,"2015-09-26 14:08:00",1443301680,"C0",197100,1443498780,"2015-09-28 20:53:00"
"4463","20155126015101-584",2,"2015-09-26 14:16:00",1443302160,"C4",779700,1444081860,"2015-10-05 14:51:00"
"6262","20152126012150-343",3,"2015-09-26 14:25:00",1443302700,"C3",431100,1443733800,"2015-10-01 14:10:00"
"3717","20155326015327-562",2,"2015-09-26 14:45:00",1443303900,"C4",251100,1443555000,"2015-09-29 12:30:00"
"385","20155826025824-717",2,"2015-09-26 15:22:00",1443306120,"C5",331500,1443637620,"2015-09-30 11:27:00"
"1582","20151426021455-333",1,"2015-09-26 15:29:00",1443306540,"C7",510180,1443816720,"2015-10-02 13:12:00"
"4986","20150826030836-996",1,"2015-09-26 16:13:00",1443309180,"C4",110040,1443419220,"2015-09-27 22:47:00"
"3120","20151926031950-628",1,"2015-09-26 16:16:00",1443309360,"C8",501060,1443810420,"2015-10-02 11:27:00"
"3675","20153126033132-596",1,"2015-09-26 16:25:00",1443309900,"C8",250500,1443560400,"2015-09-29 14:00:00"
"176","20155426035428-177",2,"2015-09-26 16:27:00",1443310020,"C7",626580,1443936600,"2015-10-03 22:30:00"
"3861","20150326040316-459",1,"2015-09-26 16:39:00",1443310740,"C2",186780,1443497520,"2015-09-28 20:32:00"
"5681","20151826041854-598",1,"2015-09-26 16:54:00",1443311640,"C2",255420,1443567060,"2015-09-29 15:51:00"
"564","20154826034855-575",1,"2015-09-26 16:58:00",1443311880,"C2",752040,1444063920,"2015-10-05 09:52:00"
"3369","20155126045131-960",1,"2015-09-26 17:14:00",1443312840,"C5",99120,1443411960,"2015-09-27 20:46:00"
"2248","20155726045730-46",1,"2015-09-26 17:24:00",1443313440,"C4",79560,1443393000,"2015-09-27 15:30:00"
"5599","20151026051047-171",1,"2015-09-26 17:38:00",1443314280,"C5",396060,1443710340,"2015-10-01 07:39:00"
"2684","20153226043220-886",1,"2015-09-26 17:42:00",1443314520,"C8",663420,1443977940,"2015-10-04 09:59:00"
"708","20154326044353-158",3,"2015-09-26 17:49:00",1443314940,"C0",950280,1444265220,"2015-10-07 17:47:00"
"1939","20153726053749-107",1,"2015-09-26 18:05:00",1443315900,"C5",691440,1444007340,"2015-10-04 18:09:00"
"6418","20155626055623-547",1,"2015-09-26 18:08:00",1443316080,"C3",412740,1443728820,"2015-10-01 12:47:00"
"6314","20155826055855-744",2,"2015-09-26 18:58:00",1443319080,"C8",948480,1444267560,"2015-10-07 18:26:00"
"3174","20152027062057-241",2,"2015-09-27 06:44:00",1443361440,"C5",204840,1443566280,"2015-09-29 15:38:00"
"3425","20152227062258-532",2,"2015-09-27 06:52:00",1443361920,"C2",100020,1443461940,"2015-09-28 10:39:00"
"2923","20154727064700-998",3,"2015-09-27 07:25:00",1443363900,"C2",1214820,1444578720,"2015-10-11 08:52:00"
"2497","20152227062255-337",2,"2015-09-27 07:28:00",1443364080,"C3",645660,1444009740,"2015-10-04 18:49:00"
"3605","20153927063907-823",3,"2015-09-27 07:45:00",1443365100,"C5",213840,1443578940,"2015-09-29 19:09:00"
"1538","20152527072503-929",1,"2015-09-27 07:59:00",1443365940,"C7",368280,1443734220,"2015-10-01 14:17:00"
"1505","20155127065120-711",3,"2015-09-27 08:06:00",1443366360,"C2",392940,1443759300,"2015-10-01 21:15:00"
"5194","20151927071926-369",3,"2015-09-27 08:06:00",1443366360,"C7",351180,1443717540,"2015-10-01 09:39:00"
"2987","20152327072324-277",2,"2015-09-27 08:19:00",1443367140,"C4",117960,1443485100,"2015-09-28 17:05:00"
"505","20150027080052-161",3,"2015-09-27 08:31:00",1443367860,"C8",903000,1444270860,"2015-10-07 19:21:00"
"2372","20154927084908-110",2,"2015-09-27 08:56:00",1443369360,"C4",446880,1443816240,"2015-10-02 13:04:00"
"3441","20153127083119-859",1,"2015-09-27 09:19:00",1443370740,"C8",771300,1444142040,"2015-10-06 07:34:00"
"3982","20152927082906-285",1,"2015-09-27 09:26:00",1443371160,"C8",86460,1443457620,"2015-09-28 09:27:00"
"1947","20150927090926-427",3,"2015-09-27 09:37:00",1443371820,"C8",715140,1444086960,"2015-10-05 16:16:00"
"106","20153527083531-898",1,"2015-09-27 09:52:00",1443372720,"C2",372060,1443744780,"2015-10-01 17:13:00"
"2014","20151327101317-796",2,"2015-09-27 11:18:00",1443377880,"C4",273540,1443651420,"2015-09-30 15:17:00"
"6504","20155927105908-127",2,"2015-09-27 11:27:00",1443378420,"C4",465960,1443844380,"2015-10-02 20:53:00"
"5643","20154027114042-147",1,"2015-09-27 12:11:00",1443381060,"C3",114660,1443495720,"2015-09-28 20:02:00"
"4555","20151727121757-443",1,"2015-09-27 12:40:00",1443382800,"C5",193080,1443575880,"2015-09-29 18:18:00"
"289","20152727122724-538",1,"2015-09-27 12:55:00",1443383700,"C5",496920,1443880620,"2015-10-03 06:57:00"
"1212","20152927012946-631",2,"2015-09-27 13:49:00",1443386940,"C6",160800,1443547740,"2015-09-29 10:29:00"
"4354","20154427014449-383",2,"2015-09-27 14:11:00",1443388260,"C5",277620,1443665880,"2015-09-30 19:18:00"
"4895","20154827014803-602",3,"2015-09-27 14:15:00",1443388500,"C5",278520,1443667020,"2015-09-30 19:37:00"
"2523","20151727021712-641",1,"2015-09-27 14:43:00",1443390180,"C5",72300,1443462480,"2015-09-28 10:48:00"
"5248","20150327030331-456",1,"2015-09-27 15:31:00",1443393060,"C4",83820,1443476880,"2015-09-28 14:48:00"
"6140","20154027024025-199",1,"2015-09-27 15:48:00",1443394080,"C2",183120,1443577200,"2015-09-29 18:40:00"
"1827","20155827025824-481",1,"2015-09-27 15:56:00",1443394560,"C2",263280,1443657840,"2015-09-30 17:04:00"
"5354","20150327030347-941",1,"2015-09-27 15:56:00",1443394560,"C5",586440,1443981000,"2015-10-04 10:50:00"
"2654","20153027033021-889",2,"2015-09-27 16:04:00",1443395040,"C5",99180,1443494220,"2015-09-28 19:37:00"
"5571","20154427034432-511",3,"2015-09-27 16:14:00",1443395640,"C6",235860,1443631500,"2015-09-30 09:45:00"
"4519","20151427031411-974",2,"2015-09-27 16:17:00",1443395820,"C2",619260,1444015080,"2015-10-04 20:18:00"
"6295","20154127034153-72",1,"2015-09-27 16:44:00",1443397440,"C2",526200,1443923640,"2015-10-03 18:54:00"
"1122","20155127035102-451",2,"2015-09-27 16:49:00",1443397740,"C2",106740,1443504480,"2015-09-28 22:28:00"
"3811","20152027052026-10",3,"2015-09-27 17:27:00",1443400020,"C8",104040,1443504060,"2015-09-28 22:21:00"
"1956","20150327050342-760",1,"2015-09-27 17:30:00",1443400200,"C4",250980,1443651180,"2015-09-30 15:13:00"
"2229","20155227055231-464",3,"2015-09-27 17:55:00",1443401700,"C6",238320,1443640020,"2015-09-30 12:07:00"
"6244","20155627045658-136",2,"2015-09-27 17:58:00",1443401880,"C8",440580,1443842460,"2015-10-02 20:21:00"
"3822","20154027054037-715",1,"2015-09-27 18:05:00",1443402300,"C5",63600,1443465900,"2015-09-28 11:45:00"
"5291","20150427050456-122",1,"2015-09-27 18:08:00",1443402480,"C8",45720,1443448200,"2015-09-28 06:50:00"
"2917","20151428061409-269",1,"2015-09-28 06:30:00",1443447000,"C7",185100,1443632100,"2015-09-30 09:55:00"
"1070","20151028071020-362",1,"2015-09-28 07:12:00",1443449520,"C6",108000,1443557520,"2015-09-29 13:12:00"
"3331","20151628071608-385",3,"2015-09-28 07:37:00",1443451020,"C5",195840,1443646860,"2015-09-30 14:01:00"
"3899","20150328070359-611",1,"2015-09-28 08:05:00",1443452700,"C3",80580,1443533280,"2015-09-29 06:28:00"
"3907","20153528073554-422",1,"2015-09-28 08:28:00",1443454080,"C4",553860,1444007940,"2015-10-04 18:19:00"
"2668","20155328085310-805",2,"2015-09-28 08:55:00",1443455700,"C6",281400,1443737100,"2015-10-01 15:05:00"
"1028","20150528090539-210",1,"2015-09-28 09:34:00",1443458040,"C8",200340,1443658380,"2015-09-30 17:13:00"
"5058","20152028092031-391",2,"2015-09-28 09:47:00",1443458820,"C3",278940,1443737760,"2015-10-01 15:16:00"
"5537","20153828093806-862",2,"2015-09-28 09:54:00",1443459240,"C0",114360,1443573600,"2015-09-29 17:40:00"
"3895","20152328102355-953",1,"2015-09-28 10:26:00",1443461160,"C6",296760,1443757920,"2015-10-01 20:52:00"
"1567","20150228100235-385",2,"2015-09-28 10:36:00",1443461760,"C0",434280,1443896040,"2015-10-03 11:14:00"
"1913","20155328095345-887",1,"2015-09-28 10:43:00",1443462180,"C8",763860,1444226040,"2015-10-07 06:54:00"
"587","20151328101312-818",2,"2015-09-28 11:14:00",1443464040,"C5",278580,1443742620,"2015-10-01 16:37:00"
"4564","20152928102926-60",1,"2015-09-28 11:28:00",1443464880,"C2",250200,1443715080,"2015-10-01 08:58:00"
"5049","20151128111144-648",2,"2015-09-28 11:42:00",1443465720,"C7",74700,1443540420,"2015-09-29 08:27:00"
"5652","20152028112022-449",1,"2015-09-28 11:47:00",1443466020,"C5",325620,1443791640,"2015-10-02 06:14:00"
"5829","20153628113615-827",2,"2015-09-28 11:56:00",1443466560,"C8",603000,1444069560,"2015-10-05 11:26:00"
"3561","20152328112352-194",1,"2015-09-28 12:26:00",1443468360,"C2",87000,1443555360,"2015-09-29 12:36:00"
"977","20152628112645-216",2,"2015-09-28 12:34:00",1443468840,"C4",256740,1443725580,"2015-10-01 11:53:00"
"768","20152328122311-696",1,"2015-09-28 12:39:00",1443469140,"C7",1495560,1444964700,"2015-10-15 20:05:00"
"1398","20154428114434-818",2,"2015-09-28 12:43:00",1443469380,"C2",411360,1443880740,"2015-10-03 06:59:00"
"797","20154728124707-118",1,"2015-09-28 13:01:00",1443470460,"C7",463260,1443933720,"2015-10-03 21:42:00"
"3180","20151128121126-103",3,"2015-09-28 13:08:00",1443470880,"C5",177840,1443648720,"2015-09-30 14:32:00"
"3446","20154928014949-969",1,"2015-09-28 13:57:00",1443473820,"C8",116280,1443590100,"2015-09-29 22:15:00"
"2311","20151328011351-370",1,"2015-09-28 14:11:00",1443474660,"C5",191280,1443665940,"2015-09-30 19:19:00"
"2887","20155228015220-418",2,"2015-09-28 14:14:00",1443474840,"C4",332640,1443807480,"2015-10-02 10:38:00"
"5231","20152528012515-626",3,"2015-09-28 14:26:00",1443475560,"C4",162780,1443638340,"2015-09-30 11:39:00"
"1194","20155928015947-290",2,"2015-09-28 14:32:00",1443475920,"C3",155340,1443631260,"2015-09-30 09:41:00"
"2066","20154728014746-613",1,"2015-09-28 14:42:00",1443476520,"C4",196500,1443673020,"2015-09-30 21:17:00"
"3190","20150928020950-296",1,"2015-09-28 15:16:00",1443478560,"C5",499860,1443978420,"2015-10-04 10:07:00"
"2155","20154828034832-761",2,"2015-09-28 16:44:00",1443483840,"C5",1536360,1445020200,"2015-10-16 11:30:00"
"4619","20150828050833-517",1,"2015-09-28 17:41:00",1443487260,"C5",91740,1443579000,"2015-09-29 19:10:00"
"532","20155528055554-549",2,"2015-09-28 18:56:00",1443491760,"C2",687540,1444179300,"2015-10-06 17:55:00"
"1000","20152529062500-596",2,"2015-09-29 06:47:00",1443534420,"C6",140760,1443675180,"2015-09-30 21:53:00"
"3949","20153429063446-548",2,"2015-09-29 07:09:00",1443535740,"C8",170820,1443706560,"2015-10-01 06:36:00"
"6457","20150229070254-204",1,"2015-09-29 07:09:00",1443535740,"C4",368760,1443904500,"2015-10-03 13:35:00"
"1962","20152529072547-796",2,"2015-09-29 08:03:00",1443538980,"C3",189780,1443728760,"2015-10-01 12:46:00"
"2472","20150829070856-319",1,"2015-09-29 08:06:00",1443539160,"C7",306180,1443845340,"2015-10-02 21:09:00"
"53","20150429080444-356",3,"2015-09-29 08:28:00",1443540480,"C4",342660,1443883140,"2015-10-03 07:39:00"
"743","20150729080703-389",1,"2015-09-29 08:32:00",1443540720,"C5",356940,1443897660,"2015-10-03 11:41:00"
"3475","20150829080813-483",2,"2015-09-29 09:05:00",1443542700,"C8",127260,1443669960,"2015-09-30 20:26:00"
"5256","20153329083354-580",1,"2015-09-29 09:43:00",1443544980,"C0",212040,1443757020,"2015-10-01 20:37:00"
"2361","20150429100402-347",1,"2015-09-29 10:29:00",1443547740,"C5",217080,1443764820,"2015-10-01 22:47:00"
"2667","20150729110716-839",1,"2015-09-29 11:23:00",1443550980,"C0",101280,1443652260,"2015-09-30 15:31:00"
"1322","20154529104539-756",1,"2015-09-29 11:43:00",1443552180,"C7",66720,1443618900,"2015-09-30 06:15:00"
"1105","20151229111259-568",1,"2015-09-29 11:46:00",1443552360,"C2",170640,1443723000,"2015-10-01 11:10:00"
"6281","20154929104953-761",1,"2015-09-29 11:49:00",1443552540,"C2",107580,1443660120,"2015-09-30 17:42:00"
"777","20151329111354-725",1,"2015-09-29 12:11:00",1443553860,"C2",355980,1443909840,"2015-10-03 15:04:00"
"739","20150229120212-565",1,"2015-09-29 12:14:00",1443554040,"C3",205980,1443760020,"2015-10-01 21:27:00"
"2313","20151229121216-715",1,"2015-09-29 12:35:00",1443555300,"C8",596340,1444151640,"2015-10-06 10:14:00"
"2540","20153329123327-162",1,"2015-09-29 12:56:00",1443556560,"C5",71340,1443627900,"2015-09-30 08:45:00"
"5189","20151129121122-794",1,"2015-09-29 12:57:00",1443556620,"C8",200820,1443757440,"2015-10-01 20:44:00"
"4843","20153029123049-92",2,"2015-09-29 13:46:00",1443559560,"C0",156120,1443715680,"2015-10-01 09:08:00"
"826","20152229012216-958",2,"2015-09-29 14:22:00",1443561720,"C6",530880,1444092600,"2015-10-05 17:50:00"
"2977","20152829012800-488",3,"2015-09-29 14:35:00",1443562500,"C4",754560,1444317060,"2015-10-08 08:11:00"
"2203","20153829013813-529",2,"2015-09-29 14:36:00",1443562560,"C2",242040,1443804600,"2015-10-02 09:50:00"
"6367","20154829024816-982",2,"2015-09-29 14:53:00",1443563580,"C2",363420,1443927000,"2015-10-03 19:50:00"
"4643","20150029020040-164",1,"2015-09-29 14:58:00",1443563880,"C7",72720,1443636600,"2015-09-30 11:10:00"
"4045","20151929021932-254",1,"2015-09-29 15:06:00",1443564360,"C8",92340,1443656700,"2015-09-30 16:45:00"
"5955","20150329030356-86",1,"2015-09-29 15:11:00",1443564660,"C4",177240,1443741900,"2015-10-01 16:25:00"
"1400","20151729021748-498",2,"2015-09-29 15:20:00",1443565200,"C7",60600,1443625800,"2015-09-30 08:10:00"
"3340","20155229035205-191",2,"2015-09-29 16:26:00",1443569160,"C0",223440,1443792600,"2015-10-02 06:30:00"
"957","20154529034521-219",1,"2015-09-29 16:42:00",1443570120,"C4",661920,1444232040,"2015-10-07 08:34:00"
"2585","20151229041207-285",2,"2015-09-29 17:03:00",1443571380,"C7",160680,1443732060,"2015-10-01 13:41:00"
"5040","20154129044136-415",1,"2015-09-29 17:06:00",1443571560,"C8",399060,1443970620,"2015-10-04 07:57:00"
"1742","20153329043333-913",1,"2015-09-29 17:21:00",1443572460,"C6",79260,1443651720,"2015-09-30 15:22:00"
"1918","20151529051508-917",1,"2015-09-29 17:22:00",1443572520,"C4",680040,1444252560,"2015-10-07 14:16:00"
"443","20151529051506-307",2,"2015-09-29 17:43:00",1443573780,"C6",160440,1443734220,"2015-10-01 14:17:00"
"1328","20152129052143-619",3,"2015-09-29 17:51:00",1443574260,"C3",771660,1444345920,"2015-10-08 16:12:00"
"5802","20151729051737-48",1,"2015-09-29 17:51:00",1443574260,"C5",134040,1443708300,"2015-10-01 07:05:00"
"2839","20155429055432-113",1,"2015-09-29 18:00:00",1443574800,"C4",154500,1443729300,"2015-10-01 12:55:00"
"3196","20153629053647-857",1,"2015-09-29 18:24:00",1443576240,"C6",448440,1444024680,"2015-10-04 22:58:00"
"1310","20151030061038-897",2,"2015-09-30 06:44:00",1443620640,"C3",388440,1444009080,"2015-10-04 18:38:00"
"905","20153030073006-385",2,"2015-09-30 07:52:00",1443624720,"C8",192600,1443817320,"2015-10-02 13:22:00"
"5024","20150030070026-128",1,"2015-09-30 07:53:00",1443624780,"C8",263580,1443888360,"2015-10-03 09:06:00"
"2531","20153330083330-845",3,"2015-09-30 09:30:00",1443630600,"C4",267900,1443898500,"2015-10-03 11:55:00"
"3996","20153730083758-789",2,"2015-09-30 09:48:00",1443631680,"C0",527160,1444158840,"2015-10-06 12:14:00"
"1179","20154030094027-816",1,"2015-09-30 10:01:00",1443632460,"C7",525660,1444158120,"2015-10-06 12:02:00"
"4875","20150230100237-163",1,"2015-09-30 10:30:00",1443634200,"C3",470880,1444105080,"2015-10-05 21:18:00"
"2394","20150430100459-528",2,"2015-09-30 11:02:00",1443636120,"C8",269280,1443905400,"2015-10-03 13:50:00"
"4134","20152130102130-760",2,"2015-09-30 11:23:00",1443637380,"C0",383940,1444021320,"2015-10-04 22:02:00"
"246","20150230110247-212",3,"2015-09-30 11:30:00",1443637800,"C3",264540,1443902340,"2015-10-03 12:59:00"
"1685","20153030113019-64",1,"2015-09-30 11:58:00",1443639480,"C4",637380,1444276860,"2015-10-07 21:01:00"
"3654","20150530120541-89",1,"2015-09-30 12:38:00",1443641880,"C2",207720,1443849600,"2015-10-02 22:20:00"
"3448","20152930122926-301",3,"2015-09-30 12:59:00",1443643140,"C4",199140,1443842280,"2015-10-02 20:18:00"
"687","20155030125002-922",3,"2015-09-30 13:32:00",1443645120,"C2",96300,1443741420,"2015-10-01 16:17:00"
"6112","20152230022253-963",1,"2015-09-30 14:45:00",1443649500,"C8",245460,1443894960,"2015-10-03 10:56:00"
"595","20152030022022-687",2,"2015-09-30 15:17:00",1443651420,"C4",351960,1444003380,"2015-10-04 17:03:00"
"2221","20152130032113-173",2,"2015-09-30 15:27:00",1443652020,"C4",372540,1444024560,"2015-10-04 22:56:00"
"3043","20153230023251-365",1,"2015-09-30 15:27:00",1443652020,"C7",89100,1443741120,"2015-10-01 16:12:00"
"262","20151530031532-48",1,"2015-09-30 15:52:00",1443653520,"C3",278160,1443931680,"2015-10-03 21:08:00"
"5842","20153430033444-725",2,"2015-09-30 15:56:00",1443653760,"C4",166320,1443820080,"2015-10-02 14:08:00"
"3396","20150930030938-661",3,"2015-09-30 16:09:00",1443654540,"C0",758940,1444413480,"2015-10-09 10:58:00"
"2912","20150730040705-133",2,"2015-09-30 17:11:00",1443658260,"C5",142740,1443801000,"2015-10-02 08:50:00"
"6032","20155930055927-156",2,"2015-09-30 18:30:00",1443663000,"C4",183300,1443846300,"2015-10-02 21:25:00"
"4775","20152501062522-694",2,"2015-10-01 06:52:00",1443707520,"C4",119400,1443826920,"2015-10-02 16:02:00"
"2308","20152702072702-121",1,"2015-10-02 07:34:00",1443796440,"C8",538140,1444334580,"2015-10-08 13:03:00"
"5937","20150002080017-383",1,"2015-10-02 09:03:00",1443801780,"C2",93840,1443895620,"2015-10-03 11:07:00"
"1054","20155002115040-685",1,"2015-10-02 11:57:00",1443812220,"C2",1136220,1444948440,"2015-10-15 15:34:00"
"2769","20153902113957-47",3,"2015-10-02 12:02:00",1443812520,"C5",72240,1443884760,"2015-10-03 08:06:00"
"4617","20154519024544-322",2,"2015-10-02 15:37:00",1443825420,"C4",201900,1444027320,"2015-10-04 23:42:00"
"3093","20153404113443-239",1,"2015-10-04 12:34:00",1443987240,"C6",80640,1444067880,"2015-10-05 10:58:00"
"6466","20154606024636-543",1,"2015-10-06 15:19:00",1444169940,"C8",86520,1444256460,"2015-10-07 15:21:00"
"2099","20152207062244-430",2,"2015-10-07 07:08:00",1444226880,"C8",867180,1445094060,"2015-10-17 08:01:00"
"3633","20151707111715-550",2,"2015-10-07 12:26:00",1444245960,"C0",118740,1444364700,"2015-10-08 21:25:00"
"5043","20152909092941-524",1,"2015-10-09 10:08:00",1444410480,"C0",195900,1444606380,"2015-10-11 16:33:00"
"1841","20150509110550-759",1,"2015-10-09 12:21:00",1444418460,"C2",383340,1444801800,"2015-10-13 22:50:00"
"2835","20153109123110-337",2,"2015-10-09 12:36:00",1444419360,"C2",244320,1444663680,"2015-10-12 08:28:00"
"42","20151712061733-488",1,"2015-10-12 06:36:00",1444656960,"C6",130200,1444787160,"2015-10-13 18:46:00"
"2421","20150613010619-88",3,"2015-10-13 13:59:00",1444769940,"C5",864540,1445634480,"2015-10-23 14:08:00"
"3229","20155415055448-117",1,"2015-10-15 18:37:00",1444959420,"C0",69900,1445029320,"2015-10-16 14:02:00"
"1881","20151516041514-25",2,"2015-10-16 16:47:00",1445039220,"C6",270660,1445309880,"2015-10-19 19:58:00"
"4964","20155617035648-789",1,"2015-10-17 17:11:00",1445127060,"C2",612420,1445739480,"2015-10-24 19:18:00"
"1777","20152918022901-486",1,"2015-10-18 14:57:00",1445205420,"C4",443700,1445649120,"2015-10-23 18:12:00"
"6248","20150419080453-269",2,"2015-10-19 08:44:00",1445269440,"C0",78720,1445348160,"2015-10-20 06:36:00"
"4269","20153319103344-890",1,"2015-10-19 11:38:00",1445279880,"C2",75960,1445355840,"2015-10-20 08:44:00"
"5737","20155705025759-63",1,"2015-10-19 18:58:00",1445306280,"C2",2915820,1448222100,"2015-11-22 11:55:00"
"4804","20151620061659-448",3,"2015-10-20 07:18:00",1445350680,"C3",174300,1445524980,"2015-10-22 07:43:00"
"1077","20153120063140-521",1,"2015-10-20 07:24:00",1445351040,"C7",539100,1445890140,"2015-10-26 13:09:00"
"515","20155821075857-972",2,"2015-10-21 08:24:00",1445441040,"C3",476820,1445917860,"2015-10-26 20:51:00"
"5487","20152822092858-860",3,"2015-10-22 10:08:00",1445533680,"C7",86400,1445620080,"2015-10-23 10:08:00"
"1873","20154623114627-225",1,"2015-10-23 12:24:00",1445628240,"C0",286200,1445914440,"2015-10-26 19:54:00"
"3782","20153223033200-444",3,"2015-10-23 16:26:00",1445642760,"C5",180540,1445823300,"2015-10-25 18:35:00"
"6557","20152823032832-378",2,"2015-10-23 16:31:00",1445643060,"C0",54900,1445697960,"2015-10-24 07:46:00"
"5795","20151823041807-23",3,"2015-10-23 17:23:00",1445646180,"C0",101460,1445747640,"2015-10-24 21:34:00"
"1059","20154324094311-697",2,"2015-10-24 10:08:00",1445706480,"C5",261240,1445967720,"2015-10-27 10:42:00"
"64","20153424013401-207",1,"2015-10-24 13:41:00",1445719260,"C8",586740,1446306000,"2015-10-31 08:40:00"
"1613","20153124013107-263",1,"2015-10-24 14:00:00",1445720400,"C5",375840,1446096240,"2015-10-28 22:24:00"
"6378","20153424023413-34",3,"2015-10-24 14:40:00",1445722800,"C2",199560,1445922360,"2015-10-26 22:06:00"
"4859","20153624043623-472",2,"2015-10-24 16:43:00",1445730180,"C4",221220,1445951400,"2015-10-27 06:10:00"
"3102","20151825091848-82",3,"2015-10-25 09:51:00",1445791860,"C3",185460,1445977320,"2015-10-27 13:22:00"
"605","20153026083032-587",1,"2015-10-26 08:58:00",1445875080,"C5",217140,1446092220,"2015-10-28 21:17:00"
"927","20150826020806-485",2,"2015-10-26 15:03:00",1445896980,"C5",140400,1446037380,"2015-10-28 06:03:00"
"1107","20152528092556-30",2,"2015-10-28 09:52:00",1446051120,"C4",110280,1446161400,"2015-10-29 16:30:00"
"4361","20152428112426-434",3,"2015-10-28 11:55:00",1446058500,"C5",78480,1446136980,"2015-10-29 09:43:00"
"3485","20153728033704-530",2,"2015-10-28 16:29:00",1446074940,"C4",145860,1446220800,"2015-10-30 09:00:00"
"302","20153230113243-759",1,"2015-10-30 11:39:00",1446230340,"C8",253920,1446484260,"2015-11-02 09:11:00"
"5496","20153031083006-993",1,"2015-10-31 09:00:00",1446307200,"C3",187560,1446494760,"2015-11-02 12:06:00"
"126","20152231122207-586",1,"2015-10-31 12:49:00",1446320940,"C4",289620,1446610560,"2015-11-03 20:16:00"
"5091","20151131021149-695",3,"2015-10-31 14:45:00",1446327900,"C5",261480,1446589380,"2015-11-03 14:23:00"
"5665","20152902112948-976",2,"2015-11-02 12:02:00",1446494520,"C5",166800,1446661320,"2015-11-04 10:22:00"
"3591","20154903114941-837",1,"2015-11-03 12:46:00",1446583560,"C6",273180,1446856740,"2015-11-06 16:39:00"
"3898","20151613061634-340",2,"2015-11-13 06:47:00",1447426020,"C8",289800,1447715820,"2015-11-16 15:17:00"
"94","20150614110632-795",3,"2015-11-14 11:50:00",1447530600,"C8",324720,1447855320,"2015-11-18 06:02:00"
"5738","20155705025759-63",1,"2015-11-22 13:00:00",1448226000,"C6",2605380,1450831380,"2015-12-22 16:43:00"
"2065","20154023084052-167",1,"2015-11-23 09:24:00",1448299440,"C8",190560,1448490000,"2015-11-25 14:20:00"
"5610","20154629064615-476",1,"2015-11-29 07:51:00",1448812260,"C3",195960,1449008220,"2015-12-01 14:17:00"
"1554","20154904064902-300",1,"2015-12-04 07:45:00",1449243900,"C8",110520,1449354420,"2015-12-05 14:27:00"
"5799","20151509081503-433",3,"2015-12-09 08:35:00",1449678900,"C8",374940,1450053840,"2015-12-13 16:44:00"
"3863","20153917053945-907",1,"2015-12-17 18:14:00",1450404840,"C2",75360,1450480200,"2015-12-18 15:10:00"
"1982","20152218122219-545",2,"2015-12-18 12:30:00",1450470600,"C4",251220,1450721820,"2015-12-21 10:17:00"
"5739","20155705025759-63",1,"2015-12-22 17:44:00",1450835040,"C3",3011640,1453846680,"2016-01-26 14:18:00"
"1927","20151828111836-799",1,"2015-12-28 11:41:00",1451331660,"C4",88860,1451420520,"2015-12-29 12:22:00"
"6347","20160506090520-274",2,"2016-01-06 09:39:00",1452101940,"C0",102420,1452204360,"2016-01-07 14:06:00"
"1001","20163708103702-555",2,"2016-01-08 11:00:00",1452279600,"C5",559740,1452839340,"2016-01-14 22:29:00"
"5765","20161915061905-937",2,"2016-01-15 07:14:00",1452870840,"C4",226680,1453097520,"2016-01-17 22:12:00"
"1193","20162716112747-330",1,"2016-01-16 12:21:00",1452975660,"C5",191760,1453167420,"2016-01-18 17:37:00"
"2748","20165519125545-196",2,"2016-01-19 13:54:00",1453240440,"C2",78120,1453318560,"2016-01-20 11:36:00"
"5386","20164124024115-14",1,"2016-01-24 15:34:00",1453678440,"C5",414900,1454093340,"2016-01-29 10:49:00"
"5740","20155705025759-63",1,"2016-01-26 14:22:00",1453846920,"C4",3034140,1456881060,"2016-03-01 17:11:00"
"4037","20162209102238-93",2,"2016-02-09 10:49:00",1455043740,"C4",127320,1455171060,"2016-02-10 22:11:00"
"191","20160411030412-40",1,"2016-02-11 15:31:00",1455233460,"C4",1388220,1456621680,"2016-02-27 17:08:00"
"3421","20160020030000-577",2,"2016-02-20 15:33:00",1456011180,"C5",160320,1456171500,"2016-02-22 12:05:00"
"2831","20165222105209-198",1,"2016-02-22 11:25:00",1456169100,"C8",90780,1456259880,"2016-02-23 12:38:00"
"5579","20164124024135-223",3,"2016-02-24 14:47:00",1456354020,"C4",94800,1456448820,"2016-02-25 17:07:00"
"3808","20164701124736-81",1,"2016-03-01 13:13:00",1456866780,"C4",73560,1456940340,"2016-03-02 09:39:00"
"5741","20155705025759-63",1,"2016-03-01 17:20:00",1456881600,"C0",2575020,1459456620,"2016-03-31 13:37:00"
"6123","20161503081526-237",1,"2016-03-03 09:26:00",1457025960,"C2",131100,1457157060,"2016-03-04 21:51:00"
"2090","20164504064540-547",1,"2016-03-04 06:51:00",1457103060,"C8",652620,1457755680,"2016-03-11 20:08:00"
"47","20162904122951-717",1,"2016-03-04 12:59:00",1457125140,"C0",203640,1457328780,"2016-03-06 21:33:00"
"6326","20161905071929-794",2,"2016-03-05 08:25:00",1457195100,"C2",1148520,1458343620,"2016-03-18 16:27:00"
"2256","20163007043005-603",3,"2016-03-07 16:40:00",1457397600,"C3",1047600,1458445200,"2016-03-19 20:40:00"
"48","20162904122951-717",1,"2016-03-11 12:55:00",1457729700,"C0",202920,1457932620,"2016-03-13 22:17:00"
"6489","20161412121444-732",1,"2016-03-12 12:29:00",1457814540,"C0",71880,1457886420,"2016-03-13 09:27:00"
"2496","20165117045137-283",1,"2016-03-17 17:16:00",1458260160,"C5",146700,1458406860,"2016-03-19 10:01:00"
"49","20162904122951-717",1,"2016-03-18 12:45:00",1458330300,"C0",204780,1458535080,"2016-03-20 21:38:00"
"780","20165624125612-641",2,"2016-03-24 13:15:00",1458850500,"C6",201540,1459052040,"2016-03-26 21:14:00"
"3268","20163125083158-7",2,"2016-03-25 08:57:00",1458921420,"C5",99180,1459020600,"2016-03-26 12:30:00"
"50","20162904122951-717",1,"2016-03-25 12:57:00",1458935820,"C0",202980,1459138800,"2016-03-27 21:20:00"
"5742","20155705025759-63",1,"2016-03-31 13:45:00",1459457100,"C4",2830500,1462287600,"2016-05-03 08:00:00"
"4810","20161731021739-422",3,"2016-03-31 15:16:00",1459462560,"C5",314880,1459777440,"2016-04-04 06:44:00"
"51","20162904122951-717",1,"2016-04-01 13:10:00",1459541400,"C0",202740,1459744140,"2016-04-03 21:29:00"
"4912","20165701055728-629",1,"2016-04-01 18:51:00",1459561860,"C4",96960,1459658820,"2016-04-02 21:47:00"
"4357","20163403093427-432",2,"2016-04-03 10:06:00",1459703160,"C4",453060,1460156220,"2016-04-08 15:57:00"
"1673","20165904095931-786",2,"2016-04-04 11:02:00",1459792920,"C5",99060,1459891980,"2016-04-05 14:33:00"
"4849","20161605081629-930",1,"2016-04-05 08:36:00",1459870560,"C7",166920,1460037480,"2016-04-07 06:58:00"
"920","20165206045258-573",1,"2016-04-06 17:16:00",1459988160,"C8",151560,1460139720,"2016-04-08 11:22:00"
"1603","20164707014735-384",2,"2016-04-07 14:31:00",1460064660,"C2",258720,1460323380,"2016-04-10 14:23:00"
"52","20162904122951-717",1,"2016-04-08 13:09:00",1460146140,"C0",203700,1460349840,"2016-04-10 21:44:00"
"4697","20161308031352-805",3,"2016-04-08 15:37:00",1460155020,"C7",442140,1460597160,"2016-04-13 18:26:00"
"2258","20162409062454-857",2,"2016-04-09 07:23:00",1460211780,"C7",554100,1460765880,"2016-04-15 17:18:00"
"5072","20162810052858-571",2,"2016-04-10 17:54:00",1460336040,"C5",70680,1460406720,"2016-04-11 13:32:00"
"1884","20161611051626-58",2,"2016-04-11 18:20:00",1460424000,"C4",403440,1460827440,"2016-04-16 10:24:00"
"4854","20164712064702-854",2,"2016-04-12 07:34:00",1460471640,"C8",192420,1460664060,"2016-04-14 13:01:00"
"87","20162113102146-554",1,"2016-04-13 11:21:00",1460571660,"C5",272160,1460843820,"2016-04-16 14:57:00"
"1279","20163014013040-441",1,"2016-04-14 13:55:00",1460667300,"C4",77700,1460745000,"2016-04-15 11:30:00"
"2979","20162115092102-471",1,"2016-04-15 09:50:00",1460739000,"C4",163380,1460902380,"2016-04-17 07:13:00"
"4015","20162616092636-320",1,"2016-04-16 10:17:00",1460827020,"C6",301740,1461128760,"2016-04-19 22:06:00"
"3075","20164021074031-924",1,"2016-04-21 08:02:00",1461250920,"C8",101520,1461352440,"2016-04-22 12:14:00"
"3768","20163922113927-867",3,"2016-04-22 12:44:00",1461354240,"C0",349140,1461703380,"2016-04-26 13:43:00"
"762","20160723050724-51",2,"2016-04-23 18:10:00",1461460200,"C2",864000,1462324200,"2016-05-03 18:10:00"
"1848","20164624094605-617",2,"2016-04-24 10:48:00",1461520080,"C4",263100,1461783180,"2016-04-27 11:53:00"
"752","20162226032206-214",1,"2016-04-26 16:14:00",1461712440,"C4",109680,1461822120,"2016-04-27 22:42:00"
"647","20161227011258-480",1,"2016-04-27 13:42:00",1461789720,"C3",180780,1461970500,"2016-04-29 15:55:00"
"2343","20161928071944-220",2,"2016-04-28 07:34:00",1461854040,"C7",199200,1462053240,"2016-04-30 14:54:00"
"2503","20161929031920-756",1,"2016-04-29 16:20:00",1461972000,"C2",335520,1462307520,"2016-05-03 13:32:00"
"2520","20161130121138-137",2,"2016-04-30 12:37:00",1462045020,"C7",123420,1462168440,"2016-05-01 22:54:00"
"6048","20165001065047-958",1,"2016-05-01 06:57:00",1462111020,"C4",104820,1462215840,"2016-05-02 12:04:00"
"930","20165001065044-854",2,"2016-05-01 07:23:00",1462112580,"C7",458160,1462570740,"2016-05-06 14:39:00"
"4216","20161501071504-180",3,"2016-05-01 07:46:00",1462113960,"C3",186780,1462300740,"2016-05-03 11:39:00"
"4652","20161001071044-510",1,"2016-05-01 08:10:00",1462115400,"C2",126240,1462241640,"2016-05-02 19:14:00"
"5327","20163301093354-99",2,"2016-05-01 09:41:00",1462120860,"C4",252000,1462372860,"2016-05-04 07:41:00"
"476","20162701092754-587",1,"2016-05-01 10:37:00",1462124220,"C8",693360,1462817580,"2016-05-09 11:13:00"
"4011","20164201094203-125",1,"2016-05-01 10:40:00",1462124400,"C4",211980,1462336380,"2016-05-03 21:33:00"
"3594","20162101102134-434",3,"2016-05-01 11:21:00",1462126860,"C0",185280,1462312140,"2016-05-03 14:49:00"
"914","20164101114139-473",3,"2016-05-01 12:45:00",1462131900,"C3",802320,1462934220,"2016-05-10 19:37:00"
"3296","20162701122721-624",3,"2016-05-01 13:42:00",1462135320,"C7",425940,1462561260,"2016-05-06 12:01:00"
"386","20163001013040-715",3,"2016-05-01 14:02:00",1462136520,"C7",80040,1462216560,"2016-05-02 12:16:00"
"986","20160301010333-533",2,"2016-05-01 14:11:00",1462137060,"C4",114780,1462251840,"2016-05-02 22:04:00"
"55","20160902060942-509",2,"2016-05-02 06:55:00",1462197300,"C6",612780,1462810080,"2016-05-09 09:08:00"
"390","20163402063435-850",1,"2016-05-02 07:05:00",1462197900,"C7",349860,1462547760,"2016-05-06 08:16:00"
"689","20162302072339-398",1,"2016-05-02 07:50:00",1462200600,"C4",96240,1462296840,"2016-05-03 10:34:00"
"6302","20165202075235-678",1,"2016-05-02 08:17:00",1462202220,"C5",277440,1462479660,"2016-05-05 13:21:00"
"2360","20163702083732-163",1,"2016-05-02 09:00:00",1462204800,"C5",336660,1462541460,"2016-05-06 06:31:00"
"4091","20160402010438-874",2,"2016-05-02 13:22:00",1462220520,"C6",259140,1462479660,"2016-05-05 13:21:00"
"2610","20160102010124-415",3,"2016-05-02 13:35:00",1462221300,"C7",259800,1462481100,"2016-05-05 13:45:00"
"802","20162502012517-879",2,"2016-05-02 13:59:00",1462222740,"C7",76980,1462299720,"2016-05-03 11:22:00"
"4211","20161103061131-806",1,"2016-05-03 07:03:00",1462284180,"C5",534840,1462819020,"2016-05-09 11:37:00"
"4764","20161903071919-851",2,"2016-05-03 07:25:00",1462285500,"C2",1119360,1463404860,"2016-05-16 06:21:00"
"5743","20155705025759-63",1,"2016-05-03 08:12:00",1462288320,"C2",1490580,1463778900,"2016-05-20 14:15:00"
"3082","20165703075701-962",1,"2016-05-03 09:02:00",1462291320,"C4",88560,1462379880,"2016-05-04 09:38:00"
"6059","20162203102237-41",1,"2016-05-03 11:17:00",1462299420,"C5",210780,1462510200,"2016-05-05 21:50:00"
"541","20163403103449-145",3,"2016-05-03 11:34:00",1462300440,"C8",69960,1462370400,"2016-05-04 07:00:00"
"405","20162703112728-345",1,"2016-05-03 11:57:00",1462301820,"C4",199800,1462501620,"2016-05-05 19:27:00"
"2315","20162403012456-660",1,"2016-05-03 13:54:00",1462308840,"C0",201300,1462510140,"2016-05-05 21:49:00"
"5073","20160003020009-483",1,"2016-05-03 14:22:00",1462310520,"C5",188160,1462498680,"2016-05-05 18:38:00"
"338","20161604061614-874",1,"2016-05-04 06:48:00",1462369680,"C5",348840,1462718520,"2016-05-08 07:42:00"
"3673","20162104082115-909",1,"2016-05-04 09:30:00",1462379400,"C8",366780,1462746180,"2016-05-08 15:23:00"
"3217","20162204092243-393",2,"2016-05-04 09:35:00",1462379700,"C7",186900,1462566600,"2016-05-06 13:30:00"
"478","20163904013912-769",2,"2016-05-04 13:45:00",1462394700,"C2",534780,1462929480,"2016-05-10 18:18:00"
"358","20160604020620-396",1,"2016-05-04 14:29:00",1462397340,"C7",539520,1462936860,"2016-05-10 20:21:00"
"4226","20162104032146-897",3,"2016-05-04 15:54:00",1462402440,"C3",184620,1462587060,"2016-05-06 19:11:00"
"2013","20165704055721-696",1,"2016-05-04 18:33:00",1462411980,"C3",411300,1462823280,"2016-05-09 12:48:00"
"4231","20161805081816-21",1,"2016-05-05 08:49:00",1462463340,"C7",170400,1462633740,"2016-05-07 08:09:00"
"1350","20161405101442-940",2,"2016-05-05 10:43:00",1462470180,"C4",89460,1462559640,"2016-05-06 11:34:00"
"1115","20165105115138-773",1,"2016-05-05 12:52:00",1462477920,"C7",599820,1463077740,"2016-05-12 11:29:00"
"5360","20162305022327-418",3,"2016-05-05 14:53:00",1462485180,"C4",109800,1462594980,"2016-05-06 21:23:00"
"5509","20165305015329-885",1,"2016-05-05 15:00:00",1462485600,"C0",175740,1462661340,"2016-05-07 15:49:00"
"2150","20165005045015-818",1,"2016-05-05 17:13:00",1462493580,"C5",364860,1462858440,"2016-05-09 22:34:00"
"4423","20161205051258-519",3,"2016-05-05 17:37:00",1462495020,"C5",330840,1462825860,"2016-05-09 13:31:00"
"764","20165706065721-811",1,"2016-05-06 08:09:00",1462547340,"C2",94800,1462642140,"2016-05-07 10:29:00"
"2670","20164006084004-327",2,"2016-05-06 09:37:00",1462552620,"C4",560040,1463112660,"2016-05-12 21:11:00"
"397","20163806093805-983",1,"2016-05-06 09:52:00",1462553520,"C0",299580,1462853100,"2016-05-09 21:05:00"
"935","20162806092859-620",2,"2016-05-06 10:14:00",1462554840,"C8",80040,1462634880,"2016-05-07 08:28:00"
"5175","20162706102701-37",3,"2016-05-06 10:59:00",1462557540,"C4",510360,1463067900,"2016-05-12 08:45:00"
"5253","20162506102549-845",1,"2016-05-06 11:17:00",1462558620,"C5",777060,1463335680,"2016-05-15 11:08:00"
"2028","20162406112415-657",1,"2016-05-06 11:26:00",1462559160,"C6",342120,1462901280,"2016-05-10 10:28:00"
"6363","20164006104039-266",3,"2016-05-06 11:37:00",1462559820,"C5",69600,1462629420,"2016-05-07 06:57:00"
"4275","20161106011142-596",2,"2016-05-06 13:31:00",1462566660,"C7",600780,1463167440,"2016-05-13 12:24:00"
"5005","20160306010354-831",2,"2016-05-06 13:37:00",1462567020,"C2",333960,1462900980,"2016-05-10 10:23:00"
"2958","20164806024852-900",1,"2016-05-06 15:24:00",1462573440,"C2",110520,1462683960,"2016-05-07 22:06:00"
"877","20161706051756-373",2,"2016-05-06 17:40:00",1462581600,"C4",221880,1462803480,"2016-05-09 07:18:00"
"2906","20162106052135-91",1,"2016-05-06 17:51:00",1462582260,"C5",447600,1463029860,"2016-05-11 22:11:00"
"3073","20161006051036-393",2,"2016-05-06 18:04:00",1462583040,"C7",336120,1462919160,"2016-05-10 15:26:00"
"1647","20162706052712-821",2,"2016-05-06 18:29:00",1462584540,"C5",325080,1462909620,"2016-05-10 12:47:00"
"5985","20163207073234-8",2,"2016-05-07 08:11:00",1462633860,"C0",215700,1462849560,"2016-05-09 20:06:00"
"4063","20161507081502-674",2,"2016-05-07 08:43:00",1462635780,"C4",384540,1463020320,"2016-05-11 19:32:00"
"3160","20161907081910-516",1,"2016-05-07 09:24:00",1462638240,"C7",383700,1463021940,"2016-05-11 19:59:00"
"2662","20165407095430-165",1,"2016-05-07 10:57:00",1462643820,"C4",1146660,1463790480,"2016-05-20 17:28:00"
"1274","20164607104629-486",1,"2016-05-07 11:05:00",1462644300,"C6",854220,1463498520,"2016-05-17 08:22:00"
"6015","20165907125955-871",2,"2016-05-07 13:29:00",1462652940,"C5",420840,1463073780,"2016-05-12 10:23:00"
"5535","20165807025851-835",3,"2016-05-07 15:29:00",1462660140,"C2",68220,1462728360,"2016-05-08 10:26:00"
"3985","20161207031252-328",2,"2016-05-07 15:35:00",1462660500,"C6",91440,1462751940,"2016-05-08 16:59:00"
"5525","20162807032803-741",2,"2016-05-07 15:50:00",1462661400,"C6",158460,1462819860,"2016-05-09 11:51:00"
"3876","20163707033759-413",1,"2016-05-07 16:37:00",1462664220,"C0",140580,1462804800,"2016-05-09 07:40:00"
"2257","20161507051513-138",2,"2016-05-07 18:09:00",1462669740,"C4",216540,1462886280,"2016-05-10 06:18:00"
"691","20164407054454-328",3,"2016-05-07 18:15:00",1462670100,"C4",63660,1462733760,"2016-05-08 11:56:00"
"5002","20163607053650-333",1,"2016-05-07 18:52:00",1462672320,"C0",61020,1462733340,"2016-05-08 11:49:00"
"598","20164508064519-442",1,"2016-05-08 07:17:00",1462717020,"C3",113760,1462830780,"2016-05-09 14:53:00"
"1711","20164708074730-603",2,"2016-05-08 08:15:00",1462720500,"C4",92100,1462812600,"2016-05-09 09:50:00"
"4584","20163108093145-941",1,"2016-05-08 10:34:00",1462728840,"C7",642240,1463371080,"2016-05-15 20:58:00"
"1950","20164108104158-541",2,"2016-05-08 11:49:00",1462733340,"C6",677160,1463410500,"2016-05-16 07:55:00"
"1121","20160508120500-362",1,"2016-05-08 12:52:00",1462737120,"C8",284340,1463021460,"2016-05-11 19:51:00"
"4173","20161508121511-970",2,"2016-05-08 13:01:00",1462737660,"C6",89280,1462826940,"2016-05-09 13:49:00"
"5113","20162308022340-411",3,"2016-05-08 14:31:00",1462743060,"C4",144660,1462887720,"2016-05-10 06:42:00"
"2867","20164308024330-236",3,"2016-05-08 15:06:00",1462745160,"C7",422160,1463167320,"2016-05-13 12:22:00"
"5798","20163508033551-791",1,"2016-05-08 16:08:00",1462748880,"C4",85500,1462834380,"2016-05-09 15:53:00"
"5379","20163108043103-996",3,"2016-05-08 17:07:00",1462752420,"C0",160920,1462913340,"2016-05-10 13:49:00"
"3550","20165408055453-259",3,"2016-05-08 18:38:00",1462757880,"C2",306360,1463064240,"2016-05-12 07:44:00"
"2696","20164808054840-252",1,"2016-05-08 18:43:00",1462758180,"C3",773340,1463531520,"2016-05-17 17:32:00"
"6471","20160709060739-448",1,"2016-05-09 06:27:00",1462800420,"C7",184380,1462984800,"2016-05-11 09:40:00"
"4723","20163309073335-602",2,"2016-05-09 07:36:00",1462804560,"C6",263460,1463068020,"2016-05-12 08:47:00"
"3909","20163909083952-107",3,"2016-05-09 08:53:00",1462809180,"C7",454200,1463263380,"2016-05-14 15:03:00"
"2111","20160809090856-701",1,"2016-05-09 09:59:00",1462813140,"C4",267960,1463081100,"2016-05-12 12:25:00"
"4807","20163909093927-432",1,"2016-05-09 10:10:00",1462813800,"C0",342060,1463155860,"2016-05-13 09:11:00"
"3136","20165709095721-17",1,"2016-05-09 10:29:00",1462814940,"C5",1133100,1463948040,"2016-05-22 13:14:00"
"2539","20162809102817-777",1,"2016-05-09 11:01:00",1462816860,"C5",262380,1463079240,"2016-05-12 11:54:00"
"455","20160109120154-984",3,"2016-05-09 12:33:00",1462822380,"C0",542460,1463364840,"2016-05-15 19:14:00"
"4200","20160909040905-953",1,"2016-05-09 16:32:00",1462836720,"C8",70320,1462907040,"2016-05-10 12:04:00"
"4334","20165710075759-354",1,"2016-05-10 08:20:00",1462893600,"C5",444120,1463337720,"2016-05-15 11:42:00"
"781","20164810074837-368",2,"2016-05-10 08:21:00",1462893660,"C8",196620,1463090280,"2016-05-12 14:58:00"
"2604","20161010091000-835",3,"2016-05-10 10:17:00",1462900620,"C7",250200,1463150820,"2016-05-13 07:47:00"
"681","20161410101407-777",3,"2016-05-10 11:08:00",1462903680,"C5",265680,1463169360,"2016-05-13 12:56:00"
"6336","20165510115511-114",2,"2016-05-10 12:21:00",1462908060,"C4",264900,1463172960,"2016-05-13 13:56:00"
"1027","20165710015727-667",2,"2016-05-10 14:29:00",1462915740,"C3",184620,1463100360,"2016-05-12 17:46:00"
"5311","20163810043842-166",2,"2016-05-10 17:18:00",1462925880,"C7",68640,1462994520,"2016-05-11 12:22:00"
"485","20162310042305-75",1,"2016-05-10 17:37:00",1462927020,"C7",400860,1463327880,"2016-05-15 08:58:00"
"2454","20163410053456-4",2,"2016-05-10 18:06:00",1462928760,"C4",331440,1463260200,"2016-05-14 14:10:00"
"3559","20161211061224-16",1,"2016-05-11 06:34:00",1462973640,"C8",276720,1463250360,"2016-05-14 11:26:00"
"6470","20161711061704-241",1,"2016-05-11 07:26:00",1462976760,"C6",270480,1463247240,"2016-05-14 10:34:00"
"4562","20165911075945-393",1,"2016-05-11 09:03:00",1462982580,"C4",132660,1463115240,"2016-05-12 21:54:00"
"4792","20162511082549-862",2,"2016-05-11 09:24:00",1462983840,"C7",210480,1463194320,"2016-05-13 19:52:00"
"3121","20162911092915-817",2,"2016-05-11 09:58:00",1462985880,"C4",284580,1463270460,"2016-05-14 17:01:00"
"5480","20160711110708-553",2,"2016-05-11 11:42:00",1462992120,"C0",508440,1463500560,"2016-05-17 08:56:00"
"6529","20165911025927-470",1,"2016-05-11 15:27:00",1463005620,"C4",232140,1463237760,"2016-05-14 07:56:00"
"2674","20160011040054-612",1,"2016-05-11 16:24:00",1463009040,"C5",412200,1463421240,"2016-05-16 10:54:00"
"3761","20160311050306-89",1,"2016-05-11 17:10:00",1463011800,"C4",250800,1463262600,"2016-05-14 14:50:00"
"4458","20160311050309-656",2,"2016-05-11 17:30:00",1463013000,"C4",49440,1463062440,"2016-05-12 07:14:00"
"5322","20162612072638-753",1,"2016-05-12 07:55:00",1463064900,"C5",183960,1463248860,"2016-05-14 11:01:00"
"1403","20161612071621-912",1,"2016-05-12 08:12:00",1463065920,"C7",178560,1463244480,"2016-05-14 09:48:00"
"4304","20162612082614-132",2,"2016-05-12 09:10:00",1463069400,"C8",177300,1463246700,"2016-05-14 10:25:00"
"5356","20160412100403-624",1,"2016-05-12 10:22:00",1463073720,"C0",631500,1463705220,"2016-05-19 17:47:00"
"4650","20161412101451-978",1,"2016-05-12 10:32:00",1463074320,"C0",271080,1463345400,"2016-05-15 13:50:00"
"3026","20165112105109-897",2,"2016-05-12 11:23:00",1463077380,"C3",155520,1463232900,"2016-05-14 06:35:00"
"832","20161912121924-319",1,"2016-05-12 13:19:00",1463084340,"C7",288000,1463372340,"2016-05-15 21:19:00"
"1346","20161112031156-198",2,"2016-05-12 15:55:00",1463093700,"C0",280320,1463374020,"2016-05-15 21:47:00"
"6238","20165712035713-404",3,"2016-05-12 16:32:00",1463095920,"C2",60240,1463156160,"2016-05-13 09:16:00"
"6427","20164912044955-331",1,"2016-05-12 17:43:00",1463100180,"C7",184200,1463284380,"2016-05-14 20:53:00"
"3388","20164212054245-135",1,"2016-05-12 18:03:00",1463101380,"C5",77880,1463179260,"2016-05-13 15:41:00"
"4779","20161213101216-677",1,"2016-05-13 10:17:00",1463159820,"C2",373320,1463533140,"2016-05-17 17:59:00"
"6555","20165313095326-823",1,"2016-05-13 10:19:00",1463159940,"C5",278520,1463438460,"2016-05-16 15:41:00"
"1653","20165213105244-282",3,"2016-05-13 11:12:00",1463163120,"C7",535740,1463698860,"2016-05-19 16:01:00"
"4980","20164713014745-616",1,"2016-05-13 14:12:00",1463173920,"C5",172560,1463346480,"2016-05-15 14:08:00"
"6511","20162213012243-861",1,"2016-05-13 14:19:00",1463174340,"C5",977880,1464152220,"2016-05-24 21:57:00"
"4746","20165813015832-479",2,"2016-05-13 14:28:00",1463174880,"C8",104880,1463279760,"2016-05-14 19:36:00"
"1904","20160813020801-597",2,"2016-05-13 14:37:00",1463175420,"C6",108960,1463284380,"2016-05-14 20:53:00"
"4016","20163413023412-159",1,"2016-05-13 14:49:00",1463176140,"C7",141900,1463318040,"2016-05-15 06:14:00"
"2107","20161613031621-889",1,"2016-05-13 16:17:00",1463181420,"C4",236100,1463417520,"2016-05-16 09:52:00"
"4132","20160414060432-270",1,"2016-05-14 06:10:00",1463231400,"C2",142980,1463374380,"2016-05-15 21:53:00"
"3252","20162014082012-197",1,"2016-05-14 08:26:00",1463239560,"C4",481980,1463721540,"2016-05-19 22:19:00"
"624","20162114082157-230",1,"2016-05-14 09:28:00",1463243280,"C2",182280,1463425560,"2016-05-16 12:06:00"
"1100","20165814095833-724",2,"2016-05-14 10:32:00",1463247120,"C0",253260,1463500380,"2016-05-17 08:53:00"
"1140","20161214011208-135",1,"2016-05-14 14:19:00",1463260740,"C0",57360,1463318100,"2016-05-15 06:15:00"
"1601","20164314024337-465",1,"2016-05-14 15:01:00",1463263260,"C6",330600,1463593860,"2016-05-18 10:51:00"
"2044","20163414033416-878",3,"2016-05-14 16:32:00",1463268720,"C2",186600,1463455320,"2016-05-16 20:22:00"
"2465","20161414041441-290",3,"2016-05-14 16:44:00",1463269440,"C0",405240,1463674680,"2016-05-19 09:18:00"
"6005","20163314053328-67",3,"2016-05-14 18:07:00",1463274420,"C2",499560,1463773980,"2016-05-20 12:53:00"
"5557","20163314053345-713",3,"2016-05-14 18:08:00",1463274480,"C8",70560,1463345040,"2016-05-15 13:44:00"
"2656","20162214052214-931",2,"2016-05-14 18:12:00",1463274720,"C8",535620,1463810340,"2016-05-20 22:59:00"
"4993","20160615090601-72",2,"2016-05-15 10:03:00",1463331780,"C8",91860,1463423640,"2016-05-16 11:34:00"
"2584","20164715104741-924",1,"2016-05-15 11:36:00",1463337360,"C8",245820,1463583180,"2016-05-18 07:53:00"
"6428","20161515101514-592",1,"2016-05-15 13:35:00",1463344500,"C2",278760,1463623260,"2016-05-18 19:01:00"
"474","20165815125818-188",1,"2016-05-15 14:04:00",1463346240,"C3",189360,1463535600,"2016-05-17 18:40:00"
"2702","20161615021657-872",3,"2016-05-15 14:50:00",1463349000,"C5",72960,1463421960,"2016-05-16 11:06:00"
"827","20162515022503-709",1,"2016-05-15 15:21:00",1463350860,"C8",249900,1463600760,"2016-05-18 12:46:00"
"514","20164115024151-5",1,"2016-05-15 15:41:00",1463352060,"C7",186840,1463538900,"2016-05-17 19:35:00"
"2432","20160715040757-420",2,"2016-05-15 16:40:00",1463355600,"C8",172380,1463527980,"2016-05-17 16:33:00"
"3047","20162015042050-853",1,"2016-05-15 16:41:00",1463355660,"C7",771000,1464126660,"2016-05-24 14:51:00"
"5405","20163015053019-83",2,"2016-05-15 17:53:00",1463359980,"C5",532440,1463892420,"2016-05-21 21:47:00"
"630","20164115054120-679",1,"2016-05-15 18:16:00",1463361360,"C6",249180,1463610540,"2016-05-18 15:29:00"
"1113","20164216084251-215",1,"2016-05-16 08:50:00",1463413800,"C8",706080,1464119880,"2016-05-24 12:58:00"
"3517","20163116093107-139",1,"2016-05-16 10:27:00",1463419620,"C5",423780,1463843400,"2016-05-21 08:10:00"
"4170","20165716115733-899",1,"2016-05-16 12:19:00",1463426340,"C6",848940,1464275280,"2016-05-26 08:08:00"
"1794","20162316122341-349",1,"2016-05-16 12:29:00",1463426940,"C2",275580,1463702520,"2016-05-19 17:02:00"
"1461","20164516124536-165",1,"2016-05-16 13:20:00",1463430000,"C3",95820,1463525820,"2016-05-17 15:57:00"
"1023","20165116035154-472",1,"2016-05-16 16:54:00",1463442840,"C0",95880,1463538720,"2016-05-17 19:32:00"
"2427","20161917061915-322",2,"2016-05-17 06:30:00",1463491800,"C3",377220,1463869020,"2016-05-21 15:17:00"
"1963","20165117075149-247",1,"2016-05-17 08:28:00",1463498880,"C3",1032720,1464531600,"2016-05-29 07:20:00"
"6518","20160317100339-729",1,"2016-05-17 10:39:00",1463506740,"C2",85740,1463592480,"2016-05-18 10:28:00"
"3104","20164717114725-131",2,"2016-05-17 12:48:00",1463514480,"C4",430200,1463944680,"2016-05-22 12:18:00"
"1268","20162317022350-38",1,"2016-05-17 14:48:00",1463521680,"C5",60300,1463581980,"2016-05-18 07:33:00"
"4642","20160017030016-746",2,"2016-05-17 15:32:00",1463524320,"C4",415980,1463940300,"2016-05-22 11:05:00"
"956","20162217032244-108",2,"2016-05-17 16:27:00",1463527620,"C5",174540,1463702160,"2016-05-19 16:56:00"
"5182","20163217053256-155",1,"2016-05-17 18:05:00",1463533500,"C0",318060,1463851560,"2016-05-21 10:26:00"
"6117","20161418061406-876",2,"2016-05-18 06:25:00",1463577900,"C3",269040,1463846940,"2016-05-21 09:09:00"
"3507","20161318071302-141",2,"2016-05-18 07:47:00",1463582820,"C5",309540,1463892360,"2016-05-21 21:46:00"
"696","20161618071617-763",2,"2016-05-18 07:50:00",1463583000,"C0",120600,1463703600,"2016-05-19 17:20:00"
"3051","20161818071801-292",1,"2016-05-18 07:52:00",1463583120,"C3",107940,1463691060,"2016-05-19 13:51:00"
"2886","20160418080421-476",2,"2016-05-18 08:10:00",1463584200,"C2",428220,1464012420,"2016-05-23 07:07:00"
"5192","20160418080457-245",1,"2016-05-18 09:02:00",1463587320,"C2",522180,1464109500,"2016-05-24 10:05:00"
"6051","20164618094655-835",1,"2016-05-18 10:50:00",1463593800,"C2",78300,1463672100,"2016-05-19 08:35:00"
"1359","20163118113139-316",1,"2016-05-18 12:41:00",1463600460,"C2",506100,1464106560,"2016-05-24 09:16:00"
"1818","20160618010659-729",2,"2016-05-18 13:51:00",1463604660,"C8",510480,1464115140,"2016-05-24 11:39:00"
"1745","20161918041903-606",1,"2016-05-18 17:17:00",1463617020,"C5",181200,1463798220,"2016-05-20 19:37:00"
"5128","20164718044740-123",1,"2016-05-18 18:04:00",1463619840,"C2",173340,1463793180,"2016-05-20 18:13:00"
"1182","20163419063429-101",3,"2016-05-19 07:25:00",1463667900,"C8",106320,1463774220,"2016-05-20 12:57:00"
"4645","20160419080431-102",1,"2016-05-19 08:32:00",1463671920,"C4",375840,1464047760,"2016-05-23 16:56:00"
"1799","20161319081321-100",3,"2016-05-19 09:03:00",1463673780,"C4",279120,1463952900,"2016-05-22 14:35:00"
"5116","20162119092147-990",2,"2016-05-19 09:55:00",1463676900,"C2",467880,1464144780,"2016-05-24 19:53:00"
"3311","20160219110233-416",1,"2016-05-19 11:10:00",1463681400,"C4",115560,1463796960,"2016-05-20 19:16:00"
"1878","20165319125305-907",1,"2016-05-19 13:14:00",1463688840,"C7",152460,1463841300,"2016-05-21 07:35:00"
"600","20165119025134-664",1,"2016-05-19 15:58:00",1463698680,"C3",76860,1463775540,"2016-05-20 13:19:00"
"6551","20164319034355-175",2,"2016-05-19 16:08:00",1463699280,"C5",190800,1463890080,"2016-05-21 21:08:00"
"648","20163020083029-640",1,"2016-05-20 09:36:00",1463762160,"C7",190500,1463952660,"2016-05-22 14:31:00"
"3849","20164220094251-139",1,"2016-05-20 10:13:00",1463764380,"C4",293160,1464057540,"2016-05-23 19:39:00"
"5946","20160920120951-598",1,"2016-05-20 12:41:00",1463773260,"C7",247080,1464020340,"2016-05-23 09:19:00"
"6026","20165320125359-334",1,"2016-05-20 13:12:00",1463775120,"C6",168360,1463943480,"2016-05-22 11:58:00"
"5530","20164020014058-615",2,"2016-05-20 14:38:00",1463780280,"C2",256980,1464037260,"2016-05-23 14:01:00"
"3648","20165920055941-216",1,"2016-05-20 18:14:00",1463793240,"C0",274500,1464067740,"2016-05-23 22:29:00"
"2630","20162421092429-563",1,"2016-05-21 10:26:00",1463851560,"C5",127140,1463978700,"2016-05-22 21:45:00"
"1389","20165621125656-604",1,"2016-05-21 14:02:00",1463864520,"C5",620400,1464484920,"2016-05-28 18:22:00"
"4181","20161121021106-144",1,"2016-05-21 14:45:00",1463867100,"C2",266280,1464133380,"2016-05-24 16:43:00"
"3558","20161421031451-792",1,"2016-05-21 15:36:00",1463870160,"C5",243960,1464114120,"2016-05-24 11:22:00"
"6115","20162621032632-655",1,"2016-05-21 16:01:00",1463871660,"C0",105480,1463977140,"2016-05-22 21:19:00"
"4857","20160521040514-90",1,"2016-05-21 16:49:00",1463874540,"C0",187140,1464061680,"2016-05-23 20:48:00"
"6476","20162921042944-446",3,"2016-05-21 16:55:00",1463874900,"C3",55440,1463930340,"2016-05-22 08:19:00"
"1893","20164322074326-978",1,"2016-05-22 08:40:00",1463931600,"C3",787320,1464718920,"2016-05-31 11:22:00"
"5626","20163922093934-985",1,"2016-05-22 10:29:00",1463938140,"C8",217740,1464155880,"2016-05-24 22:58:00"
"5825","20164622114647-721",3,"2016-05-22 12:14:00",1463944440,"C4",283140,1464227580,"2016-05-25 18:53:00"
"2567","20161222121219-49",1,"2016-05-22 13:08:00",1463947680,"C5",158280,1464105960,"2016-05-24 09:06:00"
"1222","20162222042259-769",1,"2016-05-22 16:29:00",1463959740,"C4",430680,1464390420,"2016-05-27 16:07:00"
"4684","20164222054243-411",3,"2016-05-22 18:12:00",1463965920,"C4",68640,1464034560,"2016-05-23 13:16:00"
"6528","20164622054644-414",2,"2016-05-22 18:52:00",1463968320,"C0",443340,1464411660,"2016-05-27 22:01:00"
"4208","20161523061558-393",1,"2016-05-23 07:31:00",1464013860,"C7",486660,1464500520,"2016-05-28 22:42:00"
"3512","20163223093205-573",1,"2016-05-23 09:55:00",1464022500,"C4",78420,1464100920,"2016-05-24 07:42:00"
"4477","20162323112359-854",1,"2016-05-23 11:39:00",1464028740,"C0",82380,1464111120,"2016-05-24 10:32:00"
"2618","20161623011642-809",1,"2016-05-23 14:10:00",1464037800,"C8",144180,1464181980,"2016-05-25 06:13:00"
"5306","20162823012818-280",2,"2016-05-23 14:27:00",1464038820,"C7",700800,1464739620,"2016-05-31 17:07:00"
"5903","20164923044905-91",3,"2016-05-23 17:49:00",1464050940,"C0",243600,1464294540,"2016-05-26 13:29:00"
"655","20165723055733-60",1,"2016-05-23 18:23:00",1464052980,"C4",140580,1464193560,"2016-05-25 09:26:00"
"6136","20165824065853-160",1,"2016-05-24 07:24:00",1464099840,"C4",167880,1464267720,"2016-05-26 06:02:00"
"4261","20160624070637-743",2,"2016-05-24 07:41:00",1464100860,"C7",87000,1464187860,"2016-05-25 07:51:00"
"596","20160424070451-587",1,"2016-05-24 07:58:00",1464101880,"C8",393840,1464495720,"2016-05-28 21:22:00"
"2536","20160124090148-920",1,"2016-05-24 09:22:00",1464106920,"C5",307680,1464414600,"2016-05-27 22:50:00"
"5871","20163724093730-240",3,"2016-05-24 10:34:00",1464111240,"C4",83880,1464195120,"2016-05-25 09:52:00"
"6455","20164724114712-44",2,"2016-05-24 12:08:00",1464116880,"C5",97260,1464214140,"2016-05-25 15:09:00"
"5351","20162824122829-498",1,"2016-05-24 12:57:00",1464119820,"C2",106140,1464225960,"2016-05-25 18:26:00"
"6177","20162224012201-227",1,"2016-05-24 14:15:00",1464124500,"C4",422820,1464547320,"2016-05-29 11:42:00"
"3535","20161224031222-354",1,"2016-05-24 16:06:00",1464131160,"C8",231960,1464363120,"2016-05-27 08:32:00"
"3903","20165024055011-688",3,"2016-05-24 18:14:00",1464138840,"C5",440940,1464579780,"2016-05-29 20:43:00"
"3031","20162425062418-198",1,"2016-05-25 06:32:00",1464183120,"C8",231300,1464414420,"2016-05-27 22:47:00"
"3638","20162125082144-48",3,"2016-05-25 08:38:00",1464190680,"C7",300900,1464491580,"2016-05-28 20:13:00"
"1066","20163125113148-504",2,"2016-05-25 12:19:00",1464203940,"C8",204180,1464408120,"2016-05-27 21:02:00"
"2853","20162925012937-610",2,"2016-05-25 13:35:00",1464208500,"C4",268620,1464477120,"2016-05-28 16:12:00"
"1738","20161625021649-105",2,"2016-05-25 14:40:00",1464212400,"C5",90720,1464303120,"2016-05-26 15:52:00"
"5519","20162125032104-263",2,"2016-05-25 15:50:00",1464216600,"C5",418620,1464635220,"2016-05-30 12:07:00"
"754","20162325052301-988",2,"2016-05-25 18:23:00",1464225780,"C2",178140,1464403920,"2016-05-27 19:52:00"
"3763","20164726074710-213",2,"2016-05-26 08:12:00",1464275520,"C8",210300,1464485820,"2016-05-28 18:37:00"
"56","20164026084027-353",2,"2016-05-26 09:14:00",1464279240,"C4",98580,1464377820,"2016-05-27 12:37:00"
"2572","20161226101220-113",1,"2016-05-26 10:43:00",1464284580,"C5",92640,1464377220,"2016-05-27 12:27:00"
"1709","20161326101328-758",1,"2016-05-26 11:17:00",1464286620,"C4",181440,1464468060,"2016-05-28 13:41:00"
"1229","20164826104846-825",1,"2016-05-26 11:24:00",1464287040,"C7",206640,1464493680,"2016-05-28 20:48:00"
"152","20164926124930-922",1,"2016-05-26 13:00:00",1464292800,"C3",349500,1464642300,"2016-05-30 14:05:00"
"4324","20160326030315-917",2,"2016-05-26 15:31:00",1464301860,"C5",145560,1464447420,"2016-05-28 07:57:00"
"3187","20162027072034-172",2,"2016-05-27 08:15:00",1464362100,"C4",79140,1464441240,"2016-05-28 06:14:00"
"6386","20162627082628-314",1,"2016-05-27 09:30:00",1464366600,"C4",111900,1464478500,"2016-05-28 16:35:00"
"4994","20165927105911-596",1,"2016-05-27 11:05:00",1464372300,"C8",82440,1464454740,"2016-05-28 09:59:00"
"6142","20162027042012-940",1,"2016-05-27 16:37:00",1464392220,"C1",144420,1464536640,"2016-05-29 08:44:00"
"6171","20161927041946-363",3,"2016-05-27 16:54:00",1464393240,"C7",99300,1464492540,"2016-05-28 20:29:00"
"5494","20164927034958-905",1,"2016-05-27 16:58:00",1464393480,"C8",266400,1464659880,"2016-05-30 18:58:00"
"1570","20163527043543-724",1,"2016-05-27 17:44:00",1464396240,"C3",222240,1464618480,"2016-05-30 07:28:00"
"592","20161228061242-834",1,"2016-05-28 07:12:00",1464444720,"C3",223260,1464667980,"2016-05-30 21:13:00"
"6415","20164728074737-670",1,"2016-05-28 08:49:00",1464450540,"C2",198060,1464648600,"2016-05-30 15:50:00"
"4022","20160728090757-429",1,"2016-05-28 09:42:00",1464453720,"C2",116160,1464569880,"2016-05-29 17:58:00"
"3980","20164128104138-234",1,"2016-05-28 11:04:00",1464458640,"C4",185760,1464644400,"2016-05-30 14:40:00"
"6307","20164028104033-812",3,"2016-05-28 11:37:00",1464460620,"C5",93480,1464554100,"2016-05-29 13:35:00"
"4393","20164028114031-155",1,"2016-05-28 12:51:00",1464465060,"C3",70200,1464535260,"2016-05-29 08:21:00"
"6082","20162828032836-807",2,"2016-05-28 16:11:00",1464477060,"C0",240180,1464717240,"2016-05-31 10:54:00"
"2098","20162629082608-704",1,"2016-05-29 08:50:00",1464537000,"C5",114720,1464651720,"2016-05-30 16:42:00"
"4153","20165529085512-11",1,"2016-05-29 09:09:00",1464538140,"C0",194460,1464732600,"2016-05-31 15:10:00"
"375","20165429105417-811",3,"2016-05-29 11:01:00",1464544860,"C4",85500,1464630360,"2016-05-30 10:46:00"
"4421","20160529040522-408",1,"2016-05-29 16:39:00",1464565140,"C2",104700,1464669840,"2016-05-30 21:44:00"
"5637","20163630103646-440",3,"2016-05-30 11:28:00",1464632880,"C5",68820,1464701700,"2016-05-31 06:35:00"
